system:index,AFG,BGR,LTR,PFG,SHR,TRE,Total,latitude,longitude
0,14,34,13,15,11,2,89,38.29073390135882,-109.3693918
1,12,37,13,13,11,3,89,38.29073390135882,-109.3691223
2,12,36,13,14,11,3,89,38.29073390135882,-109.3688528
3,11,34,13,15,12,2,87,38.29046440677358,-109.3693918
4,10,36,13,15,12,3,89,38.29046440677358,-109.3691223
5,10,36,13,13,11,4,87,38.29046440677358,-109.3688528
6,10,37,12,11,11,4,85,38.29046440677358,-109.3685833
7,9,37,12,11,12,4,85,38.29046440677358,-109.3683138
8,12,35,13,14,13,2,89,38.29046440677358,-109.3680443
9,14,35,13,14,10,2,88,38.29019491218835,-109.3693918
10,13,36,13,13,10,3,88,38.29019491218835,-109.3691223
11,13,36,13,13,9,4,88,38.29019491218835,-109.3688528
12,12,37,13,12,9,4,87,38.29019491218835,-109.3685833
13,10,38,12,10,10,5,85,38.29019491218835,-109.3683138
14,13,36,13,12,10,5,89,38.29019491218835,-109.3680443
15,13,33,13,16,11,3,89,38.29019491218835,-109.3677748
16,14,33,13,17,11,2,90,38.29019491218835,-109.3675053
17,14,31,13,18,11,2,89,38.29019491218835,-109.3672358
18,20,33,14,14,9,1,91,38.28992541760311,-109.3693918
19,18,34,14,13,8,2,89,38.28992541760311,-109.3691223
20,17,34,14,14,9,2,90,38.28992541760311,-109.3688528
21,17,33,13,14,9,2,88,38.28992541760311,-109.3685833
22,17,33,13,13,10,3,89,38.28992541760311,-109.3683138
23,18,31,13,16,9,2,89,38.28992541760311,-109.3680443
24,16,31,13,17,10,3,90,38.28992541760311,-109.3677748
25,14,33,13,16,11,3,90,38.28992541760311,-109.3675053
26,13,34,13,16,11,2,89,38.28992541760311,-109.3672358
27,12,33,13,18,12,2,90,38.28992541760311,-109.3669663
28,12,32,13,17,12,3,89,38.28992541760311,-109.3666968
29,15,30,13,16,11,3,88,38.28992541760311,-109.3664273
30,14,29,13,15,10,5,86,38.28992541760311,-109.3661578
31,32,24,14,16,6,1,93,38.289655923017875,-109.3693918
32,22,30,14,15,9,2,92,38.289655923017875,-109.3691223
33,16,33,13,13,9,3,87,38.289655923017875,-109.3688528
34,13,35,13,13,10,3,87,38.289655923017875,-109.3685833
35,16,34,13,13,10,2,88,38.289655923017875,-109.3683138
36,20,32,13,15,9,2,91,38.289655923017875,-109.3680443
37,16,33,13,15,10,3,90,38.289655923017875,-109.3677748
38,14,35,13,14,9,4,89,38.289655923017875,-109.3675053
39,13,36,13,13,10,4,89,38.289655923017875,-109.3672358
40,12,36,13,12,10,5,88,38.289655923017875,-109.3669663
41,12,34,13,14,11,4,88,38.289655923017875,-109.3666968
42,15,27,13,19,10,2,86,38.289655923017875,-109.3664273
43,19,23,12,25,10,1,90,38.289655923017875,-109.3661578
44,23,22,12,26,8,0,91,38.289655923017875,-109.3658883
45,21,24,12,24,8,1,90,38.289655923017875,-109.3656188
46,19,28,13,19,8,2,89,38.289655923017875,-109.3653493
47,48,16,9,12,1,0,86,38.289386428432636,-109.3693918
48,40,22,11,16,5,1,95,38.289386428432636,-109.3691223
49,29,27,12,14,8,1,91,38.289386428432636,-109.3688528
50,19,31,13,12,9,3,87,38.289386428432636,-109.3685833
51,14,36,13,12,10,4,89,38.289386428432636,-109.3683138
52,15,36,14,12,9,3,89,38.289386428432636,-109.3680443
53,19,33,13,13,9,2,89,38.289386428432636,-109.3677748
54,16,34,13,14,10,3,90,38.289386428432636,-109.3675053
55,14,35,13,13,10,4,89,38.289386428432636,-109.3672358
56,14,36,13,11,9,5,88,38.289386428432636,-109.3669663
57,15,33,13,11,9,5,86,38.289386428432636,-109.3666968
58,18,29,13,13,9,4,86,38.289386428432636,-109.3664273
59,22,24,12,22,9,0,89,38.289386428432636,-109.3661578
60,27,21,12,28,6,0,94,38.289386428432636,-109.3658883
61,28,20,11,29,5,0,93,38.289386428432636,-109.3656188
62,25,24,13,26,4,1,93,38.289386428432636,-109.3653493
63,20,29,13,18,7,2,89,38.289386428432636,-109.3650799
64,15,33,13,13,7,5,86,38.289386428432636,-109.3648104
65,48,17,12,14,3,1,95,38.28911693,-109.3693918
66,52,16,10,10,4,1,93,38.28911693,-109.3691223
67,49,17,11,11,5,1,94,38.28911693,-109.3688528
68,35,23,12,12,7,1,90,38.28911693,-109.3685833
69,24,29,12,12,9,2,88,38.28911693,-109.3683138
70,19,33,13,12,10,2,89,38.28911693,-109.3680443
71,21,31,13,12,9,3,89,38.28911693,-109.3677748
72,18,32,13,13,9,3,88,38.28911693,-109.3675053
73,15,35,13,13,9,4,89,38.28911693,-109.3672358
74,13,36,13,12,10,5,89,38.28911693,-109.3669663
75,15,34,13,12,9,5,88,38.28911693,-109.3666968
76,16,33,13,12,9,5,88,38.28911693,-109.3664273
77,17,29,13,14,9,3,85,38.28911693,-109.3661578
78,21,26,12,21,7,1,88,38.28911693,-109.3658883
79,26,21,11,28,5,0,91,38.28911693,-109.3656188
80,27,23,12,26,4,1,93,38.28911693,-109.3653493
81,23,28,12,19,6,1,89,38.28911693,-109.3650799
82,18,33,13,13,6,4,87,38.28911693,-109.3648104
83,11,34,13,12,8,6,84,38.28911693,-109.3645409
84,8,33,13,13,12,7,86,38.28911693,-109.3642714
85,5,32,14,10,15,9,85,38.28911693,-109.3640019
86,23,28,13,14,9,3,90,38.28884743926217,-109.3693918
87,34,21,13,16,6,2,92,38.28884743926217,-109.3691223
88,41,18,12,12,5,3,91,38.28884743926217,-109.3688528
89,44,17,11,13,5,2,92,38.28884743926217,-109.3685833
90,42,18,12,14,5,2,93,38.28884743926217,-109.3683138
91,37,20,13,12,5,3,90,38.28884743926217,-109.3680443
92,37,21,13,11,5,3,90,38.28884743926217,-109.3677748
93,29,26,13,12,6,3,89,38.28884743926217,-109.3675053
94,18,32,13,12,8,4,87,38.28884743926217,-109.3672358
95,14,34,13,12,10,4,87,38.28884743926217,-109.3669663
96,15,34,13,13,10,4,89,38.28884743926217,-109.3666968
97,15,34,13,12,9,5,88,38.28884743926217,-109.3664273
98,17,31,13,14,9,4,88,38.28884743926217,-109.3661578
99,20,28,12,19,9,1,89,38.28884743926217,-109.3658883
100,25,27,12,19,8,1,92,38.28884743926217,-109.3656188
101,29,26,12,18,6,0,91,38.28884743926217,-109.3653493
102,24,30,12,17,5,1,89,38.28884743926217,-109.3650799
103,19,32,12,15,6,3,87,38.28884743926217,-109.3648104
104,13,32,13,16,9,4,87,38.28884743926217,-109.3645409
105,9,30,13,18,13,4,87,38.28884743926217,-109.3642714
106,6,31,13,13,16,6,85,38.28884743926217,-109.3640019
107,5,32,14,11,16,8,86,38.28884743926217,-109.3637324
108,5,32,14,10,15,9,85,38.28884743926217,-109.3634629
109,5,30,15,11,14,11,86,38.28884743926217,-109.3631934
110,14,36,13,11,12,4,90,38.28857794467693,-109.3693918
111,26,28,13,14,8,2,91,38.28857794467693,-109.3691223
112,42,21,12,11,5,2,93,38.28857794467693,-109.3688528
113,48,19,11,8,5,3,94,38.28857794467693,-109.3685833
114,43,18,12,10,6,3,92,38.28857794467693,-109.3683138
115,38,18,13,14,6,3,92,38.28857794467693,-109.3680443
116,37,17,13,16,7,3,93,38.28857794467693,-109.3677748
117,34,19,13,14,6,3,89,38.28857794467693,-109.3675053
118,28,25,13,13,7,3,89,38.28857794467693,-109.3672358
119,20,31,13,13,9,3,89,38.28857794467693,-109.3669663
120,14,35,14,12,9,4,88,38.28857794467693,-109.3666968
121,14,34,14,12,9,5,88,38.28857794467693,-109.3664273
122,16,30,14,17,9,4,90,38.28857794467693,-109.3661578
123,16,29,13,19,8,3,88,38.28857794467693,-109.3658883
124,17,29,13,17,9,2,87,38.28857794467693,-109.3656188
125,20,32,13,14,8,3,90,38.28857794467693,-109.3653493
126,19,35,12,13,7,3,89,38.28857794467693,-109.3650799
127,17,35,12,15,8,3,90,38.28857794467693,-109.3648104
128,14,32,12,19,10,2,89,38.28857794467693,-109.3645409
129,11,28,12,22,14,1,88,38.28857794467693,-109.3642714
130,6,29,13,20,16,3,87,38.28857794467693,-109.3640019
131,6,29,14,15,16,5,85,38.28857794467693,-109.3637324
132,6,30,14,14,16,6,86,38.28857794467693,-109.3634629
133,6,29,15,12,16,7,85,38.28857794467693,-109.3631934
134,6,27,15,13,14,9,84,38.28857794467693,-109.3629239
135,7,24,16,14,12,12,85,38.28857794467693,-109.3626544
136,9,18,14,19,10,11,81,38.28857794467693,-109.3623849
137,11,37,14,13,14,2,91,38.28830845009169,-109.3693918
138,15,35,14,15,12,2,93,38.28830845009169,-109.3691223
139,20,31,13,16,11,1,92,38.28830845009169,-109.3688528
140,20,30,13,14,10,3,90,38.28830845009169,-109.3685833
141,19,29,13,14,10,3,88,38.28830845009169,-109.3683138
142,20,26,13,15,9,3,86,38.28830845009169,-109.3680443
143,36,18,14,15,6,2,91,38.28830845009169,-109.3677748
144,38,15,14,16,7,3,93,38.28830845009169,-109.3675053
145,35,18,14,14,7,3,91,38.28830845009169,-109.3672358
146,31,23,13,12,7,2,88,38.28830845009169,-109.3669663
147,21,31,13,12,8,2,87,38.28830845009169,-109.3666968
148,15,35,13,10,9,4,86,38.28830845009169,-109.3664273
149,14,33,13,14,10,4,88,38.28830845009169,-109.3661578
150,13,33,13,15,9,4,87,38.28830845009169,-109.3658883
151,11,33,13,13,9,5,84,38.28830845009169,-109.3656188
152,11,35,13,10,9,6,84,38.28830845009169,-109.3653493
153,11,35,13,15,9,3,86,38.28830845009169,-109.3650799
154,10,34,12,16,10,4,86,38.28830845009169,-109.3648104
155,8,32,13,18,12,4,87,38.28830845009169,-109.3645409
156,7,30,13,19,15,3,87,38.28830845009169,-109.3642714
157,6,28,13,22,15,4,88,38.28830845009169,-109.3640019
158,6,28,13,19,15,4,85,38.28830845009169,-109.3637324
159,6,28,13,17,16,4,84,38.28830845009169,-109.3634629
160,6,26,14,17,16,5,84,38.28830845009169,-109.3631934
161,6,24,14,18,15,6,83,38.28830845009169,-109.3629239
162,6,23,15,14,13,12,83,38.28830845009169,-109.3626544
163,8,19,14,18,10,12,81,38.28830845009169,-109.3623849
164,11,17,13,20,9,12,82,38.28830845009169,-109.3621154
165,9,16,13,18,10,12,78,38.28830845009169,-109.3618459
166,9,39,14,9,15,4,90,38.28803895550646,-109.3693918
167,11,37,15,13,14,2,92,38.28803895550646,-109.3691223
168,12,37,15,13,13,3,93,38.28803895550646,-109.3688528
169,11,37,14,11,12,4,89,38.28803895550646,-109.3685833
170,10,36,14,11,12,5,88,38.28803895550646,-109.3683138
171,13,32,14,11,12,5,87,38.28803895550646,-109.3680443
172,21,23,16,13,6,9,88,38.28803895550646,-109.3677748
173,30,17,15,16,7,5,90,38.28803895550646,-109.3675053
174,37,15,14,17,9,2,94,38.28803895550646,-109.3672358
175,38,17,13,14,8,2,92,38.28803895550646,-109.3669663
176,32,23,13,12,7,2,89,38.28803895550646,-109.3666968
177,22,29,13,13,8,3,88,38.28803895550646,-109.3664273
178,16,31,13,14,9,4,87,38.28803895550646,-109.3661578
179,14,33,13,13,10,4,87,38.28803895550646,-109.3658883
180,11,36,13,12,11,4,87,38.28803895550646,-109.3656188
181,8,37,13,9,12,6,85,38.28803895550646,-109.3653493
182,6,35,12,9,12,7,81,38.28803895550646,-109.3650799
183,6,34,13,13,14,6,86,38.28803895550646,-109.3648104
184,6,32,13,16,15,4,86,38.28803895550646,-109.3645409
185,7,30,13,16,15,5,86,38.28803895550646,-109.3642714
186,6,29,13,17,15,6,86,38.28803895550646,-109.3640019
187,6,28,13,20,15,4,86,38.28803895550646,-109.3637324
188,6,26,13,21,14,5,85,38.28803895550646,-109.3634629
189,6,24,13,22,13,5,83,38.28803895550646,-109.3631934
190,7,21,13,24,12,5,82,38.28803895550646,-109.3629239
191,7,20,13,21,12,8,81,38.28803895550646,-109.3626544
192,7,19,13,19,11,13,82,38.28803895550646,-109.3623849
193,12,17,12,20,8,15,84,38.28803895550646,-109.3621154
194,12,16,12,22,7,15,84,38.28803895550646,-109.3618459
195,6,14,14,10,6,22,72,38.28803895550646,-109.3615764
196,4,15,13,6,6,22,66,38.28803895550646,-109.3613069
197,2,18,13,4,5,22,64,38.28803895550646,-109.3610374
198,11,38,14,10,14,3,90,38.287769460921226,-109.3693918
199,12,36,15,12,14,3,92,38.287769460921226,-109.3691223
200,12,36,15,13,13,3,92,38.287769460921226,-109.3688528
201,13,35,15,14,13,3,93,38.287769460921226,-109.3685833
202,13,36,15,12,13,3,92,38.287769460921226,-109.3683138
203,12,35,14,12,12,4,89,38.287769460921226,-109.3680443
204,13,32,14,12,11,6,88,38.287769460921226,-109.3677748
205,26,25,14,12,7,5,89,38.287769460921226,-109.3675053
206,38,19,13,13,7,2,92,38.287769460921226,-109.3672358
207,41,17,12,13,7,1,91,38.287769460921226,-109.3669663
208,40,18,12,15,6,1,92,38.287769460921226,-109.3666968
209,30,23,13,21,6,1,94,38.287769460921226,-109.3664273
210,25,25,13,21,6,2,92,38.287769460921226,-109.3661578
211,19,28,14,16,8,3,88,38.287769460921226,-109.3658883
212,15,30,14,13,8,6,86,38.287769460921226,-109.3656188
213,16,29,13,16,9,4,87,38.287769460921226,-109.3653493
214,7,32,13,13,13,7,85,38.287769460921226,-109.3650799
215,5,32,13,13,15,6,84,38.287769460921226,-109.3648104
216,6,31,13,17,16,4,87,38.287769460921226,-109.3645409
217,6,30,13,17,15,5,86,38.287769460921226,-109.3642714
218,5,28,13,17,15,5,83,38.287769460921226,-109.3640019
219,8,26,12,21,15,4,86,38.287769460921226,-109.3637324
220,7,25,12,23,14,4,85,38.287769460921226,-109.3634629
221,6,24,12,25,14,4,85,38.287769460921226,-109.3631934
222,6,25,13,24,13,4,85,38.287769460921226,-109.3629239
223,8,24,13,21,12,6,84,38.287769460921226,-109.3626544
224,7,23,15,17,10,13,85,38.287769460921226,-109.3623849
225,14,18,12,22,7,13,86,38.287769460921226,-109.3621154
226,15,16,12,23,7,14,87,38.287769460921226,-109.3618459
227,5,22,16,9,6,25,83,38.287769460921226,-109.3615764
228,2,20,14,6,5,27,74,38.287769460921226,-109.3613069
229,0,26,13,5,4,23,71,38.287769460921226,-109.3610374
230,1,25,13,2,4,22,67,38.287769460921226,-109.3607679
231,0,27,14,0,5,21,67,38.287769460921226,-109.3604984
232,13,38,14,10,14,2,91,38.287499966335986,-109.3693918
233,15,36,15,12,13,2,93,38.287499966335986,-109.3691223
234,14,35,15,13,13,3,93,38.287499966335986,-109.3688528
235,12,36,14,13,13,4,92,38.287499966335986,-109.3685833
236,11,37,14,11,12,5,90,38.287499966335986,-109.3683138
237,10,37,14,10,12,6,89,38.287499966335986,-109.3680443
238,9,37,14,10,12,6,88,38.287499966335986,-109.3677748
239,12,35,14,10,11,6,88,38.287499966335986,-109.3675053
240,14,32,13,12,10,6,87,38.287499966335986,-109.3672358
241,20,27,13,13,8,5,86,38.287499966335986,-109.3669663
242,29,22,14,14,6,5,90,38.287499966335986,-109.3666968
243,35,18,12,21,6,1,93,38.287499966335986,-109.3664273
244,33,20,12,24,5,1,95,38.287499966335986,-109.3661578
245,31,23,13,23,4,1,95,38.287499966335986,-109.3658883
246,30,23,13,21,5,1,93,38.287499966335986,-109.3656188
247,28,21,12,25,6,1,93,38.287499966335986,-109.3653493
248,10,26,12,24,10,5,87,38.287499966335986,-109.3650799
249,6,28,12,20,14,5,85,38.287499966335986,-109.3648104
250,5,29,12,19,16,4,85,38.287499966335986,-109.3645409
251,5,29,12,21,15,4,86,38.287499966335986,-109.3642714
252,5,29,12,22,15,4,87,38.287499966335986,-109.3640019
253,6,28,12,19,16,4,85,38.287499966335986,-109.3637324
254,8,26,13,18,16,4,85,38.287499966335986,-109.3634629
255,7,26,13,16,15,6,83,38.287499966335986,-109.3631934
256,5,28,14,12,15,9,83,38.287499966335986,-109.3629239
257,4,28,15,10,14,13,84,38.287499966335986,-109.3626544
258,3,28,15,12,13,17,88,38.287499966335986,-109.3623849
259,5,25,15,16,10,18,89,38.287499966335986,-109.3621154
260,5,22,15,15,8,21,86,38.287499966335986,-109.3618459
261,2,24,17,7,6,29,85,38.287499966335986,-109.3615764
262,2,19,15,7,11,24,78,38.287499966335986,-109.3613069
263,1,25,13,6,10,21,76,38.287499966335986,-109.3610374
264,1,26,14,4,6,22,73,38.287499966335986,-109.3607679
265,0,24,15,0,3,25,67,38.287499966335986,-109.3604984
266,1,27,14,5,5,19,71,38.287499966335986,-109.360229
267,1,22,14,8,7,16,68,38.287499966335986,-109.3599595
268,10,38,14,9,14,4,89,38.28723047175075,-109.3693918
269,13,35,14,12,13,3,90,38.28723047175075,-109.3691223
270,12,36,13,12,13,4,90,38.28723047175075,-109.3688528
271,11,37,13,11,12,5,89,38.28723047175075,-109.3685833
272,11,38,14,10,12,6,91,38.28723047175075,-109.3683138
273,11,38,14,9,14,5,91,38.28723047175075,-109.3680443
274,12,37,14,11,14,4,92,38.28723047175075,-109.3677748
275,11,38,14,9,13,5,90,38.28723047175075,-109.3675053
276,11,39,13,10,13,5,91,38.28723047175075,-109.3672358
277,13,36,13,11,12,4,89,38.28723047175075,-109.3669663
278,21,28,13,14,9,3,88,38.28723047175075,-109.3666968
279,38,19,12,14,6,2,91,38.28723047175075,-109.3664273
280,43,16,10,20,4,1,94,38.28723047175075,-109.3661578
281,42,17,11,22,3,0,95,38.28723047175075,-109.3658883
282,37,19,12,23,4,0,95,38.28723047175075,-109.3656188
283,32,20,11,24,6,2,95,38.28723047175075,-109.3653493
284,9,28,13,19,14,5,88,38.28723047175075,-109.3650799
285,6,30,14,17,17,4,88,38.28723047175075,-109.3648104
286,5,31,14,16,17,4,87,38.28723047175075,-109.3645409
287,4,30,14,16,17,5,86,38.28723047175075,-109.3642714
288,5,29,13,18,17,4,86,38.28723047175075,-109.3640019
289,5,28,13,15,18,6,85,38.28723047175075,-109.3637324
290,4,28,14,12,17,8,83,38.28723047175075,-109.3634629
291,3,28,15,9,17,11,83,38.28723047175075,-109.3631934
292,5,24,14,12,10,17,82,38.28723047175075,-109.3629239
293,4,25,15,10,8,23,85,38.28723047175075,-109.3626544
294,2,34,15,9,10,17,87,38.28723047175075,-109.3623849
295,1,32,15,12,10,18,88,38.28723047175075,-109.3621154
296,0,30,16,12,9,22,89,38.28723047175075,-109.3618459
297,2,24,16,9,13,23,87,38.28723047175075,-109.3615764
298,1,17,14,11,14,18,75,38.28723047175075,-109.3613069
299,2,26,11,10,16,9,74,38.28723047175075,-109.3610374
300,1,30,13,6,12,15,77,38.28723047175075,-109.3607679
301,0,25,15,1,3,27,71,38.28723047175075,-109.3604984
302,0,27,15,2,4,25,73,38.28723047175075,-109.360229
303,0,25,16,5,7,18,71,38.28723047175075,-109.3599595
304,1,23,15,11,12,15,77,38.28723047175075,-109.35969
305,3,21,14,18,19,12,87,38.28723047175075,-109.3594205
306,12,36,13,10,14,4,89,38.28696097716551,-109.3693918
307,12,35,13,11,13,5,89,38.28696097716551,-109.3691223
308,10,36,13,11,13,5,88,38.28696097716551,-109.3688528
309,12,36,13,12,12,5,90,38.28696097716551,-109.3685833
310,12,35,13,13,12,4,89,38.28696097716551,-109.3683138
311,14,33,14,13,12,4,90,38.28696097716551,-109.3680443
312,20,31,14,14,9,4,92,38.28696097716551,-109.3677748
313,14,34,14,11,12,5,90,38.28696097716551,-109.3675053
314,13,35,14,11,13,4,90,38.28696097716551,-109.3672358
315,13,36,13,10,13,4,89,38.28696097716551,-109.3669663
316,13,36,13,11,13,4,90,38.28696097716551,-109.3666968
317,29,25,13,14,8,3,92,38.28696097716551,-109.3664273
318,52,14,9,14,6,2,97,38.28696097716551,-109.3661578
319,49,12,8,20,6,2,97,38.28696097716551,-109.3658883
320,36,15,10,26,6,2,95,38.28696097716551,-109.3656188
321,21,23,12,22,9,3,90,38.28696097716551,-109.3653493
322,7,31,14,16,16,4,88,38.28696097716551,-109.3650799
323,7,31,14,15,17,3,87,38.28696097716551,-109.3648104
324,6,31,14,14,18,4,87,38.28696097716551,-109.3645409
325,5,31,14,14,18,4,86,38.28696097716551,-109.3642714
326,5,30,14,16,18,5,88,38.28696097716551,-109.3640019
327,4,29,15,12,18,9,87,38.28696097716551,-109.3637324
328,3,29,16,7,15,15,85,38.28696097716551,-109.3634629
329,2,29,16,4,13,20,84,38.28696097716551,-109.3631934
330,5,21,15,8,7,24,80,38.28696097716551,-109.3629239
331,3,22,16,8,6,28,83,38.28696097716551,-109.3626544
332,1,28,16,2,14,23,84,38.28696097716551,-109.3623849
333,0,28,16,9,12,20,85,38.28696097716551,-109.3621154
334,1,24,14,16,9,19,83,38.28696097716551,-109.3618459
335,1,25,15,16,12,16,85,38.28696097716551,-109.3615764
336,1,19,13,14,16,12,75,38.28696097716551,-109.3613069
337,2,26,12,12,17,9,78,38.28696097716551,-109.3610374
338,0,29,14,7,9,18,77,38.28696097716551,-109.3607679
339,0,31,15,4,6,26,82,38.28696097716551,-109.3604984
340,0,28,16,3,4,29,80,38.28696097716551,-109.360229
341,0,26,15,3,5,25,74,38.28696097716551,-109.3599595
342,0,23,16,6,7,22,74,38.28696097716551,-109.35969
343,0,24,17,9,11,21,82,38.28696097716551,-109.3594205
344,1,25,16,9,14,18,83,38.28696097716551,-109.359151
345,1,25,14,9,10,20,79,38.28696097716551,-109.3588815
346,13,34,13,11,12,5,88,38.28669148258028,-109.3693918
347,12,34,13,12,11,6,88,38.28669148258028,-109.3691223
348,11,33,13,14,11,6,88,38.28669148258028,-109.3688528
349,11,34,13,14,11,5,88,38.28669148258028,-109.3685833
350,11,34,14,14,11,6,90,38.28669148258028,-109.3683138
351,13,31,15,13,11,6,89,38.28669148258028,-109.3680443
352,21,26,15,17,9,4,92,38.28669148258028,-109.3677748
353,15,29,15,16,9,5,89,38.28669148258028,-109.3675053
354,14,31,14,15,11,5,90,38.28669148258028,-109.3672358
355,11,35,14,12,13,5,90,38.28669148258028,-109.3669663
356,9,37,14,10,14,5,89,38.28669148258028,-109.3666968
357,20,27,13,15,13,1,89,38.28669148258028,-109.3664273
358,48,13,9,17,7,2,96,38.28669148258028,-109.3661578
359,52,10,8,19,7,2,98,38.28669148258028,-109.3658883
360,42,12,8,23,8,2,95,38.28669148258028,-109.3656188
361,36,16,9,22,8,2,93,38.28669148258028,-109.3653493
362,12,27,12,21,13,2,87,38.28669148258028,-109.3650799
363,8,30,13,17,16,2,86,38.28669148258028,-109.3648104
364,7,31,13,15,17,3,86,38.28669148258028,-109.3645409
365,5,31,14,14,17,5,86,38.28669148258028,-109.3642714
366,5,30,14,13,17,6,85,38.28669148258028,-109.3640019
367,4,29,15,10,16,11,85,38.28669148258028,-109.3637324
368,2,29,17,4,12,20,84,38.28669148258028,-109.3634629
369,3,28,16,2,8,25,82,38.28669148258028,-109.3631934
370,3,27,16,3,7,27,83,38.28669148258028,-109.3629239
371,3,27,16,1,11,26,84,38.28669148258028,-109.3626544
372,2,24,15,4,13,23,81,38.28669148258028,-109.3623849
373,1,21,14,9,12,18,75,38.28669148258028,-109.3621154
374,1,18,14,11,11,16,71,38.28669148258028,-109.3618459
375,2,25,12,15,15,11,80,38.28669148258028,-109.3615764
376,2,24,15,11,13,16,81,38.28669148258028,-109.3613069
377,2,25,15,10,12,16,80,38.28669148258028,-109.3610374
378,2,27,14,8,9,19,79,38.28669148258028,-109.3607679
379,0,28,16,5,7,25,81,38.28669148258028,-109.3604984
380,0,26,17,3,5,31,82,38.28669148258028,-109.360229
381,0,27,16,4,6,26,79,38.28669148258028,-109.3599595
382,0,27,17,5,7,25,81,38.28669148258028,-109.35969
383,0,27,19,4,6,27,83,38.28669148258028,-109.3594205
384,0,27,20,3,10,26,86,38.28669148258028,-109.359151
385,1,26,19,5,9,27,87,38.28669148258028,-109.3588815
386,1,27,17,8,12,20,85,38.28669148258028,-109.358612
387,2,28,15,10,11,15,81,38.28669148258028,-109.3583425
388,12,33,13,12,12,6,88,38.28642198799504,-109.3693918
389,12,29,15,14,10,9,89,38.28642198799504,-109.3691223
390,14,29,14,16,10,5,88,38.28642198799504,-109.3688528
391,12,31,14,15,11,5,88,38.28642198799504,-109.3685833
392,11,31,14,16,11,6,89,38.28642198799504,-109.3683138
393,13,28,14,19,10,5,89,38.28642198799504,-109.3680443
394,16,25,15,21,8,6,91,38.28642198799504,-109.3677748
395,13,28,15,19,9,5,89,38.28642198799504,-109.3675053
396,12,30,14,17,10,6,89,38.28642198799504,-109.3672358
397,10,33,14,13,11,7,88,38.28642198799504,-109.3669663
398,9,36,14,9,13,7,88,38.28642198799504,-109.3666968
399,12,32,14,13,14,4,89,38.28642198799504,-109.3664273
400,34,19,11,20,9,2,95,38.28642198799504,-109.3661578
401,42,13,8,22,8,2,95,38.28642198799504,-109.3658883
402,44,13,8,23,7,1,96,38.28642198799504,-109.3656188
403,42,14,8,24,7,1,96,38.28642198799504,-109.3653493
404,34,18,10,22,8,2,94,38.28642198799504,-109.3650799
405,19,23,12,21,11,1,87,38.28642198799504,-109.3648104
406,10,28,13,18,13,3,85,38.28642198799504,-109.3645409
407,8,29,14,16,14,4,85,38.28642198799504,-109.3642714
408,5,29,14,14,16,6,84,38.28642198799504,-109.3640019
409,4,31,15,10,16,10,86,38.28642198799504,-109.3637324
410,3,29,16,5,12,20,85,38.28642198799504,-109.3634629
411,3,26,16,2,7,26,80,38.28642198799504,-109.3631934
412,1,29,16,0,5,28,79,38.28642198799504,-109.3629239
413,1,27,15,1,10,23,77,38.28642198799504,-109.3626544
414,1,25,13,4,11,18,72,38.28642198799504,-109.3623849
415,0,22,12,6,14,16,70,38.28642198799504,-109.3621154
416,1,24,12,7,11,18,73,38.28642198799504,-109.3618459
417,1,27,15,8,8,20,79,38.28642198799504,-109.3615764
418,0,25,16,6,8,23,78,38.28642198799504,-109.3613069
419,1,26,17,7,8,22,81,38.28642198799504,-109.3610374
420,1,25,17,6,10,22,81,38.28642198799504,-109.3607679
421,1,25,17,5,8,26,82,38.28642198799504,-109.3604984
422,0,25,17,3,7,29,81,38.28642198799504,-109.360229
423,0,26,18,4,8,28,84,38.28642198799504,-109.3599595
424,0,26,18,4,7,27,82,38.28642198799504,-109.35969
425,0,25,19,4,7,29,84,38.28642198799504,-109.3594205
426,0,24,20,3,8,30,85,38.28642198799504,-109.359151
427,0,24,19,5,7,28,83,38.28642198799504,-109.3588815
428,0,26,18,4,7,28,83,38.28642198799504,-109.358612
429,0,22,16,4,6,24,72,38.28642198799504,-109.3583425
430,0,20,15,3,5,23,66,38.28642198799504,-109.358073
431,0,19,15,3,4,23,64,38.28642198799504,-109.3578035
432,11,32,14,13,12,6,88,38.28615249340981,-109.3693918
433,13,29,14,16,11,5,88,38.28615249340981,-109.3691223
434,13,29,14,18,10,5,89,38.28615249340981,-109.3688528
435,11,30,14,17,11,6,89,38.28615249340981,-109.3685833
436,12,28,14,18,11,6,89,38.28615249340981,-109.3683138
437,13,26,15,21,9,6,90,38.28615249340981,-109.3680443
438,14,26,15,21,7,6,89,38.28615249340981,-109.3677748
439,12,28,14,20,8,5,87,38.28615249340981,-109.3675053
440,11,30,14,17,10,6,88,38.28615249340981,-109.3672358
441,10,32,14,13,11,7,87,38.28615249340981,-109.3669663
442,9,34,14,10,13,8,88,38.28615249340981,-109.3666968
443,8,33,14,9,14,9,87,38.28615249340981,-109.3664273
444,17,24,14,18,12,6,91,38.28615249340981,-109.3661578
445,34,13,8,28,9,2,94,38.28615249340981,-109.3658883
446,39,12,8,26,7,1,93,38.28615249340981,-109.3656188
447,38,14,9,24,6,2,93,38.28615249340981,-109.3653493
448,35,15,9,26,6,1,92,38.28615249340981,-109.3650799
449,35,16,9,27,6,1,94,38.28615249340981,-109.3648104
450,27,19,10,27,8,2,93,38.28615249340981,-109.3645409
451,11,26,13,18,9,7,84,38.28615249340981,-109.3642714
452,7,32,14,13,13,6,85,38.28615249340981,-109.3640019
453,7,33,14,11,14,7,86,38.28615249340981,-109.3637324
454,6,29,15,7,12,15,84,38.28615249340981,-109.3634629
455,4,24,15,4,8,23,78,38.28615249340981,-109.3631934
456,3,25,16,1,7,28,80,38.28615249340981,-109.3629239
457,3,27,15,5,8,22,80,38.28615249340981,-109.3626544
458,1,27,11,6,12,12,69,38.28615249340981,-109.3623849
459,1,29,11,6,12,12,71,38.28615249340981,-109.3621154
460,0,30,12,5,13,14,74,38.28615249340981,-109.3618459
461,1,26,14,3,5,23,72,38.28615249340981,-109.3615764
462,0,23,14,3,5,22,67,38.28615249340981,-109.3613069
463,1,23,14,4,6,22,70,38.28615249340981,-109.3610374
464,0,23,15,4,6,24,72,38.28615249340981,-109.3607679
465,0,23,18,4,6,28,79,38.28615249340981,-109.3604984
466,1,24,17,5,8,28,83,38.28615249340981,-109.360229
467,1,23,16,6,9,27,82,38.28615249340981,-109.3599595
468,0,25,17,4,7,29,82,38.28615249340981,-109.35969
469,1,26,18,4,7,27,83,38.28615249340981,-109.3594205
470,1,25,18,6,9,25,84,38.28615249340981,-109.359151
471,1,24,19,6,9,27,86,38.28615249340981,-109.3588815
472,0,24,18,4,6,28,80,38.28615249340981,-109.358612
473,0,23,16,3,5,26,73,38.28615249340981,-109.3583425
474,0,22,16,4,5,24,71,38.28615249340981,-109.358073
475,0,20,16,3,5,25,69,38.28615249340981,-109.3578035
476,0,21,16,1,3,26,67,38.28615249340981,-109.357534
477,0,19,18,2,4,31,74,38.28615249340981,-109.3572645
478,13,30,14,15,11,5,88,38.285882998824576,-109.3693918
479,14,29,14,17,10,4,88,38.285882998824576,-109.3691223
480,15,27,15,18,9,5,89,38.285882998824576,-109.3688528
481,13,26,15,19,9,6,88,38.285882998824576,-109.3685833
482,13,25,15,20,9,6,88,38.285882998824576,-109.3683138
483,14,26,15,19,9,7,90,38.285882998824576,-109.3680443
484,13,28,14,17,8,8,88,38.285882998824576,-109.3677748
485,13,28,14,18,8,6,87,38.285882998824576,-109.3675053
486,10,29,14,17,9,8,87,38.285882998824576,-109.3672358
487,9,31,15,12,11,9,87,38.285882998824576,-109.3669663
488,7,31,15,9,12,11,85,38.285882998824576,-109.3666968
489,7,31,15,9,12,12,86,38.285882998824576,-109.3664273
490,10,24,16,16,10,12,88,38.285882998824576,-109.3661578
491,24,15,10,30,10,4,93,38.285882998824576,-109.3658883
492,35,10,9,30,9,2,95,38.285882998824576,-109.3656188
493,35,12,9,27,8,2,93,38.285882998824576,-109.3653493
494,41,14,9,22,6,2,94,38.285882998824576,-109.3650799
495,39,13,9,26,4,1,92,38.285882998824576,-109.3648104
496,36,14,9,29,6,1,95,38.285882998824576,-109.3645409
497,28,18,10,26,7,3,92,38.285882998824576,-109.3642714
498,13,28,14,13,10,8,86,38.285882998824576,-109.3640019
499,11,25,13,12,11,8,80,38.285882998824576,-109.3637324
500,13,23,14,14,10,11,85,38.285882998824576,-109.3634629
501,8,22,15,10,10,19,84,38.285882998824576,-109.3631934
502,5,22,15,7,5,27,81,38.285882998824576,-109.3629239
503,5,24,14,11,4,20,78,38.285882998824576,-109.3626544
504,2,29,11,7,13,11,73,38.285882998824576,-109.3623849
505,3,28,10,5,13,12,71,38.285882998824576,-109.3621154
506,2,25,11,4,12,13,67,38.285882998824576,-109.3618459
507,2,24,12,4,8,18,68,38.285882998824576,-109.3615764
508,1,25,12,4,7,18,67,38.285882998824576,-109.3613069
509,2,25,13,4,6,19,69,38.285882998824576,-109.3610374
510,2,20,14,5,5,22,68,38.285882998824576,-109.3607679
511,1,19,15,5,6,24,70,38.285882998824576,-109.3604984
512,0,25,16,7,9,25,82,38.285882998824576,-109.360229
513,1,25,17,5,7,28,83,38.285882998824576,-109.3599595
514,0,25,16,4,5,27,77,38.285882998824576,-109.35969
515,0,25,15,4,6,24,74,38.285882998824576,-109.3594205
516,0,25,14,5,7,21,72,38.285882998824576,-109.359151
517,1,31,16,7,7,21,83,38.285882998824576,-109.3588815
518,0,28,15,2,5,26,76,38.285882998824576,-109.358612
519,0,25,16,2,4,28,75,38.285882998824576,-109.3583425
520,0,24,17,3,4,29,77,38.285882998824576,-109.358073
521,0,26,19,3,7,28,83,38.285882998824576,-109.3578035
522,1,27,17,4,6,24,79,38.285882998824576,-109.357534
523,1,31,17,6,7,20,82,38.285882998824576,-109.3572645
524,0,23,16,2,5,26,72,38.285882998824576,-109.356995
525,1,23,18,2,7,28,79,38.285882998824576,-109.3567255
526,12,29,15,14,10,7,87,38.285613504239336,-109.3693918
527,13,28,14,17,9,6,87,38.285613504239336,-109.3691223
528,14,25,13,24,6,5,87,38.285613504239336,-109.3688528
529,14,23,13,26,6,6,88,38.285613504239336,-109.3685833
530,13,24,14,22,7,8,88,38.285613504239336,-109.3683138
531,11,26,15,17,9,8,86,38.285613504239336,-109.3680443
532,12,27,14,14,9,8,84,38.285613504239336,-109.3677748
533,14,28,14,16,10,5,87,38.285613504239336,-109.3675053
534,13,29,14,17,9,6,88,38.285613504239336,-109.3672358
535,11,30,15,12,11,9,88,38.285613504239336,-109.3669663
536,9,29,15,10,11,11,85,38.285613504239336,-109.3666968
537,10,27,17,13,10,11,88,38.285613504239336,-109.3664273
538,13,22,15,20,9,10,89,38.285613504239336,-109.3661578
539,17,18,13,26,9,9,92,38.285613504239336,-109.3658883
540,24,14,11,28,10,5,92,38.285613504239336,-109.3656188
541,32,11,9,32,9,2,95,38.285613504239336,-109.3653493
542,40,13,10,22,7,2,94,38.285613504239336,-109.3650799
543,39,13,9,22,6,2,91,38.285613504239336,-109.3648104
544,39,12,9,24,6,1,91,38.285613504239336,-109.3645409
545,37,12,9,28,6,1,93,38.285613504239336,-109.3642714
546,32,14,10,29,8,1,94,38.285613504239336,-109.3640019
547,26,15,10,30,9,2,92,38.285613504239336,-109.3637324
548,24,14,10,31,12,3,94,38.285613504239336,-109.3634629
549,16,15,12,19,11,16,89,38.285613504239336,-109.3631934
550,5,16,15,5,5,26,72,38.285613504239336,-109.3629239
551,1,16,13,3,5,20,58,38.285613504239336,-109.3626544
552,3,20,10,8,12,8,61,38.285613504239336,-109.3623849
553,4,21,9,8,10,8,60,38.285613504239336,-109.3621154
554,6,21,10,5,9,10,61,38.285613504239336,-109.3618459
555,6,25,10,2,5,12,60,38.285613504239336,-109.3615764
556,4,23,11,1,4,15,58,38.285613504239336,-109.3613069
557,3,24,11,5,9,12,64,38.285613504239336,-109.3610374
558,4,22,11,8,10,12,67,38.285613504239336,-109.3607679
559,3,21,13,8,10,13,68,38.285613504239336,-109.3604984
560,1,23,14,6,6,22,72,38.285613504239336,-109.360229
561,1,28,15,6,7,21,78,38.285613504239336,-109.3599595
562,2,28,15,6,11,16,78,38.285613504239336,-109.35969
563,3,29,15,9,12,12,80,38.285613504239336,-109.3594205
564,3,30,15,9,11,13,81,38.285613504239336,-109.359151
565,3,29,14,9,11,11,77,38.285613504239336,-109.3588815
566,2,31,14,6,11,11,75,38.285613504239336,-109.358612
567,0,31,14,3,7,17,72,38.285613504239336,-109.3583425
568,0,32,15,5,6,20,78,38.285613504239336,-109.358073
569,1,28,18,5,5,25,82,38.285613504239336,-109.3578035
570,0,27,17,4,7,25,80,38.285613504239336,-109.357534
571,0,27,17,3,6,25,78,38.285613504239336,-109.3572645
572,1,24,16,2,5,22,70,38.285613504239336,-109.356995
573,2,30,14,3,8,17,74,38.285613504239336,-109.3567255
574,2,27,15,2,6,20,72,38.285613504239336,-109.356456
575,6,21,17,5,13,24,86,38.285613504239336,-109.3561865
576,2,33,11,0,9,17,72,38.28534401,-109.4208652
577,1,32,10,0,9,16,68,38.28534401,-109.4205957
578,1,29,11,0,8,18,67,38.28534401,-109.4203262
579,1,30,12,0,9,20,72,38.28534401,-109.4200568
580,1,31,12,0,9,19,72,38.28534401,-109.4197873
581,2,31,12,0,9,19,73,38.28534401,-109.4195178
582,2,32,12,1,8,20,75,38.28534401,-109.4192483
583,1,38,11,0,9,17,76,38.28534401,-109.4189788
584,1,38,11,0,9,17,76,38.28534401,-109.4187093
585,2,39,11,0,10,16,78,38.28534401,-109.4184398
586,1,40,11,0,10,15,77,38.28534401,-109.4181703
587,2,32,11,0,8,18,71,38.28534401,-109.4179008
588,2,32,11,0,8,17,70,38.28534401,-109.4176313
589,2,34,11,0,8,17,72,38.28534401,-109.4173618
590,2,34,11,0,8,17,72,38.28534401,-109.4170923
591,1,33,11,0,9,17,71,38.28534401,-109.4168228
592,0,38,10,0,12,11,71,38.28534401,-109.4165533
593,1,34,10,0,10,12,67,38.28534401,-109.4162838
594,1,28,11,0,10,15,65,38.28534401,-109.4160143
595,1,28,11,0,7,18,65,38.28534401,-109.4157448
596,1,34,10,0,9,16,70,38.28534401,-109.4154753
597,2,37,11,0,13,13,76,38.28534401,-109.4152058
598,2,31,12,1,10,17,73,38.28534401,-109.4149364
599,2,28,12,2,8,19,71,38.28534401,-109.4146669
600,2,36,13,2,12,14,79,38.28534401,-109.4143974
601,2,39,12,3,14,11,81,38.28534401,-109.4141279
602,2,40,12,1,13,12,80,38.28534401,-109.4138584
603,1,37,11,0,10,15,74,38.28534401,-109.4135889
604,2,35,11,0,9,16,73,38.28534401,-109.4133194
605,1,37,10,0,10,15,73,38.28534401,-109.4130499
606,2,39,10,0,11,12,74,38.28534401,-109.4127804
607,1,39,10,0,11,13,74,38.28534401,-109.4125109
608,1,38,11,0,11,14,75,38.28534401,-109.4122414
609,1,39,11,0,11,14,76,38.28534401,-109.4119719
610,2,32,11,0,9,17,71,38.28534401,-109.4117024
611,1,33,11,0,8,17,70,38.28534401,-109.4114329
612,1,31,12,0,10,16,70,38.28534401,-109.4111634
613,1,30,12,0,8,18,69,38.28534401,-109.4108939
614,1,28,11,0,7,19,66,38.28534401,-109.4106244
615,1,28,13,0,6,23,71,38.28534401,-109.4103549
616,1,26,14,0,6,22,69,38.28534401,-109.4100855
617,1,24,13,1,7,19,65,38.28534401,-109.409816
618,1,24,12,1,7,18,63,38.28534401,-109.4095465
619,2,31,12,0,9,17,71,38.28534401,-109.409277
620,1,35,9,0,9,14,68,38.28534401,-109.4090075
621,1,38,9,0,10,11,69,38.28534401,-109.408738
622,1,36,10,1,11,11,70,38.28534401,-109.4084685
623,1,34,10,1,11,12,69,38.28534401,-109.408199
624,2,35,10,2,12,9,70,38.28534401,-109.4079295
625,3,39,11,5,13,6,77,38.28534401,-109.40766
626,4,40,12,6,14,5,81,38.28534401,-109.4073905
627,5,39,12,7,14,4,81,38.28534401,-109.407121
628,5,39,12,8,15,3,82,38.28534401,-109.4068515
629,6,32,14,11,18,6,87,38.28534401,-109.3877174
630,5,36,14,3,17,11,86,38.28534401,-109.3874479
631,4,38,14,2,16,12,86,38.28534401,-109.3871784
632,4,37,15,3,14,13,86,38.28534401,-109.3869089
633,5,34,16,4,12,15,86,38.28534401,-109.3866394
634,5,30,17,5,12,16,85,38.28534401,-109.3863699
635,5,31,17,2,10,21,86,38.28534401,-109.3861004
636,5,28,17,1,8,25,84,38.28534401,-109.3858309
637,3,29,17,0,8,26,83,38.28534401,-109.3855614
638,4,34,16,1,12,19,86,38.28534401,-109.3852919
639,7,28,16,11,14,9,85,38.28534401,-109.3850225
640,5,28,15,11,15,8,82,38.28534401,-109.384753
641,3,30,15,9,15,11,83,38.28534401,-109.3844835
642,3,32,14,7,15,11,82,38.28534401,-109.384214
643,3,31,15,6,16,13,84,38.28534401,-109.3839445
644,5,27,14,11,16,9,82,38.28534401,-109.383675
645,7,23,14,17,15,5,81,38.28534401,-109.3834055
646,7,23,13,19,15,5,82,38.28534401,-109.383136
647,4,26,14,15,16,7,82,38.28534401,-109.3828665
648,5,29,15,11,16,9,85,38.28534401,-109.382597
649,7,31,15,10,15,9,87,38.28534401,-109.3823275
650,6,33,14,8,15,9,85,38.28534401,-109.382058
651,6,35,14,6,17,9,87,38.28534401,-109.3817885
652,8,35,13,8,15,6,85,38.28534401,-109.381519
653,6,35,13,8,14,7,83,38.28534401,-109.3812495
654,7,31,14,8,13,11,84,38.28534401,-109.38098
655,8,27,15,8,11,15,84,38.28534401,-109.3807105
656,6,26,16,6,12,18,84,38.28534401,-109.380441
657,5,29,15,8,15,13,85,38.28534401,-109.3801716
658,5,30,15,8,16,12,86,38.28534401,-109.3799021
659,5,31,15,9,16,10,86,38.28534401,-109.3796326
660,6,31,14,11,16,7,85,38.28534401,-109.3793631
661,6,31,14,12,16,6,85,38.28534401,-109.3790936
662,8,31,14,11,15,7,86,38.28534401,-109.3788241
663,7,33,14,10,16,7,87,38.28534401,-109.3785546
664,6,35,14,8,17,7,87,38.28534401,-109.3782851
665,7,34,14,8,17,6,86,38.28534401,-109.3780156
666,7,33,14,12,17,5,88,38.28534401,-109.3777461
667,6,33,13,11,18,5,86,38.28534401,-109.3774766
668,7,34,13,11,18,4,87,38.28534401,-109.3772071
669,6,34,13,11,18,4,86,38.28534401,-109.3769376
670,6,34,13,11,18,4,86,38.28534401,-109.3766681
671,6,35,13,10,18,4,86,38.28534401,-109.3763986
672,6,35,13,10,19,3,86,38.28534401,-109.3761291
673,6,36,12,9,20,3,86,38.28534401,-109.3758596
674,5,36,12,9,21,3,86,38.28534401,-109.3755901
675,5,36,12,10,21,2,86,38.28534401,-109.3753206
676,4,37,12,10,21,2,86,38.28534401,-109.3750512
677,4,36,12,13,20,3,88,38.28534401,-109.3747817
678,4,29,11,21,16,3,84,38.28534401,-109.3745122
679,4,23,10,19,16,3,75,38.28534401,-109.3742427
680,4,25,10,23,17,2,81,38.28534401,-109.3739732
681,4,32,12,18,15,4,85,38.28534401,-109.3737037
682,5,34,12,13,17,4,85,38.28534401,-109.3734342
683,5,32,13,15,17,5,87,38.28534401,-109.3731647
684,5,29,13,16,17,6,86,38.28534401,-109.3728952
685,5,28,13,19,15,6,86,38.28534401,-109.3726257
686,10,29,12,20,12,5,88,38.28534401,-109.3723562
687,12,31,12,19,10,5,89,38.28534401,-109.3720867
688,10,32,12,17,10,5,86,38.28534401,-109.3718172
689,8,31,13,15,10,6,83,38.28534401,-109.3715477
690,8,31,13,14,10,5,81,38.28534401,-109.3712782
691,9,31,13,15,11,5,84,38.28534401,-109.3710087
692,10,31,13,16,11,4,85,38.28534401,-109.3707392
693,11,31,13,17,10,4,86,38.28534401,-109.3704697
694,15,29,14,17,10,3,88,38.28534401,-109.3702003
695,14,29,14,15,12,5,89,38.28534401,-109.3699308
696,11,28,15,11,10,10,85,38.28534401,-109.3696613
697,11,28,15,11,10,11,86,38.28534401,-109.3693918
698,12,27,15,16,8,9,87,38.28534401,-109.3691223
699,12,24,14,22,6,9,87,38.28534401,-109.3688528
700,15,22,12,26,7,7,89,38.28534401,-109.3685833
701,9,24,13,18,11,11,86,38.28534401,-109.3683138
702,3,26,17,9,11,20,86,38.28534401,-109.3680443
703,6,26,16,13,9,16,86,38.28534401,-109.3677748
704,9,26,15,17,8,10,85,38.28534401,-109.3675053
705,10,27,15,15,10,10,87,38.28534401,-109.3672358
706,12,26,15,13,10,10,86,38.28534401,-109.3669663
707,13,22,16,16,9,10,86,38.28534401,-109.3666968
708,15,19,14,24,8,8,88,38.28534401,-109.3664273
709,13,19,15,22,9,12,90,38.28534401,-109.3661578
710,11,19,16,20,10,15,91,38.28534401,-109.3658883
711,12,18,15,19,10,17,91,38.28534401,-109.3656188
712,20,15,11,26,11,11,94,38.28534401,-109.3653493
713,35,12,9,24,10,3,93,38.28534401,-109.3650799
714,38,12,9,24,7,2,92,38.28534401,-109.3648104
715,40,13,9,23,6,2,93,38.28534401,-109.3645409
716,38,11,9,26,8,2,94,38.28534401,-109.3642714
717,36,9,9,32,7,2,95,38.28534401,-109.3640019
718,30,11,9,33,10,2,95,38.28534401,-109.3637324
719,24,12,9,33,11,4,93,38.28534401,-109.3634629
720,16,15,11,23,12,12,89,38.28534401,-109.3631934
721,4,17,15,8,8,25,77,38.28534401,-109.3629239
722,1,16,14,4,5,22,62,38.28534401,-109.3626544
723,1,26,11,4,10,11,63,38.28534401,-109.3623849
724,2,28,8,4,10,8,60,38.28534401,-109.3621154
725,3,28,7,5,9,7,59,38.28534401,-109.3618459
726,4,29,7,5,7,7,59,38.28534401,-109.3615764
727,3,23,8,6,7,8,55,38.28534401,-109.3613069
728,3,21,8,6,7,8,53,38.28534401,-109.3610374
729,5,22,8,6,8,8,57,38.28534401,-109.3607679
730,4,22,10,6,11,9,62,38.28534401,-109.3604984
731,4,24,12,9,12,12,73,38.28534401,-109.360229
732,2,25,12,9,13,10,71,38.28534401,-109.3599595
733,2,28,11,6,15,10,72,38.28534401,-109.35969
734,2,28,15,6,12,15,78,38.28534401,-109.3594205
735,2,28,17,6,7,20,80,38.28534401,-109.359151
736,0,28,15,5,9,16,73,38.28534401,-109.3588815
737,2,32,15,2,9,17,77,38.28534401,-109.358612
738,3,31,15,2,7,17,75,38.28534401,-109.3583425
739,1,30,14,3,7,17,72,38.28534401,-109.358073
740,0,28,13,5,7,15,68,38.28534401,-109.3578035
741,1,27,13,4,8,15,68,38.28534401,-109.357534
742,0,21,16,1,3,26,67,38.28534401,-109.3572645
743,3,22,17,4,4,20,70,38.28534401,-109.356995
744,5,26,17,5,5,15,73,38.28534401,-109.3567255
745,3,22,17,7,5,19,73,38.28534401,-109.356456
746,11,18,15,11,16,14,85,38.28534401,-109.3561865
747,9,14,12,19,25,11,90,38.28534401,-109.355917
748,5,11,13,28,25,10,92,38.28534401,-109.3556475
749,2,31,13,1,7,20,74,38.285074515068864,-109.4214042
750,2,32,12,0,9,19,74,38.285074515068864,-109.4211347
751,2,31,12,0,9,19,73,38.285074515068864,-109.4208652
752,1,29,12,0,8,21,71,38.285074515068864,-109.4205957
753,1,29,14,0,6,24,74,38.285074515068864,-109.4203262
754,1,29,14,0,6,24,74,38.285074515068864,-109.4200568
755,1,29,14,0,6,24,74,38.285074515068864,-109.4197873
756,1,29,14,0,7,24,75,38.285074515068864,-109.4195178
757,1,29,13,0,7,23,73,38.285074515068864,-109.4192483
758,1,31,13,0,7,21,73,38.285074515068864,-109.4189788
759,1,32,12,0,8,20,73,38.285074515068864,-109.4187093
760,1,34,11,0,9,18,73,38.285074515068864,-109.4184398
761,1,36,10,0,9,16,72,38.285074515068864,-109.4181703
762,1,34,10,0,7,17,69,38.285074515068864,-109.4179008
763,1,36,9,0,9,14,69,38.285074515068864,-109.4176313
764,1,37,9,0,10,13,70,38.285074515068864,-109.4173618
765,1,38,9,0,9,13,70,38.285074515068864,-109.4170923
766,1,40,9,0,10,11,71,38.285074515068864,-109.4168228
767,0,44,9,0,14,6,73,38.285074515068864,-109.4165533
768,2,36,10,0,13,9,70,38.285074515068864,-109.4162838
769,1,30,11,0,12,13,67,38.285074515068864,-109.4160143
770,1,30,11,0,7,18,67,38.285074515068864,-109.4157448
771,1,34,10,0,9,16,70,38.285074515068864,-109.4154753
772,1,34,11,0,10,15,71,38.285074515068864,-109.4152058
773,1,32,10,0,7,17,67,38.285074515068864,-109.4149364
774,2,32,10,0,7,18,69,38.285074515068864,-109.4146669
775,1,33,10,0,9,15,68,38.285074515068864,-109.4143974
776,1,36,11,1,13,10,72,38.285074515068864,-109.4141279
777,1,36,11,0,11,12,71,38.285074515068864,-109.4138584
778,2,35,11,0,10,14,72,38.285074515068864,-109.4135889
779,2,33,11,0,9,15,70,38.285074515068864,-109.4133194
780,1,36,10,0,10,14,71,38.285074515068864,-109.4130499
781,2,37,9,0,8,13,69,38.285074515068864,-109.4127804
782,1,36,9,0,9,14,69,38.285074515068864,-109.4125109
783,1,34,10,0,9,15,69,38.285074515068864,-109.4122414
784,1,36,11,0,11,14,73,38.285074515068864,-109.4119719
785,2,38,11,0,11,15,77,38.285074515068864,-109.4117024
786,1,35,12,0,10,18,76,38.285074515068864,-109.4114329
787,1,31,12,0,7,23,74,38.285074515068864,-109.4111634
788,0,32,13,0,6,25,76,38.285074515068864,-109.4108939
789,0,32,13,0,7,24,76,38.285074515068864,-109.4106244
790,0,29,14,0,7,25,75,38.285074515068864,-109.4103549
791,1,28,14,2,7,22,74,38.285074515068864,-109.4100855
792,2,25,14,1,6,22,70,38.285074515068864,-109.409816
793,2,25,14,0,4,23,68,38.285074515068864,-109.4095465
794,1,26,13,0,5,22,67,38.285074515068864,-109.409277
795,2,30,11,0,7,17,67,38.285074515068864,-109.4090075
796,1,34,10,0,10,14,69,38.285074515068864,-109.408738
797,1,36,9,0,10,13,69,38.285074515068864,-109.4084685
798,1,38,11,0,12,12,74,38.285074515068864,-109.408199
799,3,39,12,3,12,9,78,38.285074515068864,-109.4079295
800,3,41,11,5,13,6,79,38.285074515068864,-109.40766
801,3,38,11,5,13,7,77,38.285074515068864,-109.4073905
802,3,37,12,6,14,5,77,38.285074515068864,-109.407121
803,7,36,13,9,15,3,83,38.285074515068864,-109.4068515
804,6,27,14,16,14,7,84,38.285074515068864,-109.3877174
805,6,30,14,10,14,9,83,38.285074515068864,-109.3874479
806,5,36,14,3,14,11,83,38.285074515068864,-109.3871784
807,5,38,13,1,13,11,81,38.285074515068864,-109.3869089
808,6,33,14,4,12,12,81,38.285074515068864,-109.3866394
809,5,30,18,3,9,20,85,38.285074515068864,-109.3863699
810,5,28,18,0,8,26,85,38.285074515068864,-109.3861004
811,4,26,19,0,6,28,83,38.285074515068864,-109.3858309
812,4,28,17,0,6,26,81,38.285074515068864,-109.3855614
813,5,29,16,4,11,18,83,38.285074515068864,-109.3852919
814,7,25,15,11,14,9,81,38.285074515068864,-109.3850225
815,7,25,15,11,15,8,81,38.285074515068864,-109.384753
816,6,29,14,9,14,9,81,38.285074515068864,-109.3844835
817,5,33,14,7,15,10,84,38.285074515068864,-109.384214
818,4,32,14,7,16,10,83,38.285074515068864,-109.3839445
819,7,25,13,16,15,6,82,38.285074515068864,-109.383675
820,9,21,13,23,14,4,84,38.285074515068864,-109.3834055
821,9,21,13,21,15,4,83,38.285074515068864,-109.383136
822,6,27,13,12,16,5,79,38.285074515068864,-109.3828665
823,5,31,15,8,15,10,84,38.285074515068864,-109.382597
824,6,36,14,6,16,8,86,38.285074515068864,-109.3823275
825,6,38,14,4,15,9,86,38.285074515068864,-109.382058
826,6,38,13,5,16,8,86,38.285074515068864,-109.3817885
827,10,31,13,11,17,4,86,38.285074515068864,-109.381519
828,12,28,13,11,14,7,85,38.285074515068864,-109.3812495
829,7,27,14,9,12,14,83,38.285074515068864,-109.38098
830,4,28,16,6,12,18,84,38.285074515068864,-109.3807105
831,5,29,15,6,14,16,85,38.285074515068864,-109.380441
832,6,31,14,8,16,10,85,38.285074515068864,-109.3801716
833,5,32,14,9,16,8,84,38.285074515068864,-109.3799021
834,6,31,14,11,16,7,85,38.285074515068864,-109.3796326
835,7,30,14,13,15,6,85,38.285074515068864,-109.3793631
836,8,30,14,13,15,5,85,38.285074515068864,-109.3790936
837,7,31,14,12,16,6,86,38.285074515068864,-109.3788241
838,6,34,14,8,16,8,86,38.285074515068864,-109.3785546
839,6,35,14,7,17,8,87,38.285074515068864,-109.3782851
840,5,35,14,9,17,7,87,38.285074515068864,-109.3780156
841,6,32,14,13,17,5,87,38.285074515068864,-109.3777461
842,5,33,13,12,18,5,86,38.285074515068864,-109.3774766
843,6,33,13,12,18,4,86,38.285074515068864,-109.3772071
844,6,33,13,12,18,4,86,38.285074515068864,-109.3769376
845,6,33,14,11,17,5,86,38.285074515068864,-109.3766681
846,7,33,13,11,17,4,85,38.285074515068864,-109.3763986
847,7,34,12,10,18,3,84,38.285074515068864,-109.3761291
848,7,35,12,8,20,2,84,38.285074515068864,-109.3758596
849,5,37,12,7,22,2,85,38.285074515068864,-109.3755901
850,4,38,12,9,21,2,86,38.285074515068864,-109.3753206
851,4,38,12,9,20,2,85,38.285074515068864,-109.3750512
852,5,36,12,10,19,3,85,38.285074515068864,-109.3747817
853,5,33,12,14,18,4,86,38.285074515068864,-109.3745122
854,3,27,10,17,16,4,77,38.285074515068864,-109.3742427
855,4,19,10,18,15,3,69,38.285074515068864,-109.3739732
856,5,27,10,21,15,2,80,38.285074515068864,-109.3737037
857,5,32,12,14,17,4,84,38.285074515068864,-109.3734342
858,5,34,12,11,18,4,84,38.285074515068864,-109.3731647
859,5,32,13,12,18,6,86,38.285074515068864,-109.3728952
860,5,31,13,14,16,7,86,38.285074515068864,-109.3726257
861,6,31,13,16,15,6,87,38.285074515068864,-109.3723562
862,12,31,11,18,12,4,88,38.285074515068864,-109.3720867
863,19,30,11,15,10,3,88,38.285074515068864,-109.3718172
864,15,31,12,17,10,4,89,38.285074515068864,-109.3715477
865,11,30,13,15,10,5,84,38.285074515068864,-109.3712782
866,9,30,13,15,10,6,83,38.285074515068864,-109.3710087
867,9,32,13,15,11,6,86,38.285074515068864,-109.3707392
868,10,32,14,15,11,5,87,38.285074515068864,-109.3704697
869,15,30,14,14,10,4,87,38.285074515068864,-109.3702003
870,15,27,14,13,10,6,85,38.285074515068864,-109.3699308
871,16,26,14,12,10,7,85,38.285074515068864,-109.3696613
872,14,27,15,10,9,10,85,38.285074515068864,-109.3693918
873,9,28,15,8,10,15,85,38.285074515068864,-109.3691223
874,6,26,15,9,11,17,84,38.285074515068864,-109.3688528
875,3,26,14,12,13,16,84,38.285074515068864,-109.3685833
876,3,25,14,9,14,18,83,38.285074515068864,-109.3683138
877,4,26,14,10,12,16,82,38.285074515068864,-109.3680443
878,2,25,17,8,12,19,83,38.285074515068864,-109.3677748
879,3,24,18,8,11,20,84,38.285074515068864,-109.3675053
880,4,23,17,10,7,20,81,38.285074515068864,-109.3672358
881,10,20,16,20,7,14,87,38.285074515068864,-109.3669663
882,20,15,13,28,10,6,92,38.285074515068864,-109.3666968
883,20,13,12,29,9,6,89,38.285074515068864,-109.3664273
884,10,16,16,25,10,13,90,38.285074515068864,-109.3661578
885,7,18,17,17,11,19,89,38.285074515068864,-109.3658883
886,4,22,19,5,10,27,87,38.285074515068864,-109.3656188
887,2,20,19,1,6,30,78,38.285074515068864,-109.3653493
888,13,19,15,14,9,18,88,38.285074515068864,-109.3650799
889,30,12,10,30,9,3,94,38.285074515068864,-109.3648104
890,33,12,10,27,8,3,93,38.285074515068864,-109.3645409
891,34,12,10,24,9,4,93,38.285074515068864,-109.3642714
892,31,11,9,31,9,3,94,38.285074515068864,-109.3640019
893,31,11,9,32,9,2,94,38.285074515068864,-109.3637324
894,26,12,9,34,10,3,94,38.285074515068864,-109.3634629
895,18,13,9,32,12,6,90,38.285074515068864,-109.3631934
896,8,17,15,16,13,19,88,38.285074515068864,-109.3629239
897,2,14,15,5,6,24,66,38.285074515068864,-109.3626544
898,1,29,10,3,9,13,65,38.285074515068864,-109.3623849
899,1,35,8,3,10,7,64,38.285074515068864,-109.3621154
900,2,34,8,4,10,6,64,38.285074515068864,-109.3618459
901,3,27,9,5,9,8,61,38.285074515068864,-109.3615764
902,4,28,10,7,11,7,67,38.285074515068864,-109.3613069
903,5,22,10,7,8,9,61,38.285074515068864,-109.3610374
904,5,17,10,7,9,9,57,38.285074515068864,-109.3607679
905,3,20,10,6,12,10,61,38.285074515068864,-109.3604984
906,4,22,13,9,11,15,74,38.285074515068864,-109.360229
907,2,23,13,8,8,17,71,38.285074515068864,-109.3599595
908,3,23,13,5,9,16,69,38.285074515068864,-109.35969
909,0,21,15,0,6,26,68,38.285074515068864,-109.3594205
910,0,22,18,0,6,29,75,38.285074515068864,-109.359151
911,0,23,18,0,5,31,77,38.285074515068864,-109.3588815
912,0,24,19,0,3,31,77,38.285074515068864,-109.358612
913,0,25,18,0,3,30,76,38.285074515068864,-109.3583425
914,0,26,16,0,3,27,72,38.285074515068864,-109.358073
915,0,26,13,0,4,20,63,38.285074515068864,-109.3578035
916,2,31,12,6,7,9,67,38.285074515068864,-109.357534
917,1,25,14,2,6,15,63,38.285074515068864,-109.3572645
918,2,21,17,5,4,16,65,38.285074515068864,-109.356995
919,6,19,17,8,5,16,71,38.285074515068864,-109.3567255
920,5,18,18,8,16,19,84,38.285074515068864,-109.356456
921,4,16,14,17,28,14,93,38.285074515068864,-109.3561865
922,5,14,15,15,25,17,91,38.285074515068864,-109.355917
923,2,16,18,10,17,20,83,38.285074515068864,-109.3556475
924,1,20,18,9,15,22,85,38.285074515068864,-109.355378
925,0,18,19,12,12,24,85,38.285074515068864,-109.3551086
926,2,33,12,1,10,18,76,38.28480502048363,-109.4216737
927,2,31,13,1,9,19,75,38.28480502048363,-109.4214042
928,2,31,12,1,9,19,74,38.28480502048363,-109.4211347
929,2,33,13,1,9,19,77,38.28480502048363,-109.4208652
930,1,33,13,0,8,23,78,38.28480502048363,-109.4205957
931,1,29,14,1,5,25,75,38.28480502048363,-109.4203262
932,1,26,15,1,4,27,74,38.28480502048363,-109.4200568
933,1,27,15,0,5,27,75,38.28480502048363,-109.4197873
934,0,27,14,0,5,26,72,38.28480502048363,-109.4195178
935,1,28,14,0,6,26,75,38.28480502048363,-109.4192483
936,1,30,14,0,7,25,77,38.28480502048363,-109.4189788
937,1,30,13,0,7,23,74,38.28480502048363,-109.4187093
938,1,30,12,0,8,21,72,38.28480502048363,-109.4184398
939,1,33,11,0,8,17,70,38.28480502048363,-109.4181703
940,1,34,10,0,6,18,69,38.28480502048363,-109.4179008
941,1,35,10,0,9,15,70,38.28480502048363,-109.4176313
942,0,37,9,0,11,11,68,38.28480502048363,-109.4173618
943,1,38,8,1,8,10,66,38.28480502048363,-109.4170923
944,2,42,8,2,10,5,69,38.28480502048363,-109.4168228
945,2,41,10,7,13,3,76,38.28480502048363,-109.4165533
946,1,29,11,3,11,10,65,38.28480502048363,-109.4162838
947,1,31,11,0,8,17,68,38.28480502048363,-109.4160143
948,2,34,10,0,7,16,69,38.28480502048363,-109.4157448
949,1,38,10,0,9,15,73,38.28480502048363,-109.4154753
950,1,36,9,0,8,15,69,38.28480502048363,-109.4152058
951,1,35,9,0,9,14,68,38.28480502048363,-109.4149364
952,1,36,9,0,8,14,68,38.28480502048363,-109.4146669
953,1,37,9,0,9,14,70,38.28480502048363,-109.4143974
954,1,37,10,0,11,12,71,38.28480502048363,-109.4141279
955,2,37,10,0,10,12,71,38.28480502048363,-109.4138584
956,2,37,11,0,11,12,73,38.28480502048363,-109.4135889
957,1,36,11,0,11,13,72,38.28480502048363,-109.4133194
958,1,34,11,0,8,17,71,38.28480502048363,-109.4130499
959,1,34,10,0,10,15,70,38.28480502048363,-109.4127804
960,1,30,10,0,9,16,66,38.28480502048363,-109.4125109
961,0,30,11,0,8,18,67,38.28480502048363,-109.4122414
962,1,34,12,0,10,19,76,38.28480502048363,-109.4119719
963,1,36,12,0,11,17,77,38.28480502048363,-109.4117024
964,2,38,12,0,14,14,80,38.28480502048363,-109.4114329
965,2,36,12,0,12,17,79,38.28480502048363,-109.4111634
966,1,34,12,0,9,21,77,38.28480502048363,-109.4108939
967,1,32,13,1,8,22,77,38.28480502048363,-109.4106244
968,2,33,13,3,9,20,80,38.28480502048363,-109.4103549
969,2,33,13,2,11,16,77,38.28480502048363,-109.4100855
970,1,29,12,0,7,20,69,38.28480502048363,-109.409816
971,1,27,12,0,6,20,66,38.28480502048363,-109.4095465
972,1,27,11,0,6,21,66,38.28480502048363,-109.409277
973,1,31,11,0,9,18,70,38.28480502048363,-109.4090075
974,1,34,11,0,9,17,72,38.28480502048363,-109.408738
975,1,35,11,0,9,18,74,38.28480502048363,-109.4084685
976,2,36,11,0,9,17,75,38.28480502048363,-109.408199
977,2,37,11,0,11,14,75,38.28480502048363,-109.4079295
978,2,39,11,2,14,9,77,38.28480502048363,-109.40766
979,3,38,11,4,14,7,77,38.28480502048363,-109.4073905
980,4,37,13,7,15,4,80,38.28480502048363,-109.407121
981,9,37,14,10,16,1,87,38.28480502048363,-109.4068515
982,5,28,15,16,15,5,84,38.28480502048363,-109.3877174
983,7,27,14,17,15,6,86,38.28480502048363,-109.3874479
984,5,30,13,6,13,10,77,38.28480502048363,-109.3871784
985,5,31,13,2,11,13,75,38.28480502048363,-109.3869089
986,6,28,14,5,8,14,75,38.28480502048363,-109.3866394
987,7,26,17,4,7,20,81,38.28480502048363,-109.3863699
988,4,23,18,0,7,29,81,38.28480502048363,-109.3861004
989,2,23,18,0,5,30,78,38.28480502048363,-109.3858309
990,1,25,17,0,5,28,76,38.28480502048363,-109.3855614
991,3,27,16,1,11,21,79,38.28480502048363,-109.3852919
992,7,24,15,9,15,10,80,38.28480502048363,-109.3850225
993,8,25,15,11,13,8,80,38.28480502048363,-109.384753
994,8,30,14,10,14,7,83,38.28480502048363,-109.3844835
995,7,32,14,9,15,6,83,38.28480502048363,-109.384214
996,9,27,13,16,15,4,84,38.28480502048363,-109.3839445
997,9,23,13,23,13,4,85,38.28480502048363,-109.383675
998,8,20,12,24,13,5,82,38.28480502048363,-109.3834055
999,6,23,13,17,14,6,79,38.28480502048363,-109.383136
1000,4,31,14,7,15,10,81,38.28480502048363,-109.3828665
1001,4,36,15,3,14,13,85,38.28480502048363,-109.382597
1002,5,39,13,3,13,10,83,38.28480502048363,-109.3823275
1003,5,40,13,3,15,8,84,38.28480502048363,-109.382058
1004,7,35,14,6,16,8,86,38.28480502048363,-109.3817885
1005,14,23,13,13,16,9,88,38.28480502048363,-109.381519
1006,18,23,12,14,13,9,89,38.28480502048363,-109.3812495
1007,6,26,15,7,12,18,84,38.28480502048363,-109.38098
1008,3,29,15,1,10,21,79,38.28480502048363,-109.3807105
1009,3,32,15,2,12,18,82,38.28480502048363,-109.380441
1010,4,34,14,5,16,11,84,38.28480502048363,-109.3801716
1011,4,34,14,7,16,9,84,38.28480502048363,-109.3799021
1012,5,33,14,9,16,8,85,38.28480502048363,-109.3796326
1013,6,33,14,10,16,7,86,38.28480502048363,-109.3793631
1014,5,34,14,9,17,7,86,38.28480502048363,-109.3790936
1015,5,35,14,7,17,8,86,38.28480502048363,-109.3788241
1016,6,35,14,7,18,7,87,38.28480502048363,-109.3785546
1017,6,34,14,9,17,7,87,38.28480502048363,-109.3782851
1018,6,33,14,10,17,6,86,38.28480502048363,-109.3780156
1019,5,32,14,12,18,6,87,38.28480502048363,-109.3777461
1020,4,34,14,8,18,8,86,38.28480502048363,-109.3774766
1021,5,33,14,11,18,5,86,38.28480502048363,-109.3772071
1022,6,32,14,14,17,4,87,38.28480502048363,-109.3769376
1023,6,31,14,14,17,4,86,38.28480502048363,-109.3766681
1024,6,30,14,14,17,3,84,38.28480502048363,-109.3763986
1025,7,30,13,12,19,3,84,38.28480502048363,-109.3761291
1026,6,33,12,9,19,3,82,38.28480502048363,-109.3758596
1027,3,38,12,7,22,3,85,38.28480502048363,-109.3755901
1028,4,39,12,8,21,2,86,38.28480502048363,-109.3753206
1029,4,38,12,8,21,3,86,38.28480502048363,-109.3750512
1030,4,36,12,10,19,3,84,38.28480502048363,-109.3747817
1031,4,34,12,13,17,5,85,38.28480502048363,-109.3745122
1032,4,29,12,17,14,5,81,38.28480502048363,-109.3742427
1033,2,21,10,17,14,5,69,38.28480502048363,-109.3739732
1034,4,22,10,16,15,4,71,38.28480502048363,-109.3737037
1035,6,29,11,18,14,4,82,38.28480502048363,-109.3734342
1036,6,33,12,13,17,4,85,38.28480502048363,-109.3731647
1037,7,33,13,12,17,4,86,38.28480502048363,-109.3728952
1038,7,31,13,13,16,5,85,38.28480502048363,-109.3726257
1039,7,30,13,14,15,5,84,38.28480502048363,-109.3723562
1040,6,31,13,15,16,6,87,38.28480502048363,-109.3720867
1041,7,30,12,19,14,5,87,38.28480502048363,-109.3718172
1042,13,29,12,19,11,5,89,38.28480502048363,-109.3715477
1043,11,31,13,15,11,5,86,38.28480502048363,-109.3712782
1044,10,33,13,14,12,4,86,38.28480502048363,-109.3710087
1045,9,33,13,13,13,5,86,38.28480502048363,-109.3707392
1046,8,33,14,12,12,6,85,38.28480502048363,-109.3704697
1047,11,30,14,13,10,7,85,38.28480502048363,-109.3702003
1048,18,24,15,11,8,9,85,38.28480502048363,-109.3699308
1049,25,20,15,10,7,9,86,38.28480502048363,-109.3696613
1050,24,20,15,10,7,10,86,38.28480502048363,-109.3693918
1051,16,24,15,9,8,13,85,38.28480502048363,-109.3691223
1052,3,30,13,7,15,15,83,38.28480502048363,-109.3688528
1053,2,29,12,9,13,14,79,38.28480502048363,-109.3685833
1054,1,28,12,8,12,16,77,38.28480502048363,-109.3683138
1055,0,28,14,7,12,19,80,38.28480502048363,-109.3680443
1056,2,28,15,8,12,17,82,38.28480502048363,-109.3677748
1057,1,29,16,6,12,19,83,38.28480502048363,-109.3675053
1058,1,25,19,5,11,23,84,38.28480502048363,-109.3672358
1059,2,22,19,9,13,19,84,38.28480502048363,-109.3669663
1060,6,18,18,17,14,15,88,38.28480502048363,-109.3666968
1061,8,18,17,19,11,15,88,38.28480502048363,-109.3664273
1062,2,22,20,6,11,26,87,38.28480502048363,-109.3661578
1063,0,22,20,4,11,29,86,38.28480502048363,-109.3658883
1064,1,20,20,1,8,31,81,38.28480502048363,-109.3656188
1065,3,17,18,3,3,29,73,38.28480502048363,-109.3653493
1066,7,20,16,10,8,20,81,38.28480502048363,-109.3650799
1067,24,11,9,37,10,3,94,38.28480502048363,-109.3648104
1068,28,10,9,36,9,2,94,38.28480502048363,-109.3645409
1069,33,10,9,30,9,3,94,38.28480502048363,-109.3642714
1070,39,10,8,28,7,2,94,38.28480502048363,-109.3640019
1071,38,10,9,29,6,1,93,38.28480502048363,-109.3637324
1072,32,10,9,32,9,2,94,38.28480502048363,-109.3634629
1073,29,10,9,34,10,2,94,38.28480502048363,-109.3631934
1074,25,11,9,29,12,6,92,38.28480502048363,-109.3629239
1075,11,18,15,11,12,18,85,38.28480502048363,-109.3626544
1076,3,25,12,7,7,15,69,38.28480502048363,-109.3623849
1077,4,30,11,8,9,8,70,38.28480502048363,-109.3621154
1078,5,26,11,10,9,9,70,38.28480502048363,-109.3618459
1079,5,15,15,11,8,14,68,38.28480502048363,-109.3615764
1080,11,18,16,12,9,16,82,38.28480502048363,-109.3613069
1081,5,14,14,7,6,22,68,38.28480502048363,-109.3610374
1082,3,12,13,6,6,22,62,38.28480502048363,-109.3607679
1083,2,21,11,6,9,17,66,38.28480502048363,-109.3604984
1084,10,20,12,7,12,12,73,38.28480502048363,-109.360229
1085,7,23,12,15,7,12,76,38.28480502048363,-109.3599595
1086,9,22,13,16,7,12,79,38.28480502048363,-109.35969
1087,2,11,12,10,9,13,57,38.28480502048363,-109.3594205
1088,2,12,13,8,7,14,56,38.28480502048363,-109.359151
1089,1,13,14,4,4,21,57,38.28480502048363,-109.3588815
1090,0,17,16,0,2,28,63,38.28480502048363,-109.358612
1091,0,20,17,0,1,30,68,38.28480502048363,-109.3583425
1092,0,20,18,0,2,33,73,38.28480502048363,-109.358073
1093,0,21,17,0,2,31,71,38.28480502048363,-109.3578035
1094,0,24,14,0,2,23,63,38.28480502048363,-109.357534
1095,2,29,12,4,5,11,63,38.28480502048363,-109.3572645
1096,1,24,11,6,8,8,58,38.28480502048363,-109.356995
1097,6,26,14,11,11,6,74,38.28480502048363,-109.3567255
1098,9,19,13,23,21,5,90,38.28480502048363,-109.356456
1099,3,16,15,21,26,14,95,38.28480502048363,-109.3561865
1100,3,24,13,16,16,17,89,38.28480502048363,-109.355917
1101,2,28,13,15,15,14,87,38.28480502048363,-109.3556475
1102,1,27,14,11,21,8,82,38.28480502048363,-109.355378
1103,4,19,14,20,17,7,81,38.28480502048363,-109.3551086
1104,4,19,13,20,17,8,81,38.28480502048363,-109.3548391
1105,7,12,12,16,12,10,69,38.28480502048363,-109.3545696
1106,4,43,13,2,18,7,87,38.28453552589839,-109.4222127
1107,3,42,13,1,18,8,85,38.28453552589839,-109.4219432
1108,2,39,13,1,16,11,82,38.28453552589839,-109.4216737
1109,3,35,13,1,12,15,79,38.28453552589839,-109.4214042
1110,2,35,12,1,12,16,78,38.28453552589839,-109.4211347
1111,2,37,12,0,12,15,78,38.28453552589839,-109.4208652
1112,1,39,12,0,13,16,81,38.28453552589839,-109.4205957
1113,1,35,12,0,10,19,77,38.28453552589839,-109.4203262
1114,1,28,14,1,5,25,74,38.28453552589839,-109.4200568
1115,1,26,14,0,5,27,73,38.28453552589839,-109.4197873
1116,0,29,14,0,6,25,74,38.28453552589839,-109.4195178
1117,0,31,14,0,8,23,76,38.28453552589839,-109.4192483
1118,1,30,14,0,7,24,76,38.28453552589839,-109.4189788
1119,1,30,12,0,7,23,73,38.28453552589839,-109.4187093
1120,1,31,11,0,7,19,69,38.28453552589839,-109.4184398
1121,1,36,10,0,9,15,71,38.28453552589839,-109.4181703
1122,1,36,10,0,10,14,71,38.28453552589839,-109.4179008
1123,1,37,10,0,10,13,71,38.28453552589839,-109.4176313
1124,1,38,9,0,11,9,68,38.28453552589839,-109.4173618
1125,1,37,8,2,9,8,65,38.28453552589839,-109.4170923
1126,3,39,9,4,10,6,71,38.28453552589839,-109.4168228
1127,2,26,12,8,12,8,68,38.28453552589839,-109.4165533
1128,1,28,11,1,12,12,65,38.28453552589839,-109.4162838
1129,1,36,10,0,9,14,70,38.28453552589839,-109.4160143
1130,1,39,9,0,9,15,73,38.28453552589839,-109.4157448
1131,1,37,10,0,11,13,72,38.28453552589839,-109.4154753
1132,1,38,10,0,10,14,73,38.28453552589839,-109.4152058
1133,1,37,10,0,9,15,72,38.28453552589839,-109.4149364
1134,1,37,9,0,8,15,70,38.28453552589839,-109.4146669
1135,1,36,9,0,9,14,69,38.28453552589839,-109.4143974
1136,1,37,9,0,10,13,70,38.28453552589839,-109.4141279
1137,1,39,10,0,11,12,73,38.28453552589839,-109.4138584
1138,1,36,10,0,10,13,70,38.28453552589839,-109.4135889
1139,2,32,11,0,9,16,70,38.28453552589839,-109.4133194
1140,1,29,12,0,7,20,69,38.28453552589839,-109.4130499
1141,1,30,14,0,9,22,76,38.28453552589839,-109.4127804
1142,2,30,13,0,9,20,74,38.28453552589839,-109.4125109
1143,2,32,12,0,8,19,73,38.28453552589839,-109.4122414
1144,3,36,12,1,11,16,79,38.28453552589839,-109.4119719
1145,3,38,13,0,14,14,82,38.28453552589839,-109.4117024
1146,2,40,12,1,15,12,82,38.28453552589839,-109.4114329
1147,2,36,12,0,12,16,78,38.28453552589839,-109.4111634
1148,1,34,12,0,9,20,76,38.28453552589839,-109.4108939
1149,1,33,12,2,7,21,76,38.28453552589839,-109.4106244
1150,2,37,12,2,8,19,80,38.28453552589839,-109.4103549
1151,2,36,12,1,9,17,77,38.28453552589839,-109.4100855
1152,2,29,13,1,7,20,72,38.28453552589839,-109.409816
1153,1,25,12,0,5,21,64,38.28453552589839,-109.4095465
1154,1,27,11,0,7,18,64,38.28453552589839,-109.409277
1155,1,37,10,0,11,14,73,38.28453552589839,-109.4090075
1156,2,40,11,0,13,14,80,38.28453552589839,-109.408738
1157,2,42,12,0,14,12,82,38.28453552589839,-109.4084685
1158,2,43,12,0,15,11,83,38.28453552589839,-109.408199
1159,2,41,12,1,16,9,81,38.28453552589839,-109.4079295
1160,3,40,12,4,17,6,82,38.28453552589839,-109.40766
1161,4,39,12,5,16,5,81,38.28453552589839,-109.4073905
1162,5,39,13,7,16,3,83,38.28453552589839,-109.407121
1163,6,41,13,9,17,1,87,38.28453552589839,-109.4068515
1164,4,29,15,11,15,9,83,38.28453552589839,-109.3877174
1165,6,26,15,15,13,9,84,38.28453552589839,-109.3874479
1166,4,26,14,6,11,14,75,38.28453552589839,-109.3871784
1167,3,24,13,3,7,17,67,38.28453552589839,-109.3869089
1168,5,24,15,4,6,17,71,38.28453552589839,-109.3866394
1169,4,23,17,2,4,24,74,38.28453552589839,-109.3863699
1170,1,22,19,0,6,32,80,38.28453552589839,-109.3861004
1171,1,25,19,0,6,29,80,38.28453552589839,-109.3858309
1172,2,29,18,0,7,25,81,38.28453552589839,-109.3855614
1173,5,28,16,5,12,17,83,38.28453552589839,-109.3852919
1174,7,25,16,9,14,12,83,38.28453552589839,-109.3850225
1175,9,27,15,11,14,8,84,38.28453552589839,-109.384753
1176,9,28,15,10,13,8,83,38.28453552589839,-109.3844835
1177,6,23,16,11,13,11,80,38.28453552589839,-109.384214
1178,7,20,15,18,13,10,83,38.28453552589839,-109.3839445
1179,6,20,16,18,11,12,83,38.28453552589839,-109.383675
1180,5,23,16,13,13,13,83,38.28453552589839,-109.3834055
1181,4,28,15,6,12,14,79,38.28453552589839,-109.383136
1182,4,34,13,3,12,12,78,38.28453552589839,-109.3828665
1183,3,37,13,2,11,12,78,38.28453552589839,-109.382597
1184,4,40,13,2,12,11,82,38.28453552589839,-109.3823275
1185,5,38,14,3,12,11,83,38.28453552589839,-109.382058
1186,8,28,15,8,13,14,86,38.28453552589839,-109.3817885
1187,12,17,15,13,16,14,87,38.28453552589839,-109.381519
1188,7,19,16,12,17,16,87,38.28453552589839,-109.3812495
1189,2,24,17,3,11,24,81,38.28453552589839,-109.38098
1190,2,28,16,1,8,24,79,38.28453552589839,-109.3807105
1191,4,34,15,2,10,17,82,38.28453552589839,-109.380441
1192,4,34,15,5,15,10,83,38.28453552589839,-109.3801716
1193,4,35,15,6,16,8,84,38.28453552589839,-109.3799021
1194,4,35,15,7,16,8,85,38.28453552589839,-109.3796326
1195,5,35,15,7,16,8,86,38.28453552589839,-109.3793631
1196,5,36,15,6,16,9,87,38.28453552589839,-109.3790936
1197,5,36,14,5,16,10,86,38.28453552589839,-109.3788241
1198,6,34,14,8,17,8,87,38.28453552589839,-109.3785546
1199,6,31,14,11,17,6,85,38.28453552589839,-109.3782851
1200,6,30,14,12,17,6,85,38.28453552589839,-109.3780156
1201,4,30,15,9,17,10,85,38.28453552589839,-109.3777461
1202,4,33,15,8,17,9,86,38.28453552589839,-109.3774766
1203,5,32,14,12,17,6,86,38.28453552589839,-109.3772071
1204,5,31,14,15,17,4,86,38.28453552589839,-109.3769376
1205,6,30,13,17,17,3,86,38.28453552589839,-109.3766681
1206,5,29,14,19,16,3,86,38.28453552589839,-109.3763986
1207,5,28,13,15,18,4,83,38.28453552589839,-109.3761291
1208,5,32,12,10,19,4,82,38.28453552589839,-109.3758596
1209,4,36,12,8,21,3,84,38.28453552589839,-109.3755901
1210,4,39,12,9,22,2,88,38.28453552589839,-109.3753206
1211,4,38,12,9,20,2,85,38.28453552589839,-109.3750512
1212,4,35,12,10,19,4,84,38.28453552589839,-109.3747817
1213,5,33,13,12,17,5,85,38.28453552589839,-109.3745122
1214,5,31,13,13,16,6,84,38.28453552589839,-109.3742427
1215,5,26,11,18,12,7,79,38.28453552589839,-109.3739732
1216,4,20,10,17,14,4,69,38.28453552589839,-109.3737037
1217,5,26,11,18,13,5,78,38.28453552589839,-109.3734342
1218,7,32,12,14,15,4,84,38.28453552589839,-109.3731647
1219,8,34,12,12,17,4,87,38.28453552589839,-109.3728952
1220,7,33,12,11,18,4,85,38.28453552589839,-109.3726257
1221,7,33,13,11,16,5,85,38.28453552589839,-109.3723562
1222,8,31,13,14,16,5,87,38.28453552589839,-109.3720867
1223,8,29,13,17,15,5,87,38.28453552589839,-109.3718172
1224,9,27,13,19,13,5,86,38.28453552589839,-109.3715477
1225,10,30,13,15,13,5,86,38.28453552589839,-109.3712782
1226,8,33,14,11,14,6,86,38.28453552589839,-109.3710087
1227,8,34,13,11,13,6,85,38.28453552589839,-109.3707392
1228,10,32,14,13,13,6,88,38.28453552589839,-109.3704697
1229,15,28,14,14,10,6,87,38.28453552589839,-109.3702003
1230,17,25,16,12,7,11,88,38.28453552589839,-109.3699308
1231,31,18,15,10,7,8,89,38.28453552589839,-109.3696613
1232,36,16,14,8,6,7,87,38.28453552589839,-109.3693918
1233,22,22,14,6,8,10,82,38.28453552589839,-109.3691223
1234,2,21,12,10,13,8,66,38.28453552589839,-109.3688528
1235,3,19,11,7,12,11,63,38.28453552589839,-109.3685833
1236,2,25,11,5,11,13,67,38.28453552589839,-109.3683138
1237,3,27,11,5,12,11,69,38.28453552589839,-109.3680443
1238,3,27,12,7,13,9,71,38.28453552589839,-109.3677748
1239,2,24,13,9,11,13,72,38.28453552589839,-109.3675053
1240,2,25,15,12,12,14,80,38.28453552589839,-109.3672358
1241,3,22,16,12,12,15,80,38.28453552589839,-109.3669663
1242,4,21,14,17,14,10,80,38.28453552589839,-109.3666968
1243,6,22,14,18,12,11,83,38.28453552589839,-109.3664273
1244,1,27,17,4,9,23,81,38.28453552589839,-109.3661578
1245,0,26,19,1,9,28,83,38.28453552589839,-109.3658883
1246,0,22,19,0,7,33,81,38.28453552589839,-109.3656188
1247,1,18,20,0,7,32,78,38.28453552589839,-109.3653493
1248,8,16,14,20,12,18,88,38.28453552589839,-109.3650799
1249,21,9,8,41,11,3,93,38.28453552589839,-109.3648104
1250,27,8,8,41,9,2,95,38.28453552589839,-109.3645409
1251,31,9,8,35,9,2,94,38.28453552589839,-109.3642714
1252,37,9,8,28,9,3,94,38.28453552589839,-109.3640019
1253,39,9,7,29,3,1,88,38.28453552589839,-109.3637324
1254,37,9,8,30,5,1,90,38.28453552589839,-109.3634629
1255,34,10,8,34,7,2,95,38.28453552589839,-109.3631934
1256,31,11,9,31,10,3,95,38.28453552589839,-109.3629239
1257,25,15,11,26,10,5,92,38.28453552589839,-109.3626544
1258,15,21,14,12,11,11,84,38.28453552589839,-109.3623849
1259,16,21,14,14,10,8,83,38.28453552589839,-109.3621154
1260,18,21,14,17,11,6,87,38.28453552589839,-109.3618459
1261,21,17,12,25,11,5,91,38.28453552589839,-109.3615764
1262,24,13,11,30,10,5,93,38.28453552589839,-109.3613069
1263,19,14,12,25,9,9,88,38.28453552589839,-109.3610374
1264,6,17,14,13,8,20,78,38.28453552589839,-109.3607679
1265,3,22,14,7,7,19,72,38.28453552589839,-109.3604984
1266,3,21,12,7,9,14,66,38.28453552589839,-109.360229
1267,5,21,10,9,12,10,67,38.28453552589839,-109.3599595
1268,3,9,11,8,12,12,55,38.28453552589839,-109.35969
1269,6,11,10,9,12,9,57,38.28453552589839,-109.3594205
1270,6,18,9,8,12,6,59,38.28453552589839,-109.359151
1271,7,16,10,6,11,6,56,38.28453552589839,-109.3588815
1272,3,12,12,7,8,11,53,38.28453552589839,-109.358612
1273,0,15,14,2,4,22,57,38.28453552589839,-109.3583425
1274,0,18,16,0,2,29,65,38.28453552589839,-109.358073
1275,0,20,18,0,2,33,73,38.28453552589839,-109.3578035
1276,0,20,18,0,1,31,70,38.28453552589839,-109.357534
1277,1,25,12,2,4,15,59,38.28453552589839,-109.3572645
1278,1,27,9,6,8,6,57,38.28453552589839,-109.356995
1279,8,34,12,17,11,2,84,38.28453552589839,-109.3567255
1280,12,26,11,24,16,0,89,38.28453552589839,-109.356456
1281,1,21,14,21,26,14,97,38.28453552589839,-109.3561865
1282,5,23,15,21,13,11,88,38.28453552589839,-109.355917
1283,6,18,13,18,15,12,82,38.28453552589839,-109.3556475
1284,7,13,12,19,18,10,79,38.28453552589839,-109.355378
1285,6,9,12,23,14,14,78,38.28453552589839,-109.3551086
1286,4,9,14,21,13,18,79,38.28453552589839,-109.3548391
1287,1,10,18,16,14,23,82,38.28453552589839,-109.3545696
1288,1,9,18,17,16,21,82,38.28453552589839,-109.3543001
1289,2,39,11,0,13,13,78,38.28426603131316,-109.4227517
1290,2,40,12,0,15,12,81,38.28426603131316,-109.4224822
1291,2,41,12,0,17,10,82,38.28426603131316,-109.4222127
1292,3,43,13,1,18,8,86,38.28426603131316,-109.4219432
1293,3,42,13,2,18,8,86,38.28426603131316,-109.4216737
1294,3,41,12,1,18,9,84,38.28426603131316,-109.4214042
1295,2,39,12,1,17,11,82,38.28426603131316,-109.4211347
1296,2,40,12,0,16,12,82,38.28426603131316,-109.4208652
1297,2,41,12,0,16,11,82,38.28426603131316,-109.4205957
1298,2,38,12,1,12,16,81,38.28426603131316,-109.4203262
1299,2,33,13,2,9,21,80,38.28426603131316,-109.4200568
1300,0,28,16,0,7,27,78,38.28426603131316,-109.4197873
1301,0,28,16,0,7,27,78,38.28426603131316,-109.4195178
1302,0,30,13,0,8,21,72,38.28426603131316,-109.4192483
1303,0,34,10,0,8,18,70,38.28426603131316,-109.4189788
1304,0,34,10,0,8,15,67,38.28426603131316,-109.4187093
1305,1,36,10,0,9,12,68,38.28426603131316,-109.4184398
1306,1,38,8,0,8,9,64,38.28426603131316,-109.4181703
1307,1,37,8,1,9,8,64,38.28426603131316,-109.4179008
1308,1,37,9,1,10,9,67,38.28426603131316,-109.4176313
1309,1,38,9,2,11,7,68,38.28426603131316,-109.4173618
1310,2,32,10,4,10,9,67,38.28426603131316,-109.4170923
1311,4,25,12,7,7,12,67,38.28426603131316,-109.4168228
1312,2,18,12,4,5,16,57,38.28426603131316,-109.4165533
1313,1,27,10,1,9,13,61,38.28426603131316,-109.4162838
1314,1,38,9,0,9,12,69,38.28426603131316,-109.4160143
1315,1,39,9,0,9,13,71,38.28426603131316,-109.4157448
1316,0,34,10,0,9,13,66,38.28426603131316,-109.4154753
1317,1,35,9,0,9,11,65,38.28426603131316,-109.4152058
1318,1,36,9,0,9,12,67,38.28426603131316,-109.4149364
1319,2,34,9,0,8,13,66,38.28426603131316,-109.4146669
1320,2,34,9,0,8,13,66,38.28426603131316,-109.4143974
1321,1,36,10,0,11,13,71,38.28426603131316,-109.4141279
1322,2,37,10,0,9,14,72,38.28426603131316,-109.4138584
1323,2,34,10,0,9,15,70,38.28426603131316,-109.4135889
1324,2,30,11,0,8,17,68,38.28426603131316,-109.4133194
1325,1,30,12,0,8,21,72,38.28426603131316,-109.4130499
1326,2,32,13,1,7,21,76,38.28426603131316,-109.4127804
1327,1,34,12,0,9,19,75,38.28426603131316,-109.4125109
1328,2,37,11,0,12,15,77,38.28426603131316,-109.4122414
1329,3,37,11,0,12,15,78,38.28426603131316,-109.4119719
1330,2,33,12,0,9,20,76,38.28426603131316,-109.4117024
1331,2,30,12,0,8,21,73,38.28426603131316,-109.4114329
1332,2,37,11,0,11,15,76,38.28426603131316,-109.4111634
1333,2,42,11,0,12,12,79,38.28426603131316,-109.4108939
1334,2,44,11,0,12,12,81,38.28426603131316,-109.4106244
1335,2,44,11,0,12,13,82,38.28426603131316,-109.4103549
1336,1,38,11,0,8,16,74,38.28426603131316,-109.4100855
1337,1,32,11,0,7,17,68,38.28426603131316,-109.409816
1338,1,27,12,0,7,18,65,38.28426603131316,-109.4095465
1339,1,27,11,0,7,18,64,38.28426603131316,-109.409277
1340,1,31,11,0,9,18,70,38.28426603131316,-109.4090075
1341,2,38,11,0,12,14,77,38.28426603131316,-109.408738
1342,2,42,12,1,15,11,83,38.28426603131316,-109.4084685
1343,2,43,13,1,17,8,84,38.28426603131316,-109.408199
1344,3,43,12,1,18,7,84,38.28426603131316,-109.4079295
1345,3,41,12,2,17,8,83,38.28426603131316,-109.40766
1346,4,41,13,3,17,6,84,38.28426603131316,-109.4073905
1347,4,43,13,4,18,4,86,38.28426603131316,-109.407121
1348,4,45,13,5,19,3,89,38.28426603131316,-109.4068515
1349,6,26,16,11,11,12,82,38.28426603131316,-109.3877174
1350,7,24,17,15,10,13,86,38.28426603131316,-109.3874479
1351,4,24,16,8,9,15,76,38.28426603131316,-109.3871784
1352,3,23,15,2,6,20,69,38.28426603131316,-109.3869089
1353,4,23,17,2,4,23,73,38.28426603131316,-109.3866394
1354,2,21,19,0,3,33,78,38.28426603131316,-109.3863699
1355,2,23,19,1,5,31,81,38.28426603131316,-109.3861004
1356,2,24,19,1,5,29,80,38.28426603131316,-109.3858309
1357,2,28,17,0,8,26,81,38.28426603131316,-109.3855614
1358,5,31,16,3,10,20,85,38.28426603131316,-109.3852919
1359,7,30,16,5,9,15,82,38.28426603131316,-109.3850225
1360,8,26,16,6,10,13,79,38.28426603131316,-109.384753
1361,7,24,16,6,10,16,79,38.28426603131316,-109.3844835
1362,2,19,18,5,10,23,77,38.28426603131316,-109.384214
1363,3,19,20,7,9,24,82,38.28426603131316,-109.3839445
1364,2,25,19,2,9,27,84,38.28426603131316,-109.383675
1365,3,27,16,2,7,22,77,38.28426603131316,-109.3834055
1366,4,33,13,3,11,12,76,38.28426603131316,-109.383136
1367,4,40,12,3,13,7,79,38.28426603131316,-109.3828665
1368,4,39,12,3,11,10,79,38.28426603131316,-109.382597
1369,3,35,13,2,8,16,77,38.28426603131316,-109.3823275
1370,3,25,15,2,6,22,73,38.28426603131316,-109.382058
1371,5,23,17,4,9,25,83,38.28426603131316,-109.3817885
1372,6,17,19,9,13,21,85,38.28426603131316,-109.381519
1373,3,19,20,5,10,26,83,38.28426603131316,-109.3812495
1374,1,23,19,1,7,28,79,38.28426603131316,-109.38098
1375,2,29,16,1,9,24,81,38.28426603131316,-109.3807105
1376,5,33,16,5,12,15,86,38.28426603131316,-109.380441
1377,4,34,14,6,15,8,81,38.28426603131316,-109.3801716
1378,5,35,14,6,16,8,84,38.28426603131316,-109.3799021
1379,5,35,15,7,16,9,87,38.28426603131316,-109.3796326
1380,5,35,15,6,15,10,86,38.28426603131316,-109.3793631
1381,6,36,15,6,14,10,87,38.28426603131316,-109.3790936
1382,5,35,15,5,15,11,86,38.28426603131316,-109.3788241
1383,5,34,15,7,16,10,87,38.28426603131316,-109.3785546
1384,6,32,15,10,16,8,87,38.28426603131316,-109.3782851
1385,5,31,15,10,17,8,86,38.28426603131316,-109.3780156
1386,4,30,16,8,16,11,85,38.28426603131316,-109.3777461
1387,5,31,15,9,16,9,85,38.28426603131316,-109.3774766
1388,5,31,14,14,17,5,86,38.28426603131316,-109.3772071
1389,6,31,13,16,16,4,86,38.28426603131316,-109.3769376
1390,6,31,14,16,16,4,87,38.28426603131316,-109.3766681
1391,6,30,13,19,16,3,87,38.28426603131316,-109.3763986
1392,6,28,13,16,17,4,84,38.28426603131316,-109.3761291
1393,5,29,13,13,19,4,83,38.28426603131316,-109.3758596
1394,5,33,12,10,21,3,84,38.28426603131316,-109.3755901
1395,4,37,12,11,21,2,87,38.28426603131316,-109.3753206
1396,4,37,12,10,20,2,85,38.28426603131316,-109.3750512
1397,4,36,13,10,20,3,86,38.28426603131316,-109.3747817
1398,5,34,13,10,18,4,84,38.28426603131316,-109.3745122
1399,6,34,13,9,17,6,85,38.28426603131316,-109.3742427
1400,7,33,12,11,14,7,84,38.28426603131316,-109.3739732
1401,4,25,10,11,12,9,71,38.28426603131316,-109.3737037
1402,5,23,11,14,14,6,73,38.28426603131316,-109.3734342
1403,6,28,12,15,13,5,79,38.28426603131316,-109.3731647
1404,6,35,13,10,16,5,85,38.28426603131316,-109.3728952
1405,6,37,12,8,18,4,85,38.28426603131316,-109.3726257
1406,7,35,12,9,17,4,84,38.28426603131316,-109.3723562
1407,7,35,12,10,17,4,85,38.28426603131316,-109.3720867
1408,7,33,13,12,15,5,85,38.28426603131316,-109.3718172
1409,8,29,13,15,15,5,85,38.28426603131316,-109.3715477
1410,7,27,13,18,14,5,84,38.28426603131316,-109.3712782
1411,7,29,14,13,15,7,85,38.28426603131316,-109.3710087
1412,9,32,14,10,13,8,86,38.28426603131316,-109.3707392
1413,9,34,14,8,12,9,86,38.28426603131316,-109.3704697
1414,7,31,14,7,12,12,83,38.28426603131316,-109.3702003
1415,13,26,15,12,11,9,86,38.28426603131316,-109.3699308
1416,23,18,13,19,8,7,88,38.28426603131316,-109.3696613
1417,27,16,14,13,8,11,89,38.28426603131316,-109.3693918
1418,18,17,15,10,8,12,80,38.28426603131316,-109.3691223
1419,2,27,10,7,11,8,65,38.28426603131316,-109.3688528
1420,5,22,10,4,8,10,59,38.28426603131316,-109.3685833
1421,6,20,11,6,10,11,64,38.28426603131316,-109.3683138
1422,5,23,11,8,11,10,68,38.28426603131316,-109.3680443
1423,4,22,11,7,13,10,67,38.28426603131316,-109.3677748
1424,2,21,11,9,13,12,68,38.28426603131316,-109.3675053
1425,1,24,14,9,11,15,74,38.28426603131316,-109.3672358
1426,2,25,15,9,12,15,78,38.28426603131316,-109.3669663
1427,1,26,15,9,12,16,79,38.28426603131316,-109.3666968
1428,1,26,15,8,12,17,79,38.28426603131316,-109.3664273
1429,0,27,15,5,8,22,77,38.28426603131316,-109.3661578
1430,0,30,15,3,11,19,78,38.28426603131316,-109.3658883
1431,0,25,16,0,6,25,72,38.28426603131316,-109.3656188
1432,0,20,17,0,4,30,71,38.28426603131316,-109.3653493
1433,2,20,18,7,11,25,83,38.28426603131316,-109.3650799
1434,12,12,11,32,17,5,89,38.28426603131316,-109.3648104
1435,22,10,9,37,13,2,93,38.28426603131316,-109.3645409
1436,25,12,9,32,12,3,93,38.28426603131316,-109.3642714
1437,26,13,10,26,12,4,91,38.28426603131316,-109.3640019
1438,33,10,9,28,6,1,87,38.28426603131316,-109.3637324
1439,32,8,8,27,0,1,76,38.28426603131316,-109.3634629
1440,33,8,7,28,0,1,77,38.28426603131316,-109.3631934
1441,37,9,7,28,4,1,86,38.28426603131316,-109.3629239
1442,35,11,9,29,8,2,94,38.28426603131316,-109.3626544
1443,31,10,10,30,10,3,94,38.28426603131316,-109.3623849
1444,35,9,9,29,10,3,95,38.28426603131316,-109.3621154
1445,35,9,9,30,9,2,94,38.28426603131316,-109.3618459
1446,32,10,9,32,10,2,95,38.28426603131316,-109.3615764
1447,31,11,9,31,9,2,93,38.28426603131316,-109.3613069
1448,28,13,11,30,8,3,93,38.28426603131316,-109.3610374
1449,16,19,15,14,10,12,86,38.28426603131316,-109.3607679
1450,5,24,15,6,8,21,79,38.28426603131316,-109.3604984
1451,3,28,15,1,8,21,76,38.28426603131316,-109.360229
1452,5,30,12,4,9,14,74,38.28426603131316,-109.3599595
1453,3,10,11,9,13,11,57,38.28426603131316,-109.35969
1454,6,11,11,11,14,10,63,38.28426603131316,-109.3594205
1455,8,18,10,7,17,6,66,38.28426603131316,-109.359151
1456,8,19,10,9,13,3,62,38.28426603131316,-109.3588815
1457,7,20,10,7,10,5,59,38.28426603131316,-109.358612
1458,2,12,11,11,11,9,56,38.28426603131316,-109.3583425
1459,1,14,13,6,6,19,59,38.28426603131316,-109.358073
1460,0,20,17,0,4,30,71,38.28426603131316,-109.3578035
1461,0,18,17,0,1,31,67,38.28426603131316,-109.357534
1462,1,21,13,0,3,20,58,38.28426603131316,-109.3572645
1463,1,27,10,6,8,7,59,38.28426603131316,-109.356995
1464,8,36,15,16,11,1,87,38.28426603131316,-109.3567255
1465,11,16,11,31,16,0,85,38.28426603131316,-109.356456
1466,4,14,13,19,17,17,84,38.28426603131316,-109.3561865
1467,5,12,14,22,13,18,84,38.28426603131316,-109.355917
1468,6,12,13,20,12,18,81,38.28426603131316,-109.3556475
1469,6,8,14,18,15,21,82,38.28426603131316,-109.355378
1470,5,8,13,21,13,21,81,38.28426603131316,-109.3551086
1471,4,11,13,22,18,12,80,38.28426603131316,-109.3548391
1472,3,16,14,19,17,11,80,38.28426603131316,-109.3545696
1473,2,15,13,19,15,10,74,38.28426603131316,-109.3543001
1474,3,19,13,16,16,10,77,38.28426603131316,-109.3540306
1475,4,18,14,17,13,13,79,38.28426603131316,-109.3537611
1476,1,31,12,1,13,13,71,38.28399653672792,-109.4230212
1477,1,30,12,0,9,18,70,38.28399653672792,-109.4227517
1478,1,34,12,0,11,17,75,38.28399653672792,-109.4224822
1479,2,37,12,0,13,15,79,38.28399653672792,-109.4222127
1480,3,40,13,1,16,12,85,38.28399653672792,-109.4219432
1481,3,41,13,2,18,9,86,38.28399653672792,-109.4216737
1482,3,40,12,1,18,9,83,38.28399653672792,-109.4214042
1483,2,38,12,1,17,10,80,38.28399653672792,-109.4211347
1484,2,38,12,0,15,13,80,38.28399653672792,-109.4208652
1485,2,39,13,0,13,14,81,38.28399653672792,-109.4205957
1486,3,34,13,2,11,17,80,38.28399653672792,-109.4203262
1487,2,31,14,2,7,21,77,38.28399653672792,-109.4200568
1488,0,22,15,0,4,26,67,38.28399653672792,-109.4197873
1489,0,21,14,0,4,25,64,38.28399653672792,-109.4195178
1490,1,26,11,2,5,17,62,38.28399653672792,-109.4192483
1491,1,33,9,2,8,12,65,38.28399653672792,-109.4189788
1492,1,33,8,2,9,11,64,38.28399653672792,-109.4187093
1493,1,35,8,1,9,9,63,38.28399653672792,-109.4184398
1494,1,36,9,1,8,9,64,38.28399653672792,-109.4181703
1495,1,36,9,2,10,7,65,38.28399653672792,-109.4179008
1496,1,37,8,2,10,7,65,38.28399653672792,-109.4176313
1497,1,39,8,2,11,6,67,38.28399653672792,-109.4173618
1498,2,35,10,3,10,10,70,38.28399653672792,-109.4170923
1499,2,27,12,3,7,16,67,38.28399653672792,-109.4168228
1500,3,24,12,2,6,16,63,38.28399653672792,-109.4165533
1501,0,26,10,1,7,15,59,38.28399653672792,-109.4162838
1502,0,35,9,0,8,13,65,38.28399653672792,-109.4160143
1503,1,37,8,0,8,10,64,38.28399653672792,-109.4157448
1504,1,32,8,2,9,9,61,38.28399653672792,-109.4154753
1505,2,37,8,3,10,7,67,38.28399653672792,-109.4152058
1506,1,35,9,1,9,8,63,38.28399653672792,-109.4149364
1507,1,33,9,1,8,10,62,38.28399653672792,-109.4146669
1508,2,33,9,2,8,9,63,38.28399653672792,-109.4143974
1509,2,34,9,1,9,10,65,38.28399653672792,-109.4141279
1510,2,38,9,0,9,12,70,38.28399653672792,-109.4138584
1511,0,33,10,0,11,15,69,38.28399653672792,-109.4135889
1512,0,29,11,0,8,19,67,38.28399653672792,-109.4133194
1513,1,32,12,0,9,20,74,38.28399653672792,-109.4130499
1514,2,30,13,2,8,20,75,38.28399653672792,-109.4127804
1515,2,31,12,1,8,20,74,38.28399653672792,-109.4125109
1516,2,31,12,1,8,19,73,38.28399653672792,-109.4122414
1517,2,30,12,0,7,20,71,38.28399653672792,-109.4119719
1518,2,31,12,0,7,20,72,38.28399653672792,-109.4117024
1519,1,33,11,0,9,17,71,38.28399653672792,-109.4114329
1520,1,39,11,0,13,12,76,38.28399653672792,-109.4111634
1521,2,45,10,1,13,10,81,38.28399653672792,-109.4108939
1522,2,48,10,1,13,10,84,38.28399653672792,-109.4106244
1523,1,47,11,0,11,14,84,38.28399653672792,-109.4103549
1524,1,41,11,0,8,16,77,38.28399653672792,-109.4100855
1525,1,36,10,0,8,16,71,38.28399653672792,-109.409816
1526,1,33,10,0,9,14,67,38.28399653672792,-109.4095465
1527,1,31,11,0,9,14,66,38.28399653672792,-109.409277
1528,2,31,12,0,8,17,70,38.28399653672792,-109.4090075
1529,1,33,11,0,9,17,71,38.28399653672792,-109.408738
1530,2,39,11,0,14,12,78,38.28399653672792,-109.4084685
1531,3,44,12,1,17,8,85,38.28399653672792,-109.408199
1532,3,43,13,1,18,7,85,38.28399653672792,-109.4079295
1533,3,42,13,3,17,7,85,38.28399653672792,-109.40766
1534,4,43,13,4,18,5,87,38.28399653672792,-109.4073905
1535,4,44,13,4,18,5,88,38.28399653672792,-109.407121
1536,4,45,13,3,19,4,88,38.28399653672792,-109.4068515
1537,3,26,16,9,9,16,79,38.28399653672792,-109.3877174
1538,1,23,17,4,7,23,75,38.28399653672792,-109.3874479
1539,1,20,16,0,4,25,66,38.28399653672792,-109.3871784
1540,0,20,16,0,4,27,67,38.28399653672792,-109.3869089
1541,0,19,18,0,3,31,71,38.28399653672792,-109.3866394
1542,1,22,20,1,5,33,82,38.28399653672792,-109.3863699
1543,1,22,18,4,8,29,82,38.28399653672792,-109.3861004
1544,1,24,17,4,7,27,80,38.28399653672792,-109.3858309
1545,0,29,17,2,8,26,82,38.28399653672792,-109.3855614
1546,2,28,17,2,7,22,78,38.28399653672792,-109.3852919
1547,4,28,15,3,6,19,75,38.28399653672792,-109.3850225
1548,5,26,15,5,7,17,75,38.28399653672792,-109.384753
1549,5,25,16,4,7,21,78,38.28399653672792,-109.3844835
1550,3,26,18,1,6,26,80,38.28399653672792,-109.384214
1551,3,27,17,0,5,27,79,38.28399653672792,-109.3839445
1552,3,24,16,0,3,26,72,38.28399653672792,-109.383675
1553,3,28,14,2,6,19,72,38.28399653672792,-109.3834055
1554,4,36,13,3,11,12,79,38.28399653672792,-109.383136
1555,4,37,13,4,12,10,80,38.28399653672792,-109.3828665
1556,4,33,14,2,8,16,77,38.28399653672792,-109.382597
1557,2,24,17,1,4,26,74,38.28399653672792,-109.3823275
1558,2,23,18,1,5,31,80,38.28399653672792,-109.382058
1559,2,25,18,2,7,30,84,38.28399653672792,-109.3817885
1560,2,22,19,4,9,28,84,38.28399653672792,-109.381519
1561,2,22,21,2,7,29,83,38.28399653672792,-109.3812495
1562,2,27,18,0,7,27,81,38.28399653672792,-109.38098
1563,2,30,16,0,10,23,81,38.28399653672792,-109.3807105
1564,4,33,16,4,12,15,84,38.28399653672792,-109.380441
1565,5,35,15,5,14,9,83,38.28399653672792,-109.3801716
1566,4,34,15,6,15,9,83,38.28399653672792,-109.3799021
1567,4,35,15,4,15,11,84,38.28399653672792,-109.3796326
1568,4,36,15,3,13,15,86,38.28399653672792,-109.3793631
1569,4,36,15,3,11,15,84,38.28399653672792,-109.3790936
1570,4,33,16,5,14,13,85,38.28399653672792,-109.3788241
1571,5,33,16,7,14,13,88,38.28399653672792,-109.3785546
1572,5,32,15,8,15,10,85,38.28399653672792,-109.3782851
1573,5,31,15,9,15,10,85,38.28399653672792,-109.3780156
1574,4,31,16,9,16,10,86,38.28399653672792,-109.3777461
1575,5,31,15,10,16,8,85,38.28399653672792,-109.3774766
1576,6,32,14,14,16,5,87,38.28399653672792,-109.3772071
1577,6,31,14,16,15,4,86,38.28399653672792,-109.3769376
1578,6,31,14,17,16,4,88,38.28399653672792,-109.3766681
1579,6,30,14,19,15,3,87,38.28399653672792,-109.3763986
1580,6,28,14,20,15,3,86,38.28399653672792,-109.3761291
1581,7,28,13,16,17,4,85,38.28399653672792,-109.3758596
1582,6,32,13,13,19,4,87,38.28399653672792,-109.3755901
1583,5,37,12,11,20,2,87,38.28399653672792,-109.3753206
1584,5,38,13,10,20,2,88,38.28399653672792,-109.3750512
1585,5,36,13,10,19,3,86,38.28399653672792,-109.3747817
1586,5,34,13,9,18,4,83,38.28399653672792,-109.3745122
1587,5,34,13,8,18,6,84,38.28399653672792,-109.3742427
1588,7,32,13,8,16,8,84,38.28399653672792,-109.3739732
1589,5,26,12,11,12,11,77,38.28399653672792,-109.3737037
1590,6,21,11,12,12,7,69,38.28399653672792,-109.3734342
1591,8,24,11,13,14,4,74,38.28399653672792,-109.3731647
1592,8,32,12,11,17,3,83,38.28399653672792,-109.3728952
1593,7,34,13,11,17,4,86,38.28399653672792,-109.3726257
1594,8,34,13,10,17,3,85,38.28399653672792,-109.3723562
1595,8,34,13,10,16,4,85,38.28399653672792,-109.3720867
1596,7,34,14,10,16,6,87,38.28399653672792,-109.3718172
1597,7,32,14,12,16,5,86,38.28399653672792,-109.3715477
1598,8,29,14,15,15,6,87,38.28399653672792,-109.3712782
1599,12,25,13,20,13,4,87,38.28399653672792,-109.3710087
1600,14,23,13,19,12,4,85,38.28399653672792,-109.3707392
1601,16,25,14,12,10,8,85,38.28399653672792,-109.3704697
1602,17,27,14,8,9,10,85,38.28399653672792,-109.3702003
1603,14,29,14,9,10,10,86,38.28399653672792,-109.3699308
1604,17,25,15,10,9,10,86,38.28399653672792,-109.3696613
1605,14,21,16,11,8,15,85,38.28399653672792,-109.3693918
1606,7,17,16,9,8,20,77,38.28399653672792,-109.3691223
1607,6,18,13,6,8,15,66,38.28399653672792,-109.3688528
1608,2,30,10,5,11,8,66,38.28399653672792,-109.3685833
1609,2,28,9,4,8,10,61,38.28399653672792,-109.3683138
1610,2,21,10,3,6,14,56,38.28399653672792,-109.3680443
1611,4,19,11,3,7,14,58,38.28399653672792,-109.3677748
1612,4,18,10,6,13,10,61,38.28399653672792,-109.3675053
1613,2,18,11,7,12,12,62,38.28399653672792,-109.3672358
1614,2,21,11,6,12,12,64,38.28399653672792,-109.3669663
1615,3,25,12,5,9,15,69,38.28399653672792,-109.3666968
1616,1,29,13,3,8,19,73,38.28399653672792,-109.3664273
1617,0,30,13,4,9,18,74,38.28399653672792,-109.3661578
1618,0,28,14,3,8,19,72,38.28399653672792,-109.3658883
1619,1,26,15,2,7,21,72,38.28399653672792,-109.3656188
1620,0,22,16,1,5,25,69,38.28399653672792,-109.3653493
1621,1,21,17,4,7,26,76,38.28399653672792,-109.3650799
1622,2,19,16,17,16,15,85,38.28399653672792,-109.3648104
1623,9,16,12,28,16,7,88,38.28399653672792,-109.3645409
1624,13,17,11,26,12,8,87,38.28399653672792,-109.3642714
1625,18,20,12,20,10,8,88,38.28399653672792,-109.3640019
1626,30,12,10,27,11,3,93,38.28399653672792,-109.3637324
1627,29,9,8,25,2,1,74,38.28399653672792,-109.3634629
1628,22,8,7,20,0,2,59,38.28399653672792,-109.3631934
1629,25,8,7,23,0,1,64,38.28399653672792,-109.3629239
1630,35,8,8,28,11,2,92,38.28399653672792,-109.3626544
1631,21,9,11,28,16,8,93,38.28399653672792,-109.3623849
1632,22,8,10,33,13,7,93,38.28399653672792,-109.3621154
1633,25,7,10,33,13,5,93,38.28399653672792,-109.3618459
1634,29,8,9,32,13,3,94,38.28399653672792,-109.3615764
1635,31,8,9,30,13,2,93,38.28399653672792,-109.3613069
1636,28,11,9,30,11,2,91,38.28399653672792,-109.3610374
1637,24,13,12,26,11,4,90,38.28399653672792,-109.3607679
1638,6,25,15,8,12,17,83,38.28399653672792,-109.3604984
1639,5,27,16,3,10,21,82,38.28399653672792,-109.360229
1640,5,26,15,4,10,17,77,38.28399653672792,-109.3599595
1641,1,21,11,8,14,12,67,38.28399653672792,-109.35969
1642,2,22,13,9,12,15,73,38.28399653672792,-109.3594205
1643,3,19,10,13,12,20,77,38.28399653672792,-109.359151
1644,3,20,13,9,10,15,70,38.28399653672792,-109.3588815
1645,6,28,10,9,11,5,69,38.28399653672792,-109.358612
1646,2,23,9,12,11,5,62,38.28399653672792,-109.3583425
1647,1,15,11,9,11,12,59,38.28399653672792,-109.358073
1648,0,20,16,0,4,29,69,38.28399653672792,-109.3578035
1649,0,20,17,0,2,29,68,38.28399653672792,-109.357534
1650,2,23,15,1,5,20,66,38.28399653672792,-109.3572645
1651,2,30,14,4,8,9,67,38.28399653672792,-109.356995
1652,9,33,17,15,12,1,87,38.28399653672792,-109.3567255
1653,6,14,12,25,18,4,79,38.28399653672792,-109.356456
1654,6,11,12,20,15,11,75,38.28399653672792,-109.3561865
1655,6,11,12,18,13,14,74,38.28399653672792,-109.355917
1656,5,11,12,21,14,10,73,38.28399653672792,-109.3556475
1657,5,14,12,19,17,7,74,38.28399653672792,-109.355378
1658,5,18,15,20,13,9,80,38.28399653672792,-109.3551086
1659,6,15,14,21,10,12,78,38.28399653672792,-109.3548391
1660,4,19,14,13,13,10,73,38.28399653672792,-109.3545696
1661,3,21,16,7,11,20,78,38.28399653672792,-109.3543001
1662,1,20,19,4,7,28,79,38.28399653672792,-109.3540306
1663,1,22,20,4,10,24,81,38.28399653672792,-109.3537611
1664,0,23,21,2,8,28,82,38.28399653672792,-109.3534916
1665,0,22,21,2,7,31,83,38.28399653672792,-109.3532221
1666,1,36,10,0,14,11,72,38.28372704214269,-109.4235602
1667,1,31,12,1,12,14,71,38.28372704214269,-109.4232907
1668,0,27,13,0,9,21,70,38.28372704214269,-109.4230212
1669,0,33,13,0,10,19,75,38.28372704214269,-109.4227517
1670,1,32,12,0,11,19,75,38.28372704214269,-109.4224822
1671,2,33,12,1,11,18,77,38.28372704214269,-109.4222127
1672,2,34,13,1,11,18,79,38.28372704214269,-109.4219432
1673,2,34,13,0,12,17,78,38.28372704214269,-109.4216737
1674,2,33,12,0,12,17,76,38.28372704214269,-109.4214042
1675,2,33,12,0,12,17,76,38.28372704214269,-109.4211347
1676,1,34,12,0,11,18,76,38.28372704214269,-109.4208652
1677,1,35,12,0,9,19,76,38.28372704214269,-109.4205957
1678,1,33,12,0,8,18,72,38.28372704214269,-109.4203262
1679,1,35,10,0,7,16,69,38.28372704214269,-109.4200568
1680,0,28,10,2,8,14,62,38.28372704214269,-109.4197873
1681,1,27,9,2,8,10,57,38.28372704214269,-109.4195178
1682,0,33,8,1,9,8,59,38.28372704214269,-109.4192483
1683,0,33,8,2,10,9,62,38.28372704214269,-109.4189788
1684,1,31,8,2,9,10,61,38.28372704214269,-109.4187093
1685,1,36,9,1,8,11,66,38.28372704214269,-109.4184398
1686,1,35,9,0,8,13,66,38.28372704214269,-109.4181703
1687,2,38,9,1,9,10,69,38.28372704214269,-109.4179008
1688,1,40,10,2,13,7,73,38.28372704214269,-109.4176313
1689,2,36,11,3,11,11,74,38.28372704214269,-109.4173618
1690,2,31,12,3,8,16,72,38.28372704214269,-109.4170923
1691,2,29,13,2,7,18,71,38.28372704214269,-109.4168228
1692,3,30,12,1,9,15,70,38.28372704214269,-109.4165533
1693,1,34,10,1,9,12,67,38.28372704214269,-109.4162838
1694,1,35,9,1,10,10,66,38.28372704214269,-109.4160143
1695,1,37,8,2,10,7,65,38.28372704214269,-109.4157448
1696,2,38,7,3,11,5,66,38.28372704214269,-109.4154753
1697,3,41,8,5,11,4,72,38.28372704214269,-109.4152058
1698,2,36,8,4,11,5,66,38.28372704214269,-109.4149364
1699,1,35,8,1,9,8,62,38.28372704214269,-109.4146669
1700,2,38,8,1,8,8,65,38.28372704214269,-109.4143974
1701,2,38,10,3,13,7,73,38.28372704214269,-109.4141279
1702,1,29,10,5,11,9,65,38.28372704214269,-109.4138584
1703,1,30,11,2,11,13,68,38.28372704214269,-109.4135889
1704,0,31,11,0,10,17,69,38.28372704214269,-109.4133194
1705,1,31,12,0,10,19,73,38.28372704214269,-109.4130499
1706,2,35,12,0,10,18,77,38.28372704214269,-109.4127804
1707,2,42,11,0,11,14,80,38.28372704214269,-109.4125109
1708,2,35,12,1,8,18,76,38.28372704214269,-109.4122414
1709,2,29,11,0,6,19,67,38.28372704214269,-109.4119719
1710,2,32,9,0,7,13,63,38.28372704214269,-109.4117024
1711,2,37,8,0,6,9,62,38.28372704214269,-109.4114329
1712,1,36,8,0,7,10,62,38.28372704214269,-109.4111634
1713,2,38,9,0,8,12,69,38.28372704214269,-109.4108939
1714,2,43,10,0,11,11,77,38.28372704214269,-109.4106244
1715,1,43,11,0,11,14,80,38.28372704214269,-109.4103549
1716,2,37,11,0,7,18,75,38.28372704214269,-109.4100855
1717,1,31,10,0,6,18,66,38.28372704214269,-109.409816
1718,1,28,11,0,7,16,63,38.28372704214269,-109.4095465
1719,2,27,11,0,8,13,61,38.28372704214269,-109.409277
1720,2,26,11,0,8,15,62,38.28372704214269,-109.4090075
1721,1,29,11,0,8,18,67,38.28372704214269,-109.408738
1722,2,36,11,0,11,15,75,38.28372704214269,-109.4084685
1723,3,42,12,0,15,11,83,38.28372704214269,-109.408199
1724,3,43,12,0,16,9,83,38.28372704214269,-109.4079295
1725,3,40,12,2,16,8,81,38.28372704214269,-109.40766
1726,3,40,13,2,16,9,83,38.28372704214269,-109.4073905
1727,3,41,13,1,15,9,82,38.28372704214269,-109.407121
1728,4,43,13,2,16,7,85,38.28372704214269,-109.4068515
1729,2,26,18,6,9,19,80,38.28372704214269,-109.3877174
1730,1,26,18,2,7,24,78,38.28372704214269,-109.3874479
1731,0,24,17,1,6,25,73,38.28372704214269,-109.3871784
1732,0,25,17,2,6,24,74,38.28372704214269,-109.3869089
1733,1,28,19,4,9,23,84,38.28372704214269,-109.3866394
1734,1,26,17,6,8,23,81,38.28372704214269,-109.3863699
1735,1,24,16,6,8,23,78,38.28372704214269,-109.3861004
1736,1,26,15,5,8,24,79,38.28372704214269,-109.3858309
1737,0,30,17,3,7,26,83,38.28372704214269,-109.3855614
1738,1,26,16,1,5,27,76,38.28372704214269,-109.3852919
1739,1,27,15,1,5,22,71,38.28372704214269,-109.3850225
1740,2,26,14,3,6,19,70,38.28372704214269,-109.384753
1741,2,23,15,1,6,21,68,38.28372704214269,-109.3844835
1742,1,23,15,0,3,24,66,38.28372704214269,-109.384214
1743,1,25,13,0,3,21,63,38.28372704214269,-109.3839445
1744,2,29,13,0,5,19,68,38.28372704214269,-109.383675
1745,3,29,14,1,6,19,72,38.28372704214269,-109.3834055
1746,3,30,15,1,7,20,76,38.28372704214269,-109.383136
1747,3,28,17,2,7,23,80,38.28372704214269,-109.3828665
1748,2,25,18,0,7,29,81,38.28372704214269,-109.382597
1749,2,25,19,0,5,33,84,38.28372704214269,-109.3823275
1750,2,25,19,1,6,32,85,38.28372704214269,-109.382058
1751,1,26,19,1,7,30,84,38.28372704214269,-109.3817885
1752,1,24,19,2,7,31,84,38.28372704214269,-109.381519
1753,3,25,19,2,5,28,82,38.28372704214269,-109.3812495
1754,3,27,16,1,6,24,77,38.28372704214269,-109.38098
1755,3,30,15,1,9,21,79,38.28372704214269,-109.3807105
1756,4,33,16,3,12,17,85,38.28372704214269,-109.380441
1757,4,34,15,4,14,14,85,38.28372704214269,-109.3801716
1758,3,35,15,4,15,14,86,38.28372704214269,-109.3799021
1759,3,35,16,2,14,17,87,38.28372704214269,-109.3796326
1760,2,35,15,0,10,19,81,38.28372704214269,-109.3793631
1761,2,33,16,0,9,21,81,38.28372704214269,-109.3790936
1762,3,33,17,2,11,20,86,38.28372704214269,-109.3788241
1763,3,32,18,3,12,20,88,38.28372704214269,-109.3785546
1764,4,31,17,6,13,16,87,38.28372704214269,-109.3782851
1765,4,31,16,7,14,13,85,38.28372704214269,-109.3780156
1766,4,32,16,8,14,12,86,38.28372704214269,-109.3777461
1767,5,32,15,7,13,12,84,38.28372704214269,-109.3774766
1768,6,31,14,9,13,10,83,38.28372704214269,-109.3772071
1769,6,30,14,13,13,7,83,38.28372704214269,-109.3769376
1770,8,31,14,16,14,5,88,38.28372704214269,-109.3766681
1771,9,31,14,17,14,3,88,38.28372704214269,-109.3763986
1772,9,30,13,18,15,3,88,38.28372704214269,-109.3761291
1773,9,30,14,16,16,3,88,38.28372704214269,-109.3758596
1774,8,33,14,13,18,3,89,38.28372704214269,-109.3755901
1775,6,38,13,10,19,2,88,38.28372704214269,-109.3753206
1776,6,40,13,9,18,1,87,38.28372704214269,-109.3750512
1777,7,37,12,10,18,2,86,38.28372704214269,-109.3747817
1778,7,35,13,11,17,3,86,38.28372704214269,-109.3745122
1779,6,34,13,11,17,4,85,38.28372704214269,-109.3742427
1780,7,34,13,11,16,4,85,38.28372704214269,-109.3739732
1781,6,32,13,10,15,8,84,38.28372704214269,-109.3737037
1782,7,24,11,15,13,5,75,38.28372704214269,-109.3734342
1783,9,23,11,12,13,4,72,38.28372704214269,-109.3731647
1784,7,28,13,14,14,4,80,38.28372704214269,-109.3728952
1785,7,34,13,9,16,5,84,38.28372704214269,-109.3726257
1786,8,32,13,9,16,5,83,38.28372704214269,-109.3723562
1787,7,32,14,8,15,8,84,38.28372704214269,-109.3720867
1788,8,31,14,8,15,8,84,38.28372704214269,-109.3718172
1789,10,31,14,9,16,6,86,38.28372704214269,-109.3715477
1790,10,29,14,14,15,4,86,38.28372704214269,-109.3712782
1791,23,23,13,18,10,2,89,38.28372704214269,-109.3710087
1792,22,19,12,22,10,3,88,38.28372704214269,-109.3707392
1793,14,20,13,22,11,5,85,38.28372704214269,-109.3704697
1794,9,24,14,15,12,10,84,38.28372704214269,-109.3702003
1795,15,23,14,13,9,12,86,38.28372704214269,-109.3699308
1796,15,22,14,12,9,13,85,38.28372704214269,-109.3696613
1797,11,24,16,9,8,17,85,38.28372704214269,-109.3693918
1798,8,23,16,7,6,22,82,38.28372704214269,-109.3691223
1799,6,20,17,5,6,25,79,38.28372704214269,-109.3688528
1800,2,23,13,2,9,18,67,38.28372704214269,-109.3685833
1801,1,24,12,2,11,15,65,38.28372704214269,-109.3683138
1802,1,29,12,3,11,13,69,38.28372704214269,-109.3680443
1803,1,27,11,2,10,14,65,38.28372704214269,-109.3677748
1804,3,31,9,12,11,10,76,38.28372704214269,-109.3675053
1805,2,19,10,7,12,12,62,38.28372704214269,-109.3672358
1806,3,22,11,6,12,12,66,38.28372704214269,-109.3669663
1807,2,22,12,5,9,17,67,38.28372704214269,-109.3666968
1808,1,25,14,1,4,25,70,38.28372704214269,-109.3664273
1809,0,25,13,2,6,19,65,38.28372704214269,-109.3661578
1810,1,25,15,2,7,17,67,38.28372704214269,-109.3658883
1811,0,24,14,2,6,20,66,38.28372704214269,-109.3656188
1812,0,24,15,2,6,23,70,38.28372704214269,-109.3653493
1813,0,22,16,0,4,27,69,38.28372704214269,-109.3650799
1814,2,20,15,7,8,21,73,38.28372704214269,-109.3648104
1815,2,20,16,11,13,18,80,38.28372704214269,-109.3645409
1816,8,18,14,20,14,12,86,38.28372704214269,-109.3642714
1817,20,17,11,25,12,6,91,38.28372704214269,-109.3640019
1818,33,11,10,25,11,3,93,38.28372704214269,-109.3637324
1819,32,10,9,26,6,2,85,38.28372704214269,-109.3634629
1820,26,8,8,25,2,1,70,38.28372704214269,-109.3631934
1821,31,9,8,28,7,1,84,38.28372704214269,-109.3629239
1822,21,9,10,31,17,6,94,38.28372704214269,-109.3626544
1823,5,20,14,13,13,21,86,38.28372704214269,-109.3623849
1824,4,22,14,12,13,21,86,38.28372704214269,-109.3621154
1825,6,21,13,22,15,14,91,38.28372704214269,-109.3618459
1826,10,18,12,31,14,7,92,38.28372704214269,-109.3615764
1827,15,12,12,35,13,4,91,38.28372704214269,-109.3613069
1828,15,11,14,31,16,3,90,38.28372704214269,-109.3610374
1829,13,10,14,34,17,4,92,38.28372704214269,-109.3607679
1830,3,23,15,20,14,13,88,38.28372704214269,-109.3604984
1831,4,26,15,11,15,14,85,38.28372704214269,-109.360229
1832,8,28,13,12,20,8,89,38.28372704214269,-109.3599595
1833,1,26,14,8,22,8,79,38.28372704214269,-109.35969
1834,2,19,13,7,15,15,71,38.28372704214269,-109.3594205
1835,4,19,13,9,11,22,78,38.28372704214269,-109.359151
1836,2,21,15,7,8,25,78,38.28372704214269,-109.3588815
1837,1,30,12,7,15,9,74,38.28372704214269,-109.358612
1838,0,30,11,8,14,9,72,38.28372704214269,-109.3583425
1839,0,22,12,7,8,16,65,38.28372704214269,-109.358073
1840,0,19,18,0,3,31,71,38.28372704214269,-109.3578035
1841,0,18,18,0,2,33,71,38.28372704214269,-109.357534
1842,2,22,16,0,2,25,67,38.28372704214269,-109.3572645
1843,4,29,14,9,8,11,75,38.28372704214269,-109.356995
1844,4,24,14,14,12,9,77,38.28372704214269,-109.3567255
1845,5,17,13,13,16,11,75,38.28372704214269,-109.356456
1846,4,24,13,10,15,10,76,38.28372704214269,-109.3561865
1847,4,26,12,11,18,7,78,38.28372704214269,-109.355917
1848,1,25,12,10,15,7,70,38.28372704214269,-109.3556475
1849,0,26,12,9,15,8,70,38.28372704214269,-109.355378
1850,0,26,13,7,12,14,72,38.28372704214269,-109.3551086
1851,1,24,20,4,8,24,81,38.28372704214269,-109.3548391
1852,1,23,19,4,9,25,81,38.28372704214269,-109.3545696
1853,2,22,20,4,8,26,82,38.28372704214269,-109.3543001
1854,2,21,19,5,8,24,79,38.28372704214269,-109.3540306
1855,1,22,17,8,10,20,78,38.28372704214269,-109.3537611
1856,0,22,19,4,8,28,81,38.28372704214269,-109.3534916
1857,1,20,20,4,6,32,83,38.28372704214269,-109.3532221
1858,1,19,20,4,6,32,82,38.28372704214269,-109.3529526
1859,0,34,10,0,11,14,69,38.28345754755745,-109.4240992
1860,0,36,10,0,12,13,71,38.28345754755745,-109.4238297
1861,1,35,11,0,14,11,72,38.28345754755745,-109.4235602
1862,1,31,11,1,11,13,68,38.28345754755745,-109.4232907
1863,0,28,12,0,9,19,68,38.28345754755745,-109.4230212
1864,0,33,11,0,11,16,71,38.28345754755745,-109.4227517
1865,1,33,12,0,11,18,75,38.28345754755745,-109.4224822
1866,1,32,13,1,9,20,76,38.28345754755745,-109.4222127
1867,2,32,13,1,9,20,77,38.28345754755745,-109.4219432
1868,1,36,12,0,10,19,78,38.28345754755745,-109.4216737
1869,1,31,12,0,10,19,73,38.28345754755745,-109.4214042
1870,1,31,12,0,11,17,72,38.28345754755745,-109.4211347
1871,1,32,11,0,11,15,70,38.28345754755745,-109.4208652
1872,1,34,10,0,10,13,68,38.28345754755745,-109.4205957
1873,0,32,10,1,8,14,65,38.28345754755745,-109.4203262
1874,1,32,9,2,9,11,64,38.28345754755745,-109.4200568
1875,1,32,9,2,10,9,63,38.28345754755745,-109.4197873
1876,1,31,8,2,10,8,60,38.28345754755745,-109.4195178
1877,0,31,8,2,9,9,59,38.28345754755745,-109.4192483
1878,0,35,8,2,9,9,63,38.28345754755745,-109.4189788
1879,0,34,8,1,9,11,63,38.28345754755745,-109.4187093
1880,1,39,9,0,9,12,70,38.28345754755745,-109.4184398
1881,1,38,9,0,8,11,67,38.28345754755745,-109.4181703
1882,2,38,9,2,9,9,69,38.28345754755745,-109.4179008
1883,1,38,11,1,13,11,75,38.28345754755745,-109.4176313
1884,1,30,12,1,8,18,70,38.28345754755745,-109.4173618
1885,2,30,12,1,9,17,71,38.28345754755745,-109.4170923
1886,3,37,12,1,11,13,77,38.28345754755745,-109.4168228
1887,3,39,12,2,13,9,78,38.28345754755745,-109.4165533
1888,1,36,9,0,10,12,68,38.28345754755745,-109.4162838
1889,2,38,8,1,10,9,68,38.28345754755745,-109.4160143
1890,2,38,8,2,9,8,67,38.28345754755745,-109.4157448
1891,1,37,10,2,10,11,71,38.28345754755745,-109.4154753
1892,4,33,13,4,8,13,75,38.28345754755745,-109.4152058
1893,2,29,12,4,8,15,70,38.28345754755745,-109.4149364
1894,1,22,13,4,7,17,64,38.28345754755745,-109.4146669
1895,1,25,13,2,7,18,66,38.28345754755745,-109.4143974
1896,1,32,12,1,10,14,70,38.28345754755745,-109.4141279
1897,0,31,11,0,11,15,68,38.28345754755745,-109.4138584
1898,0,33,11,0,10,16,70,38.28345754755745,-109.4135889
1899,1,32,10,0,8,17,68,38.28345754755745,-109.4133194
1900,1,35,11,0,9,17,73,38.28345754755745,-109.4130499
1901,2,40,11,1,11,14,79,38.28345754755745,-109.4127804
1902,1,48,10,1,12,9,81,38.28345754755745,-109.4125109
1903,1,44,10,1,13,11,80,38.28345754755745,-109.4122414
1904,1,34,12,0,7,19,73,38.28345754755745,-109.4119719
1905,0,26,12,0,2,24,64,38.28345754755745,-109.4117024
1906,1,34,10,0,7,16,68,38.28345754755745,-109.4114329
1907,2,33,10,1,9,11,66,38.28345754755745,-109.4111634
1908,1,32,10,1,10,11,65,38.28345754755745,-109.4108939
1909,1,33,11,0,11,13,69,38.28345754755745,-109.4106244
1910,1,35,10,0,10,15,71,38.28345754755745,-109.4103549
1911,1,35,10,0,8,17,71,38.28345754755745,-109.4100855
1912,1,38,9,0,8,16,72,38.28345754755745,-109.409816
1913,0,32,10,0,9,14,65,38.28345754755745,-109.4095465
1914,1,27,11,0,9,14,62,38.28345754755745,-109.409277
1915,1,27,11,0,9,15,63,38.28345754755745,-109.4090075
1916,1,28,11,0,8,20,68,38.28345754755745,-109.408738
1917,2,33,12,0,10,18,75,38.28345754755745,-109.4084685
1918,2,38,12,0,13,14,79,38.28345754755745,-109.408199
1919,3,40,12,0,14,12,81,38.28345754755745,-109.4079295
1920,3,39,12,0,12,14,80,38.28345754755745,-109.40766
1921,2,35,12,0,11,16,76,38.28345754755745,-109.4073905
1922,3,37,12,0,12,14,78,38.28345754755745,-109.407121
1923,4,38,12,1,13,11,79,38.28345754755745,-109.4068515
1924,1,25,18,7,10,22,83,38.28345754755745,-109.3879869
1925,2,25,17,8,10,21,83,38.28345754755745,-109.3877174
1926,4,23,17,8,8,21,81,38.28345754755745,-109.3874479
1927,0,26,20,3,7,27,83,38.28345754755745,-109.3871784
1928,0,25,19,4,8,25,81,38.28345754755745,-109.3869089
1929,2,26,17,7,10,20,82,38.28345754755745,-109.3866394
1930,1,26,17,8,10,20,82,38.28345754755745,-109.3863699
1931,1,24,16,5,9,24,79,38.28345754755745,-109.3861004
1932,1,27,16,4,7,26,81,38.28345754755745,-109.3858309
1933,0,28,17,2,6,28,81,38.28345754755745,-109.3855614
1934,1,25,16,0,5,27,74,38.28345754755745,-109.3852919
1935,1,24,16,1,5,25,72,38.28345754755745,-109.3850225
1936,2,27,14,3,7,19,72,38.28345754755745,-109.384753
1937,1,26,14,2,6,19,68,38.28345754755745,-109.3844835
1938,1,23,14,0,4,22,64,38.28345754755745,-109.384214
1939,0,22,13,0,3,22,60,38.28345754755745,-109.3839445
1940,2,24,13,1,4,22,66,38.28345754755745,-109.383675
1941,2,23,15,1,3,23,67,38.28345754755745,-109.3834055
1942,2,24,17,0,3,27,73,38.28345754755745,-109.383136
1943,1,22,18,0,5,30,76,38.28345754755745,-109.3828665
1944,1,23,20,1,6,33,84,38.28345754755745,-109.382597
1945,2,27,19,0,5,32,85,38.28345754755745,-109.3823275
1946,1,23,18,0,4,32,78,38.28345754755745,-109.382058
1947,0,22,19,0,5,33,79,38.28345754755745,-109.3817885
1948,0,24,20,0,4,33,81,38.28345754755745,-109.381519
1949,2,24,18,0,2,32,78,38.28345754755745,-109.3812495
1950,2,21,14,0,3,24,64,38.28345754755745,-109.38098
1951,2,23,13,0,4,21,63,38.28345754755745,-109.3807105
1952,3,26,14,0,6,21,70,38.28345754755745,-109.380441
1953,3,32,15,0,10,21,81,38.28345754755745,-109.3801716
1954,3,35,16,1,13,18,86,38.28345754755745,-109.3799021
1955,2,34,15,0,11,19,81,38.28345754755745,-109.3796326
1956,2,31,15,0,9,20,77,38.28345754755745,-109.3793631
1957,3,30,15,0,7,21,76,38.28345754755745,-109.3790936
1958,3,30,16,0,6,22,77,38.28345754755745,-109.3788241
1959,2,29,17,1,8,23,80,38.28345754755745,-109.3785546
1960,3,32,16,3,10,20,84,38.28345754755745,-109.3782851
1961,4,32,16,6,12,16,86,38.28345754755745,-109.3780156
1962,4,30,16,6,11,15,82,38.28345754755745,-109.3777461
1963,5,31,15,6,11,15,83,38.28345754755745,-109.3774766
1964,6,32,16,8,12,12,86,38.28345754755745,-109.3772071
1965,6,32,15,11,15,7,86,38.28345754755745,-109.3769376
1966,7,32,14,17,17,2,89,38.28345754755745,-109.3766681
1967,8,31,14,15,16,3,87,38.28345754755745,-109.3763986
1968,6,31,14,13,17,5,86,38.28345754755745,-109.3761291
1969,6,32,14,12,18,5,87,38.28345754755745,-109.3758596
1970,6,34,14,11,19,3,87,38.28345754755745,-109.3755901
1971,6,37,13,10,19,2,87,38.28345754755745,-109.3753206
1972,5,38,13,9,19,2,86,38.28345754755745,-109.3750512
1973,7,37,12,10,19,1,86,38.28345754755745,-109.3747817
1974,8,35,13,11,18,2,87,38.28345754755745,-109.3745122
1975,8,34,13,10,17,3,85,38.28345754755745,-109.3742427
1976,8,35,13,9,17,4,86,38.28345754755745,-109.3739732
1977,7,36,13,10,16,5,87,38.28345754755745,-109.3737037
1978,10,29,12,15,13,3,82,38.28345754755745,-109.3734342
1979,13,22,11,12,15,2,75,38.28345754755745,-109.3731647
1980,11,20,11,13,15,3,73,38.28345754755745,-109.3728952
1981,8,31,14,9,14,8,84,38.28345754755745,-109.3726257
1982,9,32,14,9,13,8,85,38.28345754755745,-109.3723562
1983,9,33,14,8,13,8,85,38.28345754755745,-109.3720867
1984,9,33,14,8,13,8,85,38.28345754755745,-109.3718172
1985,11,32,14,9,13,8,87,38.28345754755745,-109.3715477
1986,11,32,14,9,12,7,85,38.28345754755745,-109.3712782
1987,15,28,14,10,10,7,84,38.28345754755745,-109.3710087
1988,15,26,14,14,10,7,86,38.28345754755745,-109.3707392
1989,10,24,15,16,12,9,86,38.28345754755745,-109.3704697
1990,6,27,15,11,14,11,84,38.28345754755745,-109.3702003
1991,2,26,17,5,11,22,83,38.28345754755745,-109.3699308
1992,2,22,19,2,7,29,81,38.28345754755745,-109.3696613
1993,4,19,19,5,9,28,84,38.28345754755745,-109.3693918
1994,7,18,17,8,9,24,83,38.28345754755745,-109.3691223
1995,6,18,17,6,8,27,82,38.28345754755745,-109.3688528
1996,5,22,18,5,5,28,83,38.28345754755745,-109.3685833
1997,3,23,16,4,3,28,77,38.28345754755745,-109.3683138
1998,1,25,15,0,9,24,74,38.28345754755745,-109.3680443
1999,1,25,15,5,10,20,76,38.28345754755745,-109.3677748
2000,1,21,12,10,16,11,71,38.28345754755745,-109.3675053
2001,3,22,11,8,17,9,70,38.28345754755745,-109.3672358
2002,1,30,13,6,12,18,80,38.28345754755745,-109.3669663
2003,1,29,14,5,8,22,79,38.28345754755745,-109.3666968
2004,2,28,15,4,5,25,79,38.28345754755745,-109.3664273
2005,2,28,13,3,11,14,71,38.28345754755745,-109.3661578
2006,2,26,12,4,11,11,66,38.28345754755745,-109.3658883
2007,1,23,14,4,8,16,66,38.28345754755745,-109.3656188
2008,0,24,15,3,7,21,70,38.28345754755745,-109.3653493
2009,0,23,15,1,6,23,68,38.28345754755745,-109.3650799
2010,1,23,14,4,7,20,69,38.28345754755745,-109.3648104
2011,3,19,14,8,10,17,71,38.28345754755745,-109.3645409
2012,6,19,14,11,13,16,79,38.28345754755745,-109.3642714
2013,15,16,12,20,15,11,89,38.28345754755745,-109.3640019
2014,30,12,10,21,13,5,91,38.28345754755745,-109.3637324
2015,34,10,9,24,13,3,93,38.28345754755745,-109.3634629
2016,32,10,9,26,8,2,87,38.28345754755745,-109.3631934
2017,35,9,8,33,9,1,95,38.28345754755745,-109.3629239
2018,24,9,11,27,16,6,93,38.28345754755745,-109.3626544
2019,7,18,16,10,13,20,84,38.28345754755745,-109.3623849
2020,3,23,15,7,8,26,82,38.28345754755745,-109.3621154
2021,3,22,13,9,12,22,81,38.28345754755745,-109.3618459
2022,5,19,13,16,19,10,82,38.28345754755745,-109.3615764
2023,4,16,15,23,18,8,84,38.28345754755745,-109.3613069
2024,3,16,14,27,15,9,84,38.28345754755745,-109.3610374
2025,4,12,13,39,16,4,88,38.28345754755745,-109.3607679
2026,8,10,14,36,18,3,89,38.28345754755745,-109.3604984
2027,6,15,14,28,21,5,89,38.28345754755745,-109.360229
2028,2,20,14,18,22,8,84,38.28345754755745,-109.3599595
2029,0,15,16,16,17,13,77,38.28345754755745,-109.35969
2030,1,15,16,4,9,27,72,38.28345754755745,-109.3594205
2031,2,16,15,7,9,25,74,38.28345754755745,-109.359151
2032,2,18,15,7,9,25,76,38.28345754755745,-109.3588815
2033,2,23,12,13,16,8,74,38.28345754755745,-109.358612
2034,1,24,13,7,9,18,72,38.28345754755745,-109.3583425
2035,0,23,17,5,6,25,76,38.28345754755745,-109.358073
2036,0,21,21,1,4,33,80,38.28345754755745,-109.3578035
2037,0,18,21,0,2,34,75,38.28345754755745,-109.357534
2038,0,17,19,0,2,36,74,38.28345754755745,-109.3572645
2039,0,22,20,1,5,30,78,38.28345754755745,-109.356995
2040,0,23,19,4,6,26,78,38.28345754755745,-109.3567255
2041,0,24,17,2,5,28,76,38.28345754755745,-109.356456
2042,1,30,16,8,7,21,83,38.28345754755745,-109.3561865
2043,0,26,17,2,5,24,74,38.28345754755745,-109.355917
2044,0,26,14,4,5,20,69,38.28345754755745,-109.3556475
2045,0,23,12,3,6,17,61,38.28345754755745,-109.355378
2046,1,25,14,5,12,15,72,38.28345754755745,-109.3551086
2047,2,25,18,1,7,26,79,38.28345754755745,-109.3548391
2048,0,25,19,0,6,30,80,38.28345754755745,-109.3545696
2049,0,25,20,0,6,30,81,38.28345754755745,-109.3543001
2050,0,24,20,0,6,29,79,38.28345754755745,-109.3540306
2051,0,22,17,3,6,26,74,38.28345754755745,-109.3537611
2052,0,22,19,2,6,31,80,38.28345754755745,-109.3534916
2053,0,21,21,1,5,34,82,38.28345754755745,-109.3532221
2054,0,20,22,2,5,34,83,38.28345754755745,-109.3529526
2055,1,21,22,3,6,29,82,38.28345754755745,-109.3526831
2056,1,21,22,2,7,29,82,38.28345754755745,-109.3524136
2057,1,32,11,0,12,14,70,38.283188052972214,-109.4243687
2058,1,35,11,0,11,15,73,38.283188052972214,-109.4240992
2059,1,31,11,0,11,15,69,38.283188052972214,-109.4238297
2060,0,30,12,0,12,14,68,38.283188052972214,-109.4235602
2061,0,29,11,0,11,14,65,38.283188052972214,-109.4232907
2062,0,28,11,2,10,13,64,38.283188052972214,-109.4230212
2063,1,34,11,2,14,10,72,38.283188052972214,-109.4227517
2064,1,31,12,0,10,18,72,38.283188052972214,-109.4224822
2065,2,30,13,1,9,21,76,38.283188052972214,-109.4222127
2066,2,32,13,1,10,19,77,38.283188052972214,-109.4219432
2067,2,37,12,1,13,14,79,38.283188052972214,-109.4216737
2068,2,36,11,0,12,14,75,38.283188052972214,-109.4214042
2069,1,33,12,0,12,15,73,38.283188052972214,-109.4211347
2070,1,34,11,1,11,12,70,38.283188052972214,-109.4208652
2071,1,32,11,3,10,11,68,38.283188052972214,-109.4205957
2072,1,27,11,2,6,17,64,38.283188052972214,-109.4203262
2073,1,27,12,3,8,15,66,38.283188052972214,-109.4200568
2074,1,29,11,3,9,14,67,38.283188052972214,-109.4197873
2075,1,31,11,2,9,14,68,38.283188052972214,-109.4195178
2076,1,33,11,1,10,15,71,38.283188052972214,-109.4192483
2077,1,35,11,0,11,14,72,38.283188052972214,-109.4189788
2078,1,35,11,0,12,12,71,38.283188052972214,-109.4187093
2079,1,35,10,1,11,11,69,38.283188052972214,-109.4184398
2080,1,35,9,1,10,10,66,38.283188052972214,-109.4181703
2081,2,37,9,2,11,9,70,38.283188052972214,-109.4179008
2082,1,36,11,2,12,11,73,38.283188052972214,-109.4176313
2083,1,39,11,0,13,12,76,38.283188052972214,-109.4173618
2084,1,42,11,0,14,11,79,38.283188052972214,-109.4170923
2085,2,43,11,1,15,9,81,38.283188052972214,-109.4168228
2086,3,42,11,2,14,8,80,38.283188052972214,-109.4165533
2087,2,33,11,0,11,13,70,38.283188052972214,-109.4162838
2088,1,29,12,0,8,18,68,38.283188052972214,-109.4160143
2089,1,30,13,0,8,19,71,38.283188052972214,-109.4157448
2090,1,29,14,0,9,20,73,38.283188052972214,-109.4154753
2091,0,27,14,0,6,24,71,38.283188052972214,-109.4152058
2092,1,29,15,0,9,23,77,38.283188052972214,-109.4149364
2093,0,27,15,0,7,26,75,38.283188052972214,-109.4146669
2094,0,28,13,0,7,23,71,38.283188052972214,-109.4143974
2095,1,38,11,1,14,12,77,38.283188052972214,-109.4141279
2096,0,33,10,0,8,18,69,38.283188052972214,-109.4138584
2097,0,35,9,0,9,15,68,38.283188052972214,-109.4135889
2098,0,36,9,0,11,12,68,38.283188052972214,-109.4133194
2099,1,40,9,0,12,9,71,38.283188052972214,-109.4130499
2100,2,45,8,0,11,7,73,38.283188052972214,-109.4127804
2101,1,46,9,1,13,6,76,38.283188052972214,-109.4125109
2102,1,44,10,0,13,10,78,38.283188052972214,-109.4122414
2103,1,38,11,0,11,16,77,38.283188052972214,-109.4119719
2104,1,31,13,1,8,18,72,38.283188052972214,-109.4117024
2105,1,37,10,0,9,16,73,38.283188052972214,-109.4114329
2106,2,36,11,0,8,17,74,38.283188052972214,-109.4111634
2107,2,31,13,0,6,19,71,38.283188052972214,-109.4108939
2108,2,29,13,0,7,20,71,38.283188052972214,-109.4106244
2109,0,29,12,0,6,22,69,38.283188052972214,-109.4103549
2110,0,31,11,0,7,18,67,38.283188052972214,-109.4100855
2111,1,36,10,0,8,14,69,38.283188052972214,-109.409816
2112,1,34,10,0,10,12,67,38.283188052972214,-109.4095465
2113,1,30,10,1,11,12,65,38.283188052972214,-109.409277
2114,1,28,11,1,9,13,63,38.283188052972214,-109.4090075
2115,1,30,11,0,8,17,67,38.283188052972214,-109.408738
2116,2,36,12,0,11,16,77,38.283188052972214,-109.4084685
2117,2,38,12,0,12,15,79,38.283188052972214,-109.408199
2118,2,36,12,0,11,15,76,38.283188052972214,-109.4079295
2119,2,35,12,1,10,16,76,38.283188052972214,-109.40766
2120,3,33,12,1,9,16,74,38.283188052972214,-109.4073905
2121,3,33,12,1,9,17,75,38.283188052972214,-109.407121
2122,3,32,12,1,9,17,74,38.283188052972214,-109.4068515
2123,2,25,17,11,8,18,81,38.283188052972214,-109.3879869
2124,2,25,19,11,11,17,85,38.283188052972214,-109.3877174
2125,3,26,16,12,10,15,82,38.283188052972214,-109.3874479
2126,2,23,16,12,10,16,79,38.283188052972214,-109.3871784
2127,2,24,18,9,10,21,84,38.283188052972214,-109.3869089
2128,1,25,18,7,10,20,81,38.283188052972214,-109.3866394
2129,2,23,18,10,10,18,81,38.283188052972214,-109.3863699
2130,4,22,16,11,11,20,84,38.283188052972214,-109.3861004
2131,2,25,17,4,12,21,81,38.283188052972214,-109.3858309
2132,0,30,15,2,8,25,80,38.283188052972214,-109.3855614
2133,0,31,14,0,7,24,76,38.283188052972214,-109.3852919
2134,0,27,15,0,4,25,71,38.283188052972214,-109.3850225
2135,0,23,16,0,3,28,70,38.283188052972214,-109.384753
2136,1,24,15,0,4,24,68,38.283188052972214,-109.3844835
2137,0,23,14,0,4,22,63,38.283188052972214,-109.384214
2138,1,20,14,1,5,21,62,38.283188052972214,-109.3839445
2139,2,20,16,0,3,26,67,38.283188052972214,-109.383675
2140,2,22,17,0,3,28,72,38.283188052972214,-109.3834055
2141,1,21,18,0,3,30,73,38.283188052972214,-109.383136
2142,0,20,19,0,4,31,74,38.283188052972214,-109.3828665
2143,1,25,19,0,6,30,81,38.283188052972214,-109.382597
2144,2,24,16,0,5,25,72,38.283188052972214,-109.3823275
2145,1,22,17,0,4,28,72,38.283188052972214,-109.382058
2146,0,21,19,0,4,32,76,38.283188052972214,-109.3817885
2147,0,23,21,0,4,34,82,38.283188052972214,-109.381519
2148,2,25,19,0,4,31,81,38.283188052972214,-109.3812495
2149,0,23,16,0,3,29,71,38.283188052972214,-109.38098
2150,0,23,15,0,4,26,68,38.283188052972214,-109.3807105
2151,2,24,14,0,5,24,69,38.283188052972214,-109.380441
2152,2,26,15,0,6,23,72,38.283188052972214,-109.3801716
2153,2,33,14,0,10,19,78,38.283188052972214,-109.3799021
2154,2,33,14,0,10,18,77,38.283188052972214,-109.3796326
2155,2,31,15,0,8,19,75,38.283188052972214,-109.3793631
2156,2,27,16,0,6,24,75,38.283188052972214,-109.3790936
2157,2,26,16,0,4,26,74,38.283188052972214,-109.3788241
2158,2,25,17,0,4,28,76,38.283188052972214,-109.3785546
2159,3,31,16,2,9,22,83,38.283188052972214,-109.3782851
2160,4,31,16,8,13,14,86,38.283188052972214,-109.3780156
2161,4,31,15,11,14,10,85,38.283188052972214,-109.3777461
2162,6,32,16,10,13,10,87,38.283188052972214,-109.3774766
2163,7,32,16,10,14,9,88,38.283188052972214,-109.3772071
2164,8,32,15,11,15,6,87,38.283188052972214,-109.3769376
2165,8,32,15,14,16,4,89,38.283188052972214,-109.3766681
2166,6,32,15,13,16,5,87,38.283188052972214,-109.3763986
2167,5,31,14,10,16,8,84,38.283188052972214,-109.3761291
2168,5,32,14,9,18,7,85,38.283188052972214,-109.3758596
2169,5,34,14,9,18,6,86,38.283188052972214,-109.3755901
2170,5,35,14,9,19,5,87,38.283188052972214,-109.3753206
2171,5,35,13,10,19,3,85,38.283188052972214,-109.3750512
2172,5,33,12,12,20,2,84,38.283188052972214,-109.3747817
2173,5,34,13,14,20,2,88,38.283188052972214,-109.3745122
2174,6,34,13,13,19,2,87,38.283188052972214,-109.3742427
2175,9,33,13,11,18,3,87,38.283188052972214,-109.3739732
2176,9,35,13,9,17,3,86,38.283188052972214,-109.3737037
2177,9,33,12,11,14,3,82,38.283188052972214,-109.3734342
2178,11,24,11,13,14,2,75,38.283188052972214,-109.3731647
2179,11,21,11,10,16,3,72,38.283188052972214,-109.3728952
2180,9,24,13,14,13,6,79,38.283188052972214,-109.3726257
2181,10,30,14,10,13,7,84,38.283188052972214,-109.3723562
2182,11,33,14,8,12,9,87,38.283188052972214,-109.3720867
2183,11,33,14,9,12,7,86,38.283188052972214,-109.3718172
2184,12,31,13,10,12,5,83,38.283188052972214,-109.3715477
2185,11,31,14,10,11,8,85,38.283188052972214,-109.3712782
2186,9,32,15,9,11,10,86,38.283188052972214,-109.3710087
2187,8,29,15,9,13,11,85,38.283188052972214,-109.3707392
2188,7,27,15,9,15,10,83,38.283188052972214,-109.3704697
2189,7,27,15,12,15,8,84,38.283188052972214,-109.3702003
2190,4,29,16,7,14,14,84,38.283188052972214,-109.3699308
2191,2,27,16,5,10,22,82,38.283188052972214,-109.3696613
2192,3,25,17,4,8,26,83,38.283188052972214,-109.3693918
2193,3,23,18,4,7,29,84,38.283188052972214,-109.3691223
2194,3,24,17,4,9,27,84,38.283188052972214,-109.3688528
2195,3,21,17,5,6,31,83,38.283188052972214,-109.3685833
2196,2,24,16,4,5,30,81,38.283188052972214,-109.3683138
2197,2,26,16,1,12,24,81,38.283188052972214,-109.3680443
2198,1,25,15,4,11,21,77,38.283188052972214,-109.3677748
2199,2,20,13,9,12,15,71,38.283188052972214,-109.3675053
2200,3,24,12,7,15,14,75,38.283188052972214,-109.3672358
2201,1,29,14,6,13,17,80,38.283188052972214,-109.3669663
2202,1,29,14,5,12,19,80,38.283188052972214,-109.3666968
2203,0,29,14,4,10,22,79,38.283188052972214,-109.3664273
2204,0,32,14,1,11,21,79,38.283188052972214,-109.3661578
2205,1,25,12,3,11,12,64,38.283188052972214,-109.3658883
2206,0,23,13,3,10,14,63,38.283188052972214,-109.3656188
2207,0,22,14,1,6,21,64,38.283188052972214,-109.3653493
2208,2,24,15,3,6,20,70,38.283188052972214,-109.3650799
2209,1,25,14,0,5,21,66,38.283188052972214,-109.3648104
2210,1,25,13,1,8,18,66,38.283188052972214,-109.3645409
2211,2,19,15,6,8,19,69,38.283188052972214,-109.3642714
2212,4,20,17,6,13,22,82,38.283188052972214,-109.3640019
2213,15,17,14,14,15,11,86,38.283188052972214,-109.3637324
2214,28,11,11,20,16,7,93,38.283188052972214,-109.3634629
2215,32,10,9,27,12,3,93,38.283188052972214,-109.3631934
2216,32,9,8,31,10,2,92,38.283188052972214,-109.3629239
2217,25,9,11,31,12,5,93,38.283188052972214,-109.3626544
2218,10,16,14,12,19,16,87,38.283188052972214,-109.3623849
2219,2,19,14,7,15,20,77,38.283188052972214,-109.3621154
2220,2,19,12,7,17,16,73,38.283188052972214,-109.3618459
2221,3,13,12,15,18,10,71,38.283188052972214,-109.3615764
2222,4,16,12,17,14,13,76,38.283188052972214,-109.3613069
2223,5,16,14,18,17,9,79,38.283188052972214,-109.3610374
2224,6,16,14,19,17,9,81,38.283188052972214,-109.3607679
2225,5,13,15,20,19,12,84,38.283188052972214,-109.3604984
2226,4,14,14,21,20,12,85,38.283188052972214,-109.360229
2227,3,12,14,15,23,15,82,38.283188052972214,-109.3599595
2228,2,7,17,13,11,26,76,38.283188052972214,-109.35969
2229,2,11,15,7,10,28,73,38.283188052972214,-109.3594205
2230,2,15,14,10,12,21,74,38.283188052972214,-109.359151
2231,3,17,14,13,12,14,73,38.283188052972214,-109.3588815
2232,2,17,10,17,12,11,69,38.283188052972214,-109.358612
2233,1,21,17,4,8,25,76,38.283188052972214,-109.3583425
2234,1,20,21,4,6,30,82,38.283188052972214,-109.358073
2235,0,22,21,2,5,31,81,38.283188052972214,-109.3578035
2236,0,25,19,2,6,28,80,38.283188052972214,-109.357534
2237,0,24,20,1,6,31,82,38.283188052972214,-109.3572645
2238,0,23,21,1,6,32,83,38.283188052972214,-109.356995
2239,0,23,21,0,5,34,83,38.283188052972214,-109.3567255
2240,0,23,21,0,5,34,83,38.283188052972214,-109.356456
2241,0,22,21,1,5,34,83,38.283188052972214,-109.3561865
2242,1,19,21,4,6,32,83,38.283188052972214,-109.355917
2243,0,25,20,2,6,30,83,38.283188052972214,-109.3556475
2244,0,25,20,3,7,28,83,38.283188052972214,-109.355378
2245,0,21,20,3,7,30,81,38.283188052972214,-109.3551086
2246,0,23,20,0,8,29,80,38.283188052972214,-109.3548391
2247,0,20,22,1,6,32,81,38.283188052972214,-109.3545696
2248,0,19,23,0,5,33,80,38.283188052972214,-109.3543001
2249,0,20,21,1,5,31,78,38.283188052972214,-109.3540306
2250,0,21,19,2,4,29,75,38.283188052972214,-109.3537611
2251,0,22,19,2,5,31,79,38.283188052972214,-109.3534916
2252,0,22,20,0,5,33,80,38.283188052972214,-109.3532221
2253,0,22,21,0,5,33,81,38.283188052972214,-109.3529526
2254,1,21,21,2,7,28,80,38.283188052972214,-109.3526831
2255,2,18,21,7,8,23,79,38.283188052972214,-109.3524136
2256,2,20,21,4,7,27,81,38.283188052972214,-109.3521441
2257,2,32,11,1,11,12,69,38.28291855838698,-109.4246382
2258,1,31,11,0,11,14,68,38.28291855838698,-109.4243687
2259,1,36,12,0,10,14,73,38.28291855838698,-109.4240992
2260,2,32,11,0,9,16,70,38.28291855838698,-109.4238297
2261,0,29,12,0,10,16,67,38.28291855838698,-109.4235602
2262,0,28,12,0,10,15,65,38.28291855838698,-109.4232907
2263,1,28,11,1,9,14,64,38.28291855838698,-109.4230212
2264,1,33,12,1,12,13,72,38.28291855838698,-109.4227517
2265,1,28,12,0,8,21,70,38.28291855838698,-109.4224822
2266,1,28,14,1,7,23,74,38.28291855838698,-109.4222127
2267,2,29,14,1,8,22,76,38.28291855838698,-109.4219432
2268,2,30,13,2,11,17,75,38.28291855838698,-109.4216737
2269,3,33,12,2,13,13,76,38.28291855838698,-109.4214042
2270,2,32,12,0,10,17,73,38.28291855838698,-109.4211347
2271,1,31,12,0,10,18,72,38.28291855838698,-109.4208652
2272,1,32,12,0,11,16,72,38.28291855838698,-109.4205957
2273,0,27,13,0,7,23,70,38.28291855838698,-109.4203262
2274,1,30,13,0,10,19,73,38.28291855838698,-109.4200568
2275,1,27,14,0,8,22,72,38.28291855838698,-109.4197873
2276,1,27,14,0,7,23,72,38.28291855838698,-109.4195178
2277,1,30,14,0,8,23,76,38.28291855838698,-109.4192483
2278,1,29,13,0,8,21,72,38.28291855838698,-109.4189788
2279,1,28,12,0,9,18,68,38.28291855838698,-109.4187093
2280,1,33,11,1,11,13,70,38.28291855838698,-109.4184398
2281,1,35,10,1,10,10,67,38.28291855838698,-109.4181703
2282,1,38,10,0,11,11,71,38.28291855838698,-109.4179008
2283,1,34,11,0,12,14,72,38.28291855838698,-109.4176313
2284,1,36,12,0,10,16,75,38.28291855838698,-109.4173618
2285,1,37,11,0,10,15,74,38.28291855838698,-109.4170923
2286,2,39,11,0,12,12,76,38.28291855838698,-109.4168228
2287,4,43,12,2,15,7,83,38.28291855838698,-109.4165533
2288,2,37,14,2,12,15,82,38.28291855838698,-109.4162838
2289,1,34,15,1,11,19,81,38.28291855838698,-109.4160143
2290,1,29,15,0,8,25,78,38.28291855838698,-109.4157448
2291,1,28,16,0,8,26,79,38.28291855838698,-109.4154753
2292,2,33,14,0,7,21,77,38.28291855838698,-109.4152058
2293,1,32,13,0,9,19,74,38.28291855838698,-109.4149364
2294,0,31,13,0,11,20,75,38.28291855838698,-109.4146669
2295,0,30,14,0,11,21,76,38.28291855838698,-109.4143974
2296,0,30,13,0,10,21,74,38.28291855838698,-109.4141279
2297,0,30,12,0,8,21,71,38.28291855838698,-109.4138584
2298,1,34,10,0,8,16,69,38.28291855838698,-109.4135889
2299,1,37,9,0,9,12,68,38.28291855838698,-109.4133194
2300,0,37,9,0,11,11,68,38.28291855838698,-109.4130499
2301,1,38,10,0,11,13,73,38.28291855838698,-109.4127804
2302,1,36,10,0,9,15,71,38.28291855838698,-109.4125109
2303,1,35,10,0,8,17,71,38.28291855838698,-109.4122414
2304,1,36,10,0,8,17,72,38.28291855838698,-109.4119719
2305,1,40,10,0,10,14,75,38.28291855838698,-109.4117024
2306,1,42,10,0,11,13,77,38.28291855838698,-109.4114329
2307,0,29,11,0,7,19,66,38.28291855838698,-109.4111634
2308,0,29,12,0,6,21,68,38.28291855838698,-109.4108939
2309,0,32,12,0,8,20,72,38.28291855838698,-109.4106244
2310,1,32,13,0,10,18,74,38.28291855838698,-109.4103549
2311,1,34,10,0,10,15,70,38.28291855838698,-109.4100855
2312,1,32,12,0,13,12,70,38.28291855838698,-109.409816
2313,0,32,12,0,12,14,70,38.28291855838698,-109.4095465
2314,0,33,11,0,10,17,71,38.28291855838698,-109.409277
2315,0,35,10,0,9,15,69,38.28291855838698,-109.4090075
2316,0,34,10,0,11,13,68,38.28291855838698,-109.408738
2317,1,38,11,0,13,12,75,38.28291855838698,-109.4084685
2318,1,38,11,0,13,13,76,38.28291855838698,-109.408199
2319,1,34,11,0,9,18,73,38.28291855838698,-109.4079295
2320,2,37,12,0,8,19,78,38.28291855838698,-109.40766
2321,1,35,11,0,9,19,75,38.28291855838698,-109.4073905
2322,1,33,11,0,8,18,71,38.28291855838698,-109.407121
2323,2,28,12,0,6,20,68,38.28291855838698,-109.4068515
2324,3,26,19,5,7,22,82,38.28291855838698,-109.3879869
2325,2,28,20,3,8,23,84,38.28291855838698,-109.3877174
2326,3,27,18,9,9,17,83,38.28291855838698,-109.3874479
2327,1,28,19,6,8,20,82,38.28291855838698,-109.3871784
2328,1,26,15,7,9,17,75,38.28291855838698,-109.3869089
2329,1,27,14,8,12,15,77,38.28291855838698,-109.3866394
2330,2,28,14,10,14,9,77,38.28291855838698,-109.3863699
2331,2,29,13,10,16,9,79,38.28291855838698,-109.3861004
2332,3,26,15,10,12,13,79,38.28291855838698,-109.3858309
2333,1,30,15,2,8,21,77,38.28291855838698,-109.3855614
2334,0,31,12,3,7,18,71,38.28291855838698,-109.3852919
2335,1,34,12,0,7,14,68,38.28291855838698,-109.3850225
2336,1,24,14,0,4,23,66,38.28291855838698,-109.384753
2337,1,23,16,0,3,27,70,38.28291855838698,-109.3844835
2338,1,24,14,0,4,24,67,38.28291855838698,-109.384214
2339,1,23,15,3,6,20,68,38.28291855838698,-109.3839445
2340,0,27,14,1,6,22,70,38.28291855838698,-109.383675
2341,0,26,15,0,6,24,71,38.28291855838698,-109.3834055
2342,1,23,17,0,4,28,73,38.28291855838698,-109.383136
2343,1,20,18,0,3,30,72,38.28291855838698,-109.3828665
2344,1,25,17,0,6,27,76,38.28291855838698,-109.382597
2345,1,24,14,0,6,21,66,38.28291855838698,-109.3823275
2346,1,24,16,0,4,25,70,38.28291855838698,-109.382058
2347,1,24,18,0,5,28,76,38.28291855838698,-109.3817885
2348,0,24,20,1,6,31,82,38.28291855838698,-109.381519
2349,2,22,19,3,5,29,80,38.28291855838698,-109.3812495
2350,1,26,18,2,7,27,81,38.28291855838698,-109.38098
2351,1,27,18,2,7,26,81,38.28291855838698,-109.3807105
2352,7,20,13,9,7,20,76,38.28291855838698,-109.380441
2353,5,21,13,6,6,23,74,38.28291855838698,-109.3801716
2354,5,25,12,5,7,22,76,38.28291855838698,-109.3799021
2355,1,32,16,3,11,17,80,38.28291855838698,-109.3796326
2356,1,31,15,3,7,19,76,38.28291855838698,-109.3793631
2357,1,28,14,2,5,22,72,38.28291855838698,-109.3790936
2358,1,25,17,0,4,29,76,38.28291855838698,-109.3788241
2359,0,25,18,0,4,33,80,38.28291855838698,-109.3785546
2360,1,27,18,1,7,27,81,38.28291855838698,-109.3782851
2361,3,29,16,6,12,17,83,38.28291855838698,-109.3780156
2362,4,31,16,9,13,12,85,38.28291855838698,-109.3777461
2363,5,31,16,9,13,11,85,38.28291855838698,-109.3774766
2364,6,31,16,9,13,11,86,38.28291855838698,-109.3772071
2365,6,31,15,10,13,11,86,38.28291855838698,-109.3769376
2366,5,31,15,10,14,10,85,38.28291855838698,-109.3766681
2367,4,30,15,9,15,10,83,38.28291855838698,-109.3763986
2368,6,30,14,10,16,7,83,38.28291855838698,-109.3761291
2369,7,32,14,10,17,6,86,38.28291855838698,-109.3758596
2370,6,34,14,10,18,5,87,38.28291855838698,-109.3755901
2371,5,35,14,9,19,5,87,38.28291855838698,-109.3753206
2372,6,35,13,10,20,3,87,38.28291855838698,-109.3750512
2373,4,33,13,17,21,2,90,38.28291855838698,-109.3747817
2374,6,33,13,16,20,1,89,38.28291855838698,-109.3745122
2375,9,33,13,12,18,2,87,38.28291855838698,-109.3742427
2376,9,34,13,11,18,2,87,38.28291855838698,-109.3739732
2377,7,35,13,11,18,3,87,38.28291855838698,-109.3737037
2378,8,37,13,8,15,4,85,38.28291855838698,-109.3734342
2379,8,27,11,12,14,3,75,38.28291855838698,-109.3731647
2380,7,22,9,14,17,2,71,38.28291855838698,-109.3728952
2381,10,19,11,16,15,4,75,38.28291855838698,-109.3726257
2382,13,24,15,10,10,10,82,38.28291855838698,-109.3723562
2383,15,29,15,8,8,10,85,38.28291855838698,-109.3720867
2384,14,30,15,8,10,8,85,38.28291855838698,-109.3718172
2385,11,28,14,10,11,6,80,38.28291855838698,-109.3715477
2386,10,28,14,13,12,7,84,38.28291855838698,-109.3712782
2387,10,29,14,13,15,5,86,38.28291855838698,-109.3710087
2388,10,28,14,11,16,5,84,38.28291855838698,-109.3707392
2389,8,27,14,11,16,6,82,38.28291855838698,-109.3704697
2390,5,26,14,14,18,6,83,38.28291855838698,-109.3702003
2391,5,25,14,15,17,8,84,38.28291855838698,-109.3699308
2392,4,26,15,10,14,15,84,38.28291855838698,-109.3696613
2393,2,29,16,4,11,22,84,38.28291855838698,-109.3693918
2394,1,29,17,3,8,27,85,38.28291855838698,-109.3691223
2395,2,28,17,4,8,26,85,38.28291855838698,-109.3688528
2396,2,26,18,5,9,25,85,38.28291855838698,-109.3685833
2397,1,24,17,7,12,23,84,38.28291855838698,-109.3683138
2398,1,21,16,12,14,20,84,38.28291855838698,-109.3680443
2399,3,18,13,12,10,15,71,38.28291855838698,-109.3677748
2400,3,20,12,11,10,15,71,38.28291855838698,-109.3675053
2401,2,26,13,7,10,20,78,38.28291855838698,-109.3672358
2402,1,30,14,4,11,19,79,38.28291855838698,-109.3669663
2403,0,29,15,4,11,22,81,38.28291855838698,-109.3666968
2404,0,27,15,4,9,24,79,38.28291855838698,-109.3664273
2405,0,28,14,7,11,18,78,38.28291855838698,-109.3661578
2406,2,30,11,6,15,8,72,38.28291855838698,-109.3658883
2407,1,24,12,4,10,12,63,38.28291855838698,-109.3656188
2408,0,23,14,1,7,18,63,38.28291855838698,-109.3653493
2409,3,25,16,4,5,18,71,38.28291855838698,-109.3650799
2410,2,26,16,0,3,21,68,38.28291855838698,-109.3648104
2411,0,22,14,0,4,22,62,38.28291855838698,-109.3645409
2412,2,20,14,3,6,20,65,38.28291855838698,-109.3642714
2413,4,21,16,7,10,20,78,38.28291855838698,-109.3640019
2414,16,17,15,17,14,9,88,38.28291855838698,-109.3637324
2415,30,10,10,23,15,5,93,38.28291855838698,-109.3634629
2416,35,9,9,25,13,4,95,38.28291855838698,-109.3631934
2417,32,10,9,25,13,5,94,38.28291855838698,-109.3629239
2418,18,13,12,27,13,8,91,38.28291855838698,-109.3626544
2419,2,24,17,6,13,22,84,38.28291855838698,-109.3623849
2420,2,20,13,10,16,12,73,38.28291855838698,-109.3621154
2421,2,22,14,11,18,11,78,38.28291855838698,-109.3618459
2422,3,20,13,11,16,13,76,38.28291855838698,-109.3615764
2423,4,19,11,9,13,15,71,38.28291855838698,-109.3613069
2424,3,25,12,11,16,8,75,38.28291855838698,-109.3610374
2425,4,23,13,11,16,8,75,38.28291855838698,-109.3607679
2426,3,19,13,13,15,9,72,38.28291855838698,-109.3604984
2427,2,16,13,15,14,20,80,38.28291855838698,-109.360229
2428,3,12,18,13,10,27,83,38.28291855838698,-109.3599595
2429,2,13,15,11,11,27,79,38.28291855838698,-109.35969
2430,2,19,13,10,11,25,80,38.28291855838698,-109.3594205
2431,2,22,12,11,12,18,77,38.28291855838698,-109.359151
2432,0,17,11,14,15,9,66,38.28291855838698,-109.3588815
2433,3,17,12,16,8,22,78,38.28291855838698,-109.358612
2434,1,18,18,4,7,30,78,38.28291855838698,-109.3583425
2435,1,21,21,2,4,31,80,38.28291855838698,-109.358073
2436,1,24,19,1,5,29,79,38.28291855838698,-109.3578035
2437,1,27,18,1,6,25,78,38.28291855838698,-109.357534
2438,0,25,20,1,7,30,83,38.28291855838698,-109.3572645
2439,0,24,20,1,6,31,82,38.28291855838698,-109.356995
2440,0,22,21,0,5,33,81,38.28291855838698,-109.3567255
2441,0,22,21,0,5,33,81,38.28291855838698,-109.356456
2442,0,20,21,3,6,31,81,38.28291855838698,-109.3561865
2443,0,18,22,2,6,32,80,38.28291855838698,-109.355917
2444,0,21,21,1,7,30,80,38.28291855838698,-109.3556475
2445,0,23,21,1,7,29,81,38.28291855838698,-109.355378
2446,0,23,21,1,7,29,81,38.28291855838698,-109.3551086
2447,0,24,17,0,6,27,74,38.28291855838698,-109.3548391
2448,2,26,19,2,7,25,81,38.28291855838698,-109.3545696
2449,1,22,21,2,6,30,82,38.28291855838698,-109.3543001
2450,0,18,21,3,7,30,79,38.28291855838698,-109.3540306
2451,0,18,20,4,7,28,77,38.28291855838698,-109.3537611
2452,0,19,17,4,7,27,74,38.28291855838698,-109.3534916
2453,0,19,19,2,5,31,76,38.28291855838698,-109.3532221
2454,0,20,21,1,4,32,78,38.28291855838698,-109.3529526
2455,0,20,22,3,6,29,80,38.28291855838698,-109.3526831
2456,2,20,21,8,6,22,79,38.28291855838698,-109.3524136
2457,4,19,19,8,5,23,78,38.28291855838698,-109.3521441
2458,2,15,18,3,2,28,68,38.28291855838698,-109.3518746
2459,1,15,18,1,2,29,66,38.28291855838698,-109.3516051
2460,2,31,10,2,11,10,66,38.28264906380174,-109.4251771
2461,2,26,11,3,10,11,63,38.28264906380174,-109.4249077
2462,2,31,10,1,10,10,64,38.28264906380174,-109.4246382
2463,2,35,10,1,10,9,67,38.28264906380174,-109.4243687
2464,3,35,10,4,9,6,67,38.28264906380174,-109.4240992
2465,4,37,10,0,10,11,72,38.28264906380174,-109.4238297
2466,0,30,10,0,11,13,64,38.28264906380174,-109.4235602
2467,0,30,11,2,12,11,66,38.28264906380174,-109.4232907
2468,2,31,11,0,11,12,67,38.28264906380174,-109.4230212
2469,1,29,12,0,9,17,68,38.28264906380174,-109.4227517
2470,1,28,13,0,7,21,70,38.28264906380174,-109.4224822
2471,1,29,14,1,7,23,75,38.28264906380174,-109.4222127
2472,2,28,14,2,6,23,75,38.28264906380174,-109.4219432
2473,2,26,14,2,6,22,72,38.28264906380174,-109.4216737
2474,2,27,14,2,8,20,73,38.28264906380174,-109.4214042
2475,2,26,13,2,7,21,71,38.28264906380174,-109.4211347
2476,2,29,13,1,8,19,72,38.28264906380174,-109.4208652
2477,2,32,12,0,10,17,73,38.28264906380174,-109.4205957
2478,1,31,12,0,9,19,72,38.28264906380174,-109.4203262
2479,1,30,11,0,10,17,69,38.28264906380174,-109.4200568
2480,1,27,12,0,9,19,68,38.28264906380174,-109.4197873
2481,1,28,14,0,8,22,73,38.28264906380174,-109.4195178
2482,1,30,14,0,9,23,77,38.28264906380174,-109.4192483
2483,1,30,14,0,10,20,75,38.28264906380174,-109.4189788
2484,1,31,12,0,10,19,73,38.28264906380174,-109.4187093
2485,0,35,10,0,10,16,71,38.28264906380174,-109.4184398
2486,0,37,10,0,10,13,70,38.28264906380174,-109.4181703
2487,0,34,10,0,8,14,66,38.28264906380174,-109.4179008
2488,2,30,11,0,6,20,69,38.28264906380174,-109.4176313
2489,1,35,12,0,9,17,74,38.28264906380174,-109.4173618
2490,1,37,12,1,11,15,77,38.28264906380174,-109.4170923
2491,2,34,11,2,12,12,73,38.28264906380174,-109.4168228
2492,4,38,14,4,16,10,86,38.28264906380174,-109.4165533
2493,1,33,15,0,9,21,79,38.28264906380174,-109.4162838
2494,0,32,13,0,7,22,74,38.28264906380174,-109.4160143
2495,0,31,12,0,8,21,72,38.28264906380174,-109.4157448
2496,0,30,13,0,9,20,72,38.28264906380174,-109.4154753
2497,3,37,14,2,11,17,84,38.28264906380174,-109.4152058
2498,2,38,13,0,12,16,81,38.28264906380174,-109.4149364
2499,1,38,12,0,12,16,79,38.28264906380174,-109.4146669
2500,0,35,12,0,10,19,76,38.28264906380174,-109.4143974
2501,0,33,12,0,8,21,74,38.28264906380174,-109.4141279
2502,0,33,11,0,7,21,72,38.28264906380174,-109.4138584
2503,0,34,11,0,8,20,73,38.28264906380174,-109.4135889
2504,0,34,11,0,10,19,74,38.28264906380174,-109.4133194
2505,0,35,12,0,11,18,76,38.28264906380174,-109.4130499
2506,2,38,12,0,11,16,79,38.28264906380174,-109.4127804
2507,0,33,11,0,8,19,71,38.28264906380174,-109.4125109
2508,0,31,11,0,9,18,69,38.28264906380174,-109.4122414
2509,0,31,12,0,9,20,72,38.28264906380174,-109.4119719
2510,0,32,13,0,9,22,76,38.28264906380174,-109.4117024
2511,1,31,14,0,7,24,77,38.28264906380174,-109.4114329
2512,0,30,13,0,7,22,72,38.28264906380174,-109.4111634
2513,0,31,11,0,8,20,70,38.28264906380174,-109.4108939
2514,0,33,11,0,11,17,72,38.28264906380174,-109.4106244
2515,0,34,11,0,11,16,72,38.28264906380174,-109.4103549
2516,1,34,11,0,9,17,72,38.28264906380174,-109.4100855
2517,2,35,11,0,10,17,75,38.28264906380174,-109.409816
2518,1,33,12,0,10,18,74,38.28264906380174,-109.4095465
2519,0,30,12,0,8,21,71,38.28264906380174,-109.409277
2520,1,29,13,0,7,22,72,38.28264906380174,-109.4090075
2521,1,37,10,0,9,13,70,38.28264906380174,-109.408738
2522,1,43,9,0,12,11,76,38.28264906380174,-109.4084685
2523,1,43,10,0,13,13,80,38.28264906380174,-109.408199
2524,1,40,11,0,12,14,78,38.28264906380174,-109.4079295
2525,2,36,12,1,13,13,77,38.28264906380174,-109.40766
2526,2,37,12,1,14,12,78,38.28264906380174,-109.4073905
2527,2,35,12,0,11,15,75,38.28264906380174,-109.407121
2528,2,33,11,0,8,18,72,38.28264906380174,-109.4068515
2529,0,24,17,0,7,26,74,38.28264906380174,-109.3879869
2530,0,24,18,3,7,24,76,38.28264906380174,-109.3877174
2531,0,22,18,0,5,28,73,38.28264906380174,-109.3874479
2532,0,25,19,0,5,28,77,38.28264906380174,-109.3871784
2533,0,27,18,0,6,26,77,38.28264906380174,-109.3869089
2534,0,27,16,0,8,21,72,38.28264906380174,-109.3866394
2535,1,29,14,4,11,15,74,38.28264906380174,-109.3863699
2536,2,25,15,7,10,15,74,38.28264906380174,-109.3861004
2537,0,21,18,7,10,27,83,38.28264906380174,-109.3858309
2538,1,23,18,2,8,27,79,38.28264906380174,-109.3855614
2539,0,23,12,0,3,21,59,38.28264906380174,-109.3852919
2540,2,32,9,3,7,8,61,38.28264906380174,-109.3850225
2541,7,23,14,5,8,8,65,38.28264906380174,-109.384753
2542,2,18,15,3,5,22,65,38.28264906380174,-109.3844835
2543,1,23,17,0,3,28,72,38.28264906380174,-109.384214
2544,0,22,16,0,4,25,67,38.28264906380174,-109.3839445
2545,1,29,15,0,6,22,73,38.28264906380174,-109.383675
2546,1,26,14,1,8,19,69,38.28264906380174,-109.3834055
2547,1,23,16,1,7,22,70,38.28264906380174,-109.383136
2548,0,23,18,0,6,30,77,38.28264906380174,-109.3828665
2549,1,27,18,0,6,28,80,38.28264906380174,-109.382597
2550,1,21,13,3,6,18,62,38.28264906380174,-109.3823275
2551,2,23,14,3,5,20,67,38.28264906380174,-109.382058
2552,1,22,17,0,3,27,70,38.28264906380174,-109.3817885
2553,1,23,20,2,6,29,81,38.28264906380174,-109.381519
2554,2,20,17,4,7,30,80,38.28264906380174,-109.3812495
2555,1,28,17,3,9,26,84,38.28264906380174,-109.38098
2556,0,29,17,2,9,24,81,38.28264906380174,-109.3807105
2557,5,20,14,10,8,19,76,38.28264906380174,-109.380441
2558,5,19,14,10,8,21,77,38.28264906380174,-109.3801716
2559,4,20,14,9,7,23,77,38.28264906380174,-109.3799021
2560,0,32,16,3,11,22,84,38.28264906380174,-109.3796326
2561,0,27,14,4,7,20,72,38.28264906380174,-109.3793631
2562,0,25,14,2,5,21,67,38.28264906380174,-109.3790936
2563,0,23,15,2,5,23,68,38.28264906380174,-109.3788241
2564,1,21,16,0,3,27,68,38.28264906380174,-109.3785546
2565,2,23,16,1,5,24,71,38.28264906380174,-109.3782851
2566,3,26,16,3,7,20,75,38.28264906380174,-109.3780156
2567,4,29,16,6,10,16,81,38.28264906380174,-109.3777461
2568,5,30,17,8,12,14,86,38.28264906380174,-109.3774766
2569,4,27,16,7,10,16,80,38.28264906380174,-109.3772071
2570,5,29,16,7,10,15,82,38.28264906380174,-109.3769376
2571,6,32,16,7,12,13,86,38.28264906380174,-109.3766681
2572,5,32,15,7,14,12,85,38.28264906380174,-109.3763986
2573,5,33,15,8,16,9,86,38.28264906380174,-109.3761291
2574,6,34,14,9,17,6,86,38.28264906380174,-109.3758596
2575,6,35,14,8,18,6,87,38.28264906380174,-109.3755901
2576,4,36,14,7,18,7,86,38.28264906380174,-109.3753206
2577,4,37,14,8,19,6,88,38.28264906380174,-109.3750512
2578,3,36,14,11,21,3,88,38.28264906380174,-109.3747817
2579,5,35,13,13,20,2,88,38.28264906380174,-109.3745122
2580,7,35,13,12,18,2,87,38.28264906380174,-109.3742427
2581,8,35,13,10,18,2,86,38.28264906380174,-109.3739732
2582,8,35,13,10,17,3,86,38.28264906380174,-109.3737037
2583,8,33,13,9,17,5,85,38.28264906380174,-109.3734342
2584,6,29,12,15,15,4,81,38.28264906380174,-109.3731647
2585,6,23,10,16,16,2,73,38.28264906380174,-109.3728952
2586,10,20,10,14,15,2,71,38.28264906380174,-109.3726257
2587,12,21,14,11,11,9,78,38.28264906380174,-109.3723562
2588,15,27,14,10,10,8,84,38.28264906380174,-109.3720867
2589,17,28,14,10,11,6,86,38.28264906380174,-109.3718172
2590,13,27,14,14,13,4,85,38.28264906380174,-109.3715477
2591,9,26,13,20,14,4,86,38.28264906380174,-109.3712782
2592,8,28,13,14,17,5,85,38.28264906380174,-109.3710087
2593,7,28,13,13,17,5,83,38.28264906380174,-109.3707392
2594,6,26,13,13,16,8,82,38.28264906380174,-109.3704697
2595,6,24,14,12,15,13,84,38.28264906380174,-109.3702003
2596,4,26,14,9,14,15,82,38.28264906380174,-109.3699308
2597,3,25,14,7,12,19,80,38.28264906380174,-109.3696613
2598,2,28,15,5,9,22,81,38.28264906380174,-109.3693918
2599,2,27,14,6,8,23,80,38.28264906380174,-109.3691223
2600,2,27,14,7,9,19,78,38.28264906380174,-109.3688528
2601,4,28,14,12,13,11,82,38.28264906380174,-109.3685833
2602,2,24,15,13,14,14,82,38.28264906380174,-109.3683138
2603,2,23,13,12,14,13,77,38.28264906380174,-109.3680443
2604,2,23,12,10,12,14,73,38.28264906380174,-109.3677748
2605,2,24,12,10,11,16,75,38.28264906380174,-109.3675053
2606,2,25,14,7,8,24,80,38.28264906380174,-109.3672358
2607,2,28,14,6,8,24,82,38.28264906380174,-109.3669663
2608,2,29,14,6,7,23,81,38.28264906380174,-109.3666968
2609,1,28,14,5,7,23,78,38.28264906380174,-109.3664273
2610,2,23,11,9,11,12,68,38.28264906380174,-109.3661578
2611,4,31,12,8,17,6,78,38.28264906380174,-109.3658883
2612,1,30,12,1,12,13,69,38.28264906380174,-109.3656188
2613,1,27,12,0,6,18,64,38.28264906380174,-109.3653493
2614,1,24,13,1,4,20,63,38.28264906380174,-109.3650799
2615,3,22,16,4,5,18,68,38.28264906380174,-109.3648104
2616,0,21,14,0,4,23,62,38.28264906380174,-109.3645409
2617,1,19,15,2,6,21,64,38.28264906380174,-109.3642714
2618,5,22,16,10,13,15,81,38.28264906380174,-109.3640019
2619,14,14,13,26,14,7,88,38.28264906380174,-109.3637324
2620,36,8,9,25,11,4,93,38.28264906380174,-109.3634629
2621,38,8,8,27,11,4,96,38.28264906380174,-109.3631934
2622,28,12,11,24,12,6,93,38.28264906380174,-109.3629239
2623,14,19,14,12,12,14,85,38.28264906380174,-109.3626544
2624,2,23,15,6,9,25,80,38.28264906380174,-109.3623849
2625,2,18,10,9,13,10,62,38.28264906380174,-109.3621154
2626,8,24,12,16,6,12,78,38.28264906380174,-109.3618459
2627,3,24,13,9,11,16,76,38.28264906380174,-109.3615764
2628,3,22,14,6,9,17,71,38.28264906380174,-109.3613069
2629,2,29,12,7,11,9,70,38.28264906380174,-109.3610374
2630,3,31,12,7,12,5,70,38.28264906380174,-109.3607679
2631,1,26,13,7,13,9,69,38.28264906380174,-109.3604984
2632,2,25,15,8,13,16,79,38.28264906380174,-109.360229
2633,2,20,15,11,14,15,77,38.28264906380174,-109.3599595
2634,2,25,13,11,14,13,78,38.28264906380174,-109.35969
2635,3,20,12,14,18,6,73,38.28264906380174,-109.3594205
2636,1,20,12,13,15,9,70,38.28264906380174,-109.359151
2637,0,22,12,11,14,11,70,38.28264906380174,-109.3588815
2638,3,24,19,2,9,24,81,38.28264906380174,-109.358612
2639,1,18,22,2,4,31,78,38.28264906380174,-109.3583425
2640,0,19,23,1,4,33,80,38.28264906380174,-109.358073
2641,0,23,20,1,4,32,80,38.28264906380174,-109.3578035
2642,1,25,17,2,5,28,78,38.28264906380174,-109.357534
2643,1,23,19,1,6,30,80,38.28264906380174,-109.3572645
2644,0,22,19,0,5,32,78,38.28264906380174,-109.356995
2645,0,22,21,0,5,33,81,38.28264906380174,-109.3567255
2646,0,20,22,1,5,32,80,38.28264906380174,-109.356456
2647,1,20,20,4,8,28,81,38.28264906380174,-109.3561865
2648,0,19,21,2,6,30,78,38.28264906380174,-109.355917
2649,1,23,19,2,7,27,79,38.28264906380174,-109.3556475
2650,2,24,19,4,8,23,80,38.28264906380174,-109.355378
2651,1,23,18,4,7,22,75,38.28264906380174,-109.3551086
2652,0,26,18,1,8,26,79,38.28264906380174,-109.3548391
2653,0,25,20,2,9,26,82,38.28264906380174,-109.3545696
2654,1,19,20,5,10,27,82,38.28264906380174,-109.3543001
2655,2,17,19,5,9,32,84,38.28264906380174,-109.3540306
2656,2,15,19,6,8,33,83,38.28264906380174,-109.3537611
2657,1,15,21,4,7,31,79,38.28264906380174,-109.3534916
2658,1,18,20,4,7,29,79,38.28264906380174,-109.3532221
2659,0,18,21,3,6,28,76,38.28264906380174,-109.3529526
2660,0,22,20,2,6,28,78,38.28264906380174,-109.3526831
2661,0,21,18,0,3,30,72,38.28264906380174,-109.3524136
2662,0,14,15,0,2,28,59,38.28264906380174,-109.3521441
2663,0,15,17,0,2,28,62,38.28264906380174,-109.3518746
2664,1,15,19,0,2,30,67,38.28264906380174,-109.3516051
2665,1,16,19,1,2,30,69,38.28264906380174,-109.3513356
2666,2,17,19,3,3,27,71,38.28264906380174,-109.3510661
2667,2,38,10,1,11,9,71,38.28237957,-109.4254466
2668,3,34,9,3,9,8,66,38.28237957,-109.4251771
2669,1,29,8,2,8,10,58,38.28237957,-109.4249077
2670,2,33,7,2,8,8,60,38.28237957,-109.4246382
2671,3,37,7,4,9,5,65,38.28237957,-109.4243687
2672,3,38,9,5,9,3,67,38.28237957,-109.4240992
2673,3,37,9,0,9,9,67,38.28237957,-109.4238297
2674,1,37,9,0,11,8,66,38.28237957,-109.4235602
2675,1,34,10,2,12,8,67,38.28237957,-109.4232907
2676,3,31,11,0,13,11,69,38.28237957,-109.4230212
2677,2,28,12,1,9,16,68,38.28237957,-109.4227517
2678,1,28,13,0,7,21,70,38.28237957,-109.4224822
2679,2,28,14,2,6,22,74,38.28237957,-109.4222127
2680,2,27,14,3,6,23,75,38.28237957,-109.4219432
2681,2,25,15,3,5,24,74,38.28237957,-109.4216737
2682,2,24,14,3,5,23,71,38.28237957,-109.4214042
2683,2,24,14,3,5,22,70,38.28237957,-109.4211347
2684,2,28,13,3,7,20,73,38.28237957,-109.4208652
2685,2,32,12,2,9,17,74,38.28237957,-109.4205957
2686,3,33,12,2,9,16,75,38.28237957,-109.4203262
2687,2,30,11,0,7,16,66,38.28237957,-109.4200568
2688,1,28,11,0,9,16,65,38.28237957,-109.4197873
2689,1,28,12,0,10,18,69,38.28237957,-109.4195178
2690,0,28,13,0,9,22,72,38.28237957,-109.4192483
2691,1,32,14,0,12,18,77,38.28237957,-109.4189788
2692,1,29,13,0,9,19,71,38.28237957,-109.4187093
2693,0,31,11,0,10,17,69,38.28237957,-109.4184398
2694,1,35,11,0,10,15,72,38.28237957,-109.4181703
2695,0,35,11,0,7,17,70,38.28237957,-109.4179008
2696,2,29,13,0,5,21,70,38.28237957,-109.4176313
2697,1,35,11,0,8,18,73,38.28237957,-109.4173618
2698,2,35,11,1,11,13,73,38.28237957,-109.4170923
2699,5,36,13,6,14,9,83,38.28237957,-109.4168228
2700,3,34,15,4,15,16,87,38.28237957,-109.4165533
2701,1,29,15,0,5,27,77,38.28237957,-109.4162838
2702,1,31,13,0,5,23,73,38.28237957,-109.4160143
2703,1,34,12,0,9,18,74,38.28237957,-109.4157448
2704,0,35,12,0,11,17,75,38.28237957,-109.4154753
2705,2,36,14,0,12,18,82,38.28237957,-109.4152058
2706,1,31,12,0,10,19,73,38.28237957,-109.4149364
2707,0,34,11,0,10,17,72,38.28237957,-109.4146669
2708,0,34,12,0,10,19,75,38.28237957,-109.4143974
2709,0,30,12,0,8,22,72,38.28237957,-109.4141279
2710,1,31,12,0,8,22,74,38.28237957,-109.4138584
2711,1,32,12,0,8,22,75,38.28237957,-109.4135889
2712,1,32,13,0,7,23,76,38.28237957,-109.4133194
2713,1,31,14,0,7,25,78,38.28237957,-109.4130499
2714,0,31,14,0,7,25,77,38.28237957,-109.4127804
2715,1,36,13,0,9,19,78,38.28237957,-109.4125109
2716,2,37,13,0,9,18,79,38.28237957,-109.4122414
2717,1,35,13,0,9,20,78,38.28237957,-109.4119719
2718,1,32,13,0,9,21,76,38.28237957,-109.4117024
2719,1,32,12,0,9,19,73,38.28237957,-109.4114329
2720,0,31,12,0,11,18,72,38.28237957,-109.4111634
2721,0,32,12,0,11,17,72,38.28237957,-109.4108939
2722,1,33,12,0,11,17,74,38.28237957,-109.4106244
2723,1,35,11,0,12,16,75,38.28237957,-109.4103549
2724,0,35,11,0,11,17,74,38.28237957,-109.4100855
2725,1,34,12,0,10,18,75,38.28237957,-109.409816
2726,0,34,12,0,10,18,74,38.28237957,-109.4095465
2727,0,35,12,0,10,18,75,38.28237957,-109.409277
2728,1,33,12,0,9,21,76,38.28237957,-109.4090075
2729,0,32,12,0,10,19,73,38.28237957,-109.408738
2730,0,34,12,0,13,16,75,38.28237957,-109.4084685
2731,1,36,12,0,14,14,77,38.28237957,-109.408199
2732,2,40,12,0,15,12,81,38.28237957,-109.4079295
2733,3,42,12,0,15,10,82,38.28237957,-109.40766
2734,3,40,12,1,15,10,81,38.28237957,-109.4073905
2735,3,39,12,2,15,10,81,38.28237957,-109.407121
2736,3,38,12,3,14,10,80,38.28237957,-109.4068515
2737,0,25,16,0,5,26,72,38.28237957,-109.3879869
2738,0,23,16,0,4,26,69,38.28237957,-109.3877174
2739,1,24,16,0,5,25,71,38.28237957,-109.3874479
2740,0,24,18,0,4,27,73,38.28237957,-109.3871784
2741,0,26,19,0,5,29,79,38.28237957,-109.3869089
2742,0,26,19,0,6,27,78,38.28237957,-109.3866394
2743,0,28,18,3,8,21,78,38.28237957,-109.3863699
2744,2,27,17,1,8,21,76,38.28237957,-109.3861004
2745,1,25,16,0,5,25,72,38.28237957,-109.3858309
2746,0,20,15,0,2,27,64,38.28237957,-109.3855614
2747,2,18,14,3,4,18,59,38.28237957,-109.3852919
2748,2,25,9,3,7,10,56,38.28237957,-109.3850225
2749,7,21,14,4,7,9,62,38.28237957,-109.384753
2750,3,17,15,4,5,21,65,38.28237957,-109.3844835
2751,1,22,18,0,4,29,74,38.28237957,-109.384214
2752,0,25,17,0,4,29,75,38.28237957,-109.3839445
2753,1,27,14,1,5,22,70,38.28237957,-109.383675
2754,1,28,13,0,8,19,69,38.28237957,-109.3834055
2755,1,28,16,3,10,17,75,38.28237957,-109.383136
2756,1,28,17,3,8,23,80,38.28237957,-109.3828665
2757,2,28,17,2,6,25,80,38.28237957,-109.382597
2758,1,20,15,1,4,24,65,38.28237957,-109.3823275
2759,1,21,16,1,3,25,67,38.28237957,-109.382058
2760,1,23,17,0,4,29,74,38.28237957,-109.3817885
2761,1,24,19,2,6,29,81,38.28237957,-109.381519
2762,1,23,16,4,7,28,79,38.28237957,-109.3812495
2763,3,26,16,7,6,23,81,38.28237957,-109.38098
2764,2,27,16,7,7,23,82,38.28237957,-109.3807105
2765,0,29,16,3,10,22,80,38.28237957,-109.380441
2766,0,33,16,3,10,22,84,38.28237957,-109.3801716
2767,1,32,16,5,7,23,84,38.28237957,-109.3799021
2768,0,29,14,3,7,20,73,38.28237957,-109.3796326
2769,0,26,13,5,8,16,68,38.28237957,-109.3793631
2770,1,27,13,5,6,16,68,38.28237957,-109.3790936
2771,1,26,13,2,4,18,64,38.28237957,-109.3788241
2772,2,26,13,1,3,20,65,38.28237957,-109.3785546
2773,4,24,14,3,5,18,68,38.28237957,-109.3782851
2774,5,28,14,6,8,15,76,38.28237957,-109.3780156
2775,6,29,15,9,11,12,82,38.28237957,-109.3777461
2776,6,28,16,10,10,13,83,38.28237957,-109.3774766
2777,5,25,17,8,9,16,80,38.28237957,-109.3772071
2778,5,27,16,6,9,16,79,38.28237957,-109.3769376
2779,4,30,15,5,10,15,79,38.28237957,-109.3766681
2780,4,30,15,5,11,15,80,38.28237957,-109.3763986
2781,4,33,15,5,13,14,84,38.28237957,-109.3761291
2782,3,34,15,6,14,12,84,38.28237957,-109.3758596
2783,4,34,15,6,16,11,86,38.28237957,-109.3755901
2784,5,35,14,5,15,10,84,38.28237957,-109.3753206
2785,4,37,14,4,15,10,84,38.28237957,-109.3750512
2786,4,37,14,9,17,4,85,38.28237957,-109.3747817
2787,4,37,14,12,17,3,87,38.28237957,-109.3745122
2788,5,37,14,11,18,3,88,38.28237957,-109.3742427
2789,6,35,14,9,18,5,87,38.28237957,-109.3739732
2790,5,32,14,7,18,8,84,38.28237957,-109.3737037
2791,6,32,14,8,17,8,85,38.28237957,-109.3734342
2792,6,32,14,11,16,6,85,38.28237957,-109.3731647
2793,6,25,12,11,14,4,72,38.28237957,-109.3728952
2794,7,23,9,10,15,3,67,38.28237957,-109.3726257
2795,12,20,12,13,13,5,75,38.28237957,-109.3723562
2796,17,24,13,9,12,7,82,38.28237957,-109.3720867
2797,13,26,14,9,13,9,84,38.28237957,-109.3718172
2798,8,26,15,9,14,11,83,38.28237957,-109.3715477
2799,9,27,15,10,14,10,85,38.28237957,-109.3712782
2800,6,29,13,11,15,8,82,38.28237957,-109.3710087
2801,6,28,13,13,16,7,83,38.28237957,-109.3707392
2802,8,25,14,12,13,10,82,38.28237957,-109.3704697
2803,8,22,15,9,9,17,80,38.28237957,-109.3702003
2804,6,24,12,6,16,13,77,38.28237957,-109.3699308
2805,3,24,12,9,13,14,75,38.28237957,-109.3696613
2806,3,26,13,9,12,15,78,38.28237957,-109.3693918
2807,2,27,14,8,10,17,78,38.28237957,-109.3691223
2808,1,28,15,6,9,21,80,38.28237957,-109.3688528
2809,2,28,15,9,10,16,80,38.28237957,-109.3685833
2810,2,26,15,11,11,15,80,38.28237957,-109.3683138
2811,2,26,14,10,9,17,78,38.28237957,-109.3680443
2812,1,27,14,7,10,20,79,38.28237957,-109.3677748
2813,1,24,14,9,12,19,79,38.28237957,-109.3675053
2814,2,22,14,7,10,22,77,38.28237957,-109.3672358
2815,3,24,14,8,10,22,81,38.28237957,-109.3669663
2816,3,24,13,8,8,21,77,38.28237957,-109.3666968
2817,3,24,12,8,9,16,72,38.28237957,-109.3664273
2818,3,23,12,10,12,11,71,38.28237957,-109.3661578
2819,3,25,16,5,8,19,76,38.28237957,-109.3658883
2820,1,25,15,0,5,23,69,38.28237957,-109.3656188
2821,1,25,14,0,6,22,68,38.28237957,-109.3653493
2822,1,25,13,1,7,17,64,38.28237957,-109.3650799
2823,2,21,14,5,7,17,66,38.28237957,-109.3648104
2824,1,22,14,4,7,18,66,38.28237957,-109.3645409
2825,1,21,14,5,8,18,67,38.28237957,-109.3642714
2826,4,23,17,9,14,15,82,38.28237957,-109.3640019
2827,10,15,13,23,15,10,86,38.28237957,-109.3637324
2828,24,10,12,24,14,8,92,38.28237957,-109.3634629
2829,44,6,8,23,9,5,95,38.28237957,-109.3631934
2830,38,8,10,24,9,4,93,38.28237957,-109.3629239
2831,20,16,14,17,12,10,89,38.28237957,-109.3626544
2832,6,22,14,10,13,17,82,38.28237957,-109.3623849
2833,2,23,11,7,11,10,64,38.28237957,-109.3621154
2834,2,19,10,7,9,11,58,38.28237957,-109.3618459
2835,4,12,11,7,10,13,57,38.28237957,-109.3615764
2836,2,13,11,7,12,13,58,38.28237957,-109.3613069
2837,4,24,10,7,13,6,64,38.28237957,-109.3610374
2838,4,31,10,6,13,3,67,38.28237957,-109.3607679
2839,3,27,11,7,11,5,64,38.28237957,-109.3604984
2840,1,29,13,8,13,13,77,38.28237957,-109.360229
2841,1,28,14,8,15,15,81,38.28237957,-109.3599595
2842,5,23,15,12,12,10,77,38.28237957,-109.35969
2843,3,26,14,10,14,10,77,38.28237957,-109.3594205
2844,4,24,16,7,12,14,77,38.28237957,-109.359151
2845,2,24,18,3,7,24,78,38.28237957,-109.3588815
2846,1,20,20,3,6,29,79,38.28237957,-109.358612
2847,1,20,21,2,6,30,80,38.28237957,-109.3583425
2848,0,20,21,2,5,33,81,38.28237957,-109.358073
2849,0,21,21,1,5,33,81,38.28237957,-109.3578035
2850,1,22,19,0,4,32,78,38.28237957,-109.357534
2851,2,21,17,0,3,29,72,38.28237957,-109.3572645
2852,1,21,18,0,3,30,73,38.28237957,-109.356995
2853,0,21,20,0,6,31,78,38.28237957,-109.3567255
2854,1,17,21,3,6,30,78,38.28237957,-109.356456
2855,1,17,21,3,6,33,81,38.28237957,-109.3561865
2856,0,21,20,2,7,30,80,38.28237957,-109.355917
2857,1,23,19,0,6,27,76,38.28237957,-109.3556475
2858,1,24,18,1,7,23,74,38.28237957,-109.355378
2859,1,26,17,3,8,23,78,38.28237957,-109.3551086
2860,2,18,18,6,8,28,80,38.28237957,-109.3548391
2861,1,17,19,5,8,30,80,38.28237957,-109.3545696
2862,1,16,19,7,9,28,80,38.28237957,-109.3543001
2863,1,16,20,5,8,32,82,38.28237957,-109.3540306
2864,1,15,21,4,6,33,80,38.28237957,-109.3537611
2865,1,15,20,4,6,32,78,38.28237957,-109.3534916
2866,0,19,20,4,7,30,80,38.28237957,-109.3532221
2867,0,20,20,5,7,27,79,38.28237957,-109.3529526
2868,0,23,20,3,6,28,80,38.28237957,-109.3526831
2869,0,19,17,0,2,30,68,38.28237957,-109.3524136
2870,1,18,15,0,3,24,61,38.28237957,-109.3521441
2871,1,16,16,1,3,24,61,38.28237957,-109.3518746
2872,1,16,17,0,3,26,63,38.28237957,-109.3516051
2873,1,14,17,0,2,27,61,38.28237957,-109.3513356
2874,9,21,15,9,7,10,71,38.28237957,-109.3510661
2875,7,17,15,13,6,10,68,38.28237957,-109.3507966
2876,1,34,10,1,12,11,69,38.28211007463127,-109.4259856
2877,1,37,9,0,11,12,70,38.28211007463127,-109.4257161
2878,1,38,9,0,10,12,70,38.28211007463127,-109.4254466
2879,2,33,9,1,9,11,65,38.28211007463127,-109.4251771
2880,1,32,8,1,8,9,59,38.28211007463127,-109.4249077
2881,2,39,7,4,8,6,66,38.28211007463127,-109.4246382
2882,3,45,7,5,9,3,72,38.28211007463127,-109.4243687
2883,3,37,7,3,8,6,64,38.28211007463127,-109.4240992
2884,1,35,8,0,9,10,63,38.28211007463127,-109.4238297
2885,1,36,9,2,11,7,66,38.28211007463127,-109.4235602
2886,1,30,10,3,12,7,63,38.28211007463127,-109.4232907
2887,1,27,10,1,10,12,61,38.28211007463127,-109.4230212
2888,3,33,11,0,12,11,70,38.28211007463127,-109.4227517
2889,1,28,12,1,8,18,68,38.28211007463127,-109.4224822
2890,2,27,13,3,7,20,72,38.28211007463127,-109.4222127
2891,2,26,14,3,6,21,72,38.28211007463127,-109.4219432
2892,2,24,14,2,5,22,69,38.28211007463127,-109.4216737
2893,2,24,13,2,5,21,67,38.28211007463127,-109.4214042
2894,3,25,14,3,6,22,73,38.28211007463127,-109.4211347
2895,3,28,14,3,7,20,75,38.28211007463127,-109.4208652
2896,3,30,13,2,8,18,74,38.28211007463127,-109.4205957
2897,2,33,11,1,9,14,70,38.28211007463127,-109.4203262
2898,1,31,10,2,8,13,65,38.28211007463127,-109.4200568
2899,1,32,10,1,11,11,66,38.28211007463127,-109.4197873
2900,1,27,11,1,9,14,63,38.28211007463127,-109.4195178
2901,0,27,12,0,8,20,67,38.28211007463127,-109.4192483
2902,1,34,12,0,8,20,75,38.28211007463127,-109.4189788
2903,0,30,11,0,8,19,68,38.28211007463127,-109.4187093
2904,0,32,11,0,10,15,68,38.28211007463127,-109.4184398
2905,1,35,11,1,10,11,69,38.28211007463127,-109.4181703
2906,1,35,11,0,9,12,68,38.28211007463127,-109.4179008
2907,2,30,12,0,7,19,70,38.28211007463127,-109.4176313
2908,2,35,11,1,10,15,74,38.28211007463127,-109.4173618
2909,4,35,13,4,13,11,80,38.28211007463127,-109.4170923
2910,5,36,13,7,15,8,84,38.28211007463127,-109.4168228
2911,2,34,15,2,15,17,85,38.28211007463127,-109.4165533
2912,0,29,17,0,6,29,81,38.28211007463127,-109.4162838
2913,0,28,15,0,6,28,77,38.28211007463127,-109.4160143
2914,0,32,13,0,8,22,75,38.28211007463127,-109.4157448
2915,1,37,12,0,12,17,79,38.28211007463127,-109.4154753
2916,0,31,12,0,8,21,72,38.28211007463127,-109.4152058
2917,1,37,13,0,11,18,80,38.28211007463127,-109.4149364
2918,1,35,13,0,10,19,78,38.28211007463127,-109.4146669
2919,0,32,13,0,7,22,74,38.28211007463127,-109.4143974
2920,1,31,13,0,6,23,74,38.28211007463127,-109.4141279
2921,1,30,12,0,6,22,71,38.28211007463127,-109.4138584
2922,1,31,13,0,7,23,75,38.28211007463127,-109.4135889
2923,1,32,14,0,8,24,79,38.28211007463127,-109.4133194
2924,1,31,16,0,7,26,81,38.28211007463127,-109.4130499
2925,0,30,16,0,8,27,81,38.28211007463127,-109.4127804
2926,1,35,15,1,11,20,83,38.28211007463127,-109.4125109
2927,1,33,14,1,11,18,78,38.28211007463127,-109.4122414
2928,1,32,13,0,11,17,74,38.28211007463127,-109.4119719
2929,0,34,13,0,13,15,75,38.28211007463127,-109.4117024
2930,0,33,12,0,12,16,73,38.28211007463127,-109.4114329
2931,0,32,11,0,11,18,72,38.28211007463127,-109.4111634
2932,0,35,12,0,13,17,77,38.28211007463127,-109.4108939
2933,1,40,13,0,16,12,82,38.28211007463127,-109.4106244
2934,2,41,12,0,17,9,81,38.28211007463127,-109.4103549
2935,2,42,12,0,16,9,81,38.28211007463127,-109.4100855
2936,3,42,12,0,16,10,83,38.28211007463127,-109.409816
2937,2,42,12,0,16,10,82,38.28211007463127,-109.4095465
2938,2,42,12,1,17,8,82,38.28211007463127,-109.409277
2939,2,41,12,1,17,9,82,38.28211007463127,-109.4090075
2940,2,41,12,0,16,11,82,38.28211007463127,-109.408738
2941,2,41,12,1,16,10,82,38.28211007463127,-109.4084685
2942,2,42,13,1,16,9,83,38.28211007463127,-109.408199
2943,3,42,13,2,16,8,84,38.28211007463127,-109.4079295
2944,3,40,13,2,15,9,82,38.28211007463127,-109.40766
2945,3,42,13,2,17,7,84,38.28211007463127,-109.4073905
2946,3,42,12,3,16,6,82,38.28211007463127,-109.407121
2947,3,41,12,3,15,7,81,38.28211007463127,-109.4068515
2948,0,26,17,0,5,30,78,38.28211007463127,-109.3879869
2949,0,24,17,0,3,31,75,38.28211007463127,-109.3877174
2950,0,26,18,0,5,30,79,38.28211007463127,-109.3874479
2951,0,29,19,0,6,27,81,38.28211007463127,-109.3871784
2952,0,29,19,0,7,26,81,38.28211007463127,-109.3869089
2953,0,28,18,0,7,27,80,38.28211007463127,-109.3866394
2954,0,29,18,0,7,27,81,38.28211007463127,-109.3863699
2955,1,27,17,0,6,22,73,38.28211007463127,-109.3861004
2956,1,24,15,0,2,25,67,38.28211007463127,-109.3858309
2957,0,20,15,0,1,27,63,38.28211007463127,-109.3855614
2958,1,16,15,0,2,23,57,38.28211007463127,-109.3852919
2959,5,29,11,2,5,11,63,38.28211007463127,-109.3850225
2960,2,22,14,4,5,15,62,38.28211007463127,-109.384753
2961,2,19,15,4,5,22,67,38.28211007463127,-109.3844835
2962,0,23,18,0,5,31,77,38.28211007463127,-109.384214
2963,1,27,17,0,5,27,77,38.28211007463127,-109.3839445
2964,1,22,15,2,3,24,67,38.28211007463127,-109.383675
2965,1,28,15,0,7,22,73,38.28211007463127,-109.3834055
2966,1,29,17,2,10,20,79,38.28211007463127,-109.383136
2967,1,29,16,3,8,21,78,38.28211007463127,-109.3828665
2968,1,32,15,3,8,19,78,38.28211007463127,-109.382597
2969,0,25,16,0,6,24,71,38.28211007463127,-109.3823275
2970,0,25,17,0,6,27,75,38.28211007463127,-109.382058
2971,0,26,19,1,7,28,81,38.28211007463127,-109.3817885
2972,6,18,15,12,5,23,79,38.28211007463127,-109.381519
2973,2,18,14,10,7,28,79,38.28211007463127,-109.3812495
2974,2,24,14,9,6,25,80,38.28211007463127,-109.38098
2975,3,26,15,6,6,26,82,38.28211007463127,-109.3807105
2976,0,32,16,2,8,25,83,38.28211007463127,-109.380441
2977,0,30,16,2,8,25,81,38.28211007463127,-109.3801716
2978,0,32,14,4,7,21,78,38.28211007463127,-109.3799021
2979,0,30,13,2,7,18,70,38.28211007463127,-109.3796326
2980,1,30,13,1,7,17,69,38.28211007463127,-109.3793631
2981,1,30,11,1,4,16,63,38.28211007463127,-109.3790936
2982,2,28,11,1,4,15,61,38.28211007463127,-109.3788241
2983,2,27,11,2,4,15,61,38.28211007463127,-109.3785546
2984,3,23,13,3,5,16,63,38.28211007463127,-109.3782851
2985,4,24,14,4,7,17,70,38.28211007463127,-109.3780156
2986,5,26,15,5,8,17,76,38.28211007463127,-109.3777461
2987,4,25,16,6,8,17,76,38.28211007463127,-109.3774766
2988,4,25,17,5,8,18,77,38.28211007463127,-109.3772071
2989,4,27,16,4,9,16,76,38.28211007463127,-109.3769376
2990,4,29,15,4,9,16,77,38.28211007463127,-109.3766681
2991,3,29,15,3,9,18,77,38.28211007463127,-109.3763986
2992,4,31,16,4,11,17,83,38.28211007463127,-109.3761291
2993,4,32,16,6,13,14,85,38.28211007463127,-109.3758596
2994,5,34,15,7,14,11,86,38.28211007463127,-109.3755901
2995,6,35,14,6,14,9,84,38.28211007463127,-109.3753206
2996,4,37,13,4,14,10,82,38.28211007463127,-109.3750512
2997,4,36,13,8,16,6,83,38.28211007463127,-109.3747817
2998,5,36,14,11,16,4,86,38.28211007463127,-109.3745122
2999,5,35,14,10,16,6,86,38.28211007463127,-109.3742427
3000,4,33,14,7,14,11,83,38.28211007463127,-109.3739732
3001,4,30,15,6,13,13,81,38.28211007463127,-109.3737037
3002,5,32,16,4,13,14,84,38.28211007463127,-109.3734342
3003,7,32,15,6,12,13,85,38.28211007463127,-109.3731647
3004,7,28,13,8,11,8,75,38.28211007463127,-109.3728952
3005,5,22,10,10,12,4,63,38.28211007463127,-109.3726257
3006,5,18,10,12,16,4,65,38.28211007463127,-109.3723562
3007,18,20,12,12,13,5,80,38.28211007463127,-109.3720867
3008,21,20,13,12,13,5,84,38.28211007463127,-109.3718172
3009,15,21,14,15,14,5,84,38.28211007463127,-109.3715477
3010,13,23,14,14,13,7,84,38.28211007463127,-109.3712782
3011,3,25,17,8,13,18,84,38.28211007463127,-109.3710087
3012,4,26,16,4,10,20,80,38.28211007463127,-109.3707392
3013,3,26,14,0,8,19,70,38.28211007463127,-109.3704697
3014,2,23,12,1,7,17,62,38.28211007463127,-109.3702003
3015,8,28,12,6,13,10,77,38.28211007463127,-109.3699308
3016,1,28,12,7,14,13,75,38.28211007463127,-109.3696613
3017,1,30,12,7,13,15,78,38.28211007463127,-109.3693918
3018,1,30,13,6,9,20,79,38.28211007463127,-109.3691223
3019,0,30,15,5,9,22,81,38.28211007463127,-109.3688528
3020,0,28,16,3,8,24,79,38.28211007463127,-109.3685833
3021,1,28,15,7,9,21,81,38.28211007463127,-109.3683138
3022,1,27,15,7,9,22,81,38.28211007463127,-109.3680443
3023,2,25,15,7,8,24,81,38.28211007463127,-109.3677748
3024,2,23,15,8,9,22,79,38.28211007463127,-109.3675053
3025,2,23,14,8,12,20,79,38.28211007463127,-109.3672358
3026,3,21,14,9,10,19,76,38.28211007463127,-109.3669663
3027,3,21,13,11,10,16,74,38.28211007463127,-109.3666968
3028,4,22,13,11,11,11,72,38.28211007463127,-109.3664273
3029,3,23,18,7,8,21,80,38.28211007463127,-109.3661578
3030,0,20,19,0,4,31,74,38.28211007463127,-109.3658883
3031,0,22,17,0,4,29,72,38.28211007463127,-109.3656188
3032,1,24,15,0,5,25,70,38.28211007463127,-109.3653493
3033,1,24,14,0,6,21,66,38.28211007463127,-109.3650799
3034,1,25,14,3,8,17,68,38.28211007463127,-109.3648104
3035,2,25,14,6,11,14,72,38.28211007463127,-109.3645409
3036,2,24,14,11,12,12,75,38.28211007463127,-109.3642714
3037,3,23,15,13,11,13,78,38.28211007463127,-109.3640019
3038,7,19,16,17,16,12,87,38.28211007463127,-109.3637324
3039,13,16,14,28,13,8,92,38.28211007463127,-109.3634629
3040,24,10,12,25,12,7,90,38.28211007463127,-109.3631934
3041,37,7,12,19,11,6,92,38.28211007463127,-109.3629239
3042,32,9,12,21,11,6,91,38.28211007463127,-109.3626544
3043,24,16,12,20,14,6,92,38.28211007463127,-109.3623849
3044,6,19,14,10,10,12,71,38.28211007463127,-109.3621154
3045,2,22,12,7,8,14,65,38.28211007463127,-109.3618459
3046,2,17,11,7,7,13,57,38.28211007463127,-109.3615764
3047,3,16,10,9,12,9,59,38.28211007463127,-109.3613069
3048,5,25,9,9,11,4,63,38.28211007463127,-109.3610374
3049,5,23,10,8,13,5,64,38.28211007463127,-109.3607679
3050,4,25,10,7,15,5,66,38.28211007463127,-109.3604984
3051,3,23,11,5,13,8,63,38.28211007463127,-109.360229
3052,1,23,13,3,6,20,66,38.28211007463127,-109.3599595
3053,1,22,18,1,4,28,74,38.28211007463127,-109.35969
3054,2,23,20,3,5,28,81,38.28211007463127,-109.3594205
3055,1,22,21,1,5,30,80,38.28211007463127,-109.359151
3056,0,21,20,1,5,30,77,38.28211007463127,-109.3588815
3057,0,20,19,0,5,30,74,38.28211007463127,-109.358612
3058,0,22,18,0,5,28,73,38.28211007463127,-109.3583425
3059,1,24,18,1,6,29,79,38.28211007463127,-109.358073
3060,1,26,19,1,5,30,82,38.28211007463127,-109.3578035
3061,1,25,18,0,4,31,79,38.28211007463127,-109.357534
3062,1,21,17,0,3,30,72,38.28211007463127,-109.3572645
3063,1,22,19,1,6,29,78,38.28211007463127,-109.356995
3064,1,20,21,3,8,30,83,38.28211007463127,-109.3567255
3065,1,16,21,4,7,31,80,38.28211007463127,-109.356456
3066,1,16,21,4,8,31,81,38.28211007463127,-109.3561865
3067,1,19,21,4,7,30,82,38.28211007463127,-109.355917
3068,0,24,19,0,6,28,77,38.28211007463127,-109.3556475
3069,0,23,17,0,6,25,71,38.28211007463127,-109.355378
3070,0,22,18,3,7,25,75,38.28211007463127,-109.3551086
3071,0,19,18,4,6,30,77,38.28211007463127,-109.3548391
3072,0,19,20,3,6,31,79,38.28211007463127,-109.3545696
3073,1,18,20,4,6,31,80,38.28211007463127,-109.3543001
3074,1,18,21,5,7,30,82,38.28211007463127,-109.3540306
3075,1,19,21,4,7,29,81,38.28211007463127,-109.3537611
3076,1,20,20,4,7,29,81,38.28211007463127,-109.3534916
3077,0,21,19,1,6,29,76,38.28211007463127,-109.3532221
3078,1,18,17,1,5,26,68,38.28211007463127,-109.3529526
3079,2,16,15,2,4,23,62,38.28211007463127,-109.3526831
3080,2,15,15,1,3,23,59,38.28211007463127,-109.3524136
3081,2,13,15,1,3,23,57,38.28211007463127,-109.3521441
3082,2,14,16,1,3,23,59,38.28211007463127,-109.3518746
3083,2,13,16,2,2,23,58,38.28211007463127,-109.3516051
3084,3,11,14,5,4,18,55,38.28211007463127,-109.3513356
3085,12,18,14,13,9,5,71,38.28211007463127,-109.3510661
3086,12,20,16,20,9,4,81,38.28211007463127,-109.3507966
3087,21,22,16,18,11,3,91,38.28211007463127,-109.3505271
3088,23,20,11,19,6,2,81,38.28211007463127,-109.3502577
3089,2,37,10,3,12,8,72,38.28184058004604,-109.4262551
3090,2,36,10,3,11,8,70,38.28184058004604,-109.4259856
3091,1,39,9,1,11,10,71,38.28184058004604,-109.4257161
3092,1,40,10,0,12,12,75,38.28184058004604,-109.4254466
3093,2,39,10,0,11,12,74,38.28184058004604,-109.4251771
3094,1,37,9,1,11,10,69,38.28184058004604,-109.4249077
3095,2,37,8,2,9,8,66,38.28184058004604,-109.4246382
3096,1,39,7,1,9,6,63,38.28184058004604,-109.4243687
3097,1,41,7,2,9,5,65,38.28184058004604,-109.4240992
3098,3,36,9,3,11,7,69,38.28184058004604,-109.4238297
3099,2,31,10,2,11,8,64,38.28184058004604,-109.4235602
3100,1,28,10,2,11,9,61,38.28184058004604,-109.4232907
3101,1,30,9,2,12,8,62,38.28184058004604,-109.4230212
3102,2,31,11,2,14,8,68,38.28184058004604,-109.4227517
3103,1,29,11,1,9,16,67,38.28184058004604,-109.4224822
3104,2,28,12,2,8,17,69,38.28184058004604,-109.4222127
3105,3,28,12,2,8,17,70,38.28184058004604,-109.4219432
3106,2,26,12,2,7,18,67,38.28184058004604,-109.4216737
3107,2,25,13,2,6,21,69,38.28184058004604,-109.4214042
3108,2,27,14,2,7,22,74,38.28184058004604,-109.4211347
3109,2,28,14,2,7,21,74,38.28184058004604,-109.4208652
3110,2,28,12,2,8,18,70,38.28184058004604,-109.4205957
3111,2,33,10,1,10,13,69,38.28184058004604,-109.4203262
3112,1,34,10,2,10,8,65,38.28184058004604,-109.4200568
3113,1,33,8,2,10,6,60,38.28184058004604,-109.4197873
3114,1,34,8,2,10,8,63,38.28184058004604,-109.4195178
3115,1,30,10,1,12,12,66,38.28184058004604,-109.4192483
3116,1,33,10,0,7,16,67,38.28184058004604,-109.4189788
3117,1,33,10,2,11,11,68,38.28184058004604,-109.4187093
3118,1,33,9,2,9,8,62,38.28184058004604,-109.4184398
3119,2,36,8,2,8,6,62,38.28184058004604,-109.4181703
3120,2,37,9,3,9,7,67,38.28184058004604,-109.4179008
3121,1,29,11,1,7,17,66,38.28184058004604,-109.4176313
3122,3,34,12,2,10,13,74,38.28184058004604,-109.4173618
3123,5,34,13,6,13,11,82,38.28184058004604,-109.4170923
3124,3,31,13,3,15,15,80,38.28184058004604,-109.4168228
3125,2,28,15,1,11,21,78,38.28184058004604,-109.4165533
3126,2,29,16,0,9,25,81,38.28184058004604,-109.4162838
3127,1,29,15,1,8,23,77,38.28184058004604,-109.4160143
3128,0,31,13,0,8,23,75,38.28184058004604,-109.4157448
3129,1,35,12,0,10,19,77,38.28184058004604,-109.4154753
3130,1,38,11,0,9,17,76,38.28184058004604,-109.4152058
3131,1,33,13,0,10,21,78,38.28184058004604,-109.4149364
3132,1,32,13,0,9,22,77,38.28184058004604,-109.4146669
3133,1,33,13,0,8,21,76,38.28184058004604,-109.4143974
3134,3,34,13,0,8,20,78,38.28184058004604,-109.4141279
3135,1,29,13,0,6,24,73,38.28184058004604,-109.4138584
3136,1,31,14,0,7,23,76,38.28184058004604,-109.4135889
3137,1,30,15,0,7,26,79,38.28184058004604,-109.4133194
3138,0,30,17,0,8,28,83,38.28184058004604,-109.4130499
3139,1,30,17,0,8,26,82,38.28184058004604,-109.4127804
3140,0,33,14,0,11,20,78,38.28184058004604,-109.4125109
3141,0,34,13,0,11,19,77,38.28184058004604,-109.4122414
3142,0,32,13,0,9,21,75,38.28184058004604,-109.4119719
3143,0,31,12,0,8,22,73,38.28184058004604,-109.4117024
3144,1,34,11,0,7,20,73,38.28184058004604,-109.4114329
3145,1,40,12,0,11,16,80,38.28184058004604,-109.4111634
3146,2,42,12,0,13,14,83,38.28184058004604,-109.4108939
3147,2,43,12,0,15,12,84,38.28184058004604,-109.4106244
3148,3,44,13,1,16,9,86,38.28184058004604,-109.4103549
3149,4,44,13,2,18,5,86,38.28184058004604,-109.4100855
3150,4,44,12,2,19,5,86,38.28184058004604,-109.409816
3151,3,43,12,1,19,6,84,38.28184058004604,-109.4095465
3152,2,43,12,1,18,7,83,38.28184058004604,-109.409277
3153,2,44,12,2,18,6,84,38.28184058004604,-109.4090075
3154,3,45,12,1,18,6,85,38.28184058004604,-109.408738
3155,2,45,12,2,17,6,84,38.28184058004604,-109.4084685
3156,3,45,12,3,17,5,85,38.28184058004604,-109.408199
3157,4,45,13,4,17,4,87,38.28184058004604,-109.4079295
3158,4,43,13,3,18,5,86,38.28184058004604,-109.40766
3159,4,43,12,3,18,6,86,38.28184058004604,-109.4073905
3160,3,43,13,3,17,6,85,38.28184058004604,-109.407121
3161,3,42,13,3,16,7,84,38.28184058004604,-109.4068515
3162,0,25,17,0,4,30,76,38.28184058004604,-109.3879869
3163,0,25,18,0,5,30,78,38.28184058004604,-109.3877174
3164,0,25,19,0,5,31,80,38.28184058004604,-109.3874479
3165,0,27,18,0,5,31,81,38.28184058004604,-109.3871784
3166,0,26,17,0,4,28,75,38.28184058004604,-109.3869089
3167,0,25,16,0,4,27,72,38.28184058004604,-109.3866394
3168,0,25,16,0,4,27,72,38.28184058004604,-109.3863699
3169,1,24,15,0,3,25,68,38.28184058004604,-109.3861004
3170,0,21,15,0,1,26,63,38.28184058004604,-109.3858309
3171,0,21,16,0,1,28,66,38.28184058004604,-109.3855614
3172,0,21,16,0,1,29,67,38.28184058004604,-109.3852919
3173,2,24,14,1,4,18,63,38.28184058004604,-109.3850225
3174,1,25,13,4,6,16,65,38.28184058004604,-109.384753
3175,1,26,14,3,5,20,69,38.28184058004604,-109.3844835
3176,0,28,18,2,7,25,80,38.28184058004604,-109.384214
3177,0,29,20,2,8,26,85,38.28184058004604,-109.3839445
3178,0,26,19,1,7,29,82,38.28184058004604,-109.383675
3179,0,28,20,3,10,25,86,38.28184058004604,-109.3834055
3180,0,28,19,3,10,25,85,38.28184058004604,-109.383136
3181,0,29,18,2,7,26,82,38.28184058004604,-109.3828665
3182,0,28,16,2,7,24,77,38.28184058004604,-109.382597
3183,1,26,16,4,6,22,75,38.28184058004604,-109.3823275
3184,1,24,15,3,6,24,73,38.28184058004604,-109.382058
3185,1,25,18,3,7,29,83,38.28184058004604,-109.3817885
3186,1,23,17,3,10,27,81,38.28184058004604,-109.381519
3187,2,21,15,7,9,27,81,38.28184058004604,-109.3812495
3188,1,26,13,6,8,23,77,38.28184058004604,-109.38098
3189,1,29,15,4,8,25,82,38.28184058004604,-109.3807105
3190,1,30,16,3,7,26,83,38.28184058004604,-109.380441
3191,0,30,15,3,7,25,80,38.28184058004604,-109.3801716
3192,0,30,13,2,5,22,72,38.28184058004604,-109.3799021
3193,0,29,12,0,5,20,66,38.28184058004604,-109.3796326
3194,1,32,13,0,4,18,68,38.28184058004604,-109.3793631
3195,2,28,12,0,4,16,62,38.28184058004604,-109.3790936
3196,2,28,11,1,4,14,60,38.28184058004604,-109.3788241
3197,2,26,10,2,5,14,59,38.28184058004604,-109.3785546
3198,3,26,11,2,5,17,64,38.28184058004604,-109.3782851
3199,4,22,14,2,5,20,67,38.28184058004604,-109.3780156
3200,4,22,16,3,4,23,72,38.28184058004604,-109.3777461
3201,3,23,16,2,5,24,73,38.28184058004604,-109.3774766
3202,4,25,16,3,6,21,75,38.28184058004604,-109.3772071
3203,4,27,16,3,8,19,77,38.28184058004604,-109.3769376
3204,4,28,16,3,9,18,78,38.28184058004604,-109.3766681
3205,3,28,16,3,9,19,78,38.28184058004604,-109.3763986
3206,4,31,16,4,11,17,83,38.28184058004604,-109.3761291
3207,4,30,16,8,13,12,83,38.28184058004604,-109.3758596
3208,4,31,16,9,14,11,85,38.28184058004604,-109.3755901
3209,5,32,15,6,13,13,84,38.28184058004604,-109.3753206
3210,4,33,14,4,12,14,81,38.28184058004604,-109.3750512
3211,5,32,14,7,12,10,80,38.28184058004604,-109.3747817
3212,7,32,14,10,14,6,83,38.28184058004604,-109.3745122
3213,6,32,14,8,13,9,82,38.28184058004604,-109.3742427
3214,5,31,15,5,10,15,81,38.28184058004604,-109.3739732
3215,5,30,16,5,10,16,82,38.28184058004604,-109.3737037
3216,4,27,16,4,10,19,80,38.28184058004604,-109.3734342
3217,6,29,16,4,10,18,83,38.28184058004604,-109.3731647
3218,8,30,14,6,9,11,78,38.28184058004604,-109.3728952
3219,6,27,10,4,10,6,63,38.28184058004604,-109.3726257
3220,7,22,9,13,10,2,63,38.28184058004604,-109.3723562
3221,10,20,12,11,14,4,71,38.28184058004604,-109.3720867
3222,9,26,15,14,14,6,84,38.28184058004604,-109.3718172
3223,7,27,15,14,15,7,85,38.28184058004604,-109.3715477
3224,5,27,16,9,14,13,84,38.28184058004604,-109.3712782
3225,4,24,18,5,9,24,84,38.28184058004604,-109.3710087
3226,3,20,17,1,4,28,73,38.28184058004604,-109.3707392
3227,1,20,13,0,3,21,58,38.28184058004604,-109.3704697
3228,0,23,10,1,5,14,53,38.28184058004604,-109.3702003
3229,3,19,11,4,7,14,58,38.28184058004604,-109.3699308
3230,2,20,11,7,10,14,64,38.28184058004604,-109.3696613
3231,1,24,12,6,10,16,69,38.28184058004604,-109.3693918
3232,1,28,13,5,7,21,75,38.28184058004604,-109.3691223
3233,0,28,13,4,7,23,75,38.28184058004604,-109.3688528
3234,1,31,14,7,11,17,81,38.28184058004604,-109.3685833
3235,0,28,14,5,7,22,76,38.28184058004604,-109.3683138
3236,1,29,15,6,9,21,81,38.28184058004604,-109.3680443
3237,2,25,14,9,11,19,80,38.28184058004604,-109.3677748
3238,3,24,13,8,10,18,76,38.28184058004604,-109.3675053
3239,3,25,13,10,15,11,77,38.28184058004604,-109.3672358
3240,4,23,12,13,14,10,76,38.28184058004604,-109.3669663
3241,4,23,12,11,14,10,74,38.28184058004604,-109.3666968
3242,4,23,15,6,9,18,75,38.28184058004604,-109.3664273
3243,1,24,20,0,5,29,79,38.28184058004604,-109.3661578
3244,1,26,19,0,6,27,79,38.28184058004604,-109.3658883
3245,1,28,18,0,7,26,80,38.28184058004604,-109.3656188
3246,0,27,17,0,6,26,76,38.28184058004604,-109.3653493
3247,0,23,17,0,4,28,72,38.28184058004604,-109.3650799
3248,0,24,16,0,3,27,70,38.28184058004604,-109.3648104
3249,0,23,16,2,6,22,69,38.28184058004604,-109.3645409
3250,1,23,15,7,9,18,73,38.28184058004604,-109.3642714
3251,2,24,15,13,12,13,79,38.28184058004604,-109.3640019
3252,7,19,14,19,16,8,83,38.28184058004604,-109.3637324
3253,7,22,15,16,14,12,86,38.28184058004604,-109.3634629
3254,11,20,16,17,15,11,90,38.28184058004604,-109.3631934
3255,19,15,13,23,13,8,91,38.28184058004604,-109.3629239
3256,23,10,13,23,13,7,89,38.28184058004604,-109.3626544
3257,30,9,11,22,14,5,91,38.28184058004604,-109.3623849
3258,14,19,13,18,13,9,86,38.28184058004604,-109.3621154
3259,5,20,13,9,11,17,75,38.28184058004604,-109.3618459
3260,3,19,12,9,10,15,68,38.28184058004604,-109.3615764
3261,3,19,10,16,17,6,71,38.28184058004604,-109.3613069
3262,3,19,8,19,19,1,69,38.28184058004604,-109.3610374
3263,4,14,10,12,16,6,62,38.28184058004604,-109.3607679
3264,3,16,11,7,16,9,62,38.28184058004604,-109.3604984
3265,3,16,10,7,11,10,57,38.28184058004604,-109.360229
3266,4,12,11,8,9,12,56,38.28184058004604,-109.3599595
3267,2,12,13,7,5,17,56,38.28184058004604,-109.35969
3268,1,14,14,1,3,25,58,38.28184058004604,-109.3594205
3269,0,20,17,0,3,28,68,38.28184058004604,-109.359151
3270,0,21,18,0,5,28,72,38.28184058004604,-109.3588815
3271,0,23,20,1,7,28,79,38.28184058004604,-109.358612
3272,1,26,18,2,8,25,80,38.28184058004604,-109.3583425
3273,1,27,18,3,8,24,81,38.28184058004604,-109.358073
3274,1,27,18,2,8,25,81,38.28184058004604,-109.3578035
3275,2,28,18,1,6,27,82,38.28184058004604,-109.357534
3276,1,27,19,1,7,30,85,38.28184058004604,-109.3572645
3277,0,23,20,1,8,31,83,38.28184058004604,-109.356995
3278,1,19,21,3,8,30,82,38.28184058004604,-109.3567255
3279,1,19,21,4,8,29,82,38.28184058004604,-109.356456
3280,1,21,20,5,7,28,82,38.28184058004604,-109.3561865
3281,1,20,20,4,7,29,81,38.28184058004604,-109.355917
3282,1,19,20,3,7,30,80,38.28184058004604,-109.3556475
3283,0,20,20,4,7,28,79,38.28184058004604,-109.355378
3284,0,20,18,5,8,25,76,38.28184058004604,-109.3551086
3285,0,19,19,3,5,29,75,38.28184058004604,-109.3548391
3286,0,21,19,2,5,32,79,38.28184058004604,-109.3545696
3287,0,21,19,2,5,32,79,38.28184058004604,-109.3543001
3288,1,21,19,2,6,30,79,38.28184058004604,-109.3540306
3289,0,21,20,3,6,30,80,38.28184058004604,-109.3537611
3290,0,23,19,1,6,30,79,38.28184058004604,-109.3534916
3291,2,20,17,1,3,25,68,38.28184058004604,-109.3532221
3292,2,18,15,1,3,22,61,38.28184058004604,-109.3529526
3293,2,16,14,2,4,21,59,38.28184058004604,-109.3526831
3294,3,14,15,2,3,22,59,38.28184058004604,-109.3524136
3295,3,12,17,2,2,24,60,38.28184058004604,-109.3521441
3296,2,12,14,4,3,20,55,38.28184058004604,-109.3518746
3297,3,15,12,5,5,15,55,38.28184058004604,-109.3516051
3298,5,17,12,9,7,11,61,38.28184058004604,-109.3513356
3299,18,24,16,19,8,2,87,38.28184058004604,-109.3510661
3300,23,23,15,18,8,2,89,38.28184058004604,-109.3507966
3301,23,22,11,17,6,2,81,38.28184058004604,-109.3505271
3302,23,23,10,16,5,2,79,38.28184058004604,-109.3502577
3303,23,27,12,19,7,3,91,38.28184058004604,-109.3499882
3304,2,42,9,5,11,3,72,38.28157109,-109.4267941
3305,2,43,9,2,14,5,75,38.28157109,-109.4265246
3306,1,38,9,0,12,10,70,38.28157109,-109.4262551
3307,1,37,9,0,10,9,66,38.28157109,-109.4259856
3308,3,40,9,1,10,8,71,38.28157109,-109.4257161
3309,1,40,9,0,10,9,69,38.28157109,-109.4254466
3310,1,39,9,0,10,11,70,38.28157109,-109.4251771
3311,3,39,9,2,9,8,70,38.28157109,-109.4249077
3312,2,35,9,1,8,9,64,38.28157109,-109.4246382
3313,2,33,8,1,7,9,60,38.28157109,-109.4243687
3314,2,32,8,2,8,8,60,38.28157109,-109.4240992
3315,8,32,10,2,10,6,68,38.28157109,-109.4238297
3316,1,33,9,1,9,10,63,38.28157109,-109.4235602
3317,1,34,8,1,9,9,62,38.28157109,-109.4232907
3318,4,33,9,3,10,6,65,38.28157109,-109.4230212
3319,4,26,11,3,13,9,66,38.28157109,-109.4227517
3320,2,29,11,1,11,13,67,38.28157109,-109.4224822
3321,2,31,11,0,11,13,68,38.28157109,-109.4222127
3322,2,30,11,1,11,13,68,38.28157109,-109.4219432
3323,2,27,11,2,9,15,66,38.28157109,-109.4216737
3324,2,25,12,1,7,19,66,38.28157109,-109.4214042
3325,2,29,13,2,9,18,73,38.28157109,-109.4211347
3326,2,29,13,3,8,19,74,38.28157109,-109.4208652
3327,2,29,12,2,8,17,70,38.28157109,-109.4205957
3328,2,33,10,2,10,12,69,38.28157109,-109.4203262
3329,2,33,9,3,10,7,64,38.28157109,-109.4200568
3330,2,32,8,2,9,8,61,38.28157109,-109.4197873
3331,2,35,7,3,9,6,62,38.28157109,-109.4195178
3332,3,29,8,3,10,6,59,38.28157109,-109.4192483
3333,2,30,8,2,10,7,59,38.28157109,-109.4189788
3334,2,35,7,1,10,5,60,38.28157109,-109.4187093
3335,1,37,6,2,8,4,58,38.28157109,-109.4184398
3336,1,39,6,2,8,3,59,38.28157109,-109.4181703
3337,2,39,6,3,8,5,63,38.28157109,-109.4179008
3338,2,34,11,5,9,11,72,38.28157109,-109.4176313
3339,3,33,12,4,11,12,75,38.28157109,-109.4173618
3340,3,33,13,5,13,11,78,38.28157109,-109.4170923
3341,1,31,13,2,14,15,76,38.28157109,-109.4168228
3342,3,27,14,5,15,11,75,38.28157109,-109.4165533
3343,0,30,14,0,9,23,76,38.28157109,-109.4162838
3344,0,30,14,0,10,22,76,38.28157109,-109.4160143
3345,0,32,13,0,10,21,76,38.28157109,-109.4157448
3346,1,36,12,0,9,19,77,38.28157109,-109.4154753
3347,2,39,11,0,10,16,78,38.28157109,-109.4152058
3348,1,32,13,0,8,22,76,38.28157109,-109.4149364
3349,1,32,13,0,7,22,75,38.28157109,-109.4146669
3350,1,32,13,0,7,22,75,38.28157109,-109.4143974
3351,1,33,12,0,6,21,73,38.28157109,-109.4141279
3352,1,32,11,0,6,20,70,38.28157109,-109.4138584
3353,1,34,13,0,8,21,77,38.28157109,-109.4135889
3354,1,32,14,0,9,22,78,38.28157109,-109.4133194
3355,1,34,15,0,12,21,83,38.28157109,-109.4130499
3356,0,33,14,0,11,21,79,38.28157109,-109.4127804
3357,1,32,14,0,8,23,78,38.28157109,-109.4125109
3358,1,30,13,0,6,24,74,38.28157109,-109.4122414
3359,1,30,13,0,5,24,73,38.28157109,-109.4119719
3360,1,30,13,0,5,24,73,38.28157109,-109.4117024
3361,1,26,13,0,3,26,69,38.28157109,-109.4114329
3362,1,26,13,0,4,25,69,38.28157109,-109.4111634
3363,1,30,12,0,7,22,72,38.28157109,-109.4108939
3364,2,37,12,0,12,15,78,38.28157109,-109.4106244
3365,2,42,12,0,17,9,82,38.28157109,-109.4103549
3366,3,42,12,1,17,7,82,38.28157109,-109.4100855
3367,3,43,12,1,18,6,83,38.28157109,-109.409816
3368,3,41,11,1,18,7,81,38.28157109,-109.4095465
3369,3,40,11,2,18,7,81,38.28157109,-109.409277
3370,3,43,12,2,18,6,84,38.28157109,-109.4090075
3371,4,47,12,2,19,3,87,38.28157109,-109.408738
3372,3,47,12,2,18,4,86,38.28157109,-109.4084685
3373,3,45,12,3,18,4,85,38.28157109,-109.408199
3374,3,43,12,4,18,4,84,38.28157109,-109.4079295
3375,4,44,12,2,18,6,86,38.28157109,-109.40766
3376,4,43,12,3,18,6,86,38.28157109,-109.4073905
3377,4,44,13,5,18,4,88,38.28157109,-109.407121
3378,4,44,13,5,18,4,88,38.28157109,-109.4068515
3379,0,22,18,0,4,32,76,38.28157109,-109.3879869
3380,0,23,17,0,3,31,74,38.28157109,-109.3877174
3381,0,23,17,0,4,31,75,38.28157109,-109.3874479
3382,0,23,18,0,4,32,77,38.28157109,-109.3871784
3383,0,23,17,0,4,31,75,38.28157109,-109.3869089
3384,0,24,16,0,5,27,72,38.28157109,-109.3866394
3385,1,25,16,0,6,22,70,38.28157109,-109.3863699
3386,1,24,15,0,5,22,67,38.28157109,-109.3861004
3387,0,22,15,0,3,26,66,38.28157109,-109.3858309
3388,0,22,16,0,3,28,69,38.28157109,-109.3855614
3389,0,22,17,0,3,29,71,38.28157109,-109.3852919
3390,0,24,15,0,3,24,66,38.28157109,-109.3850225
3391,1,26,14,0,4,20,65,38.28157109,-109.384753
3392,0,29,13,2,6,19,69,38.28157109,-109.3844835
3393,0,29,15,4,7,21,76,38.28157109,-109.384214
3394,1,26,18,5,6,25,81,38.28157109,-109.3839445
3395,0,27,18,4,8,27,84,38.28157109,-109.383675
3396,0,29,18,4,9,24,84,38.28157109,-109.3834055
3397,0,29,19,3,9,26,86,38.28157109,-109.383136
3398,0,29,19,2,7,29,86,38.28157109,-109.3828665
3399,0,27,18,1,6,30,82,38.28157109,-109.382597
3400,1,25,17,3,5,27,78,38.28157109,-109.3823275
3401,1,26,16,5,6,25,79,38.28157109,-109.382058
3402,1,25,18,4,8,29,85,38.28157109,-109.3817885
3403,2,22,16,6,6,31,83,38.28157109,-109.381519
3404,2,21,15,8,8,28,82,38.28157109,-109.3812495
3405,1,27,14,6,9,26,83,38.28157109,-109.38098
3406,1,29,15,5,8,26,84,38.28157109,-109.3807105
3407,1,29,16,2,7,26,81,38.28157109,-109.380441
3408,1,31,15,3,6,25,81,38.28157109,-109.3801716
3409,0,36,13,3,9,19,80,38.28157109,-109.3799021
3410,0,29,12,0,6,18,65,38.28157109,-109.3796326
3411,1,33,11,0,6,13,64,38.28157109,-109.3793631
3412,2,28,10,2,6,11,59,38.28157109,-109.3790936
3413,2,26,11,1,5,13,58,38.28157109,-109.3788241
3414,1,27,10,2,6,13,59,38.28157109,-109.3785546
3415,2,28,10,2,4,17,63,38.28157109,-109.3782851
3416,3,25,13,2,4,20,67,38.28157109,-109.3780156
3417,2,20,15,2,4,22,65,38.28157109,-109.3777461
3418,3,22,15,2,4,22,68,38.28157109,-109.3774766
3419,3,22,15,3,5,21,69,38.28157109,-109.3772071
3420,3,22,16,3,6,21,71,38.28157109,-109.3769376
3421,3,24,17,2,6,23,75,38.28157109,-109.3766681
3422,2,25,17,1,6,26,77,38.28157109,-109.3763986
3423,2,26,17,1,6,25,77,38.28157109,-109.3761291
3424,3,28,17,5,10,19,82,38.28157109,-109.3758596
3425,3,28,17,5,11,20,84,38.28157109,-109.3755901
3426,2,27,17,2,9,23,80,38.28157109,-109.3753206
3427,2,24,17,2,6,23,74,38.28157109,-109.3750512
3428,4,24,15,7,9,15,74,38.28157109,-109.3747817
3429,7,28,14,10,12,8,79,38.28157109,-109.3745122
3430,7,30,14,9,12,10,82,38.28157109,-109.3742427
3431,5,30,15,6,11,14,81,38.28157109,-109.3739732
3432,5,28,15,6,10,15,79,38.28157109,-109.3737037
3433,7,26,16,6,9,16,80,38.28157109,-109.3734342
3434,8,27,16,6,10,14,81,38.28157109,-109.3731647
3435,6,28,13,6,11,11,75,38.28157109,-109.3728952
3436,3,32,10,6,13,5,69,38.28157109,-109.3726257
3437,6,28,9,13,8,1,65,38.28157109,-109.3723562
3438,8,21,11,10,14,3,67,38.28157109,-109.3720867
3439,8,25,13,9,12,7,74,38.28157109,-109.3718172
3440,7,28,14,6,11,11,77,38.28157109,-109.3715477
3441,6,26,14,4,8,14,72,38.28157109,-109.3712782
3442,3,21,15,2,4,23,68,38.28157109,-109.3710087
3443,2,19,15,0,3,25,64,38.28157109,-109.3707392
3444,1,22,11,0,3,20,57,38.28157109,-109.3704697
3445,1,27,10,1,7,13,59,38.28157109,-109.3702003
3446,3,22,10,2,8,10,55,38.28157109,-109.3699308
3447,3,15,10,5,9,13,55,38.28157109,-109.3696613
3448,4,21,11,6,12,13,67,38.28157109,-109.3693918
3449,4,25,12,5,12,16,74,38.28157109,-109.3691223
3450,2,26,12,5,11,16,72,38.28157109,-109.3688528
3451,6,28,11,5,14,7,71,38.28157109,-109.3685833
3452,2,27,10,5,11,9,64,38.28157109,-109.3683138
3453,0,29,12,6,16,10,73,38.28157109,-109.3680443
3454,2,26,12,9,17,8,74,38.28157109,-109.3677748
3455,2,27,11,8,18,9,75,38.28157109,-109.3675053
3456,5,27,15,10,13,10,80,38.28157109,-109.3672358
3457,4,26,16,9,11,14,80,38.28157109,-109.3669663
3458,1,25,18,3,8,24,79,38.28157109,-109.3666968
3459,0,27,18,0,6,28,79,38.28157109,-109.3664273
3460,3,30,17,1,6,22,79,38.28157109,-109.3661578
3461,1,29,18,0,7,24,79,38.28157109,-109.3658883
3462,0,30,18,0,8,24,80,38.28157109,-109.3656188
3463,0,29,18,0,7,26,80,38.28157109,-109.3653493
3464,0,27,19,0,6,29,81,38.28157109,-109.3650799
3465,0,28,19,0,6,30,83,38.28157109,-109.3648104
3466,0,26,18,1,6,26,77,38.28157109,-109.3645409
3467,0,22,16,5,6,24,73,38.28157109,-109.3642714
3468,2,23,16,7,7,21,76,38.28157109,-109.3640019
3469,4,25,15,10,11,14,79,38.28157109,-109.3637324
3470,3,27,15,9,13,13,80,38.28157109,-109.3634629
3471,3,26,16,10,12,15,82,38.28157109,-109.3631934
3472,4,22,17,14,12,16,85,38.28157109,-109.3629239
3473,11,16,15,27,12,9,90,38.28157109,-109.3626544
3474,16,11,12,33,13,5,90,38.28157109,-109.3623849
3475,14,14,12,29,15,6,90,38.28157109,-109.3621154
3476,6,18,15,21,17,10,87,38.28157109,-109.3618459
3477,3,19,15,19,18,12,86,38.28157109,-109.3615764
3478,3,19,13,19,19,10,83,38.28157109,-109.3613069
3479,3,16,11,17,21,4,72,38.28157109,-109.3610374
3480,3,16,10,12,18,7,66,38.28157109,-109.3607679
3481,3,15,12,11,10,13,64,38.28157109,-109.3604984
3482,3,13,11,8,14,11,60,38.28157109,-109.360229
3483,6,17,10,8,10,7,58,38.28157109,-109.3599595
3484,5,14,10,5,10,9,53,38.28157109,-109.35969
3485,6,9,12,8,9,11,55,38.28157109,-109.3594205
3486,3,13,13,7,5,17,58,38.28157109,-109.359151
3487,0,17,16,1,5,26,65,38.28157109,-109.3588815
3488,0,20,20,2,5,28,75,38.28157109,-109.358612
3489,0,26,17,3,8,23,77,38.28157109,-109.3583425
3490,0,28,18,3,10,23,82,38.28157109,-109.358073
3491,0,27,19,1,9,26,82,38.28157109,-109.3578035
3492,1,27,19,2,9,27,85,38.28157109,-109.357534
3493,0,23,20,2,9,30,84,38.28157109,-109.3572645
3494,0,23,20,3,8,29,83,38.28157109,-109.356995
3495,0,23,20,3,9,28,83,38.28157109,-109.3567255
3496,0,24,20,2,8,29,83,38.28157109,-109.356456
3497,0,23,20,2,7,29,81,38.28157109,-109.3561865
3498,1,19,21,3,8,30,82,38.28157109,-109.355917
3499,1,18,21,3,8,30,81,38.28157109,-109.3556475
3500,1,20,20,3,8,28,80,38.28157109,-109.355378
3501,0,21,19,3,8,27,78,38.28157109,-109.3551086
3502,0,18,20,4,6,30,78,38.28157109,-109.3548391
3503,0,20,20,3,7,29,79,38.28157109,-109.3545696
3504,0,23,20,2,7,29,81,38.28157109,-109.3543001
3505,0,26,20,1,6,29,82,38.28157109,-109.3540306
3506,0,24,18,0,5,30,77,38.28157109,-109.3537611
3507,1,18,17,0,3,27,66,38.28157109,-109.3534916
3508,2,20,16,0,2,25,65,38.28157109,-109.3532221
3509,2,18,16,0,2,26,64,38.28157109,-109.3529526
3510,3,17,17,1,2,26,66,38.28157109,-109.3526831
3511,3,12,17,2,2,26,62,38.28157109,-109.3524136
3512,3,14,17,5,3,23,65,38.28157109,-109.3521441
3513,11,22,14,10,7,11,75,38.28157109,-109.3518746
3514,18,30,14,12,9,5,88,38.28157109,-109.3516051
3515,21,28,12,12,8,4,85,38.28157109,-109.3513356
3516,23,25,11,13,7,3,82,38.28157109,-109.3510661
3517,24,25,10,16,6,3,84,38.28157109,-109.3507966
3518,24,27,11,15,7,3,87,38.28157109,-109.3505271
3519,23,29,12,15,7,4,90,38.28157109,-109.3502577
3520,20,28,12,19,7,4,90,38.28157109,-109.3499882
3521,22,26,12,21,6,4,91,38.28157109,-109.3497187
3522,24,26,11,19,7,3,90,38.28157109,-109.3494492
3523,1,38,9,0,10,12,70,38.281301590875565,-109.4270636
3524,2,39,9,0,10,10,70,38.281301590875565,-109.4267941
3525,2,45,9,1,12,8,77,38.281301590875565,-109.4265246
3526,1,37,10,0,13,10,71,38.281301590875565,-109.4262551
3527,2,37,10,3,12,7,71,38.281301590875565,-109.4259856
3528,2,38,9,3,10,6,68,38.281301590875565,-109.4257161
3529,2,34,9,3,10,7,65,38.281301590875565,-109.4254466
3530,1,36,9,2,11,8,67,38.281301590875565,-109.4251771
3531,2,36,9,2,9,8,66,38.281301590875565,-109.4249077
3532,2,36,9,1,9,9,66,38.281301590875565,-109.4246382
3533,1,33,10,1,9,12,66,38.281301590875565,-109.4243687
3534,2,28,10,1,9,12,62,38.281301590875565,-109.4240992
3535,5,29,10,2,9,9,64,38.281301590875565,-109.4238297
3536,2,33,9,3,9,8,64,38.281301590875565,-109.4235602
3537,2,33,9,2,10,8,64,38.281301590875565,-109.4232907
3538,6,29,10,2,9,7,63,38.281301590875565,-109.4230212
3539,5,26,10,2,11,8,62,38.281301590875565,-109.4227517
3540,2,27,10,3,11,9,62,38.281301590875565,-109.4224822
3541,2,29,10,3,11,10,65,38.281301590875565,-109.4222127
3542,2,27,11,4,10,11,65,38.281301590875565,-109.4219432
3543,3,24,11,4,9,12,63,38.281301590875565,-109.4216737
3544,2,28,12,2,9,16,69,38.281301590875565,-109.4214042
3545,3,32,12,2,11,15,75,38.281301590875565,-109.4211347
3546,3,33,12,2,11,15,76,38.281301590875565,-109.4208652
3547,2,35,10,1,10,12,70,38.281301590875565,-109.4205957
3548,1,32,8,2,8,9,60,38.281301590875565,-109.4203262
3549,1,33,8,2,10,6,60,38.281301590875565,-109.4200568
3550,1,38,7,2,9,7,64,38.281301590875565,-109.4197873
3551,2,41,7,3,9,5,67,38.281301590875565,-109.4195178
3552,1,37,7,3,9,5,62,38.281301590875565,-109.4192483
3553,1,35,7,4,8,6,61,38.281301590875565,-109.4189788
3554,1,38,6,4,8,5,62,38.281301590875565,-109.4187093
3555,1,38,6,3,8,4,60,38.281301590875565,-109.4184398
3556,1,38,6,3,8,4,60,38.281301590875565,-109.4181703
3557,2,40,7,4,9,6,68,38.281301590875565,-109.4179008
3558,4,37,8,4,7,9,69,38.281301590875565,-109.4176313
3559,5,36,13,5,14,8,81,38.281301590875565,-109.4173618
3560,2,35,12,5,14,9,77,38.281301590875565,-109.4170923
3561,4,36,11,6,20,6,83,38.281301590875565,-109.4168228
3562,4,39,9,2,20,4,78,38.281301590875565,-109.4165533
3563,1,32,12,0,14,15,74,38.281301590875565,-109.4162838
3564,1,34,12,0,11,19,77,38.281301590875565,-109.4160143
3565,0,33,12,0,8,21,74,38.281301590875565,-109.4157448
3566,1,32,12,0,7,22,74,38.281301590875565,-109.4154753
3567,1,33,12,0,8,20,74,38.281301590875565,-109.4152058
3568,1,31,13,0,8,22,75,38.281301590875565,-109.4149364
3569,1,32,13,0,7,22,75,38.281301590875565,-109.4146669
3570,0,31,12,0,7,21,71,38.281301590875565,-109.4143974
3571,0,31,12,0,6,21,70,38.281301590875565,-109.4141279
3572,0,32,11,0,10,15,68,38.281301590875565,-109.4138584
3573,1,34,11,0,8,17,71,38.281301590875565,-109.4135889
3574,1,35,12,0,10,18,76,38.281301590875565,-109.4133194
3575,1,35,14,0,12,18,80,38.281301590875565,-109.4130499
3576,2,35,13,0,10,18,78,38.281301590875565,-109.4127804
3577,2,34,14,0,6,22,78,38.281301590875565,-109.4125109
3578,2,33,14,0,6,23,78,38.281301590875565,-109.4122414
3579,1,34,13,0,8,22,78,38.281301590875565,-109.4119719
3580,1,35,12,0,9,19,76,38.281301590875565,-109.4117024
3581,1,34,11,0,8,20,74,38.281301590875565,-109.4114329
3582,1,30,12,0,6,22,71,38.281301590875565,-109.4111634
3583,0,29,12,0,6,22,69,38.281301590875565,-109.4108939
3584,0,31,12,0,8,20,71,38.281301590875565,-109.4106244
3585,1,35,11,0,11,15,73,38.281301590875565,-109.4103549
3586,1,38,11,0,14,12,76,38.281301590875565,-109.4100855
3587,2,40,11,0,16,10,79,38.281301590875565,-109.409816
3588,7,37,12,5,16,7,84,38.281301590875565,-109.4095465
3589,15,36,12,10,14,3,90,38.281301590875565,-109.409277
3590,15,36,12,11,15,2,91,38.281301590875565,-109.4090075
3591,5,40,13,6,17,4,85,38.281301590875565,-109.408738
3592,4,45,13,4,19,2,87,38.281301590875565,-109.4084685
3593,4,47,13,4,19,2,89,38.281301590875565,-109.408199
3594,4,48,12,3,17,4,88,38.281301590875565,-109.4079295
3595,3,44,12,2,16,7,84,38.281301590875565,-109.40766
3596,4,44,13,3,17,5,86,38.281301590875565,-109.4073905
3597,5,44,13,4,17,4,87,38.281301590875565,-109.407121
3598,4,44,13,5,17,4,87,38.281301590875565,-109.4068515
3599,1,20,17,0,2,31,71,38.281301590875565,-109.3879869
3600,1,21,16,0,3,28,69,38.281301590875565,-109.3877174
3601,0,23,15,0,5,27,70,38.281301590875565,-109.3874479
3602,0,24,18,0,5,31,78,38.281301590875565,-109.3871784
3603,0,23,18,0,4,32,77,38.281301590875565,-109.3869089
3604,0,23,17,0,3,31,74,38.281301590875565,-109.3866394
3605,0,25,15,0,4,25,69,38.281301590875565,-109.3863699
3606,1,27,14,0,5,22,69,38.281301590875565,-109.3861004
3607,0,25,15,0,5,25,70,38.281301590875565,-109.3858309
3608,0,24,16,0,4,26,70,38.281301590875565,-109.3855614
3609,0,23,16,0,4,26,69,38.281301590875565,-109.3852919
3610,1,23,16,0,4,24,68,38.281301590875565,-109.3850225
3611,0,24,16,0,3,27,70,38.281301590875565,-109.384753
3612,0,25,16,0,4,27,72,38.281301590875565,-109.3844835
3613,0,26,17,1,6,25,75,38.281301590875565,-109.384214
3614,1,28,19,3,8,24,83,38.281301590875565,-109.3839445
3615,0,27,19,3,7,26,82,38.281301590875565,-109.383675
3616,0,27,18,4,8,23,80,38.281301590875565,-109.3834055
3617,0,27,18,4,8,24,81,38.281301590875565,-109.383136
3618,0,29,18,3,7,28,85,38.281301590875565,-109.3828665
3619,0,28,18,3,7,29,85,38.281301590875565,-109.382597
3620,0,27,18,2,6,30,83,38.281301590875565,-109.3823275
3621,0,27,18,5,8,27,85,38.281301590875565,-109.382058
3622,1,26,17,5,8,28,85,38.281301590875565,-109.3817885
3623,2,24,15,5,6,30,82,38.281301590875565,-109.381519
3624,2,23,15,6,7,29,82,38.281301590875565,-109.3812495
3625,2,25,14,5,9,29,84,38.281301590875565,-109.38098
3626,2,26,14,7,6,28,83,38.281301590875565,-109.3807105
3627,2,26,14,7,4,28,81,38.281301590875565,-109.380441
3628,2,27,14,5,5,23,76,38.281301590875565,-109.3801716
3629,2,25,11,5,8,12,63,38.281301590875565,-109.3799021
3630,2,36,11,3,9,7,68,38.281301590875565,-109.3796326
3631,2,34,9,3,8,7,63,38.281301590875565,-109.3793631
3632,2,31,10,3,7,8,61,38.281301590875565,-109.3790936
3633,3,26,11,3,6,12,61,38.281301590875565,-109.3788241
3634,1,26,10,2,6,15,60,38.281301590875565,-109.3785546
3635,2,23,13,2,3,22,65,38.281301590875565,-109.3782851
3636,2,19,15,1,3,24,64,38.281301590875565,-109.3780156
3637,2,18,15,2,3,24,64,38.281301590875565,-109.3777461
3638,2,20,15,3,4,22,66,38.281301590875565,-109.3774766
3639,2,21,14,4,5,19,65,38.281301590875565,-109.3772071
3640,2,21,15,3,5,21,67,38.281301590875565,-109.3769376
3641,2,20,17,2,4,25,70,38.281301590875565,-109.3766681
3642,2,21,17,0,3,29,72,38.281301590875565,-109.3763986
3643,2,22,16,1,3,26,70,38.281301590875565,-109.3761291
3644,2,23,15,2,5,22,69,38.281301590875565,-109.3758596
3645,2,23,15,2,6,22,70,38.281301590875565,-109.3755901
3646,2,22,16,3,5,23,71,38.281301590875565,-109.3753206
3647,3,21,15,4,5,21,69,38.281301590875565,-109.3750512
3648,4,21,14,6,7,16,68,38.281301590875565,-109.3747817
3649,5,27,13,10,11,7,73,38.281301590875565,-109.3745122
3650,7,29,13,11,13,5,78,38.281301590875565,-109.3742427
3651,8,28,14,10,13,7,80,38.281301590875565,-109.3739732
3652,6,26,15,9,11,12,79,38.281301590875565,-109.3737037
3653,8,29,13,9,11,9,79,38.281301590875565,-109.3734342
3654,6,30,12,9,12,7,76,38.281301590875565,-109.3731647
3655,5,32,11,9,12,6,75,38.281301590875565,-109.3728952
3656,4,40,9,6,10,5,74,38.281301590875565,-109.3726257
3657,7,34,10,13,6,1,71,38.281301590875565,-109.3723562
3658,6,25,9,10,12,3,65,38.281301590875565,-109.3720867
3659,4,26,11,6,12,8,67,38.281301590875565,-109.3718172
3660,3,26,12,4,10,13,68,38.281301590875565,-109.3715477
3661,3,24,11,3,8,15,64,38.281301590875565,-109.3712782
3662,1,26,11,1,6,16,61,38.281301590875565,-109.3710087
3663,2,27,11,0,6,16,62,38.281301590875565,-109.3707392
3664,1,23,11,1,6,16,58,38.281301590875565,-109.3704697
3665,1,22,11,2,8,14,58,38.281301590875565,-109.3702003
3666,2,27,9,1,8,11,58,38.281301590875565,-109.3699308
3667,3,18,10,3,8,12,54,38.281301590875565,-109.3696613
3668,3,18,10,5,13,12,61,38.281301590875565,-109.3693918
3669,4,22,11,5,12,14,68,38.281301590875565,-109.3691223
3670,4,22,11,4,11,15,67,38.281301590875565,-109.3688528
3671,5,22,11,4,9,14,65,38.281301590875565,-109.3685833
3672,2,23,10,2,9,12,58,38.281301590875565,-109.3683138
3673,2,20,10,5,11,10,58,38.281301590875565,-109.3680443
3674,2,22,10,7,13,9,63,38.281301590875565,-109.3677748
3675,3,24,10,3,12,9,61,38.281301590875565,-109.3675053
3676,0,21,11,0,5,19,56,38.281301590875565,-109.3672358
3677,0,21,13,0,5,22,61,38.281301590875565,-109.3669663
3678,0,22,15,0,7,24,68,38.281301590875565,-109.3666968
3679,0,22,15,0,6,25,68,38.281301590875565,-109.3664273
3680,0,25,15,0,7,24,71,38.281301590875565,-109.3661578
3681,0,26,17,0,8,24,75,38.281301590875565,-109.3658883
3682,0,24,17,0,6,28,75,38.281301590875565,-109.3656188
3683,0,23,17,0,5,30,75,38.281301590875565,-109.3653493
3684,0,23,17,0,4,30,74,38.281301590875565,-109.3650799
3685,0,20,17,0,4,29,70,38.281301590875565,-109.3648104
3686,0,25,18,0,5,30,78,38.281301590875565,-109.3645409
3687,0,27,19,1,6,29,82,38.281301590875565,-109.3642714
3688,1,27,18,0,6,29,81,38.281301590875565,-109.3640019
3689,1,28,17,2,7,24,79,38.281301590875565,-109.3637324
3690,0,27,16,4,8,19,74,38.281301590875565,-109.3634629
3691,1,23,16,6,9,19,74,38.281301590875565,-109.3631934
3692,2,24,17,8,11,18,80,38.281301590875565,-109.3629239
3693,2,23,17,12,15,14,83,38.281301590875565,-109.3626544
3694,4,23,16,14,16,14,87,38.281301590875565,-109.3623849
3695,6,17,15,23,16,9,86,38.281301590875565,-109.3621154
3696,6,15,14,24,19,10,88,38.281301590875565,-109.3618459
3697,2,16,15,15,19,16,83,38.281301590875565,-109.3615764
3698,4,14,13,12,12,19,74,38.281301590875565,-109.3613069
3699,3,10,10,7,10,22,62,38.281301590875565,-109.3610374
3700,2,10,14,9,11,25,71,38.281301590875565,-109.3607679
3701,2,16,14,12,12,19,75,38.281301590875565,-109.3604984
3702,2,17,13,12,10,17,71,38.281301590875565,-109.360229
3703,3,13,12,14,14,11,67,38.281301590875565,-109.3599595
3704,4,21,10,8,9,8,60,38.281301590875565,-109.35969
3705,4,20,9,6,8,6,53,38.281301590875565,-109.3594205
3706,5,13,11,8,11,9,57,38.281301590875565,-109.359151
3707,2,15,13,4,4,23,61,38.281301590875565,-109.3588815
3708,1,19,16,1,4,28,69,38.281301590875565,-109.358612
3709,1,21,16,2,5,25,70,38.281301590875565,-109.3583425
3710,0,24,18,2,7,28,79,38.281301590875565,-109.358073
3711,0,25,19,2,8,28,82,38.281301590875565,-109.3578035
3712,0,26,19,2,9,28,84,38.281301590875565,-109.357534
3713,0,25,20,2,9,29,85,38.281301590875565,-109.3572645
3714,0,25,20,2,8,30,85,38.281301590875565,-109.356995
3715,0,25,20,2,8,30,85,38.281301590875565,-109.3567255
3716,0,23,20,3,8,29,83,38.281301590875565,-109.356456
3717,0,21,21,3,8,30,83,38.281301590875565,-109.3561865
3718,1,19,20,3,8,32,83,38.281301590875565,-109.355917
3719,0,19,20,3,7,31,80,38.281301590875565,-109.3556475
3720,0,20,20,4,8,30,82,38.281301590875565,-109.355378
3721,1,21,20,4,8,28,82,38.281301590875565,-109.3551086
3722,1,20,20,4,7,28,80,38.281301590875565,-109.3548391
3723,0,20,21,4,7,30,82,38.281301590875565,-109.3545696
3724,0,23,21,2,7,30,83,38.281301590875565,-109.3543001
3725,0,26,19,0,6,31,82,38.281301590875565,-109.3540306
3726,0,21,17,0,4,30,72,38.281301590875565,-109.3537611
3727,1,19,17,0,2,26,65,38.281301590875565,-109.3534916
3728,1,18,16,0,2,25,62,38.281301590875565,-109.3532221
3729,1,17,17,0,2,28,65,38.281301590875565,-109.3529526
3730,2,18,17,1,3,26,67,38.281301590875565,-109.3526831
3731,5,21,16,8,6,17,73,38.281301590875565,-109.3524136
3732,22,28,13,15,7,4,89,38.281301590875565,-109.3521441
3733,25,25,11,14,7,3,85,38.281301590875565,-109.3518746
3734,26,24,10,16,7,2,85,38.281301590875565,-109.3516051
3735,26,23,10,16,8,2,85,38.281301590875565,-109.3513356
3736,27,26,10,14,8,1,86,38.281301590875565,-109.3510661
3737,24,27,11,18,7,3,90,38.281301590875565,-109.3507966
3738,14,30,13,18,7,4,86,38.281301590875565,-109.3505271
3739,11,32,14,17,8,6,88,38.281301590875565,-109.3502577
3740,11,32,14,17,8,6,88,38.281301590875565,-109.3499882
3741,14,32,13,16,8,5,88,38.281301590875565,-109.3497187
3742,12,34,13,16,8,4,87,38.281301590875565,-109.3494492
3743,10,35,14,16,9,4,88,38.281301590875565,-109.3491797
3744,1,36,10,0,12,11,70,38.281032096290325,-109.4273331
3745,1,36,10,0,11,10,68,38.281032096290325,-109.4270636
3746,1,36,10,1,11,10,69,38.281032096290325,-109.4267941
3747,2,38,10,0,10,11,71,38.281032096290325,-109.4265246
3748,1,37,10,0,12,10,70,38.281032096290325,-109.4262551
3749,1,38,10,1,13,8,71,38.281032096290325,-109.4259856
3750,1,40,10,1,13,8,73,38.281032096290325,-109.4257161
3751,1,36,10,1,13,10,71,38.281032096290325,-109.4254466
3752,1,40,10,0,12,13,76,38.281032096290325,-109.4251771
3753,1,38,11,0,12,12,74,38.281032096290325,-109.4249077
3754,1,37,11,1,13,10,73,38.281032096290325,-109.4246382
3755,1,38,10,0,12,11,72,38.281032096290325,-109.4243687
3756,1,32,10,0,9,14,66,38.281032096290325,-109.4240992
3757,1,26,10,2,10,12,61,38.281032096290325,-109.4238297
3758,2,31,10,5,10,8,66,38.281032096290325,-109.4235602
3759,2,30,10,3,10,9,64,38.281032096290325,-109.4232907
3760,3,24,9,2,8,10,56,38.281032096290325,-109.4230212
3761,2,25,9,4,8,8,56,38.281032096290325,-109.4227517
3762,4,25,9,4,10,7,59,38.281032096290325,-109.4224822
3763,3,21,9,4,9,8,54,38.281032096290325,-109.4222127
3764,3,22,10,4,8,9,56,38.281032096290325,-109.4219432
3765,4,26,11,3,10,9,63,38.281032096290325,-109.4216737
3766,3,32,11,0,11,13,70,38.281032096290325,-109.4214042
3767,2,34,10,1,11,11,69,38.281032096290325,-109.4211347
3768,2,29,10,5,9,10,65,38.281032096290325,-109.4208652
3769,2,27,9,4,9,8,59,38.281032096290325,-109.4205957
3770,1,30,7,1,9,7,55,38.281032096290325,-109.4203262
3771,2,37,7,1,9,5,61,38.281032096290325,-109.4200568
3772,1,36,6,0,8,6,57,38.281032096290325,-109.4197873
3773,1,36,6,0,8,6,57,38.281032096290325,-109.4195178
3774,1,37,7,1,9,6,61,38.281032096290325,-109.4192483
3775,1,37,7,1,9,6,61,38.281032096290325,-109.4189788
3776,1,34,8,1,9,6,59,38.281032096290325,-109.4187093
3777,1,35,8,1,10,6,61,38.281032096290325,-109.4184398
3778,2,37,8,4,9,6,66,38.281032096290325,-109.4181703
3779,3,38,8,4,8,7,68,38.281032096290325,-109.4179008
3780,2,35,9,4,11,11,72,38.281032096290325,-109.4176313
3781,6,31,13,9,15,8,82,38.281032096290325,-109.4173618
3782,3,32,12,6,12,11,76,38.281032096290325,-109.4170923
3783,2,34,12,6,11,13,78,38.281032096290325,-109.4168228
3784,8,33,11,4,13,10,79,38.281032096290325,-109.4165533
3785,1,33,11,0,10,16,71,38.281032096290325,-109.4162838
3786,1,32,12,0,10,19,74,38.281032096290325,-109.4160143
3787,1,32,13,0,8,22,76,38.281032096290325,-109.4157448
3788,1,31,13,0,7,23,75,38.281032096290325,-109.4154753
3789,2,32,13,0,8,21,76,38.281032096290325,-109.4152058
3790,1,34,14,0,9,20,78,38.281032096290325,-109.4149364
3791,0,33,13,0,9,20,75,38.281032096290325,-109.4146669
3792,0,32,12,0,9,18,71,38.281032096290325,-109.4143974
3793,1,35,10,0,10,15,71,38.281032096290325,-109.4141279
3794,1,34,10,0,10,12,67,38.281032096290325,-109.4138584
3795,2,36,11,0,12,10,71,38.281032096290325,-109.4135889
3796,2,36,11,0,12,13,74,38.281032096290325,-109.4133194
3797,1,34,11,0,10,17,73,38.281032096290325,-109.4130499
3798,2,32,12,0,7,21,74,38.281032096290325,-109.4127804
3799,1,32,13,0,7,21,74,38.281032096290325,-109.4125109
3800,1,37,12,0,10,17,77,38.281032096290325,-109.4122414
3801,0,35,11,0,12,16,74,38.281032096290325,-109.4119719
3802,1,35,11,0,12,15,74,38.281032096290325,-109.4117024
3803,1,36,10,0,11,15,73,38.281032096290325,-109.4114329
3804,1,32,10,0,8,16,67,38.281032096290325,-109.4111634
3805,1,33,10,0,9,16,69,38.281032096290325,-109.4108939
3806,0,33,11,0,8,18,70,38.281032096290325,-109.4106244
3807,0,33,11,0,7,19,70,38.281032096290325,-109.4103549
3808,1,36,10,0,9,17,73,38.281032096290325,-109.4100855
3809,1,40,10,0,13,12,76,38.281032096290325,-109.409816
3810,10,39,12,5,14,7,87,38.281032096290325,-109.4095465
3811,27,33,11,8,11,2,92,38.281032096290325,-109.409277
3812,32,31,10,10,10,1,94,38.281032096290325,-109.4090075
3813,11,37,13,10,15,3,89,38.281032096290325,-109.408738
3814,6,42,13,5,18,4,88,38.281032096290325,-109.4084685
3815,4,44,13,4,19,3,87,38.281032096290325,-109.408199
3816,4,45,13,3,19,4,88,38.281032096290325,-109.4079295
3817,4,44,12,3,17,5,85,38.281032096290325,-109.40766
3818,4,44,12,3,17,5,85,38.281032096290325,-109.4073905
3819,4,43,12,3,17,5,84,38.281032096290325,-109.407121
3820,4,42,12,3,17,6,84,38.281032096290325,-109.4068515
3821,1,22,16,0,3,27,69,38.281032096290325,-109.3879869
3822,1,25,16,0,5,27,74,38.281032096290325,-109.3877174
3823,2,28,17,0,6,28,81,38.281032096290325,-109.3874479
3824,2,27,17,1,6,28,81,38.281032096290325,-109.3871784
3825,1,25,19,0,5,30,80,38.281032096290325,-109.3869089
3826,0,24,19,0,5,31,79,38.281032096290325,-109.3866394
3827,1,25,17,0,4,29,76,38.281032096290325,-109.3863699
3828,0,26,17,0,5,27,75,38.281032096290325,-109.3861004
3829,0,27,16,0,5,26,74,38.281032096290325,-109.3858309
3830,0,27,15,0,6,24,72,38.281032096290325,-109.3855614
3831,0,26,15,0,6,24,71,38.281032096290325,-109.3852919
3832,0,24,18,0,5,28,75,38.281032096290325,-109.3850225
3833,0,25,19,0,5,29,78,38.281032096290325,-109.384753
3834,0,26,19,0,7,28,80,38.281032096290325,-109.3844835
3835,1,30,19,0,9,26,85,38.281032096290325,-109.384214
3836,1,30,19,0,8,26,84,38.281032096290325,-109.3839445
3837,0,24,17,0,5,28,74,38.281032096290325,-109.383675
3838,0,25,17,0,6,25,73,38.281032096290325,-109.3834055
3839,0,24,17,1,6,25,73,38.281032096290325,-109.383136
3840,0,28,18,4,7,24,81,38.281032096290325,-109.3828665
3841,0,28,18,6,8,25,85,38.281032096290325,-109.382597
3842,0,27,18,3,6,29,83,38.281032096290325,-109.3823275
3843,1,27,18,6,8,25,85,38.281032096290325,-109.382058
3844,1,28,17,8,7,25,86,38.281032096290325,-109.3817885
3845,2,28,17,6,8,24,85,38.281032096290325,-109.381519
3846,2,27,17,3,7,27,83,38.281032096290325,-109.3812495
3847,2,27,15,4,9,26,83,38.281032096290325,-109.38098
3848,4,28,13,9,11,14,79,38.281032096290325,-109.3807105
3849,5,27,11,11,11,11,76,38.281032096290325,-109.380441
3850,5,24,9,11,12,9,70,38.281032096290325,-109.3801716
3851,2,33,10,5,8,8,66,38.281032096290325,-109.3799021
3852,2,38,8,5,9,3,65,38.281032096290325,-109.3796326
3853,1,35,7,2,9,4,58,38.281032096290325,-109.3793631
3854,2,31,9,3,8,6,59,38.281032096290325,-109.3790936
3855,2,25,11,3,6,12,59,38.281032096290325,-109.3788241
3856,1,29,11,1,4,19,65,38.281032096290325,-109.3785546
3857,2,24,15,2,4,22,69,38.281032096290325,-109.3782851
3858,2,22,17,1,3,26,71,38.281032096290325,-109.3780156
3859,1,21,17,0,4,29,72,38.281032096290325,-109.3777461
3860,1,21,18,0,4,30,74,38.281032096290325,-109.3774766
3861,1,21,18,0,4,29,73,38.281032096290325,-109.3772071
3862,1,23,17,0,4,28,73,38.281032096290325,-109.3769376
3863,1,23,16,0,3,27,70,38.281032096290325,-109.3766681
3864,2,22,15,1,3,26,69,38.281032096290325,-109.3763986
3865,2,20,15,2,3,23,65,38.281032096290325,-109.3761291
3866,2,23,13,2,4,20,64,38.281032096290325,-109.3758596
3867,3,22,12,2,5,19,63,38.281032096290325,-109.3755901
3868,3,20,13,3,5,19,63,38.281032096290325,-109.3753206
3869,3,19,12,3,4,19,60,38.281032096290325,-109.3750512
3870,5,24,13,5,5,15,67,38.281032096290325,-109.3747817
3871,5,28,12,5,9,11,70,38.281032096290325,-109.3745122
3872,5,28,12,7,11,7,70,38.281032096290325,-109.3742427
3873,5,25,12,8,11,8,69,38.281032096290325,-109.3739732
3874,4,21,14,8,9,13,69,38.281032096290325,-109.3737037
3875,4,22,13,6,7,15,67,38.281032096290325,-109.3734342
3876,3,25,12,5,7,15,67,38.281032096290325,-109.3731647
3877,2,32,11,4,9,11,69,38.281032096290325,-109.3728952
3878,4,38,9,5,11,5,72,38.281032096290325,-109.3726257
3879,2,42,8,8,9,2,71,38.281032096290325,-109.3723562
3880,9,36,9,9,8,1,72,38.281032096290325,-109.3720867
3881,7,32,10,7,14,2,72,38.281032096290325,-109.3718172
3882,3,28,12,6,12,9,70,38.281032096290325,-109.3715477
3883,4,22,11,4,7,14,62,38.281032096290325,-109.3712782
3884,1,34,9,0,9,10,63,38.281032096290325,-109.3710087
3885,2,37,9,0,12,8,68,38.281032096290325,-109.3707392
3886,1,28,10,0,8,14,61,38.281032096290325,-109.3704697
3887,0,22,12,2,7,17,60,38.281032096290325,-109.3702003
3888,1,26,11,3,9,12,62,38.281032096290325,-109.3699308
3889,2,25,10,4,8,10,59,38.281032096290325,-109.3696613
3890,4,22,9,7,9,9,60,38.281032096290325,-109.3693918
3891,5,20,10,4,11,11,61,38.281032096290325,-109.3691223
3892,4,20,10,3,9,14,60,38.281032096290325,-109.3688528
3893,3,18,11,5,7,17,61,38.281032096290325,-109.3685833
3894,2,16,11,4,5,18,56,38.281032096290325,-109.3683138
3895,3,17,9,4,8,13,54,38.281032096290325,-109.3680443
3896,3,17,9,6,8,9,52,38.281032096290325,-109.3677748
3897,4,16,9,6,9,8,52,38.281032096290325,-109.3675053
3898,1,16,11,2,5,16,51,38.281032096290325,-109.3672358
3899,0,20,13,2,4,19,58,38.281032096290325,-109.3669663
3900,0,24,13,0,5,19,61,38.281032096290325,-109.3666968
3901,1,27,13,1,7,16,65,38.281032096290325,-109.3664273
3902,1,23,12,0,7,16,59,38.281032096290325,-109.3661578
3903,0,17,12,2,4,20,55,38.281032096290325,-109.3658883
3904,2,19,13,0,3,22,59,38.281032096290325,-109.3656188
3905,2,21,14,0,3,23,63,38.281032096290325,-109.3653493
3906,1,20,14,0,3,23,61,38.281032096290325,-109.3650799
3907,1,18,14,0,3,25,61,38.281032096290325,-109.3648104
3908,0,22,18,0,4,31,75,38.281032096290325,-109.3645409
3909,0,25,19,0,5,31,80,38.281032096290325,-109.3642714
3910,0,27,19,0,6,30,82,38.281032096290325,-109.3640019
3911,0,29,20,0,7,28,84,38.281032096290325,-109.3637324
3912,0,30,19,1,7,24,81,38.281032096290325,-109.3634629
3913,0,26,17,4,7,22,76,38.281032096290325,-109.3631934
3914,1,23,17,5,8,21,75,38.281032096290325,-109.3629239
3915,1,23,17,5,9,22,77,38.281032096290325,-109.3626544
3916,2,27,18,9,11,17,84,38.281032096290325,-109.3623849
3917,3,21,16,12,16,16,84,38.281032096290325,-109.3621154
3918,3,18,15,12,18,19,85,38.281032096290325,-109.3618459
3919,3,13,13,10,12,22,73,38.281032096290325,-109.3615764
3920,4,9,13,9,8,26,69,38.281032096290325,-109.3613069
3921,4,9,13,12,9,23,70,38.281032096290325,-109.3610374
3922,4,12,15,13,10,22,76,38.281032096290325,-109.3607679
3923,3,18,15,10,9,23,78,38.281032096290325,-109.3604984
3924,2,21,14,7,7,24,75,38.281032096290325,-109.360229
3925,1,23,14,6,8,22,74,38.281032096290325,-109.3599595
3926,2,24,12,8,11,10,67,38.281032096290325,-109.35969
3927,6,23,10,13,10,3,65,38.281032096290325,-109.3594205
3928,2,20,10,11,12,6,61,38.281032096290325,-109.359151
3929,2,20,12,5,8,17,64,38.281032096290325,-109.3588815
3930,1,22,16,0,6,27,72,38.281032096290325,-109.358612
3931,1,21,16,3,8,24,73,38.281032096290325,-109.3583425
3932,0,22,17,2,6,28,75,38.281032096290325,-109.358073
3933,0,24,18,0,5,31,78,38.281032096290325,-109.3578035
3934,0,24,19,0,5,32,80,38.281032096290325,-109.357534
3935,0,25,19,0,5,31,80,38.281032096290325,-109.3572645
3936,0,23,18,0,4,33,78,38.281032096290325,-109.356995
3937,0,24,20,1,6,31,82,38.281032096290325,-109.3567255
3938,0,21,21,3,7,30,82,38.281032096290325,-109.356456
3939,0,20,21,4,7,31,83,38.281032096290325,-109.3561865
3940,0,20,20,3,7,32,82,38.281032096290325,-109.355917
3941,0,21,20,3,7,31,82,38.281032096290325,-109.3556475
3942,0,22,20,3,8,30,83,38.281032096290325,-109.355378
3943,0,22,21,3,7,29,82,38.281032096290325,-109.3551086
3944,1,23,21,4,7,28,84,38.281032096290325,-109.3548391
3945,0,22,22,3,7,29,83,38.281032096290325,-109.3545696
3946,0,26,21,0,6,32,85,38.281032096290325,-109.3543001
3947,0,22,18,0,4,31,75,38.281032096290325,-109.3540306
3948,1,21,17,0,3,28,70,38.281032096290325,-109.3537611
3949,1,21,16,0,3,25,66,38.281032096290325,-109.3534916
3950,1,21,18,1,4,28,73,38.281032096290325,-109.3532221
3951,1,19,18,0,3,29,70,38.281032096290325,-109.3529526
3952,4,22,16,6,4,20,72,38.281032096290325,-109.3526831
3953,15,35,13,12,12,3,90,38.281032096290325,-109.3524136
3954,22,26,8,11,8,1,76,38.281032096290325,-109.3521441
3955,26,22,9,13,7,2,79,38.281032096290325,-109.3518746
3956,26,21,9,20,7,1,84,38.281032096290325,-109.3516051
3957,24,21,10,22,7,1,85,38.281032096290325,-109.3513356
3958,22,25,11,22,8,1,89,38.281032096290325,-109.3510661
3959,12,32,13,17,8,5,87,38.281032096290325,-109.3507966
3960,8,35,14,15,9,6,87,38.281032096290325,-109.3505271
3961,8,37,14,13,9,5,86,38.281032096290325,-109.3502577
3962,9,37,14,13,9,5,87,38.281032096290325,-109.3499882
3963,7,38,14,12,10,6,87,38.281032096290325,-109.3497187
3964,8,37,14,14,11,4,88,38.281032096290325,-109.3494492
3965,8,37,14,15,10,4,88,38.281032096290325,-109.3491797
3966,10,34,14,16,9,5,88,38.281032096290325,-109.3489102
3967,2,38,11,0,12,13,76,38.28076260170509,-109.4278721
3968,1,37,9,0,11,12,70,38.28076260170509,-109.4276026
3969,1,38,11,1,13,9,73,38.28076260170509,-109.4273331
3970,2,39,11,2,14,8,76,38.28076260170509,-109.4270636
3971,2,38,10,0,13,10,73,38.28076260170509,-109.4267941
3972,1,38,10,0,11,12,72,38.28076260170509,-109.4265246
3973,1,38,10,0,12,12,73,38.28076260170509,-109.4262551
3974,1,39,10,0,13,11,74,38.28076260170509,-109.4259856
3975,1,42,10,0,13,11,77,38.28076260170509,-109.4257161
3976,1,41,11,0,14,11,78,38.28076260170509,-109.4254466
3977,1,47,11,0,14,11,84,38.28076260170509,-109.4251771
3978,1,44,11,0,13,12,81,38.28076260170509,-109.4249077
3979,1,42,11,0,15,9,78,38.28076260170509,-109.4246382
3980,2,41,10,0,13,10,76,38.28076260170509,-109.4243687
3981,1,34,10,0,10,14,69,38.28076260170509,-109.4240992
3982,0,32,10,0,12,12,66,38.28076260170509,-109.4238297
3983,1,30,10,2,11,10,64,38.28076260170509,-109.4235602
3984,1,31,10,5,12,7,66,38.28076260170509,-109.4232907
3985,1,28,10,2,10,10,61,38.28076260170509,-109.4230212
3986,2,25,8,2,8,9,54,38.28076260170509,-109.4227517
3987,1,29,8,3,8,7,56,38.28076260170509,-109.4224822
3988,3,26,8,3,8,8,56,38.28076260170509,-109.4222127
3989,3,20,10,5,7,10,55,38.28076260170509,-109.4219432
3990,3,23,11,4,9,11,61,38.28076260170509,-109.4216737
3991,3,32,10,3,12,9,69,38.28076260170509,-109.4214042
3992,2,25,9,3,8,9,56,38.28076260170509,-109.4211347
3993,2,25,8,2,9,8,54,38.28076260170509,-109.4208652
3994,2,28,7,2,9,7,55,38.28076260170509,-109.4205957
3995,2,32,7,1,9,6,57,38.28076260170509,-109.4203262
3996,3,36,7,1,9,5,61,38.28076260170509,-109.4200568
3997,3,30,8,2,9,7,59,38.28076260170509,-109.4197873
3998,2,32,9,3,10,7,63,38.28076260170509,-109.4195178
3999,2,38,9,4,11,6,70,38.28076260170509,-109.4192483
4000,3,39,10,5,12,5,74,38.28076260170509,-109.4189788
4001,3,36,11,5,12,9,76,38.28076260170509,-109.4187093
4002,4,35,12,6,14,8,79,38.28076260170509,-109.4184398
4003,6,32,13,9,16,5,81,38.28076260170509,-109.4181703
4004,6,31,13,16,17,3,86,38.28076260170509,-109.4179008
4005,2,32,14,12,15,9,84,38.28076260170509,-109.4176313
4006,3,28,15,15,17,7,85,38.28076260170509,-109.4173618
4007,4,27,14,14,20,6,85,38.28076260170509,-109.4170923
4008,2,30,13,8,20,9,82,38.28076260170509,-109.4168228
4009,2,32,12,3,16,14,79,38.28076260170509,-109.4165533
4010,1,34,12,0,9,18,74,38.28076260170509,-109.4162838
4011,1,34,12,0,8,20,75,38.28076260170509,-109.4160143
4012,2,32,13,0,7,21,75,38.28076260170509,-109.4157448
4013,2,31,14,0,6,23,76,38.28076260170509,-109.4154753
4014,2,30,14,0,6,24,76,38.28076260170509,-109.4152058
4015,1,30,14,0,7,24,76,38.28076260170509,-109.4149364
4016,0,32,13,0,9,22,76,38.28076260170509,-109.4146669
4017,0,33,12,0,10,18,73,38.28076260170509,-109.4143974
4018,1,36,10,0,11,14,72,38.28076260170509,-109.4141279
4019,1,36,10,0,11,14,72,38.28076260170509,-109.4138584
4020,1,37,11,0,11,15,75,38.28076260170509,-109.4135889
4021,2,38,11,0,10,15,76,38.28076260170509,-109.4133194
4022,1,36,11,0,7,17,72,38.28076260170509,-109.4130499
4023,1,32,11,0,6,19,69,38.28076260170509,-109.4127804
4024,1,35,10,0,10,15,71,38.28076260170509,-109.4125109
4025,1,35,10,0,14,12,72,38.28076260170509,-109.4122414
4026,1,36,10,0,13,14,74,38.28076260170509,-109.4119719
4027,2,37,10,0,11,15,75,38.28076260170509,-109.4117024
4028,1,38,10,0,11,14,74,38.28076260170509,-109.4114329
4029,1,39,10,0,13,13,76,38.28076260170509,-109.4111634
4030,1,37,11,0,13,13,75,38.28076260170509,-109.4108939
4031,1,37,10,0,12,14,74,38.28076260170509,-109.4106244
4032,1,36,10,0,10,16,73,38.28076260170509,-109.4103549
4033,1,35,10,0,9,16,71,38.28076260170509,-109.4100855
4034,2,37,10,0,14,11,74,38.28076260170509,-109.409816
4035,4,38,11,2,14,9,78,38.28076260170509,-109.4095465
4036,9,36,12,4,13,9,83,38.28076260170509,-109.409277
4037,10,36,13,5,12,10,86,38.28076260170509,-109.4090075
4038,8,34,13,6,13,9,83,38.28076260170509,-109.408738
4039,4,39,12,3,17,7,82,38.28076260170509,-109.4084685
4040,4,43,13,2,18,6,86,38.28076260170509,-109.408199
4041,4,46,13,2,19,5,89,38.28076260170509,-109.4079295
4042,4,45,13,2,18,4,86,38.28076260170509,-109.40766
4043,4,44,12,3,17,5,85,38.28076260170509,-109.4073905
4044,4,42,12,3,16,5,82,38.28076260170509,-109.407121
4045,5,42,12,3,16,6,84,38.28076260170509,-109.4068515
4046,1,25,18,0,5,29,78,38.28076260170509,-109.3879869
4047,0,25,19,0,6,32,82,38.28076260170509,-109.3877174
4048,0,24,19,0,5,33,81,38.28076260170509,-109.3874479
4049,1,24,18,0,5,30,78,38.28076260170509,-109.3871784
4050,0,22,19,0,4,33,78,38.28076260170509,-109.3869089
4051,1,23,20,0,5,33,82,38.28076260170509,-109.3866394
4052,1,25,20,0,5,32,83,38.28076260170509,-109.3863699
4053,0,26,18,0,6,30,80,38.28076260170509,-109.3861004
4054,0,26,18,0,6,30,80,38.28076260170509,-109.3858309
4055,1,26,17,0,6,27,77,38.28076260170509,-109.3855614
4056,0,28,17,1,7,24,77,38.28076260170509,-109.3852919
4057,0,30,18,1,10,24,83,38.28076260170509,-109.3850225
4058,1,27,18,3,9,23,81,38.28076260170509,-109.384753
4059,1,31,18,0,9,24,83,38.28076260170509,-109.3844835
4060,1,30,16,1,10,20,78,38.28076260170509,-109.384214
4061,2,29,15,0,8,19,73,38.28076260170509,-109.3839445
4062,2,28,16,1,8,19,74,38.28076260170509,-109.383675
4063,1,26,16,0,6,22,71,38.28076260170509,-109.3834055
4064,0,24,17,0,4,28,73,38.28076260170509,-109.383136
4065,0,24,18,0,5,27,74,38.28076260170509,-109.3828665
4066,1,25,17,5,7,21,76,38.28076260170509,-109.382597
4067,0,25,16,3,6,24,74,38.28076260170509,-109.3823275
4068,2,27,15,7,9,17,77,38.28076260170509,-109.382058
4069,3,29,15,12,11,13,83,38.28076260170509,-109.3817885
4070,2,30,14,8,12,14,80,38.28076260170509,-109.381519
4071,3,27,13,8,14,12,77,38.28076260170509,-109.3812495
4072,3,28,13,7,12,14,77,38.28076260170509,-109.38098
4073,2,27,12,9,15,8,73,38.28076260170509,-109.3807105
4074,1,29,11,8,15,6,70,38.28076260170509,-109.380441
4075,2,33,10,6,6,8,65,38.28076260170509,-109.3801716
4076,3,42,9,6,6,4,70,38.28076260170509,-109.3799021
4077,1,33,7,1,8,4,54,38.28076260170509,-109.3796326
4078,3,41,5,2,8,5,64,38.28076260170509,-109.3793631
4079,5,34,7,2,6,9,63,38.28076260170509,-109.3790936
4080,4,21,10,2,2,17,56,38.28076260170509,-109.3788241
4081,2,30,11,1,6,18,68,38.28076260170509,-109.3785546
4082,2,22,15,2,4,22,67,38.28076260170509,-109.3782851
4083,2,19,17,1,3,27,69,38.28076260170509,-109.3780156
4084,2,21,18,0,4,29,74,38.28076260170509,-109.3777461
4085,1,20,18,0,5,29,73,38.28076260170509,-109.3774766
4086,2,21,17,2,4,26,72,38.28076260170509,-109.3772071
4087,2,21,15,3,5,22,68,38.28076260170509,-109.3769376
4088,2,24,14,4,6,19,69,38.28076260170509,-109.3766681
4089,3,26,13,4,7,16,69,38.28076260170509,-109.3763986
4090,2,24,13,3,6,19,67,38.28076260170509,-109.3761291
4091,1,21,14,1,4,21,62,38.28076260170509,-109.3758596
4092,1,21,13,0,3,22,60,38.28076260170509,-109.3755901
4093,1,21,13,0,4,22,61,38.28076260170509,-109.3753206
4094,2,21,14,4,6,18,65,38.28076260170509,-109.3750512
4095,4,19,14,6,6,17,66,38.28076260170509,-109.3747817
4096,5,21,14,7,8,13,68,38.28076260170509,-109.3745122
4097,5,22,12,8,9,10,66,38.28076260170509,-109.3742427
4098,5,25,12,8,9,8,67,38.28076260170509,-109.3739732
4099,4,30,11,5,9,11,70,38.28076260170509,-109.3737037
4100,2,37,9,2,11,9,70,38.28076260170509,-109.3734342
4101,1,37,9,3,10,9,69,38.28076260170509,-109.3731647
4102,1,36,9,2,10,9,67,38.28076260170509,-109.3728952
4103,1,37,8,3,9,7,65,38.28076260170509,-109.3726257
4104,1,44,7,4,7,5,68,38.28076260170509,-109.3723562
4105,5,38,8,9,8,2,70,38.28076260170509,-109.3720867
4106,2,30,9,5,11,6,63,38.28076260170509,-109.3718172
4107,2,23,12,5,7,14,63,38.28076260170509,-109.3715477
4108,2,23,15,4,7,20,71,38.28076260170509,-109.3712782
4109,1,25,14,4,8,17,69,38.28076260170509,-109.3710087
4110,1,25,13,2,9,18,68,38.28076260170509,-109.3707392
4111,2,23,13,1,7,19,65,38.28076260170509,-109.3704697
4112,2,24,12,0,5,19,62,38.28076260170509,-109.3702003
4113,2,32,11,2,9,12,68,38.28076260170509,-109.3699308
4114,1,32,9,2,9,9,62,38.28076260170509,-109.3696613
4115,1,35,7,3,8,7,61,38.28076260170509,-109.3693918
4116,2,27,7,5,5,9,55,38.28076260170509,-109.3691223
4117,4,20,8,5,5,10,52,38.28076260170509,-109.3688528
4118,5,19,10,4,7,10,55,38.28076260170509,-109.3685833
4119,5,18,10,4,9,10,56,38.28076260170509,-109.3683138
4120,3,17,10,4,8,12,54,38.28076260170509,-109.3680443
4121,3,14,10,4,8,12,51,38.28076260170509,-109.3677748
4122,4,12,9,4,8,11,48,38.28076260170509,-109.3675053
4123,3,11,10,4,7,11,46,38.28076260170509,-109.3672358
4124,2,16,12,5,6,13,54,38.28076260170509,-109.3669663
4125,1,19,13,1,4,17,55,38.28076260170509,-109.3666968
4126,2,18,13,0,3,20,56,38.28076260170509,-109.3664273
4127,2,16,13,1,4,19,55,38.28076260170509,-109.3661578
4128,1,13,13,2,4,19,52,38.28076260170509,-109.3658883
4129,2,14,12,3,4,17,52,38.28076260170509,-109.3656188
4130,3,18,12,3,4,15,55,38.28076260170509,-109.3653493
4131,2,17,13,2,4,18,56,38.28076260170509,-109.3650799
4132,1,19,15,0,3,26,64,38.28076260170509,-109.3648104
4133,0,20,18,0,3,33,74,38.28076260170509,-109.3645409
4134,0,21,18,0,3,33,75,38.28076260170509,-109.3642714
4135,0,22,18,0,4,32,76,38.28076260170509,-109.3640019
4136,0,26,19,0,6,30,81,38.28076260170509,-109.3637324
4137,1,28,20,0,8,28,85,38.28076260170509,-109.3634629
4138,0,29,20,2,7,26,84,38.28076260170509,-109.3631934
4139,0,25,17,3,6,24,75,38.28076260170509,-109.3629239
4140,0,25,15,4,8,20,72,38.28076260170509,-109.3626544
4141,1,25,15,10,11,15,77,38.28076260170509,-109.3623849
4142,3,22,15,15,17,9,81,38.28076260170509,-109.3621154
4143,3,18,13,14,20,13,81,38.28076260170509,-109.3618459
4144,3,14,15,10,13,24,79,38.28076260170509,-109.3615764
4145,4,13,15,10,10,22,74,38.28076260170509,-109.3613069
4146,4,20,14,11,12,14,75,38.28076260170509,-109.3610374
4147,2,20,12,12,18,9,73,38.28076260170509,-109.3607679
4148,2,20,12,12,15,10,71,38.28076260170509,-109.3604984
4149,3,25,13,12,12,10,75,38.28076260170509,-109.360229
4150,3,27,15,10,11,15,81,38.28076260170509,-109.3599595
4151,2,28,14,10,15,11,80,38.28076260170509,-109.35969
4152,2,25,14,13,16,7,77,38.28076260170509,-109.3594205
4153,1,26,13,10,15,9,74,38.28076260170509,-109.359151
4154,0,25,13,6,9,18,71,38.28076260170509,-109.3588815
4155,0,24,18,1,7,27,77,38.28076260170509,-109.358612
4156,1,21,16,2,8,25,73,38.28076260170509,-109.3583425
4157,1,21,17,3,8,26,76,38.28076260170509,-109.358073
4158,1,22,19,2,6,29,79,38.28076260170509,-109.3578035
4159,0,22,19,0,4,33,78,38.28076260170509,-109.357534
4160,0,22,17,0,3,31,73,38.28076260170509,-109.3572645
4161,1,19,17,0,3,31,71,38.28076260170509,-109.356995
4162,0,23,20,0,4,34,81,38.28076260170509,-109.3567255
4163,0,21,22,2,5,32,82,38.28076260170509,-109.356456
4164,0,22,21,1,5,32,81,38.28076260170509,-109.3561865
4165,0,24,20,0,5,33,82,38.28076260170509,-109.355917
4166,0,24,21,2,7,30,84,38.28076260170509,-109.3556475
4167,0,22,21,2,7,30,82,38.28076260170509,-109.355378
4168,0,21,21,2,7,31,82,38.28076260170509,-109.3551086
4169,0,22,21,3,7,29,82,38.28076260170509,-109.3548391
4170,1,24,20,4,7,27,83,38.28076260170509,-109.3545696
4171,0,23,19,0,6,30,78,38.28076260170509,-109.3543001
4172,1,20,17,0,3,29,70,38.28076260170509,-109.3540306
4173,1,20,17,0,2,28,68,38.28076260170509,-109.3537611
4174,1,22,18,0,5,28,74,38.28076260170509,-109.3534916
4175,1,18,22,0,4,32,77,38.28076260170509,-109.3532221
4176,3,18,19,3,3,27,73,38.28076260170509,-109.3529526
4177,17,24,15,9,7,13,85,38.28076260170509,-109.3526831
4178,24,24,9,11,8,1,77,38.28076260170509,-109.3524136
4179,19,18,7,7,6,1,58,38.28076260170509,-109.3521441
4180,25,19,8,14,6,1,73,38.28076260170509,-109.3518746
4181,30,21,10,20,5,2,88,38.28076260170509,-109.3516051
4182,24,24,12,18,8,4,90,38.28076260170509,-109.3513356
4183,14,30,13,16,9,4,86,38.28076260170509,-109.3510661
4184,9,35,13,14,10,5,86,38.28076260170509,-109.3507966
4185,8,38,14,13,11,4,88,38.28076260170509,-109.3505271
4186,9,38,14,13,11,4,89,38.28076260170509,-109.3502577
4187,9,37,14,14,10,4,88,38.28076260170509,-109.3499882
4188,7,37,14,13,10,5,86,38.28076260170509,-109.3497187
4189,8,36,14,15,9,6,88,38.28076260170509,-109.3494492
4190,8,35,14,17,9,5,88,38.28076260170509,-109.3491797
4191,8,33,14,18,8,6,87,38.28076260170509,-109.3489102
4192,8,32,14,18,8,7,87,38.28076260170509,-109.3486407
4193,2,40,11,0,13,11,77,38.28049310711985,-109.4281416
4194,2,39,11,0,13,12,77,38.28049310711985,-109.4278721
4195,1,37,10,0,10,13,71,38.28049310711985,-109.4276026
4196,1,37,9,0,11,12,70,38.28049310711985,-109.4273331
4197,1,39,11,0,14,10,75,38.28049310711985,-109.4270636
4198,2,40,11,0,14,11,78,38.28049310711985,-109.4267941
4199,2,41,11,0,13,12,79,38.28049310711985,-109.4265246
4200,1,39,11,0,11,15,77,38.28049310711985,-109.4262551
4201,1,34,11,0,10,15,71,38.28049310711985,-109.4259856
4202,1,37,11,0,13,12,74,38.28049310711985,-109.4257161
4203,2,44,12,2,17,7,84,38.28049310711985,-109.4254466
4204,2,50,12,3,17,4,88,38.28049310711985,-109.4251771
4205,2,47,11,0,15,10,85,38.28049310711985,-109.4249077
4206,1,42,11,0,13,12,79,38.28049310711985,-109.4246382
4207,1,36,10,0,10,15,72,38.28049310711985,-109.4243687
4208,1,31,11,0,8,17,68,38.28049310711985,-109.4240992
4209,1,40,10,0,13,12,76,38.28049310711985,-109.4238297
4210,1,35,10,0,11,11,68,38.28049310711985,-109.4235602
4211,0,33,9,2,11,8,63,38.28049310711985,-109.4232907
4212,2,42,8,2,9,5,68,38.28049310711985,-109.4230212
4213,2,32,8,2,9,6,59,38.28049310711985,-109.4227517
4214,2,29,9,3,7,11,61,38.28049310711985,-109.4224822
4215,5,24,11,5,11,8,64,38.28049310711985,-109.4222127
4216,2,20,11,7,13,8,61,38.28049310711985,-109.4219432
4217,1,20,11,4,8,13,57,38.28049310711985,-109.4216737
4218,2,28,9,3,10,8,60,38.28049310711985,-109.4214042
4219,1,27,7,1,9,7,52,38.28049310711985,-109.4211347
4220,1,30,7,0,8,7,53,38.28049310711985,-109.4208652
4221,1,34,6,0,8,6,55,38.28049310711985,-109.4205957
4222,1,36,6,0,9,6,58,38.28049310711985,-109.4203262
4223,2,37,8,1,10,6,64,38.28049310711985,-109.4200568
4224,2,33,10,2,9,11,67,38.28049310711985,-109.4197873
4225,1,37,11,0,10,14,73,38.28049310711985,-109.4195178
4226,1,41,11,0,10,15,78,38.28049310711985,-109.4192483
4227,3,37,12,0,11,15,78,38.28049310711985,-109.4189788
4228,2,36,14,0,13,18,83,38.28049310711985,-109.4187093
4229,2,31,14,3,11,19,80,38.28049310711985,-109.4184398
4230,3,29,16,8,16,13,85,38.28049310711985,-109.4181703
4231,3,23,15,16,19,8,84,38.28049310711985,-109.4179008
4232,4,24,13,11,19,10,81,38.28049310711985,-109.4176313
4233,3,24,15,13,17,8,80,38.28049310711985,-109.4173618
4234,1,27,16,11,16,11,82,38.28049310711985,-109.4170923
4235,2,29,16,7,14,16,84,38.28049310711985,-109.4168228
4236,1,32,15,1,13,20,82,38.28049310711985,-109.4165533
4237,1,32,12,0,9,19,73,38.28049310711985,-109.4162838
4238,2,34,13,0,9,18,76,38.28049310711985,-109.4160143
4239,2,30,13,1,7,22,75,38.28049310711985,-109.4157448
4240,1,28,14,1,5,25,74,38.28049310711985,-109.4154753
4241,1,29,15,1,5,26,77,38.28049310711985,-109.4152058
4242,2,31,14,1,6,25,79,38.28049310711985,-109.4149364
4243,1,30,15,0,5,26,77,38.28049310711985,-109.4146669
4244,1,33,14,0,7,23,78,38.28049310711985,-109.4143974
4245,1,34,12,0,9,19,75,38.28049310711985,-109.4141279
4246,1,35,11,0,11,16,74,38.28049310711985,-109.4138584
4247,1,36,11,0,10,17,75,38.28049310711985,-109.4135889
4248,1,34,11,0,7,19,72,38.28049310711985,-109.4133194
4249,1,33,11,0,7,19,71,38.28049310711985,-109.4130499
4250,1,32,10,0,9,17,69,38.28049310711985,-109.4127804
4251,0,33,10,0,15,8,66,38.28049310711985,-109.4125109
4252,2,33,10,0,12,13,70,38.28049310711985,-109.4122414
4253,1,28,11,0,9,16,65,38.28049310711985,-109.4119719
4254,0,26,11,0,6,20,63,38.28049310711985,-109.4117024
4255,1,27,12,0,5,21,66,38.28049310711985,-109.4114329
4256,1,28,12,0,5,20,66,38.28049310711985,-109.4111634
4257,2,33,11,0,7,17,70,38.28049310711985,-109.4108939
4258,1,33,10,0,8,16,68,38.28049310711985,-109.4106244
4259,1,35,10,0,10,15,71,38.28049310711985,-109.4103549
4260,2,39,10,0,13,12,76,38.28049310711985,-109.4100855
4261,3,39,11,0,15,9,77,38.28049310711985,-109.409816
4262,3,38,11,0,15,11,78,38.28049310711985,-109.4095465
4263,2,36,11,0,12,14,75,38.28049310711985,-109.409277
4264,2,35,12,0,10,17,76,38.28049310711985,-109.4090075
4265,2,36,12,0,11,16,77,38.28049310711985,-109.408738
4266,3,41,12,0,16,10,82,38.28049310711985,-109.4084685
4267,3,44,12,0,18,7,84,38.28049310711985,-109.408199
4268,4,44,13,1,19,6,87,38.28049310711985,-109.4079295
4269,4,44,13,3,18,5,87,38.28049310711985,-109.40766
4270,4,45,13,3,17,5,87,38.28049310711985,-109.4073905
4271,5,42,12,4,15,6,84,38.28049310711985,-109.407121
4272,5,41,12,5,14,6,83,38.28049310711985,-109.4068515
4273,1,23,18,0,3,30,75,38.28049310711985,-109.3879869
4274,1,24,18,0,4,31,78,38.28049310711985,-109.3877174
4275,2,23,19,0,4,32,80,38.28049310711985,-109.3874479
4276,3,24,18,0,4,32,81,38.28049310711985,-109.3871784
4277,1,22,19,0,4,35,81,38.28049310711985,-109.3869089
4278,1,22,20,0,5,35,83,38.28049310711985,-109.3866394
4279,1,25,19,0,6,32,83,38.28049310711985,-109.3863699
4280,1,26,18,0,6,30,81,38.28049310711985,-109.3861004
4281,0,26,18,0,5,30,79,38.28049310711985,-109.3858309
4282,1,27,18,0,5,29,80,38.28049310711985,-109.3855614
4283,1,29,18,0,6,28,82,38.28049310711985,-109.3852919
4284,0,30,19,0,9,26,84,38.28049310711985,-109.3850225
4285,0,30,18,2,9,24,83,38.28049310711985,-109.384753
4286,1,31,16,1,8,23,80,38.28049310711985,-109.3844835
4287,1,28,14,0,7,19,69,38.28049310711985,-109.384214
4288,1,29,12,0,7,17,66,38.28049310711985,-109.3839445
4289,1,31,14,0,7,18,71,38.28049310711985,-109.383675
4290,1,28,15,0,8,19,71,38.28049310711985,-109.3834055
4291,1,26,17,0,6,23,73,38.28049310711985,-109.383136
4292,0,24,17,0,4,27,72,38.28049310711985,-109.3828665
4293,1,26,15,1,5,20,68,38.28049310711985,-109.382597
4294,2,29,14,2,7,16,70,38.28049310711985,-109.3823275
4295,2,32,11,5,13,9,72,38.28049310711985,-109.382058
4296,1,28,12,6,13,9,69,38.28049310711985,-109.3817885
4297,1,26,13,8,15,10,73,38.28049310711985,-109.381519
4298,2,29,14,12,11,11,79,38.28049310711985,-109.3812495
4299,2,28,13,9,12,11,75,38.28049310711985,-109.38098
4300,3,30,13,9,15,6,76,38.28049310711985,-109.3807105
4301,1,28,12,4,11,12,68,38.28049310711985,-109.380441
4302,0,31,10,1,8,13,63,38.28049310711985,-109.3801716
4303,1,38,8,3,8,5,63,38.28049310711985,-109.3799021
4304,1,34,7,1,8,4,55,38.28049310711985,-109.3796326
4305,4,38,6,4,8,6,66,38.28049310711985,-109.3793631
4306,4,29,8,3,6,11,61,38.28049310711985,-109.3790936
4307,2,20,12,2,1,22,59,38.28049310711985,-109.3788241
4308,1,25,15,4,6,19,70,38.28049310711985,-109.3785546
4309,1,18,16,1,3,26,65,38.28049310711985,-109.3782851
4310,1,17,17,0,2,29,66,38.28049310711985,-109.3780156
4311,2,19,17,0,3,27,68,38.28049310711985,-109.3777461
4312,1,18,16,0,3,25,63,38.28049310711985,-109.3774766
4313,3,21,14,3,5,20,66,38.28049310711985,-109.3772071
4314,1,22,13,2,6,20,64,38.28049310711985,-109.3769376
4315,2,22,13,2,6,20,65,38.28049310711985,-109.3766681
4316,2,22,14,2,5,21,66,38.28049310711985,-109.3763986
4317,1,23,16,0,4,26,70,38.28049310711985,-109.3761291
4318,1,24,17,0,4,29,75,38.28049310711985,-109.3758596
4319,0,23,17,0,4,29,73,38.28049310711985,-109.3755901
4320,1,22,16,1,4,25,69,38.28049310711985,-109.3753206
4321,3,21,16,3,6,20,69,38.28049310711985,-109.3750512
4322,6,26,16,6,7,17,78,38.28049310711985,-109.3747817
4323,4,24,13,6,7,14,68,38.28049310711985,-109.3745122
4324,3,25,11,5,8,12,64,38.28049310711985,-109.3742427
4325,2,27,10,5,8,10,62,38.28049310711985,-109.3739732
4326,2,29,9,4,8,9,61,38.28049310711985,-109.3737037
4327,2,34,8,4,10,7,65,38.28049310711985,-109.3734342
4328,2,37,8,4,11,6,68,38.28049310711985,-109.3731647
4329,1,40,7,3,11,5,67,38.28049310711985,-109.3728952
4330,1,45,7,4,11,4,72,38.28049310711985,-109.3726257
4331,1,49,6,5,9,2,72,38.28049310711985,-109.3723562
4332,0,41,7,9,7,3,67,38.28049310711985,-109.3720867
4333,1,34,8,3,9,8,63,38.28049310711985,-109.3718172
4334,2,27,10,2,6,14,61,38.28049310711985,-109.3715477
4335,2,21,12,3,4,18,60,38.28049310711985,-109.3712782
4336,1,20,13,2,4,20,60,38.28049310711985,-109.3710087
4337,2,27,12,2,6,16,65,38.28049310711985,-109.3707392
4338,2,26,11,2,7,15,63,38.28049310711985,-109.3704697
4339,3,30,10,1,7,13,64,38.28049310711985,-109.3702003
4340,3,35,10,2,11,8,69,38.28049310711985,-109.3699308
4341,1,38,8,2,8,10,67,38.28049310711985,-109.3696613
4342,1,39,8,3,11,6,68,38.28049310711985,-109.3693918
4343,3,43,7,5,10,4,72,38.28049310711985,-109.3691223
4344,4,38,7,6,9,4,68,38.28049310711985,-109.3688528
4345,2,30,7,5,8,7,59,38.28049310711985,-109.3685833
4346,6,21,9,7,7,7,57,38.28049310711985,-109.3683138
4347,6,13,10,5,7,12,53,38.28049310711985,-109.3680443
4348,5,12,10,5,6,14,52,38.28049310711985,-109.3677748
4349,4,12,10,5,7,14,52,38.28049310711985,-109.3675053
4350,5,20,9,4,8,8,54,38.28049310711985,-109.3672358
4351,3,26,8,5,6,8,56,38.28049310711985,-109.3669663
4352,3,22,9,4,7,9,54,38.28049310711985,-109.3666968
4353,5,15,10,4,5,12,51,38.28049310711985,-109.3664273
4354,3,14,12,4,4,15,52,38.28049310711985,-109.3661578
4355,3,17,11,4,5,14,54,38.28049310711985,-109.3658883
4356,2,15,12,2,4,17,52,38.28049310711985,-109.3656188
4357,2,16,14,0,3,21,56,38.28049310711985,-109.3653493
4358,1,15,15,1,3,25,60,38.28049310711985,-109.3650799
4359,2,18,16,1,3,31,71,38.28049310711985,-109.3648104
4360,1,18,17,0,3,32,71,38.28049310711985,-109.3645409
4361,1,20,17,0,3,32,73,38.28049310711985,-109.3642714
4362,0,20,18,0,3,32,73,38.28049310711985,-109.3640019
4363,0,21,18,0,3,32,74,38.28049310711985,-109.3637324
4364,0,22,19,0,3,33,77,38.28049310711985,-109.3634629
4365,0,23,19,0,4,32,78,38.28049310711985,-109.3631934
4366,0,22,18,0,3,29,72,38.28049310711985,-109.3629239
4367,0,25,15,1,5,23,69,38.28049310711985,-109.3626544
4368,1,27,14,6,7,17,72,38.28049310711985,-109.3623849
4369,0,25,16,9,11,16,77,38.28049310711985,-109.3621154
4370,0,23,16,9,11,16,75,38.28049310711985,-109.3618459
4371,2,26,15,8,11,18,80,38.28049310711985,-109.3615764
4372,2,26,14,9,13,15,79,38.28049310711985,-109.3613069
4373,3,28,13,10,15,7,76,38.28049310711985,-109.3610374
4374,3,29,12,14,15,3,76,38.28049310711985,-109.3607679
4375,1,27,13,10,17,8,76,38.28049310711985,-109.3604984
4376,2,23,15,8,9,18,75,38.28049310711985,-109.360229
4377,2,22,17,10,10,22,83,38.28049310711985,-109.3599595
4378,2,22,16,11,11,20,82,38.28049310711985,-109.35969
4379,0,24,18,8,10,23,83,38.28049310711985,-109.3594205
4380,0,23,20,4,8,28,83,38.28049310711985,-109.359151
4381,0,21,20,2,7,31,81,38.28049310711985,-109.3588815
4382,1,20,20,3,7,31,82,38.28049310711985,-109.358612
4383,1,18,18,3,8,28,76,38.28049310711985,-109.3583425
4384,1,21,16,4,6,28,76,38.28049310711985,-109.358073
4385,0,22,18,0,4,32,76,38.28049310711985,-109.3578035
4386,0,23,18,0,3,33,77,38.28049310711985,-109.357534
4387,0,23,18,0,3,33,77,38.28049310711985,-109.3572645
4388,0,22,18,0,4,33,77,38.28049310711985,-109.356995
4389,0,23,20,0,6,33,82,38.28049310711985,-109.3567255
4390,0,21,22,1,6,32,82,38.28049310711985,-109.356456
4391,1,21,22,2,6,31,83,38.28049310711985,-109.3561865
4392,0,21,21,2,6,31,81,38.28049310711985,-109.355917
4393,0,20,21,2,5,32,80,38.28049310711985,-109.3556475
4394,0,20,21,1,6,34,82,38.28049310711985,-109.355378
4395,0,23,21,0,6,33,83,38.28049310711985,-109.3551086
4396,0,23,18,0,4,29,74,38.28049310711985,-109.3548391
4397,1,24,17,1,5,27,75,38.28049310711985,-109.3545696
4398,1,18,18,0,3,30,70,38.28049310711985,-109.3543001
4399,1,17,17,0,2,28,65,38.28049310711985,-109.3540306
4400,1,20,17,0,3,26,67,38.28049310711985,-109.3537611
4401,2,25,20,2,8,25,82,38.28049310711985,-109.3534916
4402,2,21,21,2,7,28,81,38.28049310711985,-109.3532221
4403,7,25,17,8,8,19,84,38.28049310711985,-109.3529526
4404,20,25,14,15,7,7,88,38.28049310711985,-109.3526831
4405,28,22,10,14,6,2,82,38.28049310711985,-109.3524136
4406,28,20,9,16,6,2,81,38.28049310711985,-109.3521441
4407,30,20,10,22,5,2,89,38.28049310711985,-109.3518746
4408,26,22,11,23,6,2,90,38.28049310711985,-109.3516051
4409,17,26,13,20,7,5,88,38.28049310711985,-109.3513356
4410,10,30,14,18,9,5,86,38.28049310711985,-109.3510661
4411,9,33,14,15,10,5,86,38.28049310711985,-109.3507966
4412,8,35,14,14,10,6,87,38.28049310711985,-109.3505271
4413,8,36,14,13,10,7,88,38.28049310711985,-109.3502577
4414,8,36,14,13,10,7,88,38.28049310711985,-109.3499882
4415,8,36,15,13,10,7,89,38.28049310711985,-109.3497187
4416,8,35,15,14,9,7,88,38.28049310711985,-109.3494492
4417,8,34,14,17,8,6,87,38.28049310711985,-109.3491797
4418,8,32,14,17,9,6,86,38.28049310711985,-109.3489102
4419,8,33,14,16,10,6,87,38.28049310711985,-109.3486407
4420,7,36,14,16,9,5,87,38.28049310711985,-109.3483712
4421,8,35,13,16,9,4,85,38.28049310711985,-109.3481017
4422,1,31,10,0,9,15,66,38.28022361253462,-109.4284111
4423,2,31,10,0,8,16,67,38.28022361253462,-109.4281416
4424,2,32,10,0,9,15,68,38.28022361253462,-109.4278721
4425,2,35,10,0,8,15,70,38.28022361253462,-109.4276026
4426,1,38,10,0,12,13,74,38.28022361253462,-109.4273331
4427,2,43,12,1,15,10,83,38.28022361253462,-109.4270636
4428,2,44,12,3,16,8,85,38.28022361253462,-109.4267941
4429,2,46,12,3,16,8,87,38.28022361253462,-109.4265246
4430,2,43,11,0,12,13,81,38.28022361253462,-109.4262551
4431,1,38,11,0,11,15,76,38.28022361253462,-109.4259856
4432,2,43,11,0,14,10,80,38.28022361253462,-109.4257161
4433,2,49,11,2,16,6,86,38.28022361253462,-109.4254466
4434,3,52,12,4,17,2,90,38.28022361253462,-109.4251771
4435,3,51,11,2,15,7,89,38.28022361253462,-109.4249077
4436,2,45,11,0,13,12,83,38.28022361253462,-109.4246382
4437,1,36,11,0,10,16,74,38.28022361253462,-109.4243687
4438,1,35,10,0,9,16,71,38.28022361253462,-109.4240992
4439,1,42,10,0,13,11,77,38.28022361253462,-109.4238297
4440,1,40,10,0,13,11,75,38.28022361253462,-109.4235602
4441,1,37,9,2,13,8,70,38.28022361253462,-109.4232907
4442,2,36,9,3,11,6,67,38.28022361253462,-109.4230212
4443,2,31,9,3,10,7,62,38.28022361253462,-109.4227517
4444,2,29,12,1,10,14,68,38.28022361253462,-109.4224822
4445,1,26,11,1,17,12,68,38.28022361253462,-109.4222127
4446,1,19,11,4,10,12,57,38.28022361253462,-109.4219432
4447,0,33,9,2,10,8,62,38.28022361253462,-109.4216737
4448,1,35,7,0,9,6,58,38.28022361253462,-109.4214042
4449,1,34,6,0,9,7,57,38.28022361253462,-109.4211347
4450,1,32,7,0,9,7,56,38.28022361253462,-109.4208652
4451,1,32,8,1,9,7,58,38.28022361253462,-109.4205957
4452,2,34,8,1,9,7,61,38.28022361253462,-109.4203262
4453,3,35,9,3,8,9,67,38.28022361253462,-109.4200568
4454,2,31,12,3,12,12,72,38.28022361253462,-109.4197873
4455,2,28,12,2,9,18,71,38.28022361253462,-109.4195178
4456,2,28,13,1,7,20,71,38.28022361253462,-109.4192483
4457,1,27,14,1,8,22,73,38.28022361253462,-109.4189788
4458,2,30,13,3,13,18,79,38.28022361253462,-109.4187093
4459,1,32,12,4,16,15,80,38.28022361253462,-109.4184398
4460,1,31,12,8,18,10,80,38.28022361253462,-109.4181703
4461,1,31,12,8,20,9,81,38.28022361253462,-109.4179008
4462,0,29,14,2,15,16,76,38.28022361253462,-109.4176313
4463,0,30,15,0,13,22,80,38.28022361253462,-109.4173618
4464,0,30,16,0,11,25,82,38.28022361253462,-109.4170923
4465,1,30,15,0,9,24,79,38.28022361253462,-109.4168228
4466,1,30,14,0,8,22,75,38.28022361253462,-109.4165533
4467,0,32,10,0,9,16,67,38.28022361253462,-109.4162838
4468,2,37,11,0,11,14,75,38.28022361253462,-109.4160143
4469,2,37,12,1,10,15,77,38.28022361253462,-109.4157448
4470,2,33,12,2,8,19,76,38.28022361253462,-109.4154753
4471,2,32,13,1,7,21,76,38.28022361253462,-109.4152058
4472,1,32,13,2,6,22,76,38.28022361253462,-109.4149364
4473,1,29,15,1,5,26,77,38.28022361253462,-109.4146669
4474,1,30,15,0,5,26,77,38.28022361253462,-109.4143974
4475,1,33,14,0,6,23,77,38.28022361253462,-109.4141279
4476,1,32,12,0,7,21,73,38.28022361253462,-109.4138584
4477,2,36,10,0,9,16,73,38.28022361253462,-109.4135889
4478,1,36,10,0,9,16,72,38.28022361253462,-109.4133194
4479,1,36,11,0,10,17,75,38.28022361253462,-109.4130499
4480,2,35,11,0,11,15,74,38.28022361253462,-109.4127804
4481,1,32,8,0,12,9,62,38.28022361253462,-109.4125109
4482,1,26,9,0,8,15,59,38.28022361253462,-109.4122414
4483,1,24,10,0,5,18,58,38.28022361253462,-109.4119719
4484,1,24,11,0,4,21,61,38.28022361253462,-109.4117024
4485,1,28,12,0,5,21,67,38.28022361253462,-109.4114329
4486,0,25,12,0,3,22,62,38.28022361253462,-109.4111634
4487,1,26,11,0,3,22,63,38.28022361253462,-109.4108939
4488,1,30,11,0,5,20,67,38.28022361253462,-109.4106244
4489,2,33,11,0,7,18,71,38.28022361253462,-109.4103549
4490,2,36,11,0,11,15,75,38.28022361253462,-109.4100855
4491,3,36,11,0,13,13,76,38.28022361253462,-109.409816
4492,2,34,12,0,12,16,76,38.28022361253462,-109.4095465
4493,2,36,12,0,11,16,77,38.28022361253462,-109.409277
4494,2,40,12,0,14,13,81,38.28022361253462,-109.4090075
4495,2,41,12,0,15,13,83,38.28022361253462,-109.408738
4496,2,44,12,0,17,9,84,38.28022361253462,-109.4084685
4497,3,45,12,0,18,8,86,38.28022361253462,-109.408199
4498,3,44,12,0,18,8,85,38.28022361253462,-109.4079295
4499,4,44,13,2,17,6,86,38.28022361253462,-109.40766
4500,4,46,13,3,17,5,88,38.28022361253462,-109.4073905
4501,4,45,13,4,15,5,86,38.28022361253462,-109.407121
4502,5,43,13,5,14,6,86,38.28022361253462,-109.4068515
4503,1,22,16,0,2,28,69,38.28022361253462,-109.3879869
4504,1,23,16,0,3,29,72,38.28022361253462,-109.3877174
4505,2,24,18,0,4,32,80,38.28022361253462,-109.3874479
4506,3,25,18,0,5,31,82,38.28022361253462,-109.3871784
4507,2,23,19,0,5,33,82,38.28022361253462,-109.3869089
4508,1,22,18,0,4,32,77,38.28022361253462,-109.3866394
4509,1,23,18,0,5,30,77,38.28022361253462,-109.3863699
4510,1,23,17,0,4,30,75,38.28022361253462,-109.3861004
4511,1,22,17,0,3,30,73,38.28022361253462,-109.3858309
4512,1,24,17,0,4,28,74,38.28022361253462,-109.3855614
4513,1,24,17,0,4,28,74,38.28022361253462,-109.3852919
4514,0,25,18,0,4,31,78,38.28022361253462,-109.3850225
4515,0,26,18,0,4,32,80,38.28022361253462,-109.384753
4516,0,26,16,0,4,27,73,38.28022361253462,-109.3844835
4517,1,26,14,0,5,21,67,38.28022361253462,-109.384214
4518,1,27,13,0,5,19,65,38.28022361253462,-109.3839445
4519,1,29,13,0,6,19,68,38.28022361253462,-109.383675
4520,2,31,14,0,9,16,72,38.28022361253462,-109.3834055
4521,2,30,15,0,8,19,74,38.28022361253462,-109.383136
4522,1,28,16,0,6,23,74,38.28022361253462,-109.3828665
4523,1,26,15,0,4,24,70,38.28022361253462,-109.382597
4524,1,27,14,0,5,20,67,38.28022361253462,-109.3823275
4525,1,30,14,0,7,18,70,38.28022361253462,-109.382058
4526,1,31,14,0,9,17,72,38.28022361253462,-109.3817885
4527,2,31,15,1,8,19,76,38.28022361253462,-109.381519
4528,1,30,18,2,7,22,80,38.28022361253462,-109.3812495
4529,1,27,17,0,6,26,77,38.28022361253462,-109.38098
4530,3,25,16,2,6,21,73,38.28022361253462,-109.3807105
4531,0,26,15,0,4,26,71,38.28022361253462,-109.380441
4532,0,27,12,0,5,21,65,38.28022361253462,-109.3801716
4533,1,35,8,0,6,9,59,38.28022361253462,-109.3799021
4534,2,34,7,0,8,5,56,38.28022361253462,-109.3796326
4535,3,31,10,4,8,6,62,38.28022361253462,-109.3793631
4536,3,26,14,5,4,13,65,38.28022361253462,-109.3790936
4537,1,19,15,2,4,22,63,38.28022361253462,-109.3788241
4538,1,23,14,2,6,20,66,38.28022361253462,-109.3785546
4539,2,18,15,2,3,24,64,38.28022361253462,-109.3782851
4540,1,16,17,1,3,28,66,38.28022361253462,-109.3780156
4541,1,19,18,0,3,32,73,38.28022361253462,-109.3777461
4542,1,21,17,0,3,29,71,38.28022361253462,-109.3774766
4543,1,21,15,0,3,25,65,38.28022361253462,-109.3772071
4544,1,20,15,0,3,26,65,38.28022361253462,-109.3769376
4545,1,22,16,0,4,27,70,38.28022361253462,-109.3766681
4546,0,23,16,0,4,28,71,38.28022361253462,-109.3763986
4547,0,24,17,0,5,30,76,38.28022361253462,-109.3761291
4548,0,27,19,0,9,29,84,38.28022361253462,-109.3758596
4549,1,23,16,0,6,25,71,38.28022361253462,-109.3755901
4550,1,23,13,0,5,21,63,38.28022361253462,-109.3753206
4551,1,29,11,0,7,17,65,38.28022361253462,-109.3750512
4552,2,23,12,3,7,16,63,38.28022361253462,-109.3747817
4553,2,25,11,3,7,15,63,38.28022361253462,-109.3745122
4554,2,25,11,2,5,17,62,38.28022361253462,-109.3742427
4555,2,25,12,2,5,18,64,38.28022361253462,-109.3739732
4556,2,26,12,2,4,19,65,38.28022361253462,-109.3737037
4557,2,31,10,4,7,12,66,38.28022361253462,-109.3734342
4558,2,32,9,5,11,7,66,38.28022361253462,-109.3731647
4559,2,38,8,4,11,4,67,38.28022361253462,-109.3728952
4560,0,46,7,2,10,3,68,38.28022361253462,-109.3726257
4561,1,51,6,5,8,1,72,38.28022361253462,-109.3723562
4562,0,42,6,12,4,2,66,38.28022361253462,-109.3720867
4563,0,37,8,4,8,7,64,38.28022361253462,-109.3718172
4564,1,36,9,2,11,9,68,38.28022361253462,-109.3715477
4565,2,32,10,3,10,10,67,38.28022361253462,-109.3712782
4566,2,37,8,3,10,7,67,38.28022361253462,-109.3710087
4567,2,35,10,2,11,9,69,38.28022361253462,-109.3707392
4568,2,34,10,3,10,10,69,38.28022361253462,-109.3704697
4569,1,33,10,2,10,10,66,38.28022361253462,-109.3702003
4570,1,37,9,3,12,6,68,38.28022361253462,-109.3699308
4571,3,41,9,5,10,6,74,38.28022361253462,-109.3696613
4572,2,33,10,5,10,7,67,38.28022361253462,-109.3693918
4573,6,27,11,9,10,3,66,38.28022361253462,-109.3691223
4574,8,22,11,10,9,3,63,38.28022361253462,-109.3688528
4575,5,24,11,8,9,6,63,38.28022361253462,-109.3685833
4576,5,20,10,7,8,7,57,38.28022361253462,-109.3683138
4577,8,14,10,4,8,9,53,38.28022361253462,-109.3680443
4578,8,14,10,4,8,11,55,38.28022361253462,-109.3677748
4579,6,16,10,4,7,12,55,38.28022361253462,-109.3675053
4580,5,25,9,2,7,12,60,38.28022361253462,-109.3672358
4581,4,25,8,4,6,9,56,38.28022361253462,-109.3669663
4582,2,26,7,5,6,8,54,38.28022361253462,-109.3666968
4583,3,29,8,6,6,8,60,38.28022361253462,-109.3664273
4584,5,30,9,6,5,8,63,38.28022361253462,-109.3661578
4585,3,19,9,3,8,10,52,38.28022361253462,-109.3658883
4586,1,11,12,3,4,17,48,38.28022361253462,-109.3656188
4587,1,17,16,0,3,27,64,38.28022361253462,-109.3653493
4588,0,23,19,0,5,31,78,38.28022361253462,-109.3650799
4589,1,24,17,2,5,31,80,38.28022361253462,-109.3648104
4590,1,20,18,0,3,33,75,38.28022361253462,-109.3645409
4591,1,20,17,0,3,32,73,38.28022361253462,-109.3642714
4592,0,20,17,0,3,31,71,38.28022361253462,-109.3640019
4593,0,20,17,0,3,31,71,38.28022361253462,-109.3637324
4594,0,20,18,0,3,33,74,38.28022361253462,-109.3634629
4595,0,20,18,0,2,33,73,38.28022361253462,-109.3631934
4596,0,20,18,0,3,32,73,38.28022361253462,-109.3629239
4597,0,23,20,0,4,30,77,38.28022361253462,-109.3626544
4598,0,28,19,2,6,25,80,38.28022361253462,-109.3623849
4599,0,27,17,2,7,22,75,38.28022361253462,-109.3621154
4600,1,26,17,5,8,20,77,38.28022361253462,-109.3618459
4601,2,28,17,7,10,17,81,38.28022361253462,-109.3615764
4602,2,29,16,10,9,15,81,38.28022361253462,-109.3613069
4603,1,30,14,9,11,12,77,38.28022361253462,-109.3610374
4604,4,30,13,14,14,5,80,38.28022361253462,-109.3607679
4605,4,24,14,10,6,21,79,38.28022361253462,-109.3604984
4606,6,18,15,8,5,26,78,38.28022361253462,-109.360229
4607,4,14,15,9,6,29,77,38.28022361253462,-109.3599595
4608,2,20,18,7,9,24,80,38.28022361253462,-109.35969
4609,1,22,19,5,8,28,83,38.28022361253462,-109.3594205
4610,0,22,21,3,7,30,83,38.28022361253462,-109.359151
4611,0,21,21,2,8,32,84,38.28022361253462,-109.3588815
4612,0,18,22,3,7,35,85,38.28022361253462,-109.358612
4613,0,17,21,3,5,34,80,38.28022361253462,-109.3583425
4614,0,20,17,4,5,28,74,38.28022361253462,-109.358073
4615,0,20,17,1,4,31,73,38.28022361253462,-109.3578035
4616,0,21,19,0,4,34,78,38.28022361253462,-109.357534
4617,0,24,21,0,5,35,85,38.28022361253462,-109.3572645
4618,0,24,20,0,6,33,83,38.28022361253462,-109.356995
4619,0,24,19,0,6,32,81,38.28022361253462,-109.3567255
4620,0,24,20,1,5,32,82,38.28022361253462,-109.356456
4621,0,22,21,1,5,32,81,38.28022361253462,-109.3561865
4622,0,21,22,3,6,31,83,38.28022361253462,-109.355917
4623,0,19,22,3,5,33,82,38.28022361253462,-109.3556475
4624,0,21,22,1,6,33,83,38.28022361253462,-109.355378
4625,0,23,19,0,4,32,78,38.28022361253462,-109.3551086
4626,0,22,17,0,3,29,71,38.28022361253462,-109.3548391
4627,1,22,17,0,4,28,72,38.28022361253462,-109.3545696
4628,1,19,17,0,1,27,65,38.28022361253462,-109.3543001
4629,2,20,16,0,1,26,65,38.28022361253462,-109.3540306
4630,2,22,16,2,4,23,69,38.28022361253462,-109.3537611
4631,1,26,19,1,7,25,79,38.28022361253462,-109.3534916
4632,1,23,21,0,5,30,80,38.28022361253462,-109.3532221
4633,6,24,17,8,7,19,81,38.28022361253462,-109.3529526
4634,14,26,14,16,8,8,86,38.28022361253462,-109.3526831
4635,24,25,12,20,6,4,91,38.28022361253462,-109.3524136
4636,30,22,10,21,4,3,90,38.28022361253462,-109.3521441
4637,31,21,11,24,3,3,93,38.28022361253462,-109.3518746
4638,24,24,12,21,5,4,90,38.28022361253462,-109.3516051
4639,14,29,13,17,7,5,85,38.28022361253462,-109.3513356
4640,8,33,14,16,10,6,87,38.28022361253462,-109.3510661
4641,7,34,14,15,10,7,87,38.28022361253462,-109.3507966
4642,8,34,14,15,9,6,86,38.28022361253462,-109.3505271
4643,7,36,14,14,9,5,85,38.28022361253462,-109.3502577
4644,7,36,15,14,9,6,87,38.28022361253462,-109.3499882
4645,8,34,15,15,8,7,87,38.28022361253462,-109.3497187
4646,8,34,15,17,8,6,88,38.28022361253462,-109.3494492
4647,9,34,14,17,8,6,88,38.28022361253462,-109.3491797
4648,9,33,14,16,9,5,86,38.28022361253462,-109.3489102
4649,8,35,13,16,10,5,87,38.28022361253462,-109.3486407
4650,8,37,13,16,9,5,88,38.28022361253462,-109.3483712
4651,10,35,13,17,10,3,88,38.28022361253462,-109.3481017
4652,15,33,12,16,10,2,88,38.28022361253462,-109.3478322
4653,2,42,12,0,14,12,82,38.27995411794939,-109.4286806
4654,2,34,12,0,11,17,76,38.27995411794939,-109.4284111
4655,1,31,12,0,8,21,73,38.27995411794939,-109.4281416
4656,2,32,13,1,7,21,76,38.27995411794939,-109.4278721
4657,2,37,12,0,10,17,78,38.27995411794939,-109.4276026
4658,1,44,11,0,13,13,82,38.27995411794939,-109.4273331
4659,2,47,12,2,15,8,86,38.27995411794939,-109.4270636
4660,2,48,12,2,15,7,86,38.27995411794939,-109.4267941
4661,2,46,11,1,14,10,84,38.27995411794939,-109.4265246
4662,2,44,11,0,11,13,81,38.27995411794939,-109.4262551
4663,1,42,11,0,14,12,80,38.27995411794939,-109.4259856
4664,2,48,11,1,15,8,85,38.27995411794939,-109.4257161
4665,3,51,11,3,17,3,88,38.27995411794939,-109.4254466
4666,3,52,12,6,17,1,91,38.27995411794939,-109.4251771
4667,3,53,11,4,16,3,90,38.27995411794939,-109.4249077
4668,2,47,11,0,15,9,84,38.27995411794939,-109.4246382
4669,2,41,11,0,13,12,79,38.27995411794939,-109.4243687
4670,1,39,11,0,12,13,76,38.27995411794939,-109.4240992
4671,2,44,11,0,15,9,81,38.27995411794939,-109.4238297
4672,2,46,10,0,15,9,82,38.27995411794939,-109.4235602
4673,2,46,11,0,14,9,82,38.27995411794939,-109.4232907
4674,1,40,11,1,12,11,76,38.27995411794939,-109.4230212
4675,1,37,11,0,11,13,73,38.27995411794939,-109.4227517
4676,2,31,11,0,10,15,69,38.27995411794939,-109.4224822
4677,1,20,10,2,6,16,55,38.27995411794939,-109.4222127
4678,0,31,9,3,8,9,60,38.27995411794939,-109.4219432
4679,0,39,7,0,9,5,60,38.27995411794939,-109.4216737
4680,0,43,6,0,8,5,62,38.27995411794939,-109.4214042
4681,1,38,7,0,9,6,61,38.27995411794939,-109.4211347
4682,1,30,9,3,10,8,61,38.27995411794939,-109.4208652
4683,1,31,10,2,10,12,66,38.27995411794939,-109.4205957
4684,2,32,11,0,9,16,70,38.27995411794939,-109.4203262
4685,2,33,11,0,11,15,72,38.27995411794939,-109.4200568
4686,1,32,13,0,10,21,77,38.27995411794939,-109.4197873
4687,1,31,13,0,9,22,76,38.27995411794939,-109.4195178
4688,1,30,14,0,10,21,76,38.27995411794939,-109.4192483
4689,2,28,13,2,10,19,74,38.27995411794939,-109.4189788
4690,2,25,10,9,14,9,69,38.27995411794939,-109.4187093
4691,1,25,10,6,14,10,66,38.27995411794939,-109.4184398
4692,1,23,10,7,12,10,63,38.27995411794939,-109.4181703
4693,1,19,11,5,9,14,59,38.27995411794939,-109.4179008
4694,1,21,12,3,7,17,61,38.27995411794939,-109.4176313
4695,1,26,12,0,7,19,65,38.27995411794939,-109.4173618
4696,2,29,12,0,7,18,68,38.27995411794939,-109.4170923
4697,2,31,11,0,9,17,70,38.27995411794939,-109.4168228
4698,1,34,10,0,10,15,70,38.27995411794939,-109.4165533
4699,1,37,10,0,12,11,71,38.27995411794939,-109.4162838
4700,1,35,10,0,10,14,70,38.27995411794939,-109.4160143
4701,2,34,11,0,10,15,72,38.27995411794939,-109.4157448
4702,2,33,12,1,9,17,74,38.27995411794939,-109.4154753
4703,1,31,12,1,8,20,73,38.27995411794939,-109.4152058
4704,2,32,13,1,8,20,76,38.27995411794939,-109.4149364
4705,1,26,14,0,3,25,69,38.27995411794939,-109.4146669
4706,1,28,13,0,3,24,69,38.27995411794939,-109.4143974
4707,2,32,12,0,5,19,70,38.27995411794939,-109.4141279
4708,2,30,11,0,6,18,67,38.27995411794939,-109.4138584
4709,2,37,10,0,8,15,72,38.27995411794939,-109.4135889
4710,2,34,10,0,8,16,70,38.27995411794939,-109.4133194
4711,1,34,10,0,9,15,69,38.27995411794939,-109.4130499
4712,1,37,9,0,12,11,70,38.27995411794939,-109.4127804
4713,1,40,8,0,15,6,70,38.27995411794939,-109.4125109
4714,1,27,9,0,10,12,59,38.27995411794939,-109.4122414
4715,2,25,10,0,5,16,58,38.27995411794939,-109.4119719
4716,1,26,12,0,3,20,62,38.27995411794939,-109.4117024
4717,1,28,12,0,4,22,67,38.27995411794939,-109.4114329
4718,3,28,12,0,4,21,68,38.27995411794939,-109.4111634
4719,3,29,11,0,4,21,68,38.27995411794939,-109.4108939
4720,3,29,11,0,4,20,67,38.27995411794939,-109.4106244
4721,3,29,12,0,6,19,69,38.27995411794939,-109.4103549
4722,2,30,12,0,9,17,70,38.27995411794939,-109.4100855
4723,3,34,12,0,10,16,75,38.27995411794939,-109.409816
4724,3,34,12,0,9,16,74,38.27995411794939,-109.4095465
4725,2,38,12,0,11,16,79,38.27995411794939,-109.409277
4726,2,43,12,0,14,12,83,38.27995411794939,-109.4090075
4727,3,43,12,0,17,8,83,38.27995411794939,-109.408738
4728,3,45,12,0,17,7,84,38.27995411794939,-109.4084685
4729,3,44,12,0,17,8,84,38.27995411794939,-109.408199
4730,3,44,12,0,18,7,84,38.27995411794939,-109.4079295
4731,4,45,12,1,18,6,86,38.27995411794939,-109.40766
4732,4,46,13,4,17,4,88,38.27995411794939,-109.4073905
4733,5,45,13,4,16,4,87,38.27995411794939,-109.407121
4734,5,43,13,5,15,5,86,38.27995411794939,-109.4068515
4735,1,22,16,0,4,28,71,38.27995411794939,-109.3879869
4736,2,24,17,0,5,27,75,38.27995411794939,-109.3877174
4737,2,25,18,0,6,28,79,38.27995411794939,-109.3874479
4738,2,23,18,0,6,29,78,38.27995411794939,-109.3871784
4739,2,23,17,0,5,30,77,38.27995411794939,-109.3869089
4740,2,22,17,0,4,29,74,38.27995411794939,-109.3866394
4741,2,24,17,0,5,27,75,38.27995411794939,-109.3863699
4742,2,22,16,0,3,26,69,38.27995411794939,-109.3861004
4743,2,23,16,0,3,26,70,38.27995411794939,-109.3858309
4744,3,23,15,0,2,24,67,38.27995411794939,-109.3855614
4745,2,22,14,0,2,24,64,38.27995411794939,-109.3852919
4746,1,20,15,0,2,27,65,38.27995411794939,-109.3850225
4747,0,22,17,0,3,30,72,38.27995411794939,-109.384753
4748,0,22,17,0,3,31,73,38.27995411794939,-109.3844835
4749,0,24,16,0,3,28,71,38.27995411794939,-109.384214
4750,0,26,15,0,5,24,70,38.27995411794939,-109.3839445
4751,1,29,15,0,7,21,73,38.27995411794939,-109.383675
4752,1,30,14,0,8,17,70,38.27995411794939,-109.3834055
4753,1,28,14,0,7,19,69,38.27995411794939,-109.383136
4754,1,26,14,0,6,21,68,38.27995411794939,-109.3828665
4755,0,26,15,0,5,24,70,38.27995411794939,-109.382597
4756,0,27,16,0,6,24,73,38.27995411794939,-109.3823275
4757,1,30,16,0,8,21,76,38.27995411794939,-109.382058
4758,0,27,16,0,7,23,73,38.27995411794939,-109.3817885
4759,1,29,17,0,7,23,77,38.27995411794939,-109.381519
4760,2,31,18,0,7,23,81,38.27995411794939,-109.3812495
4761,1,25,16,0,4,27,73,38.27995411794939,-109.38098
4762,0,22,16,0,3,30,71,38.27995411794939,-109.3807105
4763,1,20,17,0,1,29,68,38.27995411794939,-109.380441
4764,1,21,14,0,2,24,62,38.27995411794939,-109.3801716
4765,1,34,9,1,7,9,61,38.27995411794939,-109.3799021
4766,2,36,7,1,7,4,57,38.27995411794939,-109.3796326
4767,5,32,10,4,9,4,64,38.27995411794939,-109.3793631
4768,4,28,14,5,5,11,67,38.27995411794939,-109.3790936
4769,3,23,14,3,4,16,63,38.27995411794939,-109.3788241
4770,3,27,11,3,10,13,67,38.27995411794939,-109.3785546
4771,3,21,15,4,5,20,68,38.27995411794939,-109.3782851
4772,1,17,17,1,3,28,67,38.27995411794939,-109.3780156
4773,0,20,18,0,3,33,74,38.27995411794939,-109.3777461
4774,0,22,18,0,4,33,77,38.27995411794939,-109.3774766
4775,0,23,17,0,5,31,76,38.27995411794939,-109.3772071
4776,1,24,17,0,6,29,77,38.27995411794939,-109.3769376
4777,1,26,16,0,7,25,75,38.27995411794939,-109.3766681
4778,1,25,17,0,6,27,76,38.27995411794939,-109.3763986
4779,0,24,19,0,5,34,82,38.27995411794939,-109.3761291
4780,1,25,17,0,7,28,78,38.27995411794939,-109.3758596
4781,1,21,15,0,4,24,65,38.27995411794939,-109.3755901
4782,1,20,12,0,4,21,58,38.27995411794939,-109.3753206
4783,1,26,11,0,5,18,61,38.27995411794939,-109.3750512
4784,1,29,11,0,6,18,65,38.27995411794939,-109.3747817
4785,2,23,12,1,5,20,63,38.27995411794939,-109.3745122
4786,2,20,15,3,5,20,65,38.27995411794939,-109.3742427
4787,2,18,16,2,5,24,67,38.27995411794939,-109.3739732
4788,2,18,18,2,5,27,72,38.27995411794939,-109.3737037
4789,2,18,16,3,5,22,66,38.27995411794939,-109.3734342
4790,1,16,13,3,4,21,58,38.27995411794939,-109.3731647
4791,1,25,11,3,6,16,62,38.27995411794939,-109.3728952
4792,0,36,8,1,10,10,65,38.27995411794939,-109.3726257
4793,1,41,8,5,9,4,68,38.27995411794939,-109.3723562
4794,1,24,8,15,8,3,59,38.27995411794939,-109.3720867
4795,5,21,10,7,9,8,60,38.27995411794939,-109.3718172
4796,2,34,9,3,11,8,67,38.27995411794939,-109.3715477
4797,1,39,8,1,11,7,67,38.27995411794939,-109.3712782
4798,1,38,7,1,7,8,62,38.27995411794939,-109.3710087
4799,1,37,9,2,11,6,66,38.27995411794939,-109.3707392
4800,1,41,8,1,11,7,69,38.27995411794939,-109.3704697
4801,2,40,9,2,10,9,72,38.27995411794939,-109.3702003
4802,2,40,10,4,12,6,74,38.27995411794939,-109.3699308
4803,4,37,10,7,9,7,74,38.27995411794939,-109.3696613
4804,2,28,12,7,9,8,66,38.27995411794939,-109.3693918
4805,3,24,12,5,9,9,62,38.27995411794939,-109.3691223
4806,3,23,11,4,7,13,61,38.27995411794939,-109.3688528
4807,2,22,11,3,7,14,59,38.27995411794939,-109.3685833
4808,1,29,9,3,9,9,60,38.27995411794939,-109.3683138
4809,2,29,9,4,10,8,62,38.27995411794939,-109.3680443
4810,2,26,8,4,8,9,57,38.27995411794939,-109.3677748
4811,2,27,9,4,9,9,60,38.27995411794939,-109.3675053
4812,3,28,9,4,8,11,63,38.27995411794939,-109.3672358
4813,3,20,10,3,7,13,56,38.27995411794939,-109.3669663
4814,8,16,11,5,6,11,57,38.27995411794939,-109.3666968
4815,6,23,11,6,6,12,64,38.27995411794939,-109.3664273
4816,5,31,11,7,4,9,67,38.27995411794939,-109.3661578
4817,6,20,10,6,9,6,57,38.27995411794939,-109.3658883
4818,2,12,12,7,6,16,55,38.27995411794939,-109.3656188
4819,0,20,17,1,4,29,71,38.27995411794939,-109.3653493
4820,1,23,19,1,5,31,80,38.27995411794939,-109.3650799
4821,1,24,17,2,5,31,80,38.27995411794939,-109.3648104
4822,1,23,19,0,4,34,81,38.27995411794939,-109.3645409
4823,1,22,18,0,4,33,78,38.27995411794939,-109.3642714
4824,1,22,18,0,4,31,76,38.27995411794939,-109.3640019
4825,1,22,17,0,3,31,74,38.27995411794939,-109.3637324
4826,1,23,18,0,4,31,77,38.27995411794939,-109.3634629
4827,0,22,18,0,3,31,74,38.27995411794939,-109.3631934
4828,0,22,19,0,3,32,76,38.27995411794939,-109.3629239
4829,0,25,21,1,6,30,83,38.27995411794939,-109.3626544
4830,1,24,20,3,7,27,82,38.27995411794939,-109.3623849
4831,0,27,21,0,8,28,84,38.27995411794939,-109.3621154
4832,1,25,22,2,7,29,86,38.27995411794939,-109.3618459
4833,2,22,22,3,6,31,86,38.27995411794939,-109.3615764
4834,1,23,21,2,7,31,85,38.27995411794939,-109.3613069
4835,0,26,21,0,8,31,86,38.27995411794939,-109.3610374
4836,0,26,20,1,7,27,81,38.27995411794939,-109.3607679
4837,5,18,15,10,6,24,78,38.27995411794939,-109.3604984
4838,5,16,16,7,5,28,77,38.27995411794939,-109.360229
4839,4,16,16,7,5,30,78,38.27995411794939,-109.3599595
4840,0,22,19,3,7,30,81,38.27995411794939,-109.35969
4841,0,22,21,2,7,31,83,38.27995411794939,-109.3594205
4842,0,21,22,2,7,32,84,38.27995411794939,-109.359151
4843,0,21,22,1,7,33,84,38.27995411794939,-109.3588815
4844,0,22,20,3,9,31,85,38.27995411794939,-109.358612
4845,0,20,21,4,9,31,85,38.27995411794939,-109.3583425
4846,0,20,19,5,9,29,82,38.27995411794939,-109.358073
4847,0,19,19,4,6,30,78,38.27995411794939,-109.3578035
4848,0,21,19,2,6,31,79,38.27995411794939,-109.357534
4849,0,22,20,2,7,31,82,38.27995411794939,-109.3572645
4850,0,24,20,1,6,31,82,38.27995411794939,-109.356995
4851,0,25,19,0,5,32,81,38.27995411794939,-109.3567255
4852,0,24,19,0,5,31,79,38.27995411794939,-109.356456
4853,1,25,20,1,6,30,83,38.27995411794939,-109.3561865
4854,1,21,21,2,6,30,81,38.27995411794939,-109.355917
4855,1,21,22,3,6,30,83,38.27995411794939,-109.3556475
4856,0,24,21,1,5,32,83,38.27995411794939,-109.355378
4857,0,21,18,0,3,32,74,38.27995411794939,-109.3551086
4858,1,20,18,0,2,30,71,38.27995411794939,-109.3548391
4859,1,22,17,0,2,27,69,38.27995411794939,-109.3545696
4860,1,23,17,0,3,26,70,38.27995411794939,-109.3543001
4861,2,23,18,2,5,27,77,38.27995411794939,-109.3540306
4862,2,22,19,1,5,31,80,38.27995411794939,-109.3537611
4863,1,18,23,2,7,32,83,38.27995411794939,-109.3534916
4864,1,16,22,0,5,33,77,38.27995411794939,-109.3532221
4865,11,21,17,12,9,17,87,38.27995411794939,-109.3529526
4866,25,21,12,22,7,5,92,38.27995411794939,-109.3526831
4867,26,22,11,26,4,3,92,38.27995411794939,-109.3524136
4868,31,21,10,25,3,1,91,38.27995411794939,-109.3521441
4869,22,25,13,24,4,4,92,38.27995411794939,-109.3518746
4870,13,28,13,22,6,7,89,38.27995411794939,-109.3516051
4871,7,31,14,18,8,7,85,38.27995411794939,-109.3513356
4872,6,33,14,16,9,7,85,38.27995411794939,-109.3510661
4873,6,33,15,14,9,10,87,38.27995411794939,-109.3507966
4874,7,32,15,16,10,6,86,38.27995411794939,-109.3505271
4875,7,33,15,16,10,6,87,38.27995411794939,-109.3502577
4876,8,34,15,15,9,6,87,38.27995411794939,-109.3499882
4877,8,34,15,16,9,6,88,38.27995411794939,-109.3497187
4878,8,33,15,16,9,6,87,38.27995411794939,-109.3494492
4879,8,33,14,16,9,6,86,38.27995411794939,-109.3491797
4880,9,34,14,16,8,6,87,38.27995411794939,-109.3489102
4881,9,35,14,16,8,5,87,38.27995411794939,-109.3486407
4882,9,37,13,15,8,4,86,38.27995411794939,-109.3483712
4883,14,35,12,16,9,3,89,38.27995411794939,-109.3481017
4884,17,33,11,16,9,2,88,38.27995411794939,-109.3478322
4885,15,33,11,17,9,3,88,38.27995411794939,-109.3475627
4886,4,42,13,4,15,5,83,38.27968462336415,-109.4292196
4887,3,41,12,3,16,7,82,38.27968462336415,-109.4289501
4888,3,44,12,1,14,10,84,38.27968462336415,-109.4286806
4889,2,43,12,1,14,10,82,38.27968462336415,-109.4284111
4890,2,42,11,0,13,12,80,38.27968462336415,-109.4281416
4891,2,39,11,0,12,14,78,38.27968462336415,-109.4278721
4892,2,40,11,0,10,16,79,38.27968462336415,-109.4276026
4893,2,43,12,1,12,13,83,38.27968462336415,-109.4273331
4894,2,47,12,2,14,9,86,38.27968462336415,-109.4270636
4895,2,49,12,2,15,7,87,38.27968462336415,-109.4267941
4896,2,48,12,1,15,9,87,38.27968462336415,-109.4265246
4897,2,44,11,0,12,12,81,38.27968462336415,-109.4262551
4898,1,45,11,0,14,11,82,38.27968462336415,-109.4259856
4899,2,50,11,1,15,7,86,38.27968462336415,-109.4257161
4900,3,52,11,4,16,2,88,38.27968462336415,-109.4254466
4901,3,53,12,6,17,1,92,38.27968462336415,-109.4251771
4902,3,53,12,4,17,2,91,38.27968462336415,-109.4249077
4903,2,49,11,1,14,8,85,38.27968462336415,-109.4246382
4904,1,43,11,0,14,11,80,38.27968462336415,-109.4243687
4905,1,41,12,0,15,11,80,38.27968462336415,-109.4240992
4906,3,47,12,2,17,6,87,38.27968462336415,-109.4238297
4907,3,54,10,2,16,5,90,38.27968462336415,-109.4235602
4908,2,54,10,2,13,7,88,38.27968462336415,-109.4232907
4909,2,51,10,1,12,9,85,38.27968462336415,-109.4230212
4910,1,45,10,0,11,12,79,38.27968462336415,-109.4227517
4911,5,31,12,0,12,10,70,38.27968462336415,-109.4224822
4912,2,32,8,4,8,8,62,38.27968462336415,-109.4222127
4913,1,41,6,2,10,4,64,38.27968462336415,-109.4219432
4914,1,47,7,2,10,3,70,38.27968462336415,-109.4216737
4915,3,44,7,3,9,3,69,38.27968462336415,-109.4214042
4916,2,39,8,2,10,6,67,38.27968462336415,-109.4211347
4917,2,33,11,3,13,10,72,38.27968462336415,-109.4208652
4918,1,32,11,1,9,16,70,38.27968462336415,-109.4205957
4919,1,32,12,0,9,19,73,38.27968462336415,-109.4203262
4920,0,32,13,0,11,21,77,38.27968462336415,-109.4200568
4921,0,30,15,0,7,28,80,38.27968462336415,-109.4197873
4922,0,30,16,0,8,28,82,38.27968462336415,-109.4195178
4923,0,32,17,0,9,26,84,38.27968462336415,-109.4192483
4924,1,34,16,1,11,22,85,38.27968462336415,-109.4189788
4925,2,31,12,5,12,13,75,38.27968462336415,-109.4187093
4926,1,26,10,3,10,12,62,38.27968462336415,-109.4184398
4927,1,25,10,3,10,11,60,38.27968462336415,-109.4181703
4928,1,23,10,3,9,12,58,38.27968462336415,-109.4179008
4929,1,27,10,4,9,11,62,38.27968462336415,-109.4176313
4930,2,32,10,2,10,10,66,38.27968462336415,-109.4173618
4931,2,34,9,2,10,9,66,38.27968462336415,-109.4170923
4932,2,35,9,1,9,10,66,38.27968462336415,-109.4168228
4933,2,37,9,0,10,10,68,38.27968462336415,-109.4165533
4934,2,37,10,0,10,9,68,38.27968462336415,-109.4162838
4935,1,34,9,0,9,14,67,38.27968462336415,-109.4160143
4936,1,30,11,0,8,17,67,38.27968462336415,-109.4157448
4937,1,29,13,0,7,22,72,38.27968462336415,-109.4154753
4938,1,29,15,0,6,26,77,38.27968462336415,-109.4152058
4939,3,33,15,0,7,22,80,38.27968462336415,-109.4149364
4940,4,32,14,0,6,19,75,38.27968462336415,-109.4146669
4941,3,31,12,0,6,18,70,38.27968462336415,-109.4143974
4942,2,30,11,0,6,18,67,38.27968462336415,-109.4141279
4943,1,28,12,0,5,20,66,38.27968462336415,-109.4138584
4944,1,36,10,0,8,16,71,38.27968462336415,-109.4135889
4945,1,30,10,0,7,18,66,38.27968462336415,-109.4133194
4946,0,31,10,0,10,14,65,38.27968462336415,-109.4130499
4947,1,40,9,0,15,6,71,38.27968462336415,-109.4127804
4948,1,42,8,0,14,5,70,38.27968462336415,-109.4125109
4949,1,34,9,0,11,12,67,38.27968462336415,-109.4122414
4950,1,29,10,0,6,16,62,38.27968462336415,-109.4119719
4951,2,27,10,0,4,19,62,38.27968462336415,-109.4117024
4952,3,27,11,0,2,22,65,38.27968462336415,-109.4114329
4953,3,31,12,0,4,21,71,38.27968462336415,-109.4111634
4954,3,32,11,0,5,19,70,38.27968462336415,-109.4108939
4955,3,33,11,0,8,16,71,38.27968462336415,-109.4106244
4956,4,38,12,0,13,11,78,38.27968462336415,-109.4103549
4957,4,41,12,0,15,9,81,38.27968462336415,-109.4100855
4958,4,44,12,0,16,8,84,38.27968462336415,-109.409816
4959,4,44,12,0,15,9,84,38.27968462336415,-109.4095465
4960,4,44,12,0,15,9,84,38.27968462336415,-109.409277
4961,4,44,12,1,16,8,85,38.27968462336415,-109.4090075
4962,4,44,12,2,17,7,86,38.27968462336415,-109.408738
4963,3,45,12,1,16,6,83,38.27968462336415,-109.4084685
4964,3,45,12,2,17,7,86,38.27968462336415,-109.408199
4965,3,45,12,2,17,6,85,38.27968462336415,-109.4079295
4966,4,46,12,2,17,5,86,38.27968462336415,-109.40766
4967,4,45,12,4,16,5,86,38.27968462336415,-109.4073905
4968,4,45,13,5,17,4,88,38.27968462336415,-109.407121
4969,5,44,13,5,17,4,88,38.27968462336415,-109.4068515
4970,1,22,17,0,3,29,72,38.27968462336415,-109.3879869
4971,1,23,17,0,4,30,75,38.27968462336415,-109.3877174
4972,2,25,17,0,5,28,77,38.27968462336415,-109.3874479
4973,1,23,17,0,4,29,74,38.27968462336415,-109.3871784
4974,1,22,17,0,5,29,74,38.27968462336415,-109.3869089
4975,1,22,17,0,4,29,73,38.27968462336415,-109.3866394
4976,2,22,16,0,4,28,72,38.27968462336415,-109.3863699
4977,3,22,15,0,4,24,68,38.27968462336415,-109.3861004
4978,3,23,13,0,4,20,63,38.27968462336415,-109.3858309
4979,2,24,12,0,4,18,60,38.27968462336415,-109.3855614
4980,2,23,12,0,4,17,58,38.27968462336415,-109.3852919
4981,2,21,12,0,3,19,57,38.27968462336415,-109.3850225
4982,1,21,15,0,2,27,66,38.27968462336415,-109.384753
4983,0,20,17,0,2,32,71,38.27968462336415,-109.3844835
4984,0,21,18,0,2,33,74,38.27968462336415,-109.384214
4985,0,24,17,0,4,30,75,38.27968462336415,-109.3839445
4986,1,28,16,0,5,25,75,38.27968462336415,-109.383675
4987,1,25,15,0,5,23,69,38.27968462336415,-109.3834055
4988,1,25,13,0,5,21,65,38.27968462336415,-109.383136
4989,1,26,13,0,5,20,65,38.27968462336415,-109.3828665
4990,1,27,14,0,5,22,69,38.27968462336415,-109.382597
4991,0,26,16,0,5,27,74,38.27968462336415,-109.3823275
4992,0,27,17,0,6,25,75,38.27968462336415,-109.382058
4993,0,26,17,0,7,25,75,38.27968462336415,-109.3817885
4994,0,28,17,0,7,24,76,38.27968462336415,-109.381519
4995,2,30,16,0,8,22,78,38.27968462336415,-109.3812495
4996,1,26,16,0,5,25,73,38.27968462336415,-109.38098
4997,0,24,16,0,5,29,74,38.27968462336415,-109.3807105
4998,0,21,17,0,3,30,71,38.27968462336415,-109.380441
4999,1,21,15,0,2,25,64,38.27968462336415,-109.3801716
5000,2,33,11,0,5,14,65,38.27968462336415,-109.3799021
5001,1,33,8,2,7,6,57,38.27968462336415,-109.3796326
5002,4,28,11,6,9,5,63,38.27968462336415,-109.3793631
5003,5,27,15,7,6,10,70,38.27968462336415,-109.3790936
5004,3,24,15,5,5,16,68,38.27968462336415,-109.3788241
5005,2,24,14,5,8,14,67,38.27968462336415,-109.3785546
5006,3,21,16,4,6,22,72,38.27968462336415,-109.3782851
5007,1,18,18,0,4,31,72,38.27968462336415,-109.3780156
5008,1,21,18,0,4,33,77,38.27968462336415,-109.3777461
5009,1,22,18,0,5,32,78,38.27968462336415,-109.3774766
5010,0,27,19,0,7,32,85,38.27968462336415,-109.3772071
5011,1,26,20,0,8,30,85,38.27968462336415,-109.3769376
5012,3,26,17,1,8,25,80,38.27968462336415,-109.3766681
5013,2,25,17,0,6,27,77,38.27968462336415,-109.3763986
5014,1,23,18,0,5,33,80,38.27968462336415,-109.3761291
5015,3,21,17,1,4,27,73,38.27968462336415,-109.3758596
5016,2,20,14,0,2,24,62,38.27968462336415,-109.3755901
5017,1,23,12,0,3,21,60,38.27968462336415,-109.3753206
5018,1,24,11,0,3,21,60,38.27968462336415,-109.3750512
5019,1,21,13,0,3,23,61,38.27968462336415,-109.3747817
5020,1,21,16,0,5,25,68,38.27968462336415,-109.3745122
5021,1,20,17,0,4,29,71,38.27968462336415,-109.3742427
5022,2,20,17,0,4,28,71,38.27968462336415,-109.3739732
5023,2,19,16,3,4,23,67,38.27968462336415,-109.3737037
5024,3,19,15,5,6,18,66,38.27968462336415,-109.3734342
5025,2,18,14,3,5,20,62,38.27968462336415,-109.3731647
5026,2,22,12,2,5,19,62,38.27968462336415,-109.3728952
5027,1,26,11,2,5,18,63,38.27968462336415,-109.3726257
5028,2,26,10,4,6,13,61,38.27968462336415,-109.3723562
5029,3,16,10,14,10,4,57,38.27968462336415,-109.3720867
5030,2,22,10,7,10,7,58,38.27968462336415,-109.3718172
5031,1,37,8,1,12,8,67,38.27968462336415,-109.3715477
5032,1,43,8,2,11,6,71,38.27968462336415,-109.3712782
5033,0,40,9,2,11,6,68,38.27968462336415,-109.3710087
5034,0,43,8,2,10,5,68,38.27968462336415,-109.3707392
5035,0,53,7,2,11,4,77,38.27968462336415,-109.3704697
5036,1,52,7,4,11,2,77,38.27968462336415,-109.3702003
5037,1,45,7,3,10,4,70,38.27968462336415,-109.3699308
5038,3,35,8,4,10,6,66,38.27968462336415,-109.3696613
5039,3,24,11,9,13,8,68,38.27968462336415,-109.3693918
5040,2,22,11,9,12,8,64,38.27968462336415,-109.3691223
5041,3,29,11,7,14,4,68,38.27968462336415,-109.3688528
5042,1,26,11,5,12,10,65,38.27968462336415,-109.3685833
5043,4,26,14,7,8,12,71,38.27968462336415,-109.3683138
5044,4,32,14,8,8,11,77,38.27968462336415,-109.3680443
5045,3,37,14,9,6,11,80,38.27968462336415,-109.3677748
5046,7,28,11,13,10,8,77,38.27968462336415,-109.3675053
5047,7,30,11,12,9,8,77,38.27968462336415,-109.3672358
5048,10,32,12,15,6,7,82,38.27968462336415,-109.3669663
5049,4,28,12,13,8,13,78,38.27968462336415,-109.3666968
5050,3,25,12,10,9,13,72,38.27968462336415,-109.3664273
5051,2,26,11,12,9,13,73,38.27968462336415,-109.3661578
5052,8,28,11,15,7,8,77,38.27968462336415,-109.3658883
5053,6,23,13,13,6,17,78,38.27968462336415,-109.3656188
5054,0,21,17,0,5,28,71,38.27968462336415,-109.3653493
5055,1,23,18,0,5,30,77,38.27968462336415,-109.3650799
5056,1,22,18,0,4,33,78,38.27968462336415,-109.3648104
5057,1,19,18,0,3,34,75,38.27968462336415,-109.3645409
5058,1,22,19,0,3,33,78,38.27968462336415,-109.3642714
5059,1,22,19,0,4,33,79,38.27968462336415,-109.3640019
5060,0,21,20,0,3,34,78,38.27968462336415,-109.3637324
5061,0,22,20,0,3,35,80,38.27968462336415,-109.3634629
5062,0,22,19,0,4,34,79,38.27968462336415,-109.3631934
5063,0,23,19,0,4,32,78,38.27968462336415,-109.3629239
5064,0,24,20,0,5,31,80,38.27968462336415,-109.3626544
5065,0,26,21,0,6,31,84,38.27968462336415,-109.3623849
5066,0,25,22,0,6,31,84,38.27968462336415,-109.3621154
5067,0,22,21,2,8,31,84,38.27968462336415,-109.3618459
5068,0,21,21,3,8,33,86,38.27968462336415,-109.3615764
5069,0,20,21,3,7,34,85,38.27968462336415,-109.3613069
5070,0,19,22,2,7,33,83,38.27968462336415,-109.3610374
5071,0,19,21,3,9,30,82,38.27968462336415,-109.3607679
5072,0,18,22,3,6,32,81,38.27968462336415,-109.3604984
5073,2,18,20,4,6,31,81,38.27968462336415,-109.360229
5074,2,18,19,4,5,30,78,38.27968462336415,-109.3599595
5075,0,21,19,2,4,32,78,38.27968462336415,-109.35969
5076,0,20,21,1,4,35,81,38.27968462336415,-109.3594205
5077,0,21,21,0,5,35,82,38.27968462336415,-109.359151
5078,0,22,21,0,4,35,82,38.27968462336415,-109.3588815
5079,0,25,21,0,6,32,84,38.27968462336415,-109.358612
5080,0,26,20,2,7,29,84,38.27968462336415,-109.3583425
5081,0,24,20,3,9,27,83,38.27968462336415,-109.358073
5082,0,22,20,3,8,28,81,38.27968462336415,-109.3578035
5083,1,21,20,4,7,28,81,38.27968462336415,-109.357534
5084,1,21,20,5,8,25,80,38.27968462336415,-109.3572645
5085,1,24,20,3,6,28,82,38.27968462336415,-109.356995
5086,0,25,20,1,6,30,82,38.27968462336415,-109.3567255
5087,0,25,20,1,6,30,82,38.27968462336415,-109.356456
5088,0,24,20,0,7,31,82,38.27968462336415,-109.3561865
5089,1,22,22,2,7,30,84,38.27968462336415,-109.355917
5090,0,22,21,1,6,32,82,38.27968462336415,-109.3556475
5091,0,24,20,2,6,29,81,38.27968462336415,-109.355378
5092,0,23,18,0,5,29,75,38.27968462336415,-109.3551086
5093,0,22,17,0,3,29,71,38.27968462336415,-109.3548391
5094,2,23,17,0,3,27,72,38.27968462336415,-109.3545696
5095,2,23,21,1,5,31,83,38.27968462336415,-109.3543001
5096,2,22,22,1,6,32,85,38.27968462336415,-109.3540306
5097,1,21,21,1,7,33,84,38.27968462336415,-109.3537611
5098,1,23,20,2,8,31,85,38.27968462336415,-109.3534916
5099,5,25,17,7,9,23,86,38.27968462336415,-109.3532221
5100,21,21,13,19,8,9,91,38.27968462336415,-109.3529526
5101,29,19,10,24,3,2,87,38.27968462336415,-109.3526831
5102,31,20,11,25,3,2,92,38.27968462336415,-109.3524136
5103,22,24,13,25,5,3,92,38.27968462336415,-109.3521441
5104,12,26,14,21,7,9,89,38.27968462336415,-109.3518746
5105,7,28,15,17,10,10,87,38.27968462336415,-109.3516051
5106,6,28,16,16,11,10,87,38.27968462336415,-109.3513356
5107,5,29,17,13,11,11,86,38.27968462336415,-109.3510661
5108,5,27,18,15,10,12,87,38.27968462336415,-109.3507966
5109,6,27,17,14,11,11,86,38.27968462336415,-109.3505271
5110,8,29,16,14,11,9,87,38.27968462336415,-109.3502577
5111,8,31,15,14,10,8,86,38.27968462336415,-109.3499882
5112,8,32,15,16,9,7,87,38.27968462336415,-109.3497187
5113,8,32,15,16,8,7,86,38.27968462336415,-109.3494492
5114,8,33,14,17,9,6,87,38.27968462336415,-109.3491797
5115,8,34,14,16,9,5,86,38.27968462336415,-109.3489102
5116,9,36,13,15,9,5,87,38.27968462336415,-109.3486407
5117,11,37,13,15,8,4,88,38.27968462336415,-109.3483712
5118,14,35,12,15,9,3,88,38.27968462336415,-109.3481017
5119,14,34,12,15,9,4,88,38.27968462336415,-109.3478322
5120,10,34,13,15,9,5,86,38.27968462336415,-109.3475627
5121,8,35,14,14,8,6,85,38.27968462336415,-109.3472932
5122,4,39,13,5,13,5,79,38.27941512877891,-109.4294891
5123,3,43,13,4,15,5,83,38.27941512877891,-109.4292196
5124,3,47,12,4,16,5,87,38.27941512877891,-109.4289501
5125,3,48,12,4,16,4,87,38.27941512877891,-109.4286806
5126,3,49,12,2,16,5,87,38.27941512877891,-109.4284111
5127,3,48,12,2,16,7,88,38.27941512877891,-109.4281416
5128,3,45,12,2,15,9,86,38.27941512877891,-109.4278721
5129,2,42,11,1,13,13,82,38.27941512877891,-109.4276026
5130,2,45,11,1,12,12,83,38.27941512877891,-109.4273331
5131,2,48,11,2,14,9,86,38.27941512877891,-109.4270636
5132,2,50,11,3,15,5,86,38.27941512877891,-109.4267941
5133,2,50,12,3,16,6,89,38.27941512877891,-109.4265246
5134,2,45,11,0,13,12,83,38.27941512877891,-109.4262551
5135,2,49,11,1,14,9,86,38.27941512877891,-109.4259856
5136,2,52,11,1,15,7,88,38.27941512877891,-109.4257161
5137,2,52,11,2,15,6,88,38.27941512877891,-109.4254466
5138,2,53,11,3,15,5,89,38.27941512877891,-109.4251771
5139,2,53,11,2,15,5,88,38.27941512877891,-109.4249077
5140,2,47,11,0,13,11,84,38.27941512877891,-109.4246382
5141,2,43,12,0,14,11,82,38.27941512877891,-109.4243687
5142,2,45,12,2,16,7,84,38.27941512877891,-109.4240992
5143,3,52,11,2,16,5,89,38.27941512877891,-109.4238297
5144,2,52,11,1,16,6,88,38.27941512877891,-109.4235602
5145,2,50,11,2,14,6,85,38.27941512877891,-109.4232907
5146,1,48,9,0,12,8,78,38.27941512877891,-109.4230212
5147,1,44,8,0,10,9,72,38.27941512877891,-109.4227517
5148,3,39,10,1,11,8,72,38.27941512877891,-109.4224822
5149,2,43,7,2,7,6,67,38.27941512877891,-109.4222127
5150,1,42,6,2,11,4,66,38.27941512877891,-109.4219432
5151,3,43,8,5,12,3,74,38.27941512877891,-109.4216737
5152,3,40,11,5,14,5,78,38.27941512877891,-109.4214042
5153,1,35,12,1,13,13,75,38.27941512877891,-109.4211347
5154,1,32,13,1,12,15,74,38.27941512877891,-109.4208652
5155,1,31,13,1,10,19,75,38.27941512877891,-109.4205957
5156,2,31,14,1,11,21,80,38.27941512877891,-109.4203262
5157,0,32,15,0,11,22,80,38.27941512877891,-109.4200568
5158,0,32,15,1,13,21,82,38.27941512877891,-109.4197873
5159,0,32,14,3,17,15,81,38.27941512877891,-109.4195178
5160,0,33,14,5,18,12,82,38.27941512877891,-109.4192483
5161,0,31,14,1,17,16,79,38.27941512877891,-109.4189788
5162,1,32,14,0,12,18,77,38.27941512877891,-109.4187093
5163,1,29,12,2,9,14,67,38.27941512877891,-109.4184398
5164,1,24,11,4,10,13,63,38.27941512877891,-109.4181703
5165,1,24,11,3,10,12,61,38.27941512877891,-109.4179008
5166,1,33,9,1,9,11,64,38.27941512877891,-109.4176313
5167,1,31,9,3,8,10,62,38.27941512877891,-109.4173618
5168,1,34,9,2,9,8,63,38.27941512877891,-109.4170923
5169,1,36,8,1,9,8,63,38.27941512877891,-109.4168228
5170,1,38,8,0,8,9,64,38.27941512877891,-109.4165533
5171,0,33,9,0,10,11,63,38.27941512877891,-109.4162838
5172,0,28,11,0,8,17,64,38.27941512877891,-109.4160143
5173,0,30,12,0,8,20,70,38.27941512877891,-109.4157448
5174,0,30,13,0,5,25,73,38.27941512877891,-109.4154753
5175,0,29,15,0,4,29,77,38.27941512877891,-109.4152058
5176,0,28,15,0,5,28,76,38.27941512877891,-109.4149364
5177,1,29,14,0,6,24,74,38.27941512877891,-109.4146669
5178,0,30,13,0,6,22,71,38.27941512877891,-109.4143974
5179,0,30,12,0,5,21,68,38.27941512877891,-109.4141279
5180,2,29,11,0,6,19,67,38.27941512877891,-109.4138584
5181,2,32,11,0,8,16,69,38.27941512877891,-109.4135889
5182,1,30,10,0,7,17,65,38.27941512877891,-109.4133194
5183,0,30,10,0,10,14,64,38.27941512877891,-109.4130499
5184,1,40,9,0,15,5,70,38.27941512877891,-109.4127804
5185,1,45,9,0,17,4,76,38.27941512877891,-109.4125109
5186,2,35,9,0,12,11,69,38.27941512877891,-109.4122414
5187,1,31,10,0,8,14,64,38.27941512877891,-109.4119719
5188,1,29,10,0,6,16,62,38.27941512877891,-109.4117024
5189,2,29,10,0,5,17,63,38.27941512877891,-109.4114329
5190,2,36,10,0,7,16,71,38.27941512877891,-109.4111634
5191,2,38,11,0,9,14,74,38.27941512877891,-109.4108939
5192,3,39,12,0,13,11,78,38.27941512877891,-109.4106244
5193,4,42,13,1,16,8,84,38.27941512877891,-109.4103549
5194,5,43,13,3,17,6,87,38.27941512877891,-109.4100855
5195,5,43,13,3,17,6,87,38.27941512877891,-109.409816
5196,5,44,12,2,18,5,86,38.27941512877891,-109.4095465
5197,5,45,12,2,18,5,87,38.27941512877891,-109.409277
5198,5,45,12,2,17,6,87,38.27941512877891,-109.4090075
5199,4,46,11,2,16,6,85,38.27941512877891,-109.408738
5200,4,48,12,3,17,3,87,38.27941512877891,-109.4084685
5201,4,47,12,3,17,4,87,38.27941512877891,-109.408199
5202,4,45,12,3,16,5,85,38.27941512877891,-109.4079295
5203,4,46,12,4,16,4,86,38.27941512877891,-109.40766
5204,4,47,13,5,17,3,89,38.27941512877891,-109.4073905
5205,4,44,13,5,18,4,88,38.27941512877891,-109.407121
5206,5,43,13,5,18,3,87,38.27941512877891,-109.4068515
5207,0,20,17,0,3,31,71,38.27941512877891,-109.3879869
5208,1,21,17,0,3,31,73,38.27941512877891,-109.3877174
5209,1,21,17,0,3,30,72,38.27941512877891,-109.3874479
5210,1,22,17,0,3,29,72,38.27941512877891,-109.3871784
5211,1,22,16,0,4,27,70,38.27941512877891,-109.3869089
5212,1,21,16,0,3,27,68,38.27941512877891,-109.3866394
5213,3,20,15,0,2,25,65,38.27941512877891,-109.3863699
5214,4,20,13,0,4,19,60,38.27941512877891,-109.3861004
5215,2,24,11,0,5,16,58,38.27941512877891,-109.3858309
5216,2,24,11,0,5,15,57,38.27941512877891,-109.3855614
5217,1,22,10,0,5,16,54,38.27941512877891,-109.3852919
5218,1,21,10,0,3,18,53,38.27941512877891,-109.3850225
5219,1,21,13,0,2,21,58,38.27941512877891,-109.384753
5220,1,16,15,0,3,26,61,38.27941512877891,-109.3844835
5221,0,18,17,0,2,31,68,38.27941512877891,-109.384214
5222,0,21,17,0,3,32,73,38.27941512877891,-109.3839445
5223,0,24,17,0,3,30,74,38.27941512877891,-109.383675
5224,0,23,16,0,2,30,71,38.27941512877891,-109.3834055
5225,1,24,15,0,3,26,69,38.27941512877891,-109.383136
5226,1,26,13,0,5,22,67,38.27941512877891,-109.3828665
5227,1,27,14,0,5,21,68,38.27941512877891,-109.382597
5228,0,27,16,0,5,26,74,38.27941512877891,-109.3823275
5229,0,26,17,0,5,29,77,38.27941512877891,-109.382058
5230,0,26,18,0,5,30,79,38.27941512877891,-109.3817885
5231,0,24,17,0,4,30,75,38.27941512877891,-109.381519
5232,1,25,15,0,5,25,71,38.27941512877891,-109.3812495
5233,0,23,16,0,3,29,71,38.27941512877891,-109.38098
5234,0,24,17,0,3,31,75,38.27941512877891,-109.3807105
5235,0,22,18,0,2,34,76,38.27941512877891,-109.380441
5236,1,21,17,0,1,30,70,38.27941512877891,-109.3801716
5237,2,27,13,0,3,21,66,38.27941512877891,-109.3799021
5238,2,37,9,2,5,8,63,38.27941512877891,-109.3796326
5239,2,27,12,5,8,7,61,38.27941512877891,-109.3793631
5240,5,24,15,9,6,10,69,38.27941512877891,-109.3790936
5241,6,25,15,8,8,14,76,38.27941512877891,-109.3788241
5242,2,23,14,5,6,19,69,38.27941512877891,-109.3785546
5243,3,21,16,5,7,20,72,38.27941512877891,-109.3782851
5244,0,19,17,0,4,31,71,38.27941512877891,-109.3780156
5245,0,21,18,0,6,33,78,38.27941512877891,-109.3777461
5246,0,24,19,1,9,29,82,38.27941512877891,-109.3774766
5247,0,27,19,0,8,31,85,38.27941512877891,-109.3772071
5248,1,22,17,0,5,29,74,38.27941512877891,-109.3769376
5249,3,26,17,1,6,25,78,38.27941512877891,-109.3766681
5250,2,25,17,1,6,25,76,38.27941512877891,-109.3763986
5251,2,22,17,2,4,27,74,38.27941512877891,-109.3761291
5252,4,20,16,1,2,25,68,38.27941512877891,-109.3758596
5253,3,22,14,2,3,20,64,38.27941512877891,-109.3755901
5254,1,21,13,3,5,19,62,38.27941512877891,-109.3753206
5255,1,18,14,2,3,23,61,38.27941512877891,-109.3750512
5256,0,19,18,0,3,32,72,38.27941512877891,-109.3747817
5257,1,21,17,0,5,29,73,38.27941512877891,-109.3745122
5258,2,22,16,2,4,22,68,38.27941512877891,-109.3742427
5259,2,25,13,3,5,18,66,38.27941512877891,-109.3739732
5260,2,28,12,4,9,13,68,38.27941512877891,-109.3737037
5261,3,31,12,6,12,8,72,38.27941512877891,-109.3734342
5262,4,21,14,7,8,14,68,38.27941512877891,-109.3731647
5263,3,17,14,7,6,17,64,38.27941512877891,-109.3728952
5264,2,18,14,6,5,18,63,38.27941512877891,-109.3726257
5265,1,19,12,5,5,18,60,38.27941512877891,-109.3723562
5266,2,17,10,11,10,7,57,38.27941512877891,-109.3720867
5267,1,20,9,8,9,9,56,38.27941512877891,-109.3718172
5268,1,27,10,3,8,14,63,38.27941512877891,-109.3715477
5269,1,37,10,1,11,11,71,38.27941512877891,-109.3712782
5270,0,40,9,2,10,7,68,38.27941512877891,-109.3710087
5271,0,46,8,2,11,5,72,38.27941512877891,-109.3707392
5272,1,49,8,3,10,4,75,38.27941512877891,-109.3704697
5273,2,45,8,4,10,4,73,38.27941512877891,-109.3702003
5274,1,45,7,3,10,4,70,38.27941512877891,-109.3699308
5275,3,36,9,6,10,5,69,38.27941512877891,-109.3696613
5276,5,26,13,12,11,7,74,38.27941512877891,-109.3693918
5277,5,26,16,4,11,16,78,38.27941512877891,-109.3691223
5278,5,26,15,3,10,15,74,38.27941512877891,-109.3688528
5279,5,29,15,0,9,17,75,38.27941512877891,-109.3685833
5280,2,29,16,0,6,23,76,38.27941512877891,-109.3683138
5281,2,30,14,2,11,19,78,38.27941512877891,-109.3680443
5282,1,32,14,5,10,19,81,38.27941512877891,-109.3677748
5283,8,24,12,14,8,13,79,38.27941512877891,-109.3675053
5284,8,27,11,18,10,7,81,38.27941512877891,-109.3672358
5285,6,29,12,12,19,2,80,38.27941512877891,-109.3669663
5286,1,26,12,11,18,8,76,38.27941512877891,-109.3666968
5287,2,23,12,9,15,12,73,38.27941512877891,-109.3664273
5288,4,27,12,8,15,11,77,38.27941512877891,-109.3661578
5289,8,27,11,15,9,7,77,38.27941512877891,-109.3658883
5290,7,25,11,13,8,13,77,38.27941512877891,-109.3656188
5291,1,19,14,1,4,25,64,38.27941512877891,-109.3653493
5292,1,24,18,1,6,29,79,38.27941512877891,-109.3650799
5293,1,25,18,1,4,33,82,38.27941512877891,-109.3648104
5294,1,24,19,0,3,34,81,38.27941512877891,-109.3645409
5295,1,23,19,0,4,34,81,38.27941512877891,-109.3642714
5296,1,23,19,0,4,33,80,38.27941512877891,-109.3640019
5297,1,22,19,0,3,33,78,38.27941512877891,-109.3637324
5298,0,21,20,0,3,35,79,38.27941512877891,-109.3634629
5299,0,22,20,0,4,34,80,38.27941512877891,-109.3631934
5300,0,23,18,0,5,32,78,38.27941512877891,-109.3629239
5301,0,23,18,0,5,31,77,38.27941512877891,-109.3626544
5302,0,24,19,0,4,32,79,38.27941512877891,-109.3623849
5303,0,24,21,0,5,34,84,38.27941512877891,-109.3621154
5304,0,23,22,2,6,31,84,38.27941512877891,-109.3618459
5305,0,22,21,3,7,30,83,38.27941512877891,-109.3615764
5306,0,21,21,3,6,31,82,38.27941512877891,-109.3613069
5307,0,20,21,3,6,32,82,38.27941512877891,-109.3610374
5308,0,20,22,3,7,31,83,38.27941512877891,-109.3607679
5309,0,20,21,3,7,30,81,38.27941512877891,-109.3604984
5310,1,20,20,4,7,30,82,38.27941512877891,-109.360229
5311,2,20,18,5,8,28,81,38.27941512877891,-109.3599595
5312,1,21,19,4,7,29,81,38.27941512877891,-109.35969
5313,0,20,21,1,5,34,81,38.27941512877891,-109.3594205
5314,0,22,19,0,4,33,78,38.27941512877891,-109.359151
5315,0,23,19,0,4,33,79,38.27941512877891,-109.3588815
5316,0,24,20,0,5,32,81,38.27941512877891,-109.358612
5317,0,22,21,2,6,31,82,38.27941512877891,-109.3583425
5318,0,24,20,2,6,29,81,38.27941512877891,-109.358073
5319,0,24,20,2,7,30,83,38.27941512877891,-109.3578035
5320,0,24,20,1,7,30,82,38.27941512877891,-109.357534
5321,0,22,21,2,7,30,82,38.27941512877891,-109.3572645
5322,1,23,21,2,6,30,83,38.27941512877891,-109.356995
5323,0,25,20,2,7,28,82,38.27941512877891,-109.3567255
5324,0,25,20,2,8,27,82,38.27941512877891,-109.356456
5325,0,25,19,2,7,28,81,38.27941512877891,-109.3561865
5326,1,23,20,2,5,30,81,38.27941512877891,-109.355917
5327,0,22,22,1,6,33,84,38.27941512877891,-109.3556475
5328,0,24,22,0,5,33,84,38.27941512877891,-109.355378
5329,0,25,22,0,6,33,86,38.27941512877891,-109.3551086
5330,0,24,21,0,6,31,82,38.27941512877891,-109.3548391
5331,2,23,20,3,5,28,81,38.27941512877891,-109.3545696
5332,3,22,21,4,6,27,83,38.27941512877891,-109.3543001
5333,2,21,21,3,7,30,84,38.27941512877891,-109.3540306
5334,4,24,20,5,9,24,86,38.27941512877891,-109.3537611
5335,4,28,19,10,10,16,87,38.27941512877891,-109.3534916
5336,6,28,15,21,10,9,89,38.27941512877891,-109.3532221
5337,26,22,11,27,6,2,94,38.27941512877891,-109.3529526
5338,28,20,10,28,4,2,92,38.27941512877891,-109.3526831
5339,22,20,11,29,7,3,92,38.27941512877891,-109.3524136
5340,10,25,15,21,9,8,88,38.27941512877891,-109.3521441
5341,5,25,16,15,12,15,88,38.27941512877891,-109.3518746
5342,7,20,17,14,11,15,84,38.27941512877891,-109.3516051
5343,5,22,19,9,10,19,84,38.27941512877891,-109.3513356
5344,2,26,20,5,8,22,83,38.27941512877891,-109.3510661
5345,5,24,19,13,10,15,86,38.27941512877891,-109.3507966
5346,5,22,19,12,11,16,85,38.27941512877891,-109.3505271
5347,6,26,18,12,9,15,86,38.27941512877891,-109.3502577
5348,7,29,16,13,8,12,85,38.27941512877891,-109.3499882
5349,8,32,15,18,8,6,87,38.27941512877891,-109.3497187
5350,9,32,15,17,7,6,86,38.27941512877891,-109.3494492
5351,8,33,15,17,8,6,87,38.27941512877891,-109.3491797
5352,9,34,14,17,9,5,88,38.27941512877891,-109.3489102
5353,11,34,13,17,8,4,87,38.27941512877891,-109.3486407
5354,13,33,12,17,9,3,87,38.27941512877891,-109.3483712
5355,14,34,12,14,9,4,87,38.27941512877891,-109.3481017
5356,11,35,13,14,9,5,87,38.27941512877891,-109.3478322
5357,9,35,13,13,10,6,86,38.27941512877891,-109.3475627
5358,7,36,14,13,10,6,86,38.27941512877891,-109.3472932
5359,8,36,14,15,8,4,85,38.27941512877891,-109.3470237
5360,3,47,11,4,13,5,83,38.279145634193675,-109.4297586
5361,3,48,11,4,14,5,85,38.279145634193675,-109.4294891
5362,3,48,12,4,15,4,86,38.279145634193675,-109.4292196
5363,3,48,12,5,15,4,87,38.279145634193675,-109.4289501
5364,4,49,12,6,15,4,90,38.279145634193675,-109.4286806
5365,3,49,12,4,16,4,88,38.279145634193675,-109.4284111
5366,3,50,12,3,16,5,89,38.279145634193675,-109.4281416
5367,3,47,12,2,15,8,87,38.279145634193675,-109.4278721
5368,2,47,11,2,14,10,86,38.279145634193675,-109.4276026
5369,2,49,10,2,12,10,85,38.279145634193675,-109.4273331
5370,2,51,10,2,13,8,86,38.279145634193675,-109.4270636
5371,2,53,11,3,16,5,90,38.279145634193675,-109.4267941
5372,2,51,12,4,17,4,90,38.279145634193675,-109.4265246
5373,2,47,11,1,14,10,85,38.279145634193675,-109.4262551
5374,2,51,10,2,13,9,87,38.279145634193675,-109.4259856
5375,1,51,10,2,14,7,85,38.279145634193675,-109.4257161
5376,2,49,11,2,14,7,85,38.279145634193675,-109.4254466
5377,2,47,11,1,14,10,85,38.279145634193675,-109.4251771
5378,1,47,10,0,13,11,82,38.279145634193675,-109.4249077
5379,2,44,10,1,11,12,80,38.279145634193675,-109.4246382
5380,2,47,11,1,15,9,85,38.279145634193675,-109.4243687
5381,2,52,11,2,16,5,88,38.279145634193675,-109.4240992
5382,2,55,10,2,14,5,88,38.279145634193675,-109.4238297
5383,2,50,10,1,14,7,84,38.279145634193675,-109.4235602
5384,1,44,10,1,12,8,76,38.279145634193675,-109.4232907
5385,1,41,9,1,12,9,73,38.279145634193675,-109.4230212
5386,1,41,10,1,13,9,75,38.279145634193675,-109.4227517
5387,1,42,11,0,14,9,77,38.279145634193675,-109.4224822
5388,2,47,9,1,11,8,78,38.279145634193675,-109.4222127
5389,1,41,10,0,13,10,75,38.279145634193675,-109.4219432
5390,1,38,11,0,13,13,76,38.279145634193675,-109.4216737
5391,2,37,11,0,10,16,76,38.279145634193675,-109.4214042
5392,0,32,12,0,8,21,73,38.279145634193675,-109.4211347
5393,0,31,14,0,10,22,77,38.279145634193675,-109.4208652
5394,0,30,14,3,11,20,78,38.279145634193675,-109.4205957
5395,0,29,13,6,14,15,77,38.279145634193675,-109.4203262
5396,0,30,12,8,16,10,76,38.279145634193675,-109.4200568
5397,0,26,10,7,13,10,66,38.279145634193675,-109.4197873
5398,0,26,10,7,13,9,65,38.279145634193675,-109.4195178
5399,0,27,11,5,12,10,65,38.279145634193675,-109.4192483
5400,0,30,11,3,12,11,67,38.279145634193675,-109.4189788
5401,1,33,12,0,10,14,70,38.279145634193675,-109.4187093
5402,0,29,12,0,9,18,68,38.279145634193675,-109.4184398
5403,0,27,12,2,11,15,67,38.279145634193675,-109.4181703
5404,0,26,11,2,10,15,64,38.279145634193675,-109.4179008
5405,0,31,11,1,9,16,68,38.279145634193675,-109.4176313
5406,0,27,13,0,8,19,67,38.279145634193675,-109.4173618
5407,1,26,12,1,10,15,65,38.279145634193675,-109.4170923
5408,1,28,11,2,11,12,65,38.279145634193675,-109.4168228
5409,0,28,11,0,9,14,62,38.279145634193675,-109.4165533
5410,0,31,12,0,12,17,72,38.279145634193675,-109.4162838
5411,0,30,12,0,9,20,71,38.279145634193675,-109.4160143
5412,0,30,12,0,7,21,70,38.279145634193675,-109.4157448
5413,0,29,13,0,6,24,72,38.279145634193675,-109.4154753
5414,0,28,14,0,4,27,73,38.279145634193675,-109.4152058
5415,0,28,16,0,4,29,77,38.279145634193675,-109.4149364
5416,2,29,14,0,7,22,74,38.279145634193675,-109.4146669
5417,2,33,13,0,8,18,74,38.279145634193675,-109.4143974
5418,2,35,11,0,10,15,73,38.279145634193675,-109.4141279
5419,2,36,10,0,13,10,71,38.279145634193675,-109.4138584
5420,2,34,10,0,10,15,71,38.279145634193675,-109.4135889
5421,1,29,10,0,7,17,64,38.279145634193675,-109.4133194
5422,0,29,10,0,9,15,63,38.279145634193675,-109.4130499
5423,1,36,10,0,11,12,70,38.279145634193675,-109.4127804
5424,1,39,9,0,14,8,71,38.279145634193675,-109.4125109
5425,0,31,9,0,9,13,62,38.279145634193675,-109.4122414
5426,1,31,10,0,8,15,65,38.279145634193675,-109.4119719
5427,1,29,10,0,7,17,64,38.279145634193675,-109.4117024
5428,2,29,10,0,5,18,64,38.279145634193675,-109.4114329
5429,2,34,11,0,7,17,71,38.279145634193675,-109.4111634
5430,3,38,12,0,13,11,77,38.279145634193675,-109.4108939
5431,3,42,12,1,15,8,81,38.279145634193675,-109.4106244
5432,4,46,13,2,17,6,88,38.279145634193675,-109.4103549
5433,4,47,13,3,18,4,89,38.279145634193675,-109.4100855
5434,5,45,13,3,18,4,88,38.279145634193675,-109.409816
5435,6,45,12,3,18,4,88,38.279145634193675,-109.4095465
5436,6,46,12,4,17,4,89,38.279145634193675,-109.409277
5437,5,47,12,3,17,4,88,38.279145634193675,-109.4090075
5438,5,46,12,4,17,3,87,38.279145634193675,-109.408738
5439,4,47,12,4,18,3,88,38.279145634193675,-109.4084685
5440,4,46,12,3,17,4,86,38.279145634193675,-109.408199
5441,4,46,12,4,17,4,87,38.279145634193675,-109.4079295
5442,4,46,12,4,17,3,86,38.279145634193675,-109.40766
5443,4,48,13,5,18,3,91,38.279145634193675,-109.4073905
5444,4,46,13,6,18,2,89,38.279145634193675,-109.407121
5445,5,44,13,5,18,3,88,38.279145634193675,-109.4068515
5446,1,21,17,0,3,31,73,38.279145634193675,-109.3879869
5447,1,21,17,0,3,31,73,38.279145634193675,-109.3877174
5448,1,19,16,0,2,29,67,38.279145634193675,-109.3874479
5449,2,21,16,0,3,27,69,38.279145634193675,-109.3871784
5450,2,23,16,0,4,26,71,38.279145634193675,-109.3869089
5451,2,22,14,0,4,23,65,38.279145634193675,-109.3866394
5452,2,22,13,0,3,21,61,38.279145634193675,-109.3863699
5453,2,23,12,0,4,19,60,38.279145634193675,-109.3861004
5454,1,23,11,0,4,17,56,38.279145634193675,-109.3858309
5455,1,23,11,0,6,16,57,38.279145634193675,-109.3855614
5456,0,23,11,0,6,16,56,38.279145634193675,-109.3852919
5457,1,23,11,0,4,18,57,38.279145634193675,-109.3850225
5458,1,23,11,0,4,18,57,38.279145634193675,-109.384753
5459,2,20,13,0,3,21,59,38.279145634193675,-109.3844835
5460,1,17,14,0,2,25,59,38.279145634193675,-109.384214
5461,1,16,15,0,2,28,62,38.279145634193675,-109.3839445
5462,0,19,17,0,2,31,69,38.279145634193675,-109.383675
5463,1,20,18,0,1,32,72,38.279145634193675,-109.3834055
5464,1,22,16,0,3,28,70,38.279145634193675,-109.383136
5465,1,24,14,0,4,24,67,38.279145634193675,-109.3828665
5466,1,25,14,0,5,23,68,38.279145634193675,-109.382597
5467,1,26,15,0,5,25,72,38.279145634193675,-109.3823275
5468,0,26,16,0,5,28,75,38.279145634193675,-109.382058
5469,0,23,16,0,4,30,73,38.279145634193675,-109.3817885
5470,0,21,16,0,3,29,69,38.279145634193675,-109.381519
5471,1,21,15,0,3,27,67,38.279145634193675,-109.3812495
5472,0,21,16,0,2,30,69,38.279145634193675,-109.38098
5473,1,20,16,0,2,31,70,38.279145634193675,-109.3807105
5474,1,21,17,0,1,32,72,38.279145634193675,-109.380441
5475,1,21,17,0,1,30,70,38.279145634193675,-109.3801716
5476,1,22,15,0,1,26,65,38.279145634193675,-109.3799021
5477,2,30,12,2,6,12,64,38.279145634193675,-109.3796326
5478,2,30,11,4,6,9,62,38.279145634193675,-109.3793631
5479,2,23,14,6,7,12,64,38.279145634193675,-109.3790936
5480,4,25,16,7,8,15,75,38.279145634193675,-109.3788241
5481,2,28,15,3,6,20,74,38.279145634193675,-109.3785546
5482,1,27,15,2,6,23,74,38.279145634193675,-109.3782851
5483,0,23,17,2,7,27,76,38.279145634193675,-109.3780156
5484,1,24,19,3,9,28,84,38.279145634193675,-109.3777461
5485,1,27,19,3,12,25,87,38.279145634193675,-109.3774766
5486,1,26,17,0,8,26,78,38.279145634193675,-109.3772071
5487,1,23,16,1,5,26,72,38.279145634193675,-109.3769376
5488,2,24,16,0,5,25,72,38.279145634193675,-109.3766681
5489,1,24,16,0,4,26,71,38.279145634193675,-109.3763986
5490,1,23,15,0,3,24,66,38.279145634193675,-109.3761291
5491,1,21,13,1,3,21,60,38.279145634193675,-109.3758596
5492,1,20,14,2,4,20,61,38.279145634193675,-109.3755901
5493,1,19,14,1,4,22,61,38.279145634193675,-109.3753206
5494,1,19,15,0,3,26,64,38.279145634193675,-109.3750512
5495,1,19,18,0,3,33,74,38.279145634193675,-109.3747817
5496,1,18,17,0,3,29,68,38.279145634193675,-109.3745122
5497,2,26,13,4,6,17,68,38.279145634193675,-109.3742427
5498,2,31,12,5,9,11,70,38.279145634193675,-109.3739732
5499,2,32,11,4,10,12,71,38.279145634193675,-109.3737037
5500,3,27,12,4,9,14,69,38.279145634193675,-109.3734342
5501,3,17,17,5,7,23,72,38.279145634193675,-109.3731647
5502,3,16,16,7,7,24,73,38.279145634193675,-109.3728952
5503,5,15,14,9,7,17,67,38.279145634193675,-109.3726257
5504,4,22,11,9,7,11,64,38.279145634193675,-109.3723562
5505,1,19,9,9,8,7,53,38.279145634193675,-109.3720867
5506,1,17,10,11,10,7,56,38.279145634193675,-109.3718172
5507,1,19,11,7,8,13,59,38.279145634193675,-109.3715477
5508,1,29,10,2,8,15,65,38.279145634193675,-109.3712782
5509,1,38,10,1,11,11,72,38.279145634193675,-109.3710087
5510,1,42,10,6,13,4,76,38.279145634193675,-109.3707392
5511,1,41,10,7,12,4,75,38.279145634193675,-109.3704697
5512,2,44,12,12,11,1,82,38.279145634193675,-109.3702003
5513,3,45,13,16,11,1,89,38.279145634193675,-109.3699308
5514,3,32,12,10,14,7,78,38.279145634193675,-109.3696613
5515,2,28,13,5,15,12,75,38.279145634193675,-109.3693918
5516,1,31,15,3,11,18,79,38.279145634193675,-109.3691223
5517,2,30,15,3,14,14,78,38.279145634193675,-109.3688528
5518,4,30,14,6,15,12,81,38.279145634193675,-109.3685833
5519,4,30,13,6,15,13,81,38.279145634193675,-109.3683138
5520,6,29,13,7,17,13,85,38.279145634193675,-109.3680443
5521,1,24,16,11,16,17,85,38.279145634193675,-109.3677748
5522,0,22,17,10,15,19,83,38.279145634193675,-109.3675053
5523,2,21,15,15,15,12,80,38.279145634193675,-109.3672358
5524,2,18,13,12,13,13,71,38.279145634193675,-109.3669663
5525,2,21,13,11,11,16,74,38.279145634193675,-109.3666968
5526,2,22,13,9,11,16,73,38.279145634193675,-109.3664273
5527,3,22,11,12,16,8,72,38.279145634193675,-109.3661578
5528,1,24,10,15,16,4,70,38.279145634193675,-109.3658883
5529,0,23,12,8,11,12,66,38.279145634193675,-109.3656188
5530,1,22,15,4,6,25,73,38.279145634193675,-109.3653493
5531,0,22,19,2,5,33,81,38.279145634193675,-109.3650799
5532,1,22,18,2,5,34,82,38.279145634193675,-109.3648104
5533,0,22,20,1,4,35,82,38.279145634193675,-109.3645409
5534,0,22,20,0,4,34,80,38.279145634193675,-109.3642714
5535,0,24,19,0,5,32,80,38.279145634193675,-109.3640019
5536,0,26,19,0,6,31,82,38.279145634193675,-109.3637324
5537,0,22,20,0,3,35,80,38.279145634193675,-109.3634629
5538,0,21,19,0,3,35,78,38.279145634193675,-109.3631934
5539,0,21,18,0,3,34,76,38.279145634193675,-109.3629239
5540,0,21,18,0,4,32,75,38.279145634193675,-109.3626544
5541,0,22,18,0,4,30,74,38.279145634193675,-109.3623849
5542,0,21,19,0,4,33,77,38.279145634193675,-109.3621154
5543,0,23,21,0,4,34,82,38.279145634193675,-109.3618459
5544,0,22,21,0,4,35,82,38.279145634193675,-109.3615764
5545,0,22,21,0,4,35,82,38.279145634193675,-109.3613069
5546,0,24,22,0,5,34,85,38.279145634193675,-109.3610374
5547,0,25,22,0,6,32,85,38.279145634193675,-109.3607679
5548,0,23,22,1,6,31,83,38.279145634193675,-109.3604984
5549,0,22,22,2,7,30,83,38.279145634193675,-109.360229
5550,0,22,21,2,8,30,83,38.279145634193675,-109.3599595
5551,0,22,20,2,8,30,82,38.279145634193675,-109.35969
5552,0,24,20,1,7,31,83,38.279145634193675,-109.3594205
5553,0,25,20,0,5,31,81,38.279145634193675,-109.359151
5554,0,25,19,1,6,31,82,38.279145634193675,-109.3588815
5555,0,23,20,2,6,31,82,38.279145634193675,-109.358612
5556,0,20,22,2,5,32,81,38.279145634193675,-109.3583425
5557,0,21,22,1,5,32,81,38.279145634193675,-109.358073
5558,0,23,21,1,6,31,82,38.279145634193675,-109.3578035
5559,0,23,21,1,6,32,83,38.279145634193675,-109.357534
5560,0,23,21,1,5,32,82,38.279145634193675,-109.3572645
5561,0,23,20,2,7,29,81,38.279145634193675,-109.356995
5562,0,23,21,3,8,27,82,38.279145634193675,-109.3567255
5563,0,24,20,2,8,29,83,38.279145634193675,-109.356456
5564,0,24,21,1,6,30,82,38.279145634193675,-109.3561865
5565,0,22,21,2,6,31,82,38.279145634193675,-109.355917
5566,0,21,22,1,6,33,83,38.279145634193675,-109.3556475
5567,0,21,22,0,5,35,83,38.279145634193675,-109.355378
5568,0,23,22,0,5,35,85,38.279145634193675,-109.3551086
5569,0,24,22,0,6,33,85,38.279145634193675,-109.3548391
5570,0,24,21,0,7,30,82,38.279145634193675,-109.3545696
5571,3,23,21,3,8,27,85,38.279145634193675,-109.3543001
5572,3,22,21,3,7,28,84,38.279145634193675,-109.3540306
5573,4,24,20,6,9,23,86,38.279145634193675,-109.3537611
5574,4,24,17,17,11,14,87,38.279145634193675,-109.3534916
5575,12,25,13,24,10,6,90,38.279145634193675,-109.3532221
5576,17,22,12,30,7,3,91,38.279145634193675,-109.3529526
5577,13,23,13,28,9,6,92,38.279145634193675,-109.3526831
5578,5,24,17,19,13,10,88,38.279145634193675,-109.3524136
5579,5,24,18,9,14,15,85,38.279145634193675,-109.3521441
5580,6,23,18,9,11,15,82,38.279145634193675,-109.3518746
5581,6,20,21,9,9,18,83,38.279145634193675,-109.3516051
5582,3,21,22,7,8,22,83,38.279145634193675,-109.3513356
5583,3,21,22,7,7,24,84,38.279145634193675,-109.3510661
5584,6,18,22,8,5,23,82,38.279145634193675,-109.3507966
5585,2,21,21,3,6,29,82,38.279145634193675,-109.3505271
5586,3,21,18,5,6,23,76,38.279145634193675,-109.3502577
5587,5,28,17,7,9,16,82,38.279145634193675,-109.3499882
5588,7,32,16,14,10,9,88,38.279145634193675,-109.3497187
5589,9,31,15,17,9,6,87,38.279145634193675,-109.3494492
5590,8,32,14,17,9,5,85,38.279145634193675,-109.3491797
5591,9,32,13,18,9,4,85,38.279145634193675,-109.3489102
5592,13,31,12,17,9,3,85,38.279145634193675,-109.3486407
5593,13,32,12,17,9,4,87,38.279145634193675,-109.3483712
5594,11,34,13,15,9,5,87,38.279145634193675,-109.3481017
5595,8,35,13,15,10,5,86,38.279145634193675,-109.3478322
5596,8,35,13,14,10,6,86,38.279145634193675,-109.3475627
5597,8,36,13,15,8,5,85,38.279145634193675,-109.3472932
5598,8,36,14,16,8,4,86,38.279145634193675,-109.3470237
5599,8,38,14,14,9,5,88,38.279145634193675,-109.3467542
5600,8,37,14,14,9,4,86,38.279145634193675,-109.3464847
5601,2,43,11,0,12,13,81,38.27887613960844,-109.4302975
5602,2,49,11,3,13,8,86,38.27887613960844,-109.430028
5603,2,50,11,2,14,7,86,38.27887613960844,-109.4297586
5604,3,49,11,3,15,5,86,38.27887613960844,-109.4294891
5605,3,49,11,3,14,5,85,38.27887613960844,-109.4292196
5606,3,50,11,3,14,5,86,38.27887613960844,-109.4289501
5607,2,51,11,2,15,5,86,38.27887613960844,-109.4286806
5608,2,48,11,1,15,6,83,38.27887613960844,-109.4284111
5609,2,48,11,2,15,6,84,38.27887613960844,-109.4281416
5610,2,48,11,2,15,7,85,38.27887613960844,-109.4278721
5611,2,48,11,2,13,9,85,38.27887613960844,-109.4276026
5612,2,47,10,1,12,11,83,38.27887613960844,-109.4273331
5613,2,50,10,1,14,9,86,38.27887613960844,-109.4270636
5614,3,51,12,3,16,5,90,38.27887613960844,-109.4267941
5615,3,51,12,5,17,3,91,38.27887613960844,-109.4265246
5616,3,49,12,4,16,6,90,38.27887613960844,-109.4262551
5617,2,50,10,2,14,9,87,38.27887613960844,-109.4259856
5618,2,49,11,2,14,9,87,38.27887613960844,-109.4257161
5619,2,48,11,2,14,8,85,38.27887613960844,-109.4254466
5620,1,46,10,1,14,9,81,38.27887613960844,-109.4251771
5621,1,49,9,0,13,10,82,38.27887613960844,-109.4249077
5622,1,50,10,1,14,9,85,38.27887613960844,-109.4246382
5623,1,53,9,1,14,7,85,38.27887613960844,-109.4243687
5624,1,52,9,2,13,6,83,38.27887613960844,-109.4240992
5625,1,51,9,2,13,6,82,38.27887613960844,-109.4238297
5626,1,47,10,1,14,7,80,38.27887613960844,-109.4235602
5627,1,41,10,0,11,11,74,38.27887613960844,-109.4232907
5628,1,36,10,0,10,14,71,38.27887613960844,-109.4230212
5629,1,37,11,0,13,12,74,38.27887613960844,-109.4227517
5630,2,43,12,3,17,7,84,38.27887613960844,-109.4224822
5631,2,43,12,2,16,8,83,38.27887613960844,-109.4222127
5632,2,41,13,0,17,9,82,38.27887613960844,-109.4219432
5633,1,41,12,0,15,12,81,38.27887613960844,-109.4216737
5634,1,38,12,0,12,16,79,38.27887613960844,-109.4214042
5635,0,32,12,0,7,21,72,38.27887613960844,-109.4211347
5636,1,29,12,2,10,17,71,38.27887613960844,-109.4208652
5637,1,28,11,7,11,12,70,38.27887613960844,-109.4205957
5638,1,27,10,6,10,10,64,38.27887613960844,-109.4203262
5639,2,27,9,4,9,10,61,38.27887613960844,-109.4200568
5640,1,32,10,5,9,8,65,38.27887613960844,-109.4197873
5641,2,32,10,3,9,8,64,38.27887613960844,-109.4195178
5642,1,32,10,2,10,10,65,38.27887613960844,-109.4192483
5643,0,34,10,0,10,13,67,38.27887613960844,-109.4189788
5644,0,34,10,0,10,15,69,38.27887613960844,-109.4187093
5645,0,29,11,0,8,17,65,38.27887613960844,-109.4184398
5646,0,30,11,0,9,18,68,38.27887613960844,-109.4181703
5647,1,33,13,0,13,16,76,38.27887613960844,-109.4179008
5648,0,33,14,0,11,20,78,38.27887613960844,-109.4176313
5649,0,28,14,0,9,22,73,38.27887613960844,-109.4173618
5650,1,33,13,0,9,20,76,38.27887613960844,-109.4170923
5651,0,29,13,0,8,21,71,38.27887613960844,-109.4168228
5652,0,30,14,0,12,18,74,38.27887613960844,-109.4165533
5653,1,31,14,0,11,18,75,38.27887613960844,-109.4162838
5654,0,30,13,0,7,22,72,38.27887613960844,-109.4160143
5655,1,30,13,0,7,22,73,38.27887613960844,-109.4157448
5656,0,31,13,0,7,23,74,38.27887613960844,-109.4154753
5657,0,31,13,0,6,24,74,38.27887613960844,-109.4152058
5658,2,28,16,1,5,27,79,38.27887613960844,-109.4149364
5659,1,29,16,0,4,29,79,38.27887613960844,-109.4146669
5660,0,29,14,0,6,25,74,38.27887613960844,-109.4143974
5661,1,29,12,0,8,20,70,38.27887613960844,-109.4141279
5662,1,33,12,1,12,12,71,38.27887613960844,-109.4138584
5663,1,31,11,0,9,15,67,38.27887613960844,-109.4135889
5664,0,29,9,0,6,15,59,38.27887613960844,-109.4133194
5665,0,34,9,0,9,14,66,38.27887613960844,-109.4130499
5666,0,39,9,0,12,12,72,38.27887613960844,-109.4127804
5667,1,37,8,0,12,10,68,38.27887613960844,-109.4125109
5668,1,28,11,0,7,16,63,38.27887613960844,-109.4122414
5669,1,26,11,0,5,20,63,38.27887613960844,-109.4119719
5670,1,25,11,0,3,21,61,38.27887613960844,-109.4117024
5671,2,23,11,0,3,21,60,38.27887613960844,-109.4114329
5672,2,24,11,1,4,19,61,38.27887613960844,-109.4111634
5673,4,34,12,3,12,10,75,38.27887613960844,-109.4108939
5674,5,38,13,4,15,7,82,38.27887613960844,-109.4106244
5675,5,44,13,5,17,4,88,38.27887613960844,-109.4103549
5676,6,46,13,6,17,2,90,38.27887613960844,-109.4100855
5677,7,45,13,6,18,2,91,38.27887613960844,-109.409816
5678,6,47,13,4,18,3,91,38.27887613960844,-109.4095465
5679,6,47,13,4,18,3,91,38.27887613960844,-109.409277
5680,5,45,12,4,17,3,86,38.27887613960844,-109.4090075
5681,5,41,12,4,17,5,84,38.27887613960844,-109.408738
5682,3,42,12,3,17,5,82,38.27887613960844,-109.4084685
5683,4,46,12,3,17,4,86,38.27887613960844,-109.408199
5684,4,46,12,4,17,4,87,38.27887613960844,-109.4079295
5685,4,44,13,5,17,3,86,38.27887613960844,-109.40766
5686,4,46,13,6,18,2,89,38.27887613960844,-109.4073905
5687,5,43,13,6,18,2,87,38.27887613960844,-109.407121
5688,5,43,13,5,18,3,87,38.27887613960844,-109.4068515
5689,1,21,16,0,2,30,70,38.27887613960844,-109.3879869
5690,2,20,16,0,2,27,67,38.27887613960844,-109.3877174
5691,2,21,14,0,3,24,64,38.27887613960844,-109.3874479
5692,3,23,15,1,4,21,67,38.27887613960844,-109.3871784
5693,3,24,14,0,4,21,66,38.27887613960844,-109.3869089
5694,2,22,13,0,4,19,60,38.27887613960844,-109.3866394
5695,2,22,12,0,4,19,59,38.27887613960844,-109.3863699
5696,1,24,13,0,3,20,61,38.27887613960844,-109.3861004
5697,0,22,12,0,3,21,58,38.27887613960844,-109.3858309
5698,0,22,12,0,4,20,58,38.27887613960844,-109.3855614
5699,1,23,11,0,4,19,58,38.27887613960844,-109.3852919
5700,1,23,11,0,5,18,58,38.27887613960844,-109.3850225
5701,1,22,11,0,4,19,57,38.27887613960844,-109.384753
5702,2,22,12,0,4,19,59,38.27887613960844,-109.3844835
5703,2,21,12,0,4,18,57,38.27887613960844,-109.384214
5704,2,19,13,1,3,20,58,38.27887613960844,-109.3839445
5705,2,17,14,0,2,24,59,38.27887613960844,-109.383675
5706,1,16,16,0,1,29,63,38.27887613960844,-109.3834055
5707,1,21,15,0,2,27,66,38.27887613960844,-109.383136
5708,1,23,14,0,3,24,65,38.27887613960844,-109.3828665
5709,1,24,14,0,3,24,66,38.27887613960844,-109.382597
5710,2,26,15,0,5,25,73,38.27887613960844,-109.3823275
5711,0,26,15,0,5,27,73,38.27887613960844,-109.382058
5712,0,24,15,0,4,26,69,38.27887613960844,-109.3817885
5713,1,22,15,0,4,27,69,38.27887613960844,-109.381519
5714,1,21,16,0,3,28,69,38.27887613960844,-109.3812495
5715,0,23,17,0,3,29,72,38.27887613960844,-109.38098
5716,0,22,16,0,3,28,69,38.27887613960844,-109.3807105
5717,1,22,16,0,3,28,70,38.27887613960844,-109.380441
5718,2,22,16,0,2,28,70,38.27887613960844,-109.3801716
5719,1,21,16,0,1,29,68,38.27887613960844,-109.3799021
5720,1,23,14,0,3,22,63,38.27887613960844,-109.3796326
5721,1,26,12,1,5,15,60,38.27887613960844,-109.3793631
5722,2,27,12,4,7,11,63,38.27887613960844,-109.3790936
5723,2,27,14,5,8,11,67,38.27887613960844,-109.3788241
5724,1,29,13,3,7,14,67,38.27887613960844,-109.3785546
5725,0,28,14,3,7,20,72,38.27887613960844,-109.3782851
5726,1,27,15,8,10,19,80,38.27887613960844,-109.3780156
5727,2,26,15,8,15,17,83,38.27887613960844,-109.3777461
5728,1,27,15,7,16,17,83,38.27887613960844,-109.3774766
5729,0,29,16,3,11,20,79,38.27887613960844,-109.3772071
5730,1,28,16,1,11,23,80,38.27887613960844,-109.3769376
5731,1,27,16,0,8,24,76,38.27887613960844,-109.3766681
5732,1,26,15,0,6,24,72,38.27887613960844,-109.3763986
5733,1,22,15,0,4,24,66,38.27887613960844,-109.3761291
5734,1,24,13,1,4,20,63,38.27887613960844,-109.3758596
5735,1,19,14,0,3,24,61,38.27887613960844,-109.3755901
5736,0,20,16,0,3,28,67,38.27887613960844,-109.3753206
5737,1,21,16,0,3,29,70,38.27887613960844,-109.3750512
5738,2,24,17,1,6,25,75,38.27887613960844,-109.3747817
5739,1,22,13,3,4,22,65,38.27887613960844,-109.3745122
5740,2,31,12,5,10,12,72,38.27887613960844,-109.3742427
5741,1,36,11,2,11,10,71,38.27887613960844,-109.3739732
5742,1,38,9,1,9,10,68,38.27887613960844,-109.3737037
5743,2,40,11,3,12,7,75,38.27887613960844,-109.3734342
5744,2,21,16,2,6,23,70,38.27887613960844,-109.3731647
5745,1,18,19,2,7,31,78,38.27887613960844,-109.3728952
5746,6,17,16,11,9,19,78,38.27887613960844,-109.3726257
5747,11,17,13,14,10,9,74,38.27887613960844,-109.3723562
5748,5,13,11,11,10,9,59,38.27887613960844,-109.3720867
5749,8,20,10,12,11,2,63,38.27887613960844,-109.3718172
5750,3,32,9,5,12,5,66,38.27887613960844,-109.3715477
5751,1,37,9,1,11,10,69,38.27887613960844,-109.3712782
5752,2,31,10,1,7,14,65,38.27887613960844,-109.3710087
5753,2,21,12,4,6,17,62,38.27887613960844,-109.3707392
5754,4,29,13,3,10,13,72,38.27887613960844,-109.3704697
5755,3,31,12,3,11,11,71,38.27887613960844,-109.3702003
5756,2,28,12,4,9,12,67,38.27887613960844,-109.3699308
5757,3,24,13,7,11,13,71,38.27887613960844,-109.3696613
5758,1,25,13,2,12,19,72,38.27887613960844,-109.3693918
5759,2,27,13,3,10,16,71,38.27887613960844,-109.3691223
5760,0,27,10,0,12,13,62,38.27887613960844,-109.3688528
5761,2,36,13,3,8,13,75,38.27887613960844,-109.3685833
5762,3,29,14,11,8,17,82,38.27887613960844,-109.3683138
5763,7,28,13,19,11,7,85,38.27887613960844,-109.3680443
5764,0,22,15,16,19,13,85,38.27887613960844,-109.3677748
5765,1,20,14,15,15,14,79,38.27887613960844,-109.3675053
5766,5,19,12,17,14,10,77,38.27887613960844,-109.3672358
5767,2,20,14,11,10,21,78,38.27887613960844,-109.3669663
5768,2,25,14,5,14,18,78,38.27887613960844,-109.3666968
5769,2,24,13,5,11,19,74,38.27887613960844,-109.3664273
5770,3,24,11,8,15,11,72,38.27887613960844,-109.3661578
5771,2,22,10,13,16,6,69,38.27887613960844,-109.3658883
5772,2,25,15,8,9,20,79,38.27887613960844,-109.3656188
5773,1,23,18,4,6,30,82,38.27887613960844,-109.3653493
5774,0,20,19,2,4,35,80,38.27887613960844,-109.3650799
5775,1,21,19,2,5,35,83,38.27887613960844,-109.3648104
5776,0,21,20,1,4,36,82,38.27887613960844,-109.3645409
5777,1,21,20,0,3,35,80,38.27887613960844,-109.3642714
5778,0,23,19,0,4,33,79,38.27887613960844,-109.3640019
5779,0,24,18,0,5,32,79,38.27887613960844,-109.3637324
5780,0,22,18,0,4,34,78,38.27887613960844,-109.3634629
5781,0,19,18,0,3,33,73,38.27887613960844,-109.3631934
5782,0,18,18,0,3,33,72,38.27887613960844,-109.3629239
5783,0,19,18,0,3,32,72,38.27887613960844,-109.3626544
5784,0,19,17,0,3,30,69,38.27887613960844,-109.3623849
5785,1,19,17,0,3,30,70,38.27887613960844,-109.3621154
5786,0,18,18,0,3,32,71,38.27887613960844,-109.3618459
5787,0,18,19,0,3,34,74,38.27887613960844,-109.3615764
5788,0,20,19,0,3,34,76,38.27887613960844,-109.3613069
5789,0,23,19,0,4,33,79,38.27887613960844,-109.3610374
5790,0,24,19,0,5,32,80,38.27887613960844,-109.3607679
5791,0,24,21,0,6,33,84,38.27887613960844,-109.3604984
5792,0,22,22,0,6,34,84,38.27887613960844,-109.360229
5793,0,23,22,0,5,34,84,38.27887613960844,-109.3599595
5794,0,24,22,0,6,32,84,38.27887613960844,-109.35969
5795,0,26,20,1,7,29,83,38.27887613960844,-109.3594205
5796,0,26,20,1,6,30,83,38.27887613960844,-109.359151
5797,0,25,20,0,6,31,82,38.27887613960844,-109.3588815
5798,0,24,20,1,6,31,82,38.27887613960844,-109.358612
5799,0,23,21,1,6,32,83,38.27887613960844,-109.3583425
5800,0,22,21,1,6,32,82,38.27887613960844,-109.358073
5801,0,21,21,2,6,31,81,38.27887613960844,-109.3578035
5802,1,22,20,2,5,31,81,38.27887613960844,-109.357534
5803,1,23,19,3,5,30,81,38.27887613960844,-109.3572645
5804,1,22,19,3,6,28,79,38.27887613960844,-109.356995
5805,1,21,20,4,8,27,81,38.27887613960844,-109.3567255
5806,1,21,21,3,7,28,81,38.27887613960844,-109.356456
5807,1,22,21,2,6,30,82,38.27887613960844,-109.3561865
5808,2,22,20,2,7,30,83,38.27887613960844,-109.355917
5809,1,24,20,2,6,29,82,38.27887613960844,-109.3556475
5810,1,22,20,2,5,32,82,38.27887613960844,-109.355378
5811,0,21,20,0,4,33,78,38.27887613960844,-109.3551086
5812,0,23,20,0,5,32,80,38.27887613960844,-109.3548391
5813,0,24,20,1,7,29,81,38.27887613960844,-109.3545696
5814,1,24,20,1,7,29,82,38.27887613960844,-109.3543001
5815,1,21,21,2,7,31,83,38.27887613960844,-109.3540306
5816,2,23,19,5,10,26,85,38.27887613960844,-109.3537611
5817,4,25,16,15,12,16,88,38.27887613960844,-109.3534916
5818,9,23,15,23,11,10,91,38.27887613960844,-109.3532221
5819,8,21,15,22,10,13,89,38.27887613960844,-109.3529526
5820,5,20,18,15,10,18,86,38.27887613960844,-109.3526831
5821,3,18,21,9,10,23,84,38.27887613960844,-109.3524136
5822,2,16,23,5,9,30,85,38.27887613960844,-109.3521441
5823,2,18,22,4,9,28,83,38.27887613960844,-109.3518746
5824,3,19,22,3,5,30,82,38.27887613960844,-109.3516051
5825,2,21,22,2,4,30,81,38.27887613960844,-109.3513356
5826,2,21,21,1,5,29,79,38.27887613960844,-109.3510661
5827,2,20,19,1,3,28,73,38.27887613960844,-109.3507966
5828,2,15,17,1,3,23,61,38.27887613960844,-109.3505271
5829,4,18,16,6,5,17,66,38.27887613960844,-109.3502577
5830,6,23,17,12,7,11,76,38.27887613960844,-109.3499882
5831,6,29,17,13,11,11,87,38.27887613960844,-109.3497187
5832,6,30,15,14,13,7,85,38.27887613960844,-109.3494492
5833,7,32,14,16,10,5,84,38.27887613960844,-109.3491797
5834,8,33,13,16,10,5,85,38.27887613960844,-109.3489102
5835,9,34,13,15,11,4,86,38.27887613960844,-109.3486407
5836,9,34,13,18,10,4,88,38.27887613960844,-109.3483712
5837,9,35,13,16,9,5,87,38.27887613960844,-109.3481017
5838,9,33,13,17,9,4,85,38.27887613960844,-109.3478322
5839,10,34,13,16,8,4,85,38.27887613960844,-109.3475627
5840,10,34,13,16,8,4,85,38.27887613960844,-109.3472932
5841,9,35,14,16,8,5,87,38.27887613960844,-109.3470237
5842,8,37,14,14,8,5,86,38.27887613960844,-109.3467542
5843,9,36,14,14,9,5,87,38.27887613960844,-109.3464847
5844,10,34,14,15,9,4,86,38.27887613960844,-109.3462152
5845,2,42,12,1,13,11,81,38.27860665,-109.430567
5846,1,47,11,1,13,12,85,38.27860665,-109.4302975
5847,2,50,11,4,14,7,88,38.27860665,-109.430028
5848,3,49,11,4,14,7,88,38.27860665,-109.4297586
5849,2,49,11,3,14,6,85,38.27860665,-109.4294891
5850,2,50,11,4,14,5,86,38.27860665,-109.4292196
5851,2,51,11,4,14,4,86,38.27860665,-109.4289501
5852,3,51,11,4,14,4,87,38.27860665,-109.4286806
5853,2,49,11,3,15,5,85,38.27860665,-109.4284111
5854,2,48,11,3,15,5,84,38.27860665,-109.4281416
5855,3,49,11,3,16,5,87,38.27860665,-109.4278721
5856,3,47,11,2,15,8,86,38.27860665,-109.4276026
5857,1,43,11,0,12,13,80,38.27860665,-109.4273331
5858,2,47,11,1,14,10,85,38.27860665,-109.4270636
5859,3,51,12,4,16,4,90,38.27860665,-109.4267941
5860,3,52,12,4,16,3,90,38.27860665,-109.4265246
5861,2,50,11,3,15,7,88,38.27860665,-109.4262551
5862,2,48,11,1,14,10,86,38.27860665,-109.4259856
5863,2,47,11,1,14,10,85,38.27860665,-109.4257161
5864,1,46,11,0,14,9,81,38.27860665,-109.4254466
5865,1,46,10,0,12,11,80,38.27860665,-109.4251771
5866,1,41,10,1,11,10,74,38.27860665,-109.4249077
5867,1,45,8,1,11,7,73,38.27860665,-109.4246382
5868,0,49,8,0,12,6,75,38.27860665,-109.4243687
5869,0,52,8,1,12,5,78,38.27860665,-109.4240992
5870,1,46,9,2,12,8,78,38.27860665,-109.4238297
5871,1,43,11,2,15,8,80,38.27860665,-109.4235602
5872,2,39,11,0,12,12,76,38.27860665,-109.4232907
5873,1,40,11,0,13,12,77,38.27860665,-109.4230212
5874,2,46,12,2,17,7,86,38.27860665,-109.4227517
5875,3,46,12,3,16,6,86,38.27860665,-109.4224822
5876,3,43,12,3,17,6,84,38.27860665,-109.4222127
5877,3,42,13,4,18,6,86,38.27860665,-109.4219432
5878,2,42,13,2,18,8,85,38.27860665,-109.4216737
5879,2,41,12,0,15,12,82,38.27860665,-109.4214042
5880,1,35,12,0,11,17,76,38.27860665,-109.4211347
5881,1,28,12,0,7,19,67,38.27860665,-109.4208652
5882,1,26,12,0,6,18,63,38.27860665,-109.4205957
5883,0,29,11,0,8,15,63,38.27860665,-109.4203262
5884,0,31,10,5,10,11,67,38.27860665,-109.4200568
5885,1,28,11,6,12,10,68,38.27860665,-109.4197873
5886,1,29,11,4,11,11,67,38.27860665,-109.4195178
5887,1,28,12,3,11,14,69,38.27860665,-109.4192483
5888,1,28,11,1,8,16,65,38.27860665,-109.4189788
5889,0,33,11,0,8,16,68,38.27860665,-109.4187093
5890,0,36,9,0,8,16,69,38.27860665,-109.4184398
5891,0,33,10,0,7,17,67,38.27860665,-109.4181703
5892,1,33,10,0,9,17,70,38.27860665,-109.4179008
5893,0,31,11,0,9,19,70,38.27860665,-109.4176313
5894,0,31,11,0,11,17,70,38.27860665,-109.4173618
5895,0,30,11,0,10,18,69,38.27860665,-109.4170923
5896,1,29,12,0,10,18,70,38.27860665,-109.4168228
5897,0,29,13,0,11,19,72,38.27860665,-109.4165533
5898,1,28,14,0,10,22,75,38.27860665,-109.4162838
5899,0,27,14,0,7,25,73,38.27860665,-109.4160143
5900,1,27,13,0,6,24,71,38.27860665,-109.4157448
5901,1,28,13,0,7,23,72,38.27860665,-109.4154753
5902,1,31,13,0,8,22,75,38.27860665,-109.4152058
5903,1,29,14,1,7,24,76,38.27860665,-109.4149364
5904,1,26,15,2,6,27,77,38.27860665,-109.4146669
5905,2,26,15,3,6,25,77,38.27860665,-109.4143974
5906,2,27,14,2,6,22,73,38.27860665,-109.4141279
5907,1,31,13,1,8,19,73,38.27860665,-109.4138584
5908,2,32,11,0,7,18,70,38.27860665,-109.4135889
5909,0,34,9,0,8,14,65,38.27860665,-109.4133194
5910,0,42,8,0,11,10,71,38.27860665,-109.4130499
5911,0,43,8,0,12,10,73,38.27860665,-109.4127804
5912,1,35,8,0,10,11,65,38.27860665,-109.4125109
5913,0,26,11,0,5,19,61,38.27860665,-109.4122414
5914,1,23,12,0,2,23,61,38.27860665,-109.4119719
5915,1,22,13,0,1,25,62,38.27860665,-109.4117024
5916,2,21,13,0,1,25,62,38.27860665,-109.4114329
5917,3,22,12,4,5,18,64,38.27860665,-109.4111634
5918,6,27,12,6,9,10,70,38.27860665,-109.4108939
5919,8,31,12,8,12,6,77,38.27860665,-109.4106244
5920,10,36,13,9,14,3,85,38.27860665,-109.4103549
5921,8,39,14,10,15,2,88,38.27860665,-109.4100855
5922,6,41,13,7,16,3,86,38.27860665,-109.409816
5923,6,45,12,5,17,3,88,38.27860665,-109.4095465
5924,5,45,12,4,17,3,86,38.27860665,-109.409277
5925,4,43,12,4,17,4,84,38.27860665,-109.4090075
5926,4,39,12,5,16,5,81,38.27860665,-109.408738
5927,4,39,13,7,16,3,82,38.27860665,-109.4084685
5928,4,44,13,6,17,3,87,38.27860665,-109.408199
5929,4,45,13,4,17,4,87,38.27860665,-109.4079295
5930,4,43,12,5,16,4,84,38.27860665,-109.40766
5931,5,44,13,6,17,3,88,38.27860665,-109.4073905
5932,6,42,13,7,17,2,87,38.27860665,-109.407121
5933,5,45,12,5,17,3,87,38.27860665,-109.4068515
5934,2,20,14,0,2,24,62,38.27860665,-109.3879869
5935,2,21,12,0,3,20,58,38.27860665,-109.3877174
5936,2,25,11,0,4,17,59,38.27860665,-109.3874479
5937,3,24,11,0,5,15,58,38.27860665,-109.3871784
5938,3,21,12,0,5,16,57,38.27860665,-109.3869089
5939,3,22,11,0,5,15,56,38.27860665,-109.3866394
5940,2,23,11,1,5,16,58,38.27860665,-109.3863699
5941,2,23,12,0,4,18,59,38.27860665,-109.3861004
5942,1,21,12,0,3,19,56,38.27860665,-109.3858309
5943,1,22,12,0,4,19,58,38.27860665,-109.3855614
5944,0,22,12,0,4,20,58,38.27860665,-109.3852919
5945,0,21,11,0,4,19,55,38.27860665,-109.3850225
5946,0,21,11,0,4,18,54,38.27860665,-109.384753
5947,1,23,11,0,5,17,57,38.27860665,-109.3844835
5948,1,24,11,0,5,17,58,38.27860665,-109.384214
5949,2,23,11,0,4,18,58,38.27860665,-109.3839445
5950,2,21,12,0,3,18,56,38.27860665,-109.383675
5951,1,18,13,0,3,21,56,38.27860665,-109.3834055
5952,1,20,13,0,3,20,57,38.27860665,-109.383136
5953,1,22,13,0,3,21,60,38.27860665,-109.3828665
5954,0,21,13,0,3,23,60,38.27860665,-109.382597
5955,1,22,16,0,4,28,71,38.27860665,-109.3823275
5956,0,23,16,0,4,29,72,38.27860665,-109.382058
5957,1,24,16,0,3,28,72,38.27860665,-109.3817885
5958,1,24,17,0,3,29,74,38.27860665,-109.381519
5959,1,24,16,0,3,29,73,38.27860665,-109.3812495
5960,1,24,17,0,4,29,75,38.27860665,-109.38098
5961,1,24,16,0,3,27,71,38.27860665,-109.3807105
5962,1,23,15,0,3,26,68,38.27860665,-109.380441
5963,1,23,15,0,3,27,69,38.27860665,-109.3801716
5964,1,22,16,0,2,27,68,38.27860665,-109.3799021
5965,1,22,16,0,2,27,68,38.27860665,-109.3796326
5966,1,26,14,0,4,22,67,38.27860665,-109.3793631
5967,1,27,12,0,6,16,62,38.27860665,-109.3790936
5968,2,28,12,4,8,11,65,38.27860665,-109.3788241
5969,3,30,12,5,9,8,67,38.27860665,-109.3785546
5970,1,26,13,3,5,18,66,38.27860665,-109.3782851
5971,1,27,15,8,11,15,77,38.27860665,-109.3780156
5972,2,26,15,9,13,13,78,38.27860665,-109.3777461
5973,2,28,14,9,14,11,78,38.27860665,-109.3774766
5974,3,29,14,9,14,12,81,38.27860665,-109.3772071
5975,1,30,15,3,11,18,78,38.27860665,-109.3769376
5976,1,28,16,1,9,22,77,38.27860665,-109.3766681
5977,1,27,17,1,8,25,79,38.27860665,-109.3763986
5978,1,25,17,0,7,27,77,38.27860665,-109.3761291
5979,0,26,15,0,7,25,73,38.27860665,-109.3758596
5980,0,27,15,0,6,25,73,38.27860665,-109.3755901
5981,0,24,15,0,5,27,71,38.27860665,-109.3753206
5982,0,22,15,0,5,28,70,38.27860665,-109.3750512
5983,4,26,16,4,10,18,78,38.27860665,-109.3747817
5984,4,25,13,7,8,15,72,38.27860665,-109.3745122
5985,3,30,12,5,12,13,75,38.27860665,-109.3742427
5986,1,32,11,2,13,13,72,38.27860665,-109.3739732
5987,0,36,11,0,12,12,71,38.27860665,-109.3737037
5988,1,45,10,0,13,6,75,38.27860665,-109.3734342
5989,1,39,11,0,13,11,75,38.27860665,-109.3731647
5990,0,31,13,0,9,18,71,38.27860665,-109.3728952
5991,1,27,15,0,8,21,72,38.27860665,-109.3726257
5992,3,20,15,9,8,20,75,38.27860665,-109.3723562
5993,3,13,12,12,8,17,65,38.27860665,-109.3720867
5994,8,19,10,11,12,3,63,38.27860665,-109.3718172
5995,2,35,9,7,11,4,68,38.27860665,-109.3715477
5996,2,37,9,3,12,7,70,38.27860665,-109.3712782
5997,1,27,10,2,7,14,61,38.27860665,-109.3710087
5998,1,25,12,0,6,18,62,38.27860665,-109.3707392
5999,3,27,12,1,8,15,66,38.27860665,-109.3704697
6000,4,28,12,3,10,12,69,38.27860665,-109.3702003
6001,4,26,12,4,10,13,69,38.27860665,-109.3699308
6002,3,26,14,2,10,18,73,38.27860665,-109.3696613
6003,3,26,13,2,9,16,69,38.27860665,-109.3693918
6004,2,32,11,6,8,11,70,38.27860665,-109.3691223
6005,1,37,8,2,9,8,65,38.27860665,-109.3688528
6006,4,33,12,7,9,7,72,38.27860665,-109.3685833
6007,2,31,14,0,10,17,74,38.27860665,-109.3683138
6008,2,29,13,13,19,7,83,38.27860665,-109.3680443
6009,3,28,12,13,20,6,82,38.27860665,-109.3677748
6010,2,28,13,9,18,9,79,38.27860665,-109.3675053
6011,2,30,13,6,15,13,79,38.27860665,-109.3672358
6012,1,30,14,4,14,15,78,38.27860665,-109.3669663
6013,1,27,14,5,9,20,76,38.27860665,-109.3666968
6014,2,27,13,5,13,16,76,38.27860665,-109.3664273
6015,0,27,13,8,11,17,76,38.27860665,-109.3661578
6016,4,24,14,8,14,9,73,38.27860665,-109.3658883
6017,0,25,19,2,8,25,79,38.27860665,-109.3656188
6018,0,22,20,1,5,33,81,38.27860665,-109.3653493
6019,0,21,20,0,4,36,81,38.27860665,-109.3650799
6020,1,21,19,0,3,35,79,38.27860665,-109.3648104
6021,1,19,19,0,2,35,76,38.27860665,-109.3645409
6022,1,18,17,0,1,33,70,38.27860665,-109.3642714
6023,1,18,16,0,2,29,66,38.27860665,-109.3640019
6024,1,18,15,0,3,27,64,38.27860665,-109.3637324
6025,1,20,15,1,5,24,66,38.27860665,-109.3634629
6026,1,17,16,0,3,27,64,38.27860665,-109.3631934
6027,1,15,16,0,3,29,64,38.27860665,-109.3629239
6028,1,16,17,0,3,32,69,38.27860665,-109.3626544
6029,1,18,17,0,3,32,71,38.27860665,-109.3623849
6030,1,20,17,0,3,31,72,38.27860665,-109.3621154
6031,1,20,17,0,3,30,71,38.27860665,-109.3618459
6032,1,21,18,0,4,31,75,38.27860665,-109.3615764
6033,0,23,18,0,5,31,77,38.27860665,-109.3613069
6034,0,23,18,0,5,32,78,38.27860665,-109.3610374
6035,0,22,19,0,4,34,79,38.27860665,-109.3607679
6036,0,22,19,0,4,35,80,38.27860665,-109.3604984
6037,0,22,19,0,3,35,79,38.27860665,-109.360229
6038,0,22,19,0,3,35,79,38.27860665,-109.3599595
6039,0,25,20,0,4,34,83,38.27860665,-109.35969
6040,0,26,21,0,6,32,85,38.27860665,-109.3594205
6041,0,24,20,0,6,33,83,38.27860665,-109.359151
6042,0,24,20,0,6,32,82,38.27860665,-109.3588815
6043,0,25,19,0,6,30,80,38.27860665,-109.358612
6044,0,25,18,0,6,29,78,38.27860665,-109.3583425
6045,0,25,20,1,6,31,83,38.27860665,-109.358073
6046,0,24,21,0,6,32,83,38.27860665,-109.3578035
6047,0,24,21,0,6,32,83,38.27860665,-109.357534
6048,0,25,20,0,6,31,82,38.27860665,-109.3572645
6049,1,25,19,1,6,29,81,38.27860665,-109.356995
6050,0,24,20,2,7,29,82,38.27860665,-109.3567255
6051,0,23,21,1,7,31,83,38.27860665,-109.356456
6052,0,24,21,0,6,32,83,38.27860665,-109.3561865
6053,1,25,19,1,6,30,82,38.27860665,-109.355917
6054,1,24,20,1,6,29,81,38.27860665,-109.3556475
6055,1,20,18,0,3,29,71,38.27860665,-109.355378
6056,0,21,17,0,2,29,69,38.27860665,-109.3551086
6057,1,22,17,0,4,28,72,38.27860665,-109.3548391
6058,0,24,18,1,6,27,76,38.27860665,-109.3545696
6059,1,23,21,2,7,29,83,38.27860665,-109.3543001
6060,2,20,21,3,8,29,83,38.27860665,-109.3540306
6061,2,20,20,5,9,28,84,38.27860665,-109.3537611
6062,2,20,21,6,9,26,84,38.27860665,-109.3534916
6063,1,17,21,5,10,29,83,38.27860665,-109.3532221
6064,1,16,22,5,9,32,85,38.27860665,-109.3529526
6065,1,14,22,4,8,36,85,38.27860665,-109.3526831
6066,1,14,22,4,7,35,83,38.27860665,-109.3524136
6067,2,16,24,3,7,31,83,38.27860665,-109.3521441
6068,0,15,24,0,5,36,80,38.27860665,-109.3518746
6069,0,17,23,0,5,37,82,38.27860665,-109.3516051
6070,1,23,20,0,5,31,80,38.27860665,-109.3513356
6071,3,24,18,3,4,23,75,38.27860665,-109.3510661
6072,1,19,17,0,2,25,64,38.27860665,-109.3507966
6073,3,19,15,3,4,17,61,38.27860665,-109.3505271
6074,3,19,17,5,4,18,66,38.27860665,-109.3502577
6075,4,26,19,9,8,17,83,38.27860665,-109.3499882
6076,4,28,16,14,12,10,84,38.27860665,-109.3497187
6077,6,31,14,15,13,5,84,38.27860665,-109.3494492
6078,8,33,13,15,10,4,83,38.27860665,-109.3491797
6079,7,35,13,14,11,5,85,38.27860665,-109.3489102
6080,7,36,14,13,12,5,87,38.27860665,-109.3486407
6081,8,35,14,14,10,6,87,38.27860665,-109.3483712
6082,7,36,14,14,12,5,88,38.27860665,-109.3481017
6083,8,35,14,16,10,5,88,38.27860665,-109.3478322
6084,9,34,13,17,9,5,87,38.27860665,-109.3475627
6085,10,34,14,15,8,5,86,38.27860665,-109.3472932
6086,8,35,14,15,8,6,86,38.27860665,-109.3470237
6087,8,36,14,13,9,6,86,38.27860665,-109.3467542
6088,10,34,14,14,10,5,87,38.27860665,-109.3464847
6089,12,33,14,14,10,4,87,38.27860665,-109.3462152
6090,13,34,14,14,10,4,89,38.27860665,-109.3459457
6091,1,41,11,0,12,12,77,38.27833715043797,-109.4308365
6092,2,40,11,1,11,14,79,38.27833715043797,-109.430567
6093,2,40,11,1,11,14,79,38.27833715043797,-109.4302975
6094,3,44,12,4,13,9,85,38.27833715043797,-109.430028
6095,2,48,11,3,13,7,84,38.27833715043797,-109.4297586
6096,2,50,11,3,14,5,85,38.27833715043797,-109.4294891
6097,3,51,11,4,14,4,87,38.27833715043797,-109.4292196
6098,3,52,11,5,14,4,89,38.27833715043797,-109.4289501
6099,2,53,11,4,14,4,88,38.27833715043797,-109.4286806
6100,2,51,11,3,14,5,86,38.27833715043797,-109.4284111
6101,3,49,11,3,14,6,86,38.27833715043797,-109.4281416
6102,2,49,12,2,15,7,87,38.27833715043797,-109.4278721
6103,2,48,12,2,15,8,87,38.27833715043797,-109.4276026
6104,2,42,11,0,11,14,80,38.27833715043797,-109.4273331
6105,2,46,11,2,15,9,85,38.27833715043797,-109.4270636
6106,3,51,12,3,16,5,90,38.27833715043797,-109.4267941
6107,2,53,11,3,15,5,89,38.27833715043797,-109.4265246
6108,2,48,11,1,13,10,85,38.27833715043797,-109.4262551
6109,1,44,11,0,12,12,80,38.27833715043797,-109.4259856
6110,1,41,11,0,12,11,76,38.27833715043797,-109.4257161
6111,1,40,10,0,11,10,72,38.27833715043797,-109.4254466
6112,1,39,10,1,11,10,72,38.27833715043797,-109.4251771
6113,1,39,10,1,12,9,72,38.27833715043797,-109.4249077
6114,1,42,9,1,12,8,73,38.27833715043797,-109.4246382
6115,1,44,9,0,13,8,75,38.27833715043797,-109.4243687
6116,1,45,10,0,15,9,80,38.27833715043797,-109.4240992
6117,1,45,10,0,14,11,81,38.27833715043797,-109.4238297
6118,1,43,11,0,15,10,80,38.27833715043797,-109.4235602
6119,2,44,11,0,14,10,81,38.27833715043797,-109.4232907
6120,2,47,12,1,17,7,86,38.27833715043797,-109.4230212
6121,3,48,13,4,18,4,90,38.27833715043797,-109.4227517
6122,3,45,12,4,17,5,86,38.27833715043797,-109.4224822
6123,3,45,13,5,17,5,88,38.27833715043797,-109.4222127
6124,3,43,13,3,17,7,86,38.27833715043797,-109.4219432
6125,2,40,12,1,16,10,81,38.27833715043797,-109.4216737
6126,1,38,12,0,14,14,79,38.27833715043797,-109.4214042
6127,1,35,12,0,11,18,77,38.27833715043797,-109.4211347
6128,0,32,13,0,9,21,75,38.27833715043797,-109.4208652
6129,0,28,15,0,8,24,75,38.27833715043797,-109.4205957
6130,0,29,14,0,10,22,75,38.27833715043797,-109.4203262
6131,0,31,13,0,12,19,75,38.27833715043797,-109.4200568
6132,0,33,12,0,10,20,75,38.27833715043797,-109.4197873
6133,0,32,12,0,9,20,73,38.27833715043797,-109.4195178
6134,0,31,11,0,9,19,70,38.27833715043797,-109.4192483
6135,0,29,11,0,9,17,66,38.27833715043797,-109.4189788
6136,0,29,10,0,7,18,64,38.27833715043797,-109.4187093
6137,0,32,10,0,8,17,67,38.27833715043797,-109.4184398
6138,0,34,10,0,8,17,69,38.27833715043797,-109.4181703
6139,1,37,10,0,8,17,73,38.27833715043797,-109.4179008
6140,1,37,10,0,8,17,73,38.27833715043797,-109.4176313
6141,1,39,11,0,12,15,78,38.27833715043797,-109.4173618
6142,1,33,11,0,11,16,72,38.27833715043797,-109.4170923
6143,1,32,12,0,10,18,73,38.27833715043797,-109.4168228
6144,0,31,12,0,9,19,71,38.27833715043797,-109.4165533
6145,0,32,12,0,9,20,73,38.27833715043797,-109.4162838
6146,0,29,13,0,7,23,72,38.27833715043797,-109.4160143
6147,0,30,13,0,7,22,72,38.27833715043797,-109.4157448
6148,1,28,13,0,6,23,71,38.27833715043797,-109.4154753
6149,1,27,13,0,7,21,69,38.27833715043797,-109.4152058
6150,1,31,12,0,8,18,70,38.27833715043797,-109.4149364
6151,1,29,13,1,8,20,72,38.27833715043797,-109.4146669
6152,3,32,13,3,10,17,78,38.27833715043797,-109.4143974
6153,3,34,12,3,11,15,78,38.27833715043797,-109.4141279
6154,2,33,12,2,10,15,74,38.27833715043797,-109.4138584
6155,1,29,12,1,9,16,68,38.27833715043797,-109.4135889
6156,1,31,11,1,10,13,67,38.27833715043797,-109.4133194
6157,0,39,9,0,11,11,70,38.27833715043797,-109.4130499
6158,1,45,8,0,12,9,75,38.27833715043797,-109.4127804
6159,1,36,9,0,10,10,66,38.27833715043797,-109.4125109
6160,1,28,10,0,8,15,62,38.27833715043797,-109.4122414
6161,1,27,10,0,5,19,62,38.27833715043797,-109.4119719
6162,2,24,11,0,4,21,62,38.27833715043797,-109.4117024
6163,2,21,12,3,4,19,61,38.27833715043797,-109.4114329
6164,5,25,12,7,9,10,68,38.27833715043797,-109.4111634
6165,7,27,11,9,10,6,70,38.27833715043797,-109.4108939
6166,9,28,11,10,11,4,73,38.27833715043797,-109.4106244
6167,10,28,12,11,12,4,77,38.27833715043797,-109.4103549
6168,9,31,11,10,13,4,78,38.27833715043797,-109.4100855
6169,7,36,12,10,14,2,81,38.27833715043797,-109.409816
6170,6,43,13,7,15,2,86,38.27833715043797,-109.4095465
6171,5,44,12,5,16,3,85,38.27833715043797,-109.409277
6172,4,43,12,5,16,4,84,38.27833715043797,-109.4090075
6173,4,41,13,5,16,4,83,38.27833715043797,-109.408738
6174,4,44,13,6,17,3,87,38.27833715043797,-109.4084685
6175,4,45,13,5,17,4,88,38.27833715043797,-109.408199
6176,3,43,13,4,16,6,85,38.27833715043797,-109.4079295
6177,4,42,13,4,15,7,85,38.27833715043797,-109.40766
6178,5,42,13,5,15,6,86,38.27833715043797,-109.4073905
6179,6,42,13,6,16,4,87,38.27833715043797,-109.407121
6180,4,47,12,5,17,3,88,38.27833715043797,-109.4068515
6181,1,21,12,0,3,20,57,38.27833715043797,-109.3879869
6182,0,25,10,0,4,17,56,38.27833715043797,-109.3877174
6183,1,28,9,0,5,16,59,38.27833715043797,-109.3874479
6184,1,30,9,0,6,13,59,38.27833715043797,-109.3871784
6185,2,28,10,1,6,13,60,38.27833715043797,-109.3869089
6186,2,28,10,0,6,13,59,38.27833715043797,-109.3866394
6187,2,26,11,0,5,15,59,38.27833715043797,-109.3863699
6188,1,22,12,0,3,20,58,38.27833715043797,-109.3861004
6189,2,23,12,0,4,18,59,38.27833715043797,-109.3858309
6190,1,23,11,0,4,17,56,38.27833715043797,-109.3855614
6191,1,24,11,0,5,17,58,38.27833715043797,-109.3852919
6192,1,24,11,0,5,16,57,38.27833715043797,-109.3850225
6193,1,25,10,0,5,16,57,38.27833715043797,-109.384753
6194,1,25,11,0,5,16,58,38.27833715043797,-109.3844835
6195,1,24,11,0,5,17,58,38.27833715043797,-109.384214
6196,1,24,11,0,5,18,59,38.27833715043797,-109.3839445
6197,1,23,11,0,5,18,58,38.27833715043797,-109.383675
6198,1,21,11,0,4,18,55,38.27833715043797,-109.3834055
6199,1,21,12,0,4,17,55,38.27833715043797,-109.383136
6200,1,22,12,0,4,19,58,38.27833715043797,-109.3828665
6201,1,21,14,0,3,23,62,38.27833715043797,-109.382597
6202,0,20,16,0,4,27,67,38.27833715043797,-109.3823275
6203,0,20,15,0,3,26,64,38.27833715043797,-109.382058
6204,0,21,16,0,2,27,66,38.27833715043797,-109.3817885
6205,0,21,17,0,3,29,70,38.27833715043797,-109.381519
6206,0,22,17,0,3,30,72,38.27833715043797,-109.3812495
6207,1,23,16,0,3,28,71,38.27833715043797,-109.38098
6208,1,23,16,0,3,27,70,38.27833715043797,-109.3807105
6209,1,23,15,0,3,26,68,38.27833715043797,-109.380441
6210,0,23,15,0,2,26,66,38.27833715043797,-109.3801716
6211,1,23,15,0,3,26,68,38.27833715043797,-109.3799021
6212,3,23,17,0,4,26,73,38.27833715043797,-109.3796326
6213,2,23,18,0,3,29,75,38.27833715043797,-109.3793631
6214,1,26,16,0,3,27,73,38.27833715043797,-109.3790936
6215,0,26,13,0,4,22,65,38.27833715043797,-109.3788241
6216,1,25,13,0,5,16,60,38.27833715043797,-109.3785546
6217,3,35,13,3,5,13,72,38.27833715043797,-109.3782851
6218,1,30,13,3,9,13,69,38.27833715043797,-109.3780156
6219,1,31,14,4,10,12,72,38.27833715043797,-109.3777461
6220,0,29,13,4,7,15,68,38.27833715043797,-109.3774766
6221,0,25,12,3,6,17,63,38.27833715043797,-109.3772071
6222,0,26,12,3,5,20,66,38.27833715043797,-109.3769376
6223,0,25,14,4,7,21,71,38.27833715043797,-109.3766681
6224,0,24,15,5,8,21,73,38.27833715043797,-109.3763986
6225,0,26,15,3,9,22,75,38.27833715043797,-109.3761291
6226,0,28,15,4,12,19,78,38.27833715043797,-109.3758596
6227,0,27,16,3,11,19,76,38.27833715043797,-109.3755901
6228,1,27,16,3,11,19,77,38.27833715043797,-109.3753206
6229,1,28,17,7,10,18,81,38.27833715043797,-109.3750512
6230,3,28,17,12,9,12,81,38.27833715043797,-109.3747817
6231,2,30,15,4,10,18,79,38.27833715043797,-109.3745122
6232,2,28,15,3,10,19,77,38.27833715043797,-109.3742427
6233,3,27,14,3,12,17,76,38.27833715043797,-109.3739732
6234,3,30,13,6,13,14,79,38.27833715043797,-109.3737037
6235,2,30,11,11,13,9,76,38.27833715043797,-109.3734342
6236,3,33,12,13,15,5,81,38.27833715043797,-109.3731647
6237,3,34,11,4,14,8,74,38.27833715043797,-109.3728952
6238,2,34,11,1,12,10,70,38.27833715043797,-109.3726257
6239,1,32,10,0,11,12,66,38.27833715043797,-109.3723562
6240,4,23,13,4,4,17,65,38.27833715043797,-109.3720867
6241,3,13,11,11,11,9,58,38.27833715043797,-109.3718172
6242,2,17,11,9,9,10,58,38.27833715043797,-109.3715477
6243,2,24,10,4,7,14,61,38.27833715043797,-109.3712782
6244,1,28,10,2,10,12,63,38.27833715043797,-109.3710087
6245,1,25,11,0,4,20,61,38.27833715043797,-109.3707392
6246,2,32,11,0,10,13,68,38.27833715043797,-109.3704697
6247,2,38,10,1,13,9,73,38.27833715043797,-109.3702003
6248,1,39,10,1,13,8,72,38.27833715043797,-109.3699308
6249,1,37,11,1,14,7,71,38.27833715043797,-109.3696613
6250,2,31,10,1,10,11,65,38.27833715043797,-109.3693918
6251,2,38,9,0,15,5,69,38.27833715043797,-109.3691223
6252,2,47,9,4,14,1,77,38.27833715043797,-109.3688528
6253,0,48,8,6,11,2,75,38.27833715043797,-109.3685833
6254,2,32,8,4,8,5,59,38.27833715043797,-109.3683138
6255,1,18,10,9,10,8,56,38.27833715043797,-109.3680443
6256,4,16,10,7,12,9,58,38.27833715043797,-109.3677748
6257,5,21,11,6,12,9,64,38.27833715043797,-109.3675053
6258,3,31,13,5,9,15,76,38.27833715043797,-109.3672358
6259,1,27,13,4,6,21,72,38.27833715043797,-109.3669663
6260,2,28,12,6,6,20,74,38.27833715043797,-109.3666968
6261,3,26,13,7,8,18,75,38.27833715043797,-109.3664273
6262,2,24,13,9,9,18,75,38.27833715043797,-109.3661578
6263,3,25,16,4,9,21,78,38.27833715043797,-109.3658883
6264,4,22,18,1,5,29,79,38.27833715043797,-109.3656188
6265,0,20,18,0,3,34,75,38.27833715043797,-109.3653493
6266,0,18,18,0,2,34,72,38.27833715043797,-109.3650799
6267,0,18,17,0,2,34,71,38.27833715043797,-109.3648104
6268,1,19,17,0,2,32,71,38.27833715043797,-109.3645409
6269,0,19,15,0,1,29,64,38.27833715043797,-109.3642714
6270,1,19,14,0,2,26,62,38.27833715043797,-109.3640019
6271,1,20,14,0,3,23,61,38.27833715043797,-109.3637324
6272,3,22,14,1,4,19,63,38.27833715043797,-109.3634629
6273,2,17,14,2,4,20,59,38.27833715043797,-109.3631934
6274,1,16,14,1,3,24,59,38.27833715043797,-109.3629239
6275,1,16,15,0,3,29,64,38.27833715043797,-109.3626544
6276,0,18,17,0,4,32,71,38.27833715043797,-109.3623849
6277,0,23,19,0,5,31,78,38.27833715043797,-109.3621154
6278,0,23,19,0,5,32,79,38.27833715043797,-109.3618459
6279,0,24,19,0,5,32,80,38.27833715043797,-109.3615764
6280,0,25,19,0,6,32,82,38.27833715043797,-109.3613069
6281,0,25,20,0,6,33,84,38.27833715043797,-109.3610374
6282,1,24,20,0,5,35,85,38.27833715043797,-109.3607679
6283,0,21,18,0,3,33,75,38.27833715043797,-109.3604984
6284,0,20,17,0,3,32,72,38.27833715043797,-109.360229
6285,0,20,18,0,2,32,72,38.27833715043797,-109.3599595
6286,0,22,18,0,3,33,76,38.27833715043797,-109.35969
6287,0,25,18,0,4,32,79,38.27833715043797,-109.3594205
6288,0,25,19,0,6,31,81,38.27833715043797,-109.359151
6289,0,27,19,0,7,30,83,38.27833715043797,-109.3588815
6290,0,26,20,1,6,29,82,38.27833715043797,-109.358612
6291,0,27,19,1,6,29,82,38.27833715043797,-109.3583425
6292,0,26,20,1,8,28,83,38.27833715043797,-109.358073
6293,1,26,20,2,7,27,83,38.27833715043797,-109.3578035
6294,1,25,18,3,6,26,79,38.27833715043797,-109.357534
6295,2,25,17,3,6,24,77,38.27833715043797,-109.3572645
6296,3,25,16,3,5,22,74,38.27833715043797,-109.356995
6297,3,26,19,2,7,24,81,38.27833715043797,-109.3567255
6298,2,27,20,2,8,26,85,38.27833715043797,-109.356456
6299,0,27,19,1,7,29,83,38.27833715043797,-109.3561865
6300,0,27,19,1,8,27,82,38.27833715043797,-109.355917
6301,1,25,19,3,6,27,81,38.27833715043797,-109.3556475
6302,0,22,17,0,4,28,71,38.27833715043797,-109.355378
6303,0,22,17,0,4,28,71,38.27833715043797,-109.3551086
6304,1,23,18,0,5,28,75,38.27833715043797,-109.3548391
6305,0,22,20,0,5,30,77,38.27833715043797,-109.3545696
6306,1,23,21,4,8,28,85,38.27833715043797,-109.3543001
6307,2,19,22,5,10,26,84,38.27833715043797,-109.3540306
6308,2,19,22,5,10,26,84,38.27833715043797,-109.3537611
6309,1,17,22,3,8,32,83,38.27833715043797,-109.3534916
6310,1,16,22,3,7,34,83,38.27833715043797,-109.3532221
6311,2,17,21,4,8,32,84,38.27833715043797,-109.3529526
6312,1,15,22,4,8,34,84,38.27833715043797,-109.3526831
6313,1,15,22,3,7,34,82,38.27833715043797,-109.3524136
6314,2,18,24,3,6,28,81,38.27833715043797,-109.3521441
6315,1,18,23,4,6,29,81,38.27833715043797,-109.3518746
6316,0,22,21,1,6,29,79,38.27833715043797,-109.3516051
6317,4,28,18,4,8,20,82,38.27833715043797,-109.3513356
6318,4,28,17,3,8,20,80,38.27833715043797,-109.3510661
6319,1,20,18,0,4,27,70,38.27833715043797,-109.3507966
6320,1,20,17,2,3,23,66,38.27833715043797,-109.3505271
6321,1,22,18,2,4,25,72,38.27833715043797,-109.3502577
6322,3,28,19,5,9,20,84,38.27833715043797,-109.3499882
6323,5,29,16,10,11,12,83,38.27833715043797,-109.3497187
6324,5,31,14,16,12,5,83,38.27833715043797,-109.3494492
6325,6,33,13,16,13,4,85,38.27833715043797,-109.3491797
6326,7,35,13,15,14,4,88,38.27833715043797,-109.3489102
6327,7,35,14,13,13,5,87,38.27833715043797,-109.3486407
6328,7,35,15,13,11,6,87,38.27833715043797,-109.3483712
6329,7,36,14,12,12,6,87,38.27833715043797,-109.3481017
6330,8,35,14,16,9,6,88,38.27833715043797,-109.3478322
6331,8,35,14,17,8,5,87,38.27833715043797,-109.3475627
6332,8,34,15,17,8,6,88,38.27833715043797,-109.3472932
6333,8,34,15,15,8,7,87,38.27833715043797,-109.3470237
6334,12,33,13,16,8,5,87,38.27833715043797,-109.3467542
6335,12,33,13,16,9,4,87,38.27833715043797,-109.3464847
6336,12,33,13,16,10,4,88,38.27833715043797,-109.3462152
6337,12,35,13,14,10,4,88,38.27833715043797,-109.3459457
6338,9,38,14,13,12,3,89,38.27833715043797,-109.3456762
6339,2,40,11,0,11,15,79,38.27806765585273,-109.431106
6340,1,44,11,0,12,14,82,38.27806765585273,-109.4308365
6341,2,47,11,0,12,12,84,38.27806765585273,-109.430567
6342,2,48,11,1,12,11,85,38.27806765585273,-109.4302975
6343,2,47,11,3,13,9,85,38.27806765585273,-109.430028
6344,2,49,11,3,13,7,85,38.27806765585273,-109.4297586
6345,2,52,11,2,14,5,86,38.27806765585273,-109.4294891
6346,2,52,10,1,14,5,84,38.27806765585273,-109.4292196
6347,2,51,10,2,14,5,84,38.27806765585273,-109.4289501
6348,2,52,10,1,13,7,85,38.27806765585273,-109.4286806
6349,2,53,11,1,14,6,87,38.27806765585273,-109.4284111
6350,2,51,11,1,14,7,86,38.27806765585273,-109.4281416
6351,2,50,11,2,14,8,87,38.27806765585273,-109.4278721
6352,2,51,10,2,14,8,87,38.27806765585273,-109.4276026
6353,2,48,10,0,13,11,84,38.27806765585273,-109.4273331
6354,2,49,12,3,14,7,87,38.27806765585273,-109.4270636
6355,2,50,11,5,14,4,86,38.27806765585273,-109.4267941
6356,2,51,10,3,13,5,84,38.27806765585273,-109.4265246
6357,2,46,10,0,12,10,80,38.27806765585273,-109.4262551
6358,1,38,11,0,14,11,75,38.27806765585273,-109.4259856
6359,1,36,11,1,14,11,74,38.27806765585273,-109.4257161
6360,1,37,11,1,15,10,75,38.27806765585273,-109.4254466
6361,1,38,12,2,17,9,79,38.27806765585273,-109.4251771
6362,1,37,12,1,15,12,78,38.27806765585273,-109.4249077
6363,0,35,12,0,14,14,75,38.27806765585273,-109.4246382
6364,1,35,12,0,14,14,76,38.27806765585273,-109.4243687
6365,1,36,11,0,14,13,75,38.27806765585273,-109.4240992
6366,1,43,10,0,13,12,79,38.27806765585273,-109.4238297
6367,1,45,11,0,14,11,82,38.27806765585273,-109.4235602
6368,1,48,11,1,16,8,85,38.27806765585273,-109.4232907
6369,2,48,12,2,17,7,88,38.27806765585273,-109.4230212
6370,3,46,13,3,17,6,88,38.27806765585273,-109.4227517
6371,3,45,12,3,17,6,86,38.27806765585273,-109.4224822
6372,2,44,12,3,17,6,84,38.27806765585273,-109.4222127
6373,2,42,12,1,16,10,83,38.27806765585273,-109.4219432
6374,1,38,12,0,13,13,77,38.27806765585273,-109.4216737
6375,1,35,12,0,11,18,77,38.27806765585273,-109.4214042
6376,0,29,12,0,6,22,69,38.27806765585273,-109.4211347
6377,0,31,12,0,10,19,72,38.27806765585273,-109.4208652
6378,0,31,12,0,10,20,73,38.27806765585273,-109.4205957
6379,0,31,12,0,9,21,73,38.27806765585273,-109.4203262
6380,0,32,11,0,11,19,73,38.27806765585273,-109.4200568
6381,0,33,12,0,11,18,74,38.27806765585273,-109.4197873
6382,0,30,11,0,10,20,71,38.27806765585273,-109.4195178
6383,0,29,11,0,9,18,67,38.27806765585273,-109.4192483
6384,0,30,11,0,10,15,66,38.27806765585273,-109.4189788
6385,1,32,10,0,10,14,67,38.27806765585273,-109.4187093
6386,0,30,12,0,10,18,70,38.27806765585273,-109.4184398
6387,0,33,12,0,8,21,74,38.27806765585273,-109.4181703
6388,1,33,12,0,7,21,74,38.27806765585273,-109.4179008
6389,1,37,11,0,9,18,76,38.27806765585273,-109.4176313
6390,1,41,11,0,13,13,79,38.27806765585273,-109.4173618
6391,2,40,11,0,14,11,78,38.27806765585273,-109.4170923
6392,2,39,11,0,14,11,77,38.27806765585273,-109.4168228
6393,2,39,11,0,13,12,77,38.27806765585273,-109.4165533
6394,3,37,11,0,13,13,77,38.27806765585273,-109.4162838
6395,2,33,12,0,10,17,74,38.27806765585273,-109.4160143
6396,1,31,12,0,8,19,71,38.27806765585273,-109.4157448
6397,1,30,11,0,7,20,69,38.27806765585273,-109.4154753
6398,1,31,11,0,9,17,69,38.27806765585273,-109.4152058
6399,1,33,11,0,11,14,70,38.27806765585273,-109.4149364
6400,2,33,12,0,10,17,74,38.27806765585273,-109.4146669
6401,2,39,12,0,11,14,78,38.27806765585273,-109.4143974
6402,2,39,12,1,13,12,79,38.27806765585273,-109.4141279
6403,2,34,11,2,12,12,73,38.27806765585273,-109.4138584
6404,1,27,11,0,6,19,64,38.27806765585273,-109.4135889
6405,0,30,11,0,7,17,65,38.27806765585273,-109.4133194
6406,0,36,9,0,9,14,68,38.27806765585273,-109.4130499
6407,1,40,9,0,11,12,73,38.27806765585273,-109.4127804
6408,1,37,9,0,11,11,69,38.27806765585273,-109.4125109
6409,1,26,10,0,6,18,61,38.27806765585273,-109.4122414
6410,1,30,10,0,6,17,64,38.27806765585273,-109.4119719
6411,2,30,10,2,8,14,66,38.27806765585273,-109.4117024
6412,4,28,11,6,10,9,68,38.27806765585273,-109.4114329
6413,9,29,12,10,12,5,77,38.27806765585273,-109.4111634
6414,9,31,12,13,12,3,80,38.27806765585273,-109.4108939
6415,8,30,12,13,12,3,78,38.27806765585273,-109.4106244
6416,8,29,11,12,11,3,74,38.27806765585273,-109.4103549
6417,7,29,11,10,12,4,73,38.27806765585273,-109.4100855
6418,5,34,11,7,12,5,74,38.27806765585273,-109.409816
6419,5,42,12,4,13,4,80,38.27806765585273,-109.4095465
6420,4,46,12,4,14,3,83,38.27806765585273,-109.409277
6421,4,46,13,4,15,3,85,38.27806765585273,-109.4090075
6422,4,47,13,4,15,4,87,38.27806765585273,-109.408738
6423,4,46,13,4,16,4,87,38.27806765585273,-109.4084685
6424,4,44,13,5,16,4,86,38.27806765585273,-109.408199
6425,4,43,13,6,17,5,88,38.27806765585273,-109.4079295
6426,4,42,13,5,16,5,85,38.27806765585273,-109.40766
6427,5,42,12,4,15,6,84,38.27806765585273,-109.4073905
6428,6,43,13,6,17,3,88,38.27806765585273,-109.407121
6429,3,45,12,5,17,3,85,38.27806765585273,-109.4068515
6430,1,23,11,0,4,18,57,38.27806765585273,-109.3879869
6431,1,25,10,0,5,16,57,38.27806765585273,-109.3877174
6432,1,27,9,0,6,14,57,38.27806765585273,-109.3874479
6433,1,27,9,0,5,15,57,38.27806765585273,-109.3871784
6434,2,27,10,0,6,13,58,38.27806765585273,-109.3869089
6435,2,28,10,0,7,13,60,38.27806765585273,-109.3866394
6436,2,25,11,0,5,15,58,38.27806765585273,-109.3863699
6437,1,22,13,0,3,22,61,38.27806765585273,-109.3861004
6438,3,25,13,0,4,19,64,38.27806765585273,-109.3858309
6439,1,23,11,0,4,18,57,38.27806765585273,-109.3855614
6440,1,24,11,0,5,17,58,38.27806765585273,-109.3852919
6441,1,24,11,0,5,16,57,38.27806765585273,-109.3850225
6442,1,23,10,0,4,17,55,38.27806765585273,-109.384753
6443,1,22,11,0,3,17,54,38.27806765585273,-109.3844835
6444,1,22,11,0,4,16,54,38.27806765585273,-109.384214
6445,1,21,11,0,4,18,55,38.27806765585273,-109.3839445
6446,0,21,12,0,4,21,58,38.27806765585273,-109.383675
6447,0,22,12,0,4,21,59,38.27806765585273,-109.3834055
6448,1,22,12,0,4,20,59,38.27806765585273,-109.383136
6449,1,22,13,0,3,21,60,38.27806765585273,-109.3828665
6450,0,22,13,0,3,23,61,38.27806765585273,-109.382597
6451,0,21,13,0,3,22,59,38.27806765585273,-109.3823275
6452,0,23,11,0,4,18,56,38.27806765585273,-109.382058
6453,0,22,13,0,3,22,60,38.27806765585273,-109.3817885
6454,0,21,15,0,2,27,65,38.27806765585273,-109.381519
6455,0,21,16,0,3,29,69,38.27806765585273,-109.3812495
6456,0,23,16,0,3,28,70,38.27806765585273,-109.38098
6457,0,21,16,0,2,28,67,38.27806765585273,-109.3807105
6458,1,21,15,0,2,26,65,38.27806765585273,-109.380441
6459,1,22,14,0,3,24,64,38.27806765585273,-109.3801716
6460,1,23,15,0,4,24,67,38.27806765585273,-109.3799021
6461,1,24,17,0,5,27,74,38.27806765585273,-109.3796326
6462,0,24,18,0,4,30,76,38.27806765585273,-109.3793631
6463,0,22,17,0,3,30,72,38.27806765585273,-109.3790936
6464,0,21,16,0,1,30,68,38.27806765585273,-109.3788241
6465,0,21,15,0,1,29,66,38.27806765585273,-109.3785546
6466,4,30,15,0,4,20,73,38.27806765585273,-109.3782851
6467,0,28,12,0,7,18,65,38.27806765585273,-109.3780156
6468,1,29,12,2,7,13,64,38.27806765585273,-109.3777461
6469,2,34,12,3,8,9,68,38.27806765585273,-109.3774766
6470,2,34,11,3,8,9,67,38.27806765585273,-109.3772071
6471,1,31,10,3,6,10,61,38.27806765585273,-109.3769376
6472,1,28,10,5,7,10,61,38.27806765585273,-109.3766681
6473,2,28,11,4,8,9,62,38.27806765585273,-109.3763986
6474,3,30,12,4,9,9,67,38.27806765585273,-109.3761291
6475,2,26,12,5,10,12,67,38.27806765585273,-109.3758596
6476,1,24,13,5,8,14,65,38.27806765585273,-109.3755901
6477,1,22,10,6,7,15,61,38.27806765585273,-109.3753206
6478,1,21,10,5,6,16,59,38.27806765585273,-109.3750512
6479,1,26,13,4,11,17,72,38.27806765585273,-109.3747817
6480,0,27,13,0,11,18,69,38.27806765585273,-109.3745122
6481,0,28,13,0,11,18,70,38.27806765585273,-109.3742427
6482,0,31,13,0,13,17,74,38.27806765585273,-109.3739732
6483,0,31,13,1,15,14,74,38.27806765585273,-109.3737037
6484,0,31,11,3,15,10,70,38.27806765585273,-109.3734342
6485,8,27,12,17,12,3,79,38.27806765585273,-109.3731647
6486,2,34,10,4,16,7,73,38.27806765585273,-109.3728952
6487,1,40,11,5,13,5,75,38.27806765585273,-109.3726257
6488,1,40,10,6,12,6,75,38.27806765585273,-109.3723562
6489,3,41,12,13,12,2,83,38.27806765585273,-109.3720867
6490,2,20,10,13,12,6,63,38.27806765585273,-109.3718172
6491,3,19,11,9,10,9,61,38.27806765585273,-109.3715477
6492,2,29,11,5,10,10,67,38.27806765585273,-109.3712782
6493,2,35,10,1,11,10,69,38.27806765585273,-109.3710087
6494,2,27,12,1,7,16,65,38.27806765585273,-109.3707392
6495,1,22,13,1,5,20,62,38.27806765585273,-109.3704697
6496,2,29,11,1,9,14,66,38.27806765585273,-109.3702003
6497,2,40,10,0,14,8,74,38.27806765585273,-109.3699308
6498,2,49,10,0,17,4,82,38.27806765585273,-109.3696613
6499,2,34,10,1,11,9,67,38.27806765585273,-109.3693918
6500,2,34,10,1,15,5,67,38.27806765585273,-109.3691223
6501,1,47,8,3,14,2,75,38.27806765585273,-109.3688528
6502,3,49,8,6,11,2,79,38.27806765585273,-109.3685833
6503,3,47,8,6,11,2,77,38.27806765585273,-109.3683138
6504,1,54,7,2,8,5,77,38.27806765585273,-109.3680443
6505,3,51,7,4,8,5,78,38.27806765585273,-109.3677748
6506,5,26,9,3,6,7,56,38.27806765585273,-109.3675053
6507,9,18,10,2,7,10,56,38.27806765585273,-109.3672358
6508,7,16,10,2,7,13,55,38.27806765585273,-109.3669663
6509,6,19,11,3,9,13,61,38.27806765585273,-109.3666968
6510,3,24,10,2,13,14,66,38.27806765585273,-109.3664273
6511,4,26,11,7,9,16,73,38.27806765585273,-109.3661578
6512,5,25,14,9,6,18,77,38.27806765585273,-109.3658883
6513,5,24,15,4,4,26,78,38.27806765585273,-109.3656188
6514,1,19,16,0,3,30,69,38.27806765585273,-109.3653493
6515,1,19,17,0,3,31,71,38.27806765585273,-109.3650799
6516,1,20,18,0,3,33,75,38.27806765585273,-109.3648104
6517,1,20,17,0,3,31,72,38.27806765585273,-109.3645409
6518,0,20,15,0,2,27,64,38.27806765585273,-109.3642714
6519,1,20,13,0,3,24,61,38.27806765585273,-109.3640019
6520,2,22,13,0,5,19,61,38.27806765585273,-109.3637324
6521,3,24,14,3,7,15,66,38.27806765585273,-109.3634629
6522,2,21,14,3,6,17,63,38.27806765585273,-109.3631934
6523,1,16,13,4,5,21,60,38.27806765585273,-109.3629239
6524,1,18,14,2,5,26,66,38.27806765585273,-109.3626544
6525,0,22,17,0,5,31,75,38.27806765585273,-109.3623849
6526,0,24,19,0,6,31,80,38.27806765585273,-109.3621154
6527,0,23,18,0,4,34,79,38.27806765585273,-109.3618459
6528,0,24,17,0,4,33,78,38.27806765585273,-109.3615764
6529,0,24,18,0,5,33,80,38.27806765585273,-109.3613069
6530,0,23,19,0,5,33,80,38.27806765585273,-109.3610374
6531,1,24,20,0,6,34,85,38.27806765585273,-109.3607679
6532,0,22,18,0,4,33,77,38.27806765585273,-109.3604984
6533,0,21,18,0,4,34,77,38.27806765585273,-109.360229
6534,0,21,18,0,4,33,76,38.27806765585273,-109.3599595
6535,0,23,18,0,4,32,77,38.27806765585273,-109.35969
6536,0,25,18,0,4,31,78,38.27806765585273,-109.3594205
6537,0,26,19,1,6,30,82,38.27806765585273,-109.359151
6538,0,24,19,2,7,30,82,38.27806765585273,-109.3588815
6539,0,24,19,2,6,30,81,38.27806765585273,-109.358612
6540,0,27,20,0,7,30,84,38.27806765585273,-109.3583425
6541,0,27,21,0,7,31,86,38.27806765585273,-109.358073
6542,0,27,20,0,8,29,84,38.27806765585273,-109.3578035
6543,0,27,19,0,6,30,82,38.27806765585273,-109.357534
6544,0,29,18,0,6,29,82,38.27806765585273,-109.3572645
6545,0,29,18,1,6,28,82,38.27806765585273,-109.356995
6546,0,27,18,0,6,30,81,38.27806765585273,-109.3567255
6547,0,28,18,1,8,28,83,38.27806765585273,-109.356456
6548,0,26,18,3,8,27,82,38.27806765585273,-109.3561865
6549,0,26,19,3,6,29,83,38.27806765585273,-109.355917
6550,0,23,17,0,4,29,73,38.27806765585273,-109.3556475
6551,0,21,18,0,3,30,72,38.27806765585273,-109.355378
6552,0,21,19,0,3,32,75,38.27806765585273,-109.3551086
6553,0,21,20,0,4,35,80,38.27806765585273,-109.3548391
6554,0,23,20,0,4,33,80,38.27806765585273,-109.3545696
6555,1,25,21,2,7,29,85,38.27806765585273,-109.3543001
6556,2,22,21,3,8,27,83,38.27806765585273,-109.3540306
6557,2,21,20,3,7,28,81,38.27806765585273,-109.3537611
6558,1,23,22,2,8,29,85,38.27806765585273,-109.3534916
6559,1,21,22,2,8,30,84,38.27806765585273,-109.3532221
6560,1,19,21,3,8,31,83,38.27806765585273,-109.3529526
6561,1,17,22,4,8,32,84,38.27806765585273,-109.3526831
6562,1,15,22,4,7,35,84,38.27806765585273,-109.3524136
6563,2,15,22,4,5,36,84,38.27806765585273,-109.3521441
6564,0,19,22,2,6,34,83,38.27806765585273,-109.3518746
6565,1,22,21,1,6,31,82,38.27806765585273,-109.3516051
6566,2,23,19,2,6,27,79,38.27806765585273,-109.3513356
6567,2,21,19,1,4,28,75,38.27806765585273,-109.3510661
6568,1,16,20,0,3,32,72,38.27806765585273,-109.3507966
6569,2,19,19,0,2,26,68,38.27806765585273,-109.3505271
6570,1,24,17,1,4,25,72,38.27806765585273,-109.3502577
6571,3,30,17,7,9,17,83,38.27806765585273,-109.3499882
6572,6,30,16,13,10,8,83,38.27806765585273,-109.3497187
6573,7,31,14,17,10,5,84,38.27806765585273,-109.3494492
6574,5,31,14,19,13,4,86,38.27806765585273,-109.3491797
6575,6,33,13,17,14,4,87,38.27806765585273,-109.3489102
6576,7,34,14,16,13,5,89,38.27806765585273,-109.3486407
6577,8,35,15,15,11,6,90,38.27806765585273,-109.3483712
6578,8,36,14,12,13,6,89,38.27806765585273,-109.3481017
6579,8,35,15,14,10,7,89,38.27806765585273,-109.3478322
6580,8,34,15,16,8,7,88,38.27806765585273,-109.3475627
6581,9,33,15,18,7,6,88,38.27806765585273,-109.3472932
6582,13,30,13,18,8,5,87,38.27806765585273,-109.3470237
6583,18,29,12,17,8,4,88,38.27806765585273,-109.3467542
6584,14,30,13,17,9,4,87,38.27806765585273,-109.3464847
6585,12,32,14,17,9,4,88,38.27806765585273,-109.3462152
6586,12,35,14,15,10,4,90,38.27806765585273,-109.3459457
6587,9,37,14,13,11,4,88,38.27806765585273,-109.3456762
6588,9,39,14,12,11,4,89,38.27806765585273,-109.3454068
6589,1,53,9,2,11,9,85,38.27779816,-109.4313755
6590,2,44,11,2,12,12,83,38.27779816,-109.431106
6591,2,45,11,1,12,12,83,38.27779816,-109.4308365
6592,2,48,11,2,13,9,85,38.27779816,-109.430567
6593,2,51,11,2,14,7,87,38.27779816,-109.4302975
6594,2,50,10,3,13,7,85,38.27779816,-109.430028
6595,3,49,11,4,14,5,86,38.27779816,-109.4297586
6596,2,48,11,2,14,6,83,38.27779816,-109.4294891
6597,2,47,10,1,14,7,81,38.27779816,-109.4292196
6598,2,44,10,1,13,8,78,38.27779816,-109.4289501
6599,2,44,11,0,12,10,79,38.27779816,-109.4286806
6600,2,46,11,1,14,7,81,38.27779816,-109.4284111
6601,2,46,11,0,13,9,81,38.27779816,-109.4281416
6602,2,48,11,1,13,9,84,38.27779816,-109.4278721
6603,2,52,10,2,14,6,86,38.27779816,-109.4276026
6604,2,48,10,2,13,8,83,38.27779816,-109.4273331
6605,2,44,11,3,12,7,79,38.27779816,-109.4270636
6606,3,45,11,3,12,5,79,38.27779816,-109.4267941
6607,2,48,11,1,14,5,81,38.27779816,-109.4265246
6608,1,39,11,0,14,11,76,38.27779816,-109.4262551
6609,0,38,11,0,17,11,77,38.27779816,-109.4259856
6610,2,40,12,1,19,8,82,38.27779816,-109.4257161
6611,2,41,12,1,19,8,83,38.27779816,-109.4254466
6612,1,41,12,0,19,9,82,38.27779816,-109.4251771
6613,1,40,13,0,18,10,82,38.27779816,-109.4249077
6614,1,41,12,0,17,12,83,38.27779816,-109.4246382
6615,2,41,12,0,17,11,83,38.27779816,-109.4243687
6616,2,41,12,0,17,10,82,38.27779816,-109.4240992
6617,2,45,11,1,16,8,83,38.27779816,-109.4238297
6618,2,48,11,1,14,8,84,38.27779816,-109.4235602
6619,2,49,10,0,15,7,83,38.27779816,-109.4232907
6620,2,48,11,1,16,8,86,38.27779816,-109.4230212
6621,2,44,11,1,15,10,83,38.27779816,-109.4227517
6622,2,40,12,0,15,11,80,38.27779816,-109.4224822
6623,2,38,12,1,16,10,79,38.27779816,-109.4222127
6624,1,38,11,0,15,11,76,38.27779816,-109.4219432
6625,1,37,11,0,13,13,75,38.27779816,-109.4216737
6626,0,36,12,0,13,14,75,38.27779816,-109.4214042
6627,0,30,12,0,7,21,70,38.27779816,-109.4211347
6628,1,32,10,0,8,19,70,38.27779816,-109.4208652
6629,0,32,10,0,8,19,69,38.27779816,-109.4205957
6630,0,31,11,0,8,20,70,38.27779816,-109.4203262
6631,0,33,11,0,11,18,73,38.27779816,-109.4200568
6632,0,32,12,0,11,18,73,38.27779816,-109.4197873
6633,0,30,12,0,9,20,71,38.27779816,-109.4195178
6634,0,31,11,0,10,18,70,38.27779816,-109.4192483
6635,0,33,10,0,13,13,69,38.27779816,-109.4189788
6636,0,33,10,0,12,13,68,38.27779816,-109.4187093
6637,0,33,12,0,11,17,73,38.27779816,-109.4184398
6638,1,33,13,0,8,23,78,38.27779816,-109.4181703
6639,1,34,13,0,7,23,78,38.27779816,-109.4179008
6640,2,35,12,0,9,19,77,38.27779816,-109.4176313
6641,2,36,12,1,15,12,78,38.27779816,-109.4173618
6642,3,39,12,2,15,10,81,38.27779816,-109.4170923
6643,4,41,12,2,16,8,83,38.27779816,-109.4168228
6644,3,41,12,1,16,9,82,38.27779816,-109.4165533
6645,4,41,12,0,14,11,82,38.27779816,-109.4162838
6646,2,39,12,0,15,12,80,38.27779816,-109.4160143
6647,2,37,11,0,12,14,76,38.27779816,-109.4157448
6648,2,34,11,0,11,15,73,38.27779816,-109.4154753
6649,1,32,11,0,10,16,70,38.27779816,-109.4152058
6650,1,33,11,0,10,16,71,38.27779816,-109.4149364
6651,1,30,11,0,6,19,67,38.27779816,-109.4146669
6652,2,33,11,0,8,17,71,38.27779816,-109.4143974
6653,2,34,10,0,9,15,70,38.27779816,-109.4141279
6654,1,32,10,0,8,16,67,38.27779816,-109.4138584
6655,1,31,11,0,5,16,64,38.27779816,-109.4135889
6656,1,40,9,0,13,8,71,38.27779816,-109.4133194
6657,2,44,9,0,14,7,76,38.27779816,-109.4130499
6658,2,42,10,0,13,8,75,38.27779816,-109.4127804
6659,2,38,9,0,12,9,70,38.27779816,-109.4125109
6660,1,27,10,0,5,17,60,38.27779816,-109.4122414
6661,3,35,11,3,11,10,73,38.27779816,-109.4119719
6662,4,36,12,6,13,6,77,38.27779816,-109.4117024
6663,5,33,12,7,13,7,77,38.27779816,-109.4114329
6664,6,34,12,8,13,5,78,38.27779816,-109.4111634
6665,7,37,12,10,14,2,82,38.27779816,-109.4108939
6666,8,37,13,11,14,2,85,38.27779816,-109.4106244
6667,8,36,13,11,14,2,84,38.27779816,-109.4103549
6668,7,38,12,9,14,2,82,38.27779816,-109.4100855
6669,5,40,12,7,14,3,81,38.27779816,-109.409816
6670,5,46,12,5,14,3,85,38.27779816,-109.4095465
6671,4,47,12,5,15,3,86,38.27779816,-109.409277
6672,4,47,13,6,16,2,88,38.27779816,-109.4090075
6673,5,47,13,6,17,2,90,38.27779816,-109.408738
6674,5,44,13,8,17,2,89,38.27779816,-109.4084685
6675,5,44,14,8,16,3,90,38.27779816,-109.408199
6676,5,45,13,7,16,3,89,38.27779816,-109.4079295
6677,5,45,13,5,15,4,87,38.27779816,-109.40766
6678,5,44,13,5,15,5,87,38.27779816,-109.4073905
6679,5,45,13,5,15,4,87,38.27779816,-109.407121
6680,4,44,11,5,14,4,82,38.27779816,-109.4068515
6681,1,25,12,0,4,18,60,38.27779816,-109.3879869
6682,1,24,11,0,5,18,59,38.27779816,-109.3877174
6683,1,24,11,0,4,18,58,38.27779816,-109.3874479
6684,1,22,12,0,3,21,59,38.27779816,-109.3871784
6685,2,24,12,0,4,18,60,38.27779816,-109.3869089
6686,3,25,12,0,5,18,63,38.27779816,-109.3866394
6687,3,24,13,0,4,20,64,38.27779816,-109.3863699
6688,2,21,14,0,3,23,63,38.27779816,-109.3861004
6689,3,22,13,0,3,20,61,38.27779816,-109.3858309
6690,2,24,12,0,4,19,61,38.27779816,-109.3855614
6691,2,24,12,0,4,18,60,38.27779816,-109.3852919
6692,1,23,12,0,4,19,59,38.27779816,-109.3850225
6693,1,23,13,0,3,21,61,38.27779816,-109.384753
6694,1,23,12,0,4,19,59,38.27779816,-109.3844835
6695,1,22,11,0,4,17,55,38.27779816,-109.384214
6696,2,22,12,0,3,18,57,38.27779816,-109.3839445
6697,2,22,13,0,4,22,63,38.27779816,-109.383675
6698,0,21,14,0,3,24,62,38.27779816,-109.3834055
6699,1,22,14,0,4,23,64,38.27779816,-109.383136
6700,1,22,14,0,3,23,63,38.27779816,-109.3828665
6701,0,22,13,0,3,22,60,38.27779816,-109.382597
6702,0,24,11,0,4,18,57,38.27779816,-109.3823275
6703,0,25,10,0,5,15,55,38.27779816,-109.382058
6704,0,23,11,0,4,18,56,38.27779816,-109.3817885
6705,0,22,13,0,3,23,61,38.27779816,-109.381519
6706,1,22,15,0,2,26,66,38.27779816,-109.3812495
6707,0,23,15,0,2,26,66,38.27779816,-109.38098
6708,0,22,16,0,2,28,68,38.27779816,-109.3807105
6709,1,23,16,0,3,26,69,38.27779816,-109.380441
6710,0,23,14,0,3,25,65,38.27779816,-109.3801716
6711,0,21,14,0,3,24,62,38.27779816,-109.3799021
6712,1,24,16,0,4,24,69,38.27779816,-109.3796326
6713,1,21,16,0,3,28,69,38.27779816,-109.3793631
6714,1,19,16,0,2,28,66,38.27779816,-109.3790936
6715,1,18,16,0,1,28,64,38.27779816,-109.3788241
6716,1,17,16,0,0,29,63,38.27779816,-109.3785546
6717,0,16,16,0,1,30,63,38.27779816,-109.3782851
6718,0,18,13,1,2,22,56,38.27779816,-109.3780156
6719,1,26,8,2,3,14,54,38.27779816,-109.3777461
6720,2,34,6,3,5,8,58,38.27779816,-109.3774766
6721,4,40,5,3,7,3,62,38.27779816,-109.3772071
6722,2,36,5,2,6,4,55,38.27779816,-109.3769376
6723,2,33,4,1,6,4,50,38.27779816,-109.3766681
6724,3,33,4,2,6,4,52,38.27779816,-109.3763986
6725,3,32,4,3,6,4,52,38.27779816,-109.3761291
6726,3,26,5,5,6,5,50,38.27779816,-109.3758596
6727,5,32,6,4,6,4,57,38.27779816,-109.3755901
6728,2,38,7,4,8,4,63,38.27779816,-109.3753206
6729,2,39,7,5,10,4,67,38.27779816,-109.3750512
6730,2,38,8,4,9,6,67,38.27779816,-109.3747817
6731,4,33,9,5,9,7,67,38.27779816,-109.3745122
6732,5,32,9,4,8,7,65,38.27779816,-109.3742427
6733,5,32,9,4,8,7,65,38.27779816,-109.3739732
6734,3,33,8,5,10,5,64,38.27779816,-109.3737037
6735,1,37,9,4,11,7,69,38.27779816,-109.3734342
6736,1,43,9,5,11,4,73,38.27779816,-109.3731647
6737,1,48,8,3,11,3,74,38.27779816,-109.3728952
6738,1,48,8,3,11,4,75,38.27779816,-109.3726257
6739,1,44,9,5,11,5,75,38.27779816,-109.3723562
6740,3,45,8,5,9,4,74,38.27779816,-109.3720867
6741,5,27,10,9,11,4,66,38.27779816,-109.3718172
6742,7,20,11,10,11,7,66,38.27779816,-109.3715477
6743,3,21,11,6,8,13,62,38.27779816,-109.3712782
6744,2,27,12,3,8,15,67,38.27779816,-109.3710087
6745,1,26,12,0,8,20,67,38.27779816,-109.3707392
6746,2,26,13,0,10,18,69,38.27779816,-109.3704697
6747,1,28,12,0,9,17,67,38.27779816,-109.3702003
6748,2,31,12,1,9,15,70,38.27779816,-109.3699308
6749,3,36,11,2,12,10,74,38.27779816,-109.3696613
6750,2,37,11,2,13,8,73,38.27779816,-109.3693918
6751,1,45,9,1,16,4,76,38.27779816,-109.3691223
6752,4,48,8,5,9,4,78,38.27779816,-109.3688528
6753,2,56,7,3,9,5,82,38.27779816,-109.3685833
6754,1,55,9,4,10,4,83,38.27779816,-109.3683138
6755,4,50,7,5,9,4,79,38.27779816,-109.3680443
6756,1,56,8,3,10,4,82,38.27779816,-109.3677748
6757,2,46,8,5,11,4,76,38.27779816,-109.3675053
6758,2,45,8,4,10,4,73,38.27779816,-109.3672358
6759,1,36,8,4,9,10,68,38.27779816,-109.3669663
6760,5,28,9,5,9,8,64,38.27779816,-109.3666968
6761,9,24,11,4,12,10,70,38.27779816,-109.3664273
6762,9,23,12,6,10,13,73,38.27779816,-109.3661578
6763,4,16,11,8,13,9,61,38.27779816,-109.3658883
6764,3,15,13,5,6,17,59,38.27779816,-109.3656188
6765,2,15,14,1,3,25,60,38.27779816,-109.3653493
6766,2,15,16,1,2,28,64,38.27779816,-109.3650799
6767,1,16,16,0,2,30,65,38.27779816,-109.3648104
6768,2,19,16,0,2,28,67,38.27779816,-109.3645409
6769,1,20,13,0,2,24,60,38.27779816,-109.3642714
6770,1,19,13,0,3,21,57,38.27779816,-109.3640019
6771,1,18,14,1,4,20,58,38.27779816,-109.3637324
6772,2,19,14,3,5,20,63,38.27779816,-109.3634629
6773,1,20,15,1,6,23,66,38.27779816,-109.3631934
6774,0,20,14,2,7,24,67,38.27779816,-109.3629239
6775,0,24,15,2,7,26,74,38.27779816,-109.3626544
6776,0,27,17,0,7,29,80,38.27779816,-109.3623849
6777,0,24,17,0,5,31,77,38.27779816,-109.3621154
6778,0,22,16,0,3,30,71,38.27779816,-109.3618459
6779,0,21,17,0,2,31,71,38.27779816,-109.3615764
6780,0,21,17,0,3,31,72,38.27779816,-109.3613069
6781,0,21,17,0,4,31,73,38.27779816,-109.3610374
6782,0,20,18,0,4,33,75,38.27779816,-109.3607679
6783,0,22,19,0,4,34,79,38.27779816,-109.3604984
6784,0,23,19,0,4,34,80,38.27779816,-109.360229
6785,0,22,18,0,4,33,77,38.27779816,-109.3599595
6786,0,23,18,0,4,31,76,38.27779816,-109.35969
6787,1,26,18,1,6,29,81,38.27779816,-109.3594205
6788,1,25,17,3,6,28,80,38.27779816,-109.359151
6789,0,26,18,1,7,29,81,38.27779816,-109.3588815
6790,0,26,19,0,7,30,82,38.27779816,-109.358612
6791,0,26,19,0,7,31,83,38.27779816,-109.3583425
6792,0,26,20,0,5,34,85,38.27779816,-109.358073
6793,0,25,21,1,6,32,85,38.27779816,-109.3578035
6794,0,25,20,2,7,30,84,38.27779816,-109.357534
6795,0,26,20,2,7,29,84,38.27779816,-109.3572645
6796,0,26,20,3,9,28,86,38.27779816,-109.356995
6797,0,24,20,2,6,31,83,38.27779816,-109.3567255
6798,0,27,20,0,6,30,83,38.27779816,-109.356456
6799,0,25,18,0,5,29,77,38.27779816,-109.3561865
6800,0,23,16,0,4,26,69,38.27779816,-109.355917
6801,0,21,17,0,4,29,71,38.27779816,-109.3556475
6802,0,20,18,0,3,31,72,38.27779816,-109.355378
6803,1,22,18,1,4,29,75,38.27779816,-109.3551086
6804,0,22,18,2,4,28,74,38.27779816,-109.3548391
6805,0,20,18,0,2,29,69,38.27779816,-109.3545696
6806,1,23,18,2,5,27,76,38.27779816,-109.3543001
6807,1,25,21,2,7,29,85,38.27779816,-109.3540306
6808,4,24,19,3,6,27,83,38.27779816,-109.3537611
6809,2,25,20,3,5,28,83,38.27779816,-109.3534916
6810,1,26,21,1,9,28,86,38.27779816,-109.3532221
6811,0,20,22,3,6,33,84,38.27779816,-109.3529526
6812,0,18,23,3,7,35,86,38.27779816,-109.3526831
6813,1,15,22,3,6,37,84,38.27779816,-109.3524136
6814,1,15,21,3,6,37,83,38.27779816,-109.3521441
6815,1,19,21,3,6,35,85,38.27779816,-109.3518746
6816,1,21,21,2,7,32,84,38.27779816,-109.3516051
6817,3,23,21,2,6,29,84,38.27779816,-109.3513356
6818,1,20,19,1,3,29,73,38.27779816,-109.3510661
6819,0,17,20,0,3,32,72,38.27779816,-109.3507966
6820,3,23,19,3,4,25,77,38.27779816,-109.3505271
6821,3,29,18,6,8,18,82,38.27779816,-109.3502577
6822,3,30,16,9,12,13,83,38.27779816,-109.3499882
6823,5,31,15,13,13,8,85,38.27779816,-109.3497187
6824,6,31,14,17,11,5,84,38.27779816,-109.3494492
6825,6,31,14,16,12,6,85,38.27779816,-109.3491797
6826,7,30,14,17,12,7,87,38.27779816,-109.3489102
6827,9,31,14,16,10,7,87,38.27779816,-109.3486407
6828,10,34,14,14,9,7,88,38.27779816,-109.3483712
6829,8,34,14,13,12,7,88,38.27779816,-109.3481017
6830,9,34,15,14,11,7,90,38.27779816,-109.3478322
6831,8,32,15,19,9,6,89,38.27779816,-109.3475627
6832,11,31,14,20,9,5,90,38.27779816,-109.3472932
6833,15,28,13,20,9,4,89,38.27779816,-109.3470237
6834,14,30,13,18,10,5,90,38.27779816,-109.3467542
6835,11,32,14,17,10,5,89,38.27779816,-109.3464847
6836,11,35,14,15,10,4,89,38.27779816,-109.3462152
6837,11,36,14,14,10,4,89,38.27779816,-109.3459457
6838,9,37,14,15,10,4,89,38.27779816,-109.3456762
6839,10,37,14,15,9,4,89,38.27779816,-109.3454068
6840,9,36,14,15,9,5,88,38.27779816,-109.3451373
6841,1,51,10,2,13,8,85,38.27752866668226,-109.431645
6842,2,55,9,3,12,7,88,38.27752866668226,-109.4313755
6843,2,52,10,2,12,9,87,38.27752866668226,-109.431106
6844,2,53,9,3,13,7,87,38.27752866668226,-109.4308365
6845,1,52,9,4,13,6,85,38.27752866668226,-109.430567
6846,1,51,10,3,13,6,84,38.27752866668226,-109.4302975
6847,2,48,11,1,14,7,83,38.27752866668226,-109.430028
6848,2,48,11,3,15,6,85,38.27752866668226,-109.4297586
6849,2,47,11,2,13,8,83,38.27752866668226,-109.4294891
6850,2,47,11,1,13,9,83,38.27752866668226,-109.4292196
6851,3,48,11,1,13,7,83,38.27752866668226,-109.4289501
6852,3,48,11,1,14,7,84,38.27752866668226,-109.4286806
6853,3,49,12,3,16,5,88,38.27752866668226,-109.4284111
6854,3,48,12,3,15,6,87,38.27752866668226,-109.4281416
6855,2,47,11,2,13,7,82,38.27752866668226,-109.4278721
6856,2,48,10,2,13,6,81,38.27752866668226,-109.4276026
6857,1,41,9,1,11,5,68,38.27752866668226,-109.4273331
6858,2,38,10,4,11,5,70,38.27752866668226,-109.4270636
6859,2,39,10,1,14,7,73,38.27752866668226,-109.4267941
6860,1,40,11,0,16,9,77,38.27752866668226,-109.4265246
6861,0,37,11,0,15,13,76,38.27752866668226,-109.4262551
6862,2,46,12,1,19,6,86,38.27752866668226,-109.4259856
6863,3,48,12,3,20,3,89,38.27752866668226,-109.4257161
6864,3,47,12,2,20,4,88,38.27752866668226,-109.4254466
6865,3,46,12,2,19,5,87,38.27752866668226,-109.4251771
6866,3,47,12,2,20,4,88,38.27752866668226,-109.4249077
6867,3,48,12,2,18,4,87,38.27752866668226,-109.4246382
6868,3,47,12,2,19,4,87,38.27752866668226,-109.4243687
6869,3,46,13,4,20,3,89,38.27752866668226,-109.4240992
6870,3,47,12,4,19,3,88,38.27752866668226,-109.4238297
6871,3,45,12,3,19,4,86,38.27752866668226,-109.4235602
6872,2,47,11,2,16,7,85,38.27752866668226,-109.4232907
6873,2,46,11,0,15,10,84,38.27752866668226,-109.4230212
6874,2,43,11,0,14,12,82,38.27752866668226,-109.4227517
6875,2,36,12,0,12,15,77,38.27752866668226,-109.4224822
6876,1,34,11,0,12,15,73,38.27752866668226,-109.4222127
6877,1,35,11,0,13,13,73,38.27752866668226,-109.4219432
6878,1,36,11,0,14,12,74,38.27752866668226,-109.4216737
6879,0,34,11,0,13,13,71,38.27752866668226,-109.4214042
6880,0,31,12,0,11,16,70,38.27752866668226,-109.4211347
6881,0,31,11,0,7,19,68,38.27752866668226,-109.4208652
6882,0,34,10,0,6,19,69,38.27752866668226,-109.4205957
6883,0,31,10,0,7,19,67,38.27752866668226,-109.4203262
6884,0,30,12,0,9,20,71,38.27752866668226,-109.4200568
6885,0,31,12,0,9,20,72,38.27752866668226,-109.4197873
6886,0,29,12,0,9,17,67,38.27752866668226,-109.4195178
6887,0,29,11,1,15,12,68,38.27752866668226,-109.4192483
6888,0,32,11,2,18,8,71,38.27752866668226,-109.4189788
6889,0,32,12,4,16,10,74,38.27752866668226,-109.4187093
6890,0,34,12,0,14,15,75,38.27752866668226,-109.4184398
6891,1,34,12,0,11,18,76,38.27752866668226,-109.4181703
6892,1,34,12,0,9,20,76,38.27752866668226,-109.4179008
6893,2,35,12,0,10,18,77,38.27752866668226,-109.4176313
6894,2,38,13,1,15,13,82,38.27752866668226,-109.4173618
6895,4,38,12,2,15,10,81,38.27752866668226,-109.4170923
6896,3,38,12,2,15,10,80,38.27752866668226,-109.4168228
6897,3,39,12,2,15,9,80,38.27752866668226,-109.4165533
6898,4,40,12,2,16,8,82,38.27752866668226,-109.4162838
6899,4,41,12,2,16,9,84,38.27752866668226,-109.4160143
6900,2,36,12,1,13,13,77,38.27752866668226,-109.4157448
6901,2,35,12,0,12,15,76,38.27752866668226,-109.4154753
6902,2,35,11,0,11,14,73,38.27752866668226,-109.4152058
6903,1,37,10,0,10,15,73,38.27752866668226,-109.4149364
6904,1,35,10,0,8,18,72,38.27752866668226,-109.4146669
6905,1,34,11,0,9,17,72,38.27752866668226,-109.4143974
6906,1,32,10,0,9,16,68,38.27752866668226,-109.4141279
6907,1,31,10,0,8,16,66,38.27752866668226,-109.4138584
6908,1,35,9,1,10,9,65,38.27752866668226,-109.4135889
6909,1,46,9,3,15,3,77,38.27752866668226,-109.4133194
6910,3,48,11,4,17,2,85,38.27752866668226,-109.4130499
6911,3,48,10,2,16,5,84,38.27752866668226,-109.4127804
6912,2,46,9,0,13,8,78,38.27752866668226,-109.4125109
6913,1,34,9,0,8,13,65,38.27752866668226,-109.4122414
6914,2,32,11,3,10,11,69,38.27752866668226,-109.4119719
6915,7,34,12,7,13,5,78,38.27752866668226,-109.4117024
6916,8,37,13,8,15,3,84,38.27752866668226,-109.4114329
6917,8,42,14,9,15,3,91,38.27752866668226,-109.4111634
6918,7,44,13,9,15,2,90,38.27752866668226,-109.4108939
6919,5,44,13,7,14,3,86,38.27752866668226,-109.4106244
6920,5,45,12,6,14,3,85,38.27752866668226,-109.4103549
6921,4,48,12,4,15,3,86,38.27752866668226,-109.4100855
6922,5,48,12,5,15,3,88,38.27752866668226,-109.409816
6923,5,48,13,5,15,2,88,38.27752866668226,-109.4095465
6924,4,48,13,5,16,2,88,38.27752866668226,-109.409277
6925,4,49,13,5,17,2,90,38.27752866668226,-109.4090075
6926,4,49,13,5,16,2,89,38.27752866668226,-109.408738
6927,5,45,12,4,16,3,85,38.27752866668226,-109.4084685
6928,5,44,13,7,15,3,87,38.27752866668226,-109.408199
6929,6,43,13,8,15,3,88,38.27752866668226,-109.4079295
6930,5,42,12,6,14,5,84,38.27752866668226,-109.40766
6931,4,43,13,4,15,5,84,38.27752866668226,-109.4073905
6932,4,45,12,4,14,5,84,38.27752866668226,-109.407121
6933,5,43,10,5,12,4,79,38.27752866668226,-109.4068515
6934,1,27,12,0,4,18,62,38.27752866668226,-109.3879869
6935,1,24,13,0,4,20,62,38.27752866668226,-109.3877174
6936,1,23,13,0,4,22,63,38.27752866668226,-109.3874479
6937,1,23,14,0,3,23,64,38.27752866668226,-109.3871784
6938,3,24,14,0,3,22,66,38.27752866668226,-109.3869089
6939,3,24,14,0,4,21,66,38.27752866668226,-109.3866394
6940,3,24,14,0,4,20,65,38.27752866668226,-109.3863699
6941,4,24,14,0,4,19,65,38.27752866668226,-109.3861004
6942,3,23,14,0,3,21,64,38.27752866668226,-109.3858309
6943,4,25,14,0,4,18,65,38.27752866668226,-109.3855614
6944,3,24,14,0,4,19,64,38.27752866668226,-109.3852919
6945,3,23,14,0,4,20,64,38.27752866668226,-109.3850225
6946,3,25,15,0,4,22,69,38.27752866668226,-109.384753
6947,1,22,13,0,4,21,61,38.27752866668226,-109.3844835
6948,2,23,13,0,4,20,62,38.27752866668226,-109.384214
6949,3,24,13,0,4,19,63,38.27752866668226,-109.3839445
6950,3,24,13,0,4,19,63,38.27752866668226,-109.383675
6951,1,22,12,0,3,21,59,38.27752866668226,-109.3834055
6952,2,24,13,0,4,20,63,38.27752866668226,-109.383136
6953,1,23,13,0,3,22,62,38.27752866668226,-109.3828665
6954,0,22,13,0,3,22,60,38.27752866668226,-109.382597
6955,0,24,12,0,4,20,60,38.27752866668226,-109.3823275
6956,0,23,10,0,4,17,54,38.27752866668226,-109.382058
6957,0,23,10,0,4,18,55,38.27752866668226,-109.3817885
6958,0,23,11,0,4,20,58,38.27752866668226,-109.381519
6959,0,23,13,0,3,23,62,38.27752866668226,-109.3812495
6960,0,24,14,0,3,24,65,38.27752866668226,-109.38098
6961,0,23,15,0,2,27,67,38.27752866668226,-109.3807105
6962,0,22,16,0,2,29,69,38.27752866668226,-109.380441
6963,0,23,15,0,2,27,67,38.27752866668226,-109.3801716
6964,0,24,13,0,2,23,62,38.27752866668226,-109.3799021
6965,1,23,14,0,4,22,64,38.27752866668226,-109.3796326
6966,1,20,14,0,2,25,62,38.27752866668226,-109.3793631
6967,1,19,14,0,2,24,60,38.27752866668226,-109.3790936
6968,1,18,13,1,3,21,57,38.27752866668226,-109.3788241
6969,8,20,11,0,0,19,58,38.27752866668226,-109.3785546
6970,7,23,9,0,2,15,56,38.27752866668226,-109.3782851
6971,5,24,7,1,4,9,50,38.27752866668226,-109.3780156
6972,3,31,5,3,7,5,54,38.27752866668226,-109.3777461
6973,1,34,3,2,6,4,50,38.27752866668226,-109.3774766
6974,2,29,4,1,6,4,46,38.27752866668226,-109.3772071
6975,2,29,5,1,8,5,50,38.27752866668226,-109.3769376
6976,2,31,6,3,8,5,55,38.27752866668226,-109.3766681
6977,2,32,7,3,8,5,57,38.27752866668226,-109.3763986
6978,2,35,7,4,8,5,61,38.27752866668226,-109.3761291
6979,1,39,7,3,8,5,63,38.27752866668226,-109.3758596
6980,1,48,7,3,10,4,73,38.27752866668226,-109.3755901
6981,2,49,7,3,10,4,75,38.27752866668226,-109.3753206
6982,2,49,7,4,10,4,76,38.27752866668226,-109.3750512
6983,2,50,7,4,9,3,75,38.27752866668226,-109.3747817
6984,2,52,7,4,9,3,77,38.27752866668226,-109.3745122
6985,2,48,6,4,9,4,73,38.27752866668226,-109.3742427
6986,1,45,6,3,9,4,68,38.27752866668226,-109.3739732
6987,1,45,6,3,10,4,69,38.27752866668226,-109.3737037
6988,0,47,6,2,10,4,69,38.27752866668226,-109.3734342
6989,2,50,7,4,10,3,76,38.27752866668226,-109.3731647
6990,2,42,7,3,10,6,70,38.27752866668226,-109.3728952
6991,1,37,8,3,11,7,67,38.27752866668226,-109.3726257
6992,1,41,9,4,12,7,74,38.27752866668226,-109.3723562
6993,2,40,8,2,9,8,69,38.27752866668226,-109.3720867
6994,5,14,10,10,11,7,57,38.27752866668226,-109.3718172
6995,4,17,11,10,12,8,62,38.27752866668226,-109.3715477
6996,2,23,11,6,10,12,64,38.27752866668226,-109.3712782
6997,1,28,11,1,9,15,65,38.27752866668226,-109.3710087
6998,1,28,12,0,9,16,66,38.27752866668226,-109.3707392
6999,4,30,15,9,5,15,78,38.27752866668226,-109.3704697
7000,5,28,16,8,5,16,78,38.27752866668226,-109.3702003
7001,2,31,12,0,9,16,70,38.27752866668226,-109.3699308
7002,2,40,11,1,12,10,76,38.27752866668226,-109.3696613
7003,1,50,10,4,14,5,84,38.27752866668226,-109.3693918
7004,6,35,8,10,11,3,73,38.27752866668226,-109.3691223
7005,6,31,8,10,10,3,68,38.27752866668226,-109.3688528
7006,6,31,7,9,10,3,66,38.27752866668226,-109.3685833
7007,4,43,8,4,9,9,77,38.27752866668226,-109.3683138
7008,5,37,10,6,9,7,74,38.27752866668226,-109.3680443
7009,1,51,9,2,11,6,80,38.27752866668226,-109.3677748
7010,2,43,9,4,11,7,76,38.27752866668226,-109.3675053
7011,2,43,9,4,11,5,74,38.27752866668226,-109.3672358
7012,1,27,9,4,11,8,60,38.27752866668226,-109.3669663
7013,5,26,9,10,12,4,66,38.27752866668226,-109.3666968
7014,7,25,9,7,14,5,67,38.27752866668226,-109.3664273
7015,9,27,9,6,13,7,71,38.27752866668226,-109.3661578
7016,10,31,10,12,9,5,77,38.27752866668226,-109.3658883
7017,7,14,10,6,9,7,53,38.27752866668226,-109.3656188
7018,5,13,11,4,8,12,53,38.27752866668226,-109.3653493
7019,2,14,13,2,4,20,55,38.27752866668226,-109.3650799
7020,2,17,14,1,3,24,61,38.27752866668226,-109.3648104
7021,3,20,16,1,3,25,68,38.27752866668226,-109.3645409
7022,1,17,14,0,2,25,59,38.27752866668226,-109.3642714
7023,1,17,15,0,2,26,61,38.27752866668226,-109.3640019
7024,1,16,16,0,2,28,63,38.27752866668226,-109.3637324
7025,0,18,17,0,3,31,69,38.27752866668226,-109.3634629
7026,0,22,18,0,6,28,74,38.27752866668226,-109.3631934
7027,0,26,17,1,8,24,76,38.27752866668226,-109.3629239
7028,0,26,17,0,7,28,78,38.27752866668226,-109.3626544
7029,0,24,17,0,5,31,77,38.27752866668226,-109.3623849
7030,1,25,17,0,5,29,77,38.27752866668226,-109.3621154
7031,0,23,17,0,4,30,74,38.27752866668226,-109.3618459
7032,0,21,18,0,3,32,74,38.27752866668226,-109.3615764
7033,0,21,18,0,4,32,75,38.27752866668226,-109.3613069
7034,0,21,18,0,3,33,75,38.27752866668226,-109.3610374
7035,1,19,18,0,4,31,73,38.27752866668226,-109.3607679
7036,1,22,19,0,4,33,79,38.27752866668226,-109.3604984
7037,0,22,18,0,4,33,77,38.27752866668226,-109.360229
7038,0,23,18,0,5,31,77,38.27752866668226,-109.3599595
7039,0,26,18,0,7,30,81,38.27752866668226,-109.35969
7040,0,25,17,1,6,29,78,38.27752866668226,-109.3594205
7041,1,24,17,2,7,29,80,38.27752866668226,-109.359151
7042,0,25,18,0,6,31,80,38.27752866668226,-109.3588815
7043,0,23,18,0,5,32,78,38.27752866668226,-109.358612
7044,0,24,17,0,7,28,76,38.27752866668226,-109.3583425
7045,0,24,17,0,7,30,78,38.27752866668226,-109.358073
7046,0,24,19,1,9,31,84,38.27752866668226,-109.3578035
7047,0,25,20,1,7,31,84,38.27752866668226,-109.357534
7048,0,25,19,0,5,30,79,38.27752866668226,-109.3572645
7049,0,25,19,0,5,29,78,38.27752866668226,-109.356995
7050,0,25,20,0,5,32,82,38.27752866668226,-109.3567255
7051,0,25,19,0,4,32,80,38.27752866668226,-109.356456
7052,0,23,17,0,4,30,74,38.27752866668226,-109.3561865
7053,1,22,17,0,3,29,72,38.27752866668226,-109.355917
7054,0,19,18,0,3,31,71,38.27752866668226,-109.3556475
7055,0,17,18,0,3,33,71,38.27752866668226,-109.355378
7056,0,20,19,0,4,32,75,38.27752866668226,-109.3551086
7057,1,22,20,1,4,31,79,38.27752866668226,-109.3548391
7058,0,21,19,0,3,32,75,38.27752866668226,-109.3545696
7059,0,26,20,2,6,28,82,38.27752866668226,-109.3543001
7060,1,26,20,2,7,27,83,38.27752866668226,-109.3540306
7061,3,25,19,3,7,26,83,38.27752866668226,-109.3537611
7062,2,24,20,3,6,26,81,38.27752866668226,-109.3534916
7063,4,24,21,3,6,27,85,38.27752866668226,-109.3532221
7064,2,20,21,2,5,32,82,38.27752866668226,-109.3529526
7065,2,19,22,2,5,34,84,38.27752866668226,-109.3526831
7066,1,19,22,3,6,34,85,38.27752866668226,-109.3524136
7067,1,20,22,3,6,34,86,38.27752866668226,-109.3521441
7068,2,20,21,2,6,34,85,38.27752866668226,-109.3518746
7069,3,24,19,2,5,29,82,38.27752866668226,-109.3516051
7070,3,26,18,2,5,24,78,38.27752866668226,-109.3513356
7071,3,25,17,1,5,23,74,38.27752866668226,-109.3510661
7072,1,25,17,0,6,24,73,38.27752866668226,-109.3507966
7073,3,28,18,1,7,24,81,38.27752866668226,-109.3505271
7074,3,29,18,4,9,20,83,38.27752866668226,-109.3502577
7075,4,31,16,8,11,15,85,38.27752866668226,-109.3499882
7076,5,31,15,13,12,8,84,38.27752866668226,-109.3497187
7077,5,30,14,19,12,5,85,38.27752866668226,-109.3494492
7078,8,30,14,16,12,6,86,38.27752866668226,-109.3491797
7079,8,30,14,16,12,7,87,38.27752866668226,-109.3489102
7080,9,32,14,15,11,7,88,38.27752866668226,-109.3486407
7081,11,33,14,13,11,7,89,38.27752866668226,-109.3483712
7082,9,33,14,14,12,6,88,38.27752866668226,-109.3481017
7083,9,30,14,19,9,6,87,38.27752866668226,-109.3478322
7084,10,29,14,21,9,5,88,38.27752866668226,-109.3475627
7085,13,28,13,21,10,4,89,38.27752866668226,-109.3472932
7086,13,30,13,18,11,4,89,38.27752866668226,-109.3470237
7087,11,33,14,14,11,6,89,38.27752866668226,-109.3467542
7088,10,34,14,14,10,6,88,38.27752866668226,-109.3464847
7089,9,35,14,14,10,5,87,38.27752866668226,-109.3462152
7090,9,36,14,15,10,4,88,38.27752866668226,-109.3459457
7091,8,39,14,14,11,3,89,38.27752866668226,-109.3456762
7092,10,37,13,15,11,3,89,38.27752866668226,-109.3454068
7093,9,36,14,15,11,4,89,38.27752866668226,-109.3451373
7094,8,36,14,14,11,5,88,38.27752866668226,-109.3448678
7095,2,47,10,1,13,9,82,38.277259172097025,-109.4319145
7096,1,48,10,1,12,9,81,38.277259172097025,-109.431645
7097,1,49,10,2,13,7,82,38.277259172097025,-109.4313755
7098,1,51,9,2,13,6,82,38.277259172097025,-109.431106
7099,1,53,9,2,13,6,84,38.277259172097025,-109.4308365
7100,1,52,9,1,13,6,82,38.277259172097025,-109.430567
7101,2,47,10,2,13,6,80,38.277259172097025,-109.4302975
7102,2,45,11,2,14,7,81,38.277259172097025,-109.430028
7103,2,47,11,2,14,7,83,38.277259172097025,-109.4297586
7104,2,48,11,1,13,8,83,38.277259172097025,-109.4294891
7105,2,48,11,1,13,8,83,38.277259172097025,-109.4292196
7106,3,48,11,2,13,7,84,38.277259172097025,-109.4289501
7107,3,49,11,2,13,5,83,38.277259172097025,-109.4286806
7108,3,49,11,5,14,4,86,38.277259172097025,-109.4284111
7109,3,49,11,4,13,5,85,38.277259172097025,-109.4281416
7110,2,45,10,2,12,7,78,38.277259172097025,-109.4278721
7111,2,40,10,2,9,8,71,38.277259172097025,-109.4276026
7112,2,37,10,4,10,4,67,38.277259172097025,-109.4273331
7113,3,40,12,7,16,1,79,38.277259172097025,-109.4270636
7114,0,35,12,3,18,8,76,38.277259172097025,-109.4267941
7115,0,34,12,0,15,15,76,38.277259172097025,-109.4265246
7116,1,40,12,0,16,11,80,38.277259172097025,-109.4262551
7117,3,50,13,3,18,4,91,38.277259172097025,-109.4259856
7118,3,48,13,5,20,2,91,38.277259172097025,-109.4257161
7119,4,47,13,5,21,1,91,38.277259172097025,-109.4254466
7120,4,46,13,6,21,1,91,38.277259172097025,-109.4251771
7121,4,48,13,5,20,1,91,38.277259172097025,-109.4249077
7122,4,48,13,4,20,1,90,38.277259172097025,-109.4246382
7123,4,46,13,6,21,1,91,38.277259172097025,-109.4243687
7124,4,45,13,7,21,1,91,38.277259172097025,-109.4240992
7125,4,46,12,5,21,2,90,38.277259172097025,-109.4238297
7126,3,47,12,4,20,3,89,38.277259172097025,-109.4235602
7127,3,49,12,3,17,6,90,38.277259172097025,-109.4232907
7128,2,49,11,0,15,9,86,38.277259172097025,-109.4230212
7129,2,47,11,0,14,11,85,38.277259172097025,-109.4227517
7130,1,42,11,0,13,13,80,38.277259172097025,-109.4224822
7131,0,34,12,0,11,17,74,38.277259172097025,-109.4222127
7132,0,34,12,0,12,17,75,38.277259172097025,-109.4219432
7133,0,33,11,0,12,16,72,38.277259172097025,-109.4216737
7134,0,31,11,0,11,16,69,38.277259172097025,-109.4214042
7135,0,32,11,0,9,16,68,38.277259172097025,-109.4211347
7136,0,33,10,0,8,18,69,38.277259172097025,-109.4208652
7137,0,34,10,0,8,17,69,38.277259172097025,-109.4205957
7138,0,32,10,0,8,17,67,38.277259172097025,-109.4203262
7139,0,30,11,0,8,19,68,38.277259172097025,-109.4200568
7140,0,28,12,0,8,19,67,38.277259172097025,-109.4197873
7141,0,29,11,1,11,13,65,38.277259172097025,-109.4195178
7142,0,32,10,4,14,8,68,38.277259172097025,-109.4192483
7143,0,34,10,1,15,9,69,38.277259172097025,-109.4189788
7144,0,34,10,0,13,11,68,38.277259172097025,-109.4187093
7145,1,34,11,0,13,13,72,38.277259172097025,-109.4184398
7146,1,33,12,1,12,15,74,38.277259172097025,-109.4181703
7147,2,32,12,0,10,17,73,38.277259172097025,-109.4179008
7148,2,34,12,0,10,18,76,38.277259172097025,-109.4176313
7149,2,36,13,1,13,15,80,38.277259172097025,-109.4173618
7150,3,40,12,2,14,10,81,38.277259172097025,-109.4170923
7151,4,43,12,2,16,7,84,38.277259172097025,-109.4168228
7152,5,43,12,3,16,6,85,38.277259172097025,-109.4165533
7153,5,42,12,2,15,7,83,38.277259172097025,-109.4162838
7154,4,43,11,2,15,7,82,38.277259172097025,-109.4160143
7155,3,40,11,1,13,10,78,38.277259172097025,-109.4157448
7156,3,40,11,1,12,11,78,38.277259172097025,-109.4154753
7157,3,42,11,1,13,10,80,38.277259172097025,-109.4152058
7158,3,41,10,1,13,10,78,38.277259172097025,-109.4149364
7159,3,39,11,1,12,11,77,38.277259172097025,-109.4146669
7160,2,36,11,1,12,13,75,38.277259172097025,-109.4143974
7161,2,31,11,0,8,17,69,38.277259172097025,-109.4141279
7162,1,29,11,0,6,19,66,38.277259172097025,-109.4138584
7163,1,41,9,0,11,11,73,38.277259172097025,-109.4135889
7164,2,46,10,1,15,6,80,38.277259172097025,-109.4133194
7165,7,44,12,5,16,4,88,38.277259172097025,-109.4130499
7166,8,45,13,5,16,3,90,38.277259172097025,-109.4127804
7167,5,44,12,3,15,5,84,38.277259172097025,-109.4125109
7168,3,39,11,1,13,8,75,38.277259172097025,-109.4122414
7169,3,37,12,3,12,9,76,38.277259172097025,-109.4119719
7170,5,37,12,7,14,5,80,38.277259172097025,-109.4117024
7171,6,40,13,8,15,3,85,38.277259172097025,-109.4114329
7172,6,45,13,6,15,4,89,38.277259172097025,-109.4111634
7173,5,48,12,4,15,3,87,38.277259172097025,-109.4108939
7174,5,49,13,5,15,3,90,38.277259172097025,-109.4106244
7175,4,50,13,5,15,3,90,38.277259172097025,-109.4103549
7176,4,52,12,4,15,3,90,38.277259172097025,-109.4100855
7177,4,49,12,4,15,4,88,38.277259172097025,-109.409816
7178,4,50,12,4,15,2,87,38.277259172097025,-109.4095465
7179,4,49,12,4,16,2,87,38.277259172097025,-109.409277
7180,4,49,12,4,16,2,87,38.277259172097025,-109.4090075
7181,4,48,12,5,16,2,87,38.277259172097025,-109.408738
7182,4,45,13,7,16,2,87,38.277259172097025,-109.4084685
7183,5,43,13,9,15,2,87,38.277259172097025,-109.408199
7184,5,42,13,8,15,3,86,38.277259172097025,-109.4079295
7185,4,41,12,6,14,4,81,38.277259172097025,-109.40766
7186,4,41,13,6,15,4,83,38.277259172097025,-109.4073905
7187,5,42,12,6,14,4,83,38.277259172097025,-109.407121
7188,5,40,11,8,12,4,80,38.277259172097025,-109.4068515
7189,1,26,11,0,6,16,60,38.277259172097025,-109.3879869
7190,1,24,12,0,5,18,60,38.277259172097025,-109.3877174
7191,2,25,12,0,5,19,63,38.277259172097025,-109.3874479
7192,2,24,13,0,5,19,63,38.277259172097025,-109.3871784
7193,4,27,13,0,5,16,65,38.277259172097025,-109.3869089
7194,4,23,14,1,4,19,65,38.277259172097025,-109.3866394
7195,4,21,14,1,4,18,62,38.277259172097025,-109.3863699
7196,5,24,14,2,5,16,66,38.277259172097025,-109.3861004
7197,4,23,15,1,3,20,66,38.277259172097025,-109.3858309
7198,5,22,15,1,3,20,66,38.277259172097025,-109.3855614
7199,4,20,15,1,3,22,65,38.277259172097025,-109.3852919
7200,4,22,16,1,3,21,67,38.277259172097025,-109.3850225
7201,6,25,16,1,4,19,71,38.277259172097025,-109.384753
7202,3,22,14,0,4,20,63,38.277259172097025,-109.3844835
7203,3,21,15,0,4,22,65,38.277259172097025,-109.384214
7204,4,23,14,0,4,21,66,38.277259172097025,-109.3839445
7205,3,23,12,0,4,18,60,38.277259172097025,-109.383675
7206,2,25,10,0,5,15,57,38.277259172097025,-109.3834055
7207,2,25,12,0,5,17,61,38.277259172097025,-109.383136
7208,1,24,12,0,4,19,60,38.277259172097025,-109.3828665
7209,1,24,12,0,3,20,60,38.277259172097025,-109.382597
7210,1,24,12,0,4,20,61,38.277259172097025,-109.3823275
7211,0,22,12,0,3,21,58,38.277259172097025,-109.382058
7212,0,24,12,0,4,20,60,38.277259172097025,-109.3817885
7213,0,23,12,0,4,21,60,38.277259172097025,-109.381519
7214,0,23,13,0,3,23,62,38.277259172097025,-109.3812495
7215,0,22,15,0,3,27,67,38.277259172097025,-109.38098
7216,1,22,16,0,2,27,68,38.277259172097025,-109.3807105
7217,0,22,17,0,1,29,69,38.277259172097025,-109.380441
7218,0,23,15,0,2,26,66,38.277259172097025,-109.3801716
7219,0,24,12,0,3,22,61,38.277259172097025,-109.3799021
7220,0,22,12,0,3,20,57,38.277259172097025,-109.3796326
7221,1,19,14,0,2,23,59,38.277259172097025,-109.3793631
7222,1,18,12,2,3,19,55,38.277259172097025,-109.3790936
7223,4,22,8,1,3,13,51,38.277259172097025,-109.3788241
7224,5,33,6,3,5,6,58,38.277259172097025,-109.3785546
7225,3,41,4,4,8,3,63,38.277259172097025,-109.3782851
7226,1,41,4,2,8,3,59,38.277259172097025,-109.3780156
7227,1,28,4,0,7,5,45,38.277259172097025,-109.3777461
7228,3,33,5,0,8,4,53,38.277259172097025,-109.3774766
7229,2,27,7,2,7,6,51,38.277259172097025,-109.3772071
7230,2,30,7,5,9,6,59,38.277259172097025,-109.3769376
7231,2,36,9,5,10,6,68,38.277259172097025,-109.3766681
7232,2,39,9,5,11,6,72,38.277259172097025,-109.3763986
7233,1,38,10,4,10,7,70,38.277259172097025,-109.3761291
7234,1,36,7,3,10,7,64,38.277259172097025,-109.3758596
7235,2,45,7,4,9,4,71,38.277259172097025,-109.3755901
7236,1,45,7,2,10,5,70,38.277259172097025,-109.3753206
7237,1,44,7,2,11,6,71,38.277259172097025,-109.3750512
7238,1,46,8,2,11,6,74,38.277259172097025,-109.3747817
7239,1,47,7,2,10,6,73,38.277259172097025,-109.3745122
7240,1,39,8,3,10,7,68,38.277259172097025,-109.3742427
7241,1,37,8,3,10,8,67,38.277259172097025,-109.3739732
7242,1,40,8,3,10,7,69,38.277259172097025,-109.3737037
7243,1,42,7,3,9,6,68,38.277259172097025,-109.3734342
7244,2,38,7,4,9,7,67,38.277259172097025,-109.3731647
7245,2,34,8,5,10,7,66,38.277259172097025,-109.3728952
7246,0,39,9,2,11,9,70,38.277259172097025,-109.3726257
7247,0,29,9,3,6,12,59,38.277259172097025,-109.3723562
7248,4,21,11,5,5,14,60,38.277259172097025,-109.3720867
7249,8,13,11,14,11,7,64,38.277259172097025,-109.3718172
7250,4,18,11,9,10,8,60,38.277259172097025,-109.3715477
7251,3,26,10,3,10,11,63,38.277259172097025,-109.3712782
7252,2,28,11,1,9,16,67,38.277259172097025,-109.3710087
7253,2,25,13,2,8,18,68,38.277259172097025,-109.3707392
7254,3,30,15,9,5,15,77,38.277259172097025,-109.3704697
7255,4,30,15,10,5,14,78,38.277259172097025,-109.3702003
7256,3,32,13,3,10,13,74,38.277259172097025,-109.3699308
7257,4,37,13,6,10,11,81,38.277259172097025,-109.3696613
7258,4,39,13,9,9,9,83,38.277259172097025,-109.3693918
7259,4,39,14,12,9,8,86,38.277259172097025,-109.3691223
7260,5,38,14,13,9,6,85,38.277259172097025,-109.3688528
7261,7,28,10,13,12,5,75,38.277259172097025,-109.3685833
7262,7,34,14,3,12,10,80,38.277259172097025,-109.3683138
7263,6,35,12,2,12,8,75,38.277259172097025,-109.3680443
7264,4,36,12,8,17,3,80,38.277259172097025,-109.3677748
7265,3,34,12,10,17,3,79,38.277259172097025,-109.3675053
7266,3,29,10,14,11,5,72,38.277259172097025,-109.3672358
7267,1,27,10,10,16,5,69,38.277259172097025,-109.3669663
7268,1,27,11,12,19,1,71,38.277259172097025,-109.3666968
7269,5,27,11,14,14,4,75,38.277259172097025,-109.3664273
7270,6,20,10,18,13,8,75,38.277259172097025,-109.3661578
7271,6,25,8,16,12,8,75,38.277259172097025,-109.3658883
7272,9,27,9,14,12,5,76,38.277259172097025,-109.3656188
7273,3,21,9,8,10,7,58,38.277259172097025,-109.3653493
7274,1,20,12,3,6,16,58,38.277259172097025,-109.3650799
7275,1,19,14,0,3,24,61,38.277259172097025,-109.3648104
7276,2,21,17,0,4,29,73,38.277259172097025,-109.3645409
7277,0,17,17,0,2,32,68,38.277259172097025,-109.3642714
7278,0,17,18,0,3,33,71,38.277259172097025,-109.3640019
7279,0,20,20,0,4,32,76,38.277259172097025,-109.3637324
7280,0,22,21,0,7,30,80,38.277259172097025,-109.3634629
7281,0,23,20,0,6,28,77,38.277259172097025,-109.3631934
7282,1,23,15,3,8,23,73,38.277259172097025,-109.3629239
7283,0,24,16,1,7,28,76,38.277259172097025,-109.3626544
7284,0,23,18,0,5,32,78,38.277259172097025,-109.3623849
7285,0,24,18,0,4,32,78,38.277259172097025,-109.3621154
7286,0,23,19,0,4,33,79,38.277259172097025,-109.3618459
7287,0,22,19,0,4,33,78,38.277259172097025,-109.3615764
7288,0,22,20,0,4,33,79,38.277259172097025,-109.3613069
7289,0,22,21,0,4,34,81,38.277259172097025,-109.3610374
7290,0,21,20,0,4,34,79,38.277259172097025,-109.3607679
7291,0,21,20,0,3,35,79,38.277259172097025,-109.3604984
7292,0,23,18,0,4,33,78,38.277259172097025,-109.360229
7293,0,25,18,0,6,30,79,38.277259172097025,-109.3599595
7294,1,26,17,0,7,28,79,38.277259172097025,-109.35969
7295,0,25,16,2,6,28,77,38.277259172097025,-109.3594205
7296,0,26,16,1,7,28,78,38.277259172097025,-109.359151
7297,0,23,17,0,5,31,76,38.277259172097025,-109.3588815
7298,0,21,17,0,4,31,73,38.277259172097025,-109.358612
7299,0,21,17,0,3,29,70,38.277259172097025,-109.3583425
7300,1,23,17,1,5,27,74,38.277259172097025,-109.358073
7301,0,22,17,0,7,27,73,38.277259172097025,-109.3578035
7302,0,24,16,0,8,27,75,38.277259172097025,-109.357534
7303,0,23,17,1,6,28,75,38.277259172097025,-109.3572645
7304,0,23,19,0,5,31,78,38.277259172097025,-109.356995
7305,1,26,18,1,6,28,80,38.277259172097025,-109.3567255
7306,1,25,17,0,5,27,75,38.277259172097025,-109.356456
7307,2,24,16,1,4,25,72,38.277259172097025,-109.3561865
7308,2,23,15,2,4,23,69,38.277259172097025,-109.355917
7309,1,21,16,0,3,27,68,38.277259172097025,-109.3556475
7310,0,20,17,0,4,29,70,38.277259172097025,-109.355378
7311,0,21,19,1,5,30,76,38.277259172097025,-109.3551086
7312,0,26,20,1,7,28,82,38.277259172097025,-109.3548391
7313,2,26,20,4,7,26,85,38.277259172097025,-109.3545696
7314,1,25,18,2,6,26,78,38.277259172097025,-109.3543001
7315,3,25,19,2,5,26,80,38.277259172097025,-109.3540306
7316,2,27,19,2,6,27,83,38.277259172097025,-109.3537611
7317,2,28,20,4,8,23,85,38.277259172097025,-109.3534916
7318,2,26,20,3,9,25,85,38.277259172097025,-109.3532221
7319,2,24,20,2,7,29,84,38.277259172097025,-109.3529526
7320,1,22,21,2,7,31,84,38.277259172097025,-109.3526831
7321,1,21,21,3,6,32,84,38.277259172097025,-109.3524136
7322,1,22,21,3,7,30,84,38.277259172097025,-109.3521441
7323,1,25,20,1,4,31,82,38.277259172097025,-109.3518746
7324,2,27,17,0,4,25,75,38.277259172097025,-109.3516051
7325,3,27,17,1,6,22,76,38.277259172097025,-109.3513356
7326,3,28,18,2,8,21,80,38.277259172097025,-109.3510661
7327,3,28,19,2,8,23,83,38.277259172097025,-109.3507966
7328,3,24,20,4,8,25,84,38.277259172097025,-109.3505271
7329,3,28,20,3,9,22,85,38.277259172097025,-109.3502577
7330,4,29,18,5,9,20,85,38.277259172097025,-109.3499882
7331,5,29,16,10,11,15,86,38.277259172097025,-109.3497187
7332,4,29,15,19,13,7,87,38.277259172097025,-109.3494492
7333,6,30,15,16,12,7,86,38.277259172097025,-109.3491797
7334,8,31,15,15,12,7,88,38.277259172097025,-109.3489102
7335,8,31,14,16,12,7,88,38.277259172097025,-109.3486407
7336,9,30,14,17,10,7,87,38.277259172097025,-109.3483712
7337,8,29,14,21,9,6,87,38.277259172097025,-109.3481017
7338,10,29,14,19,10,7,89,38.277259172097025,-109.3478322
7339,10,28,14,19,10,6,87,38.277259172097025,-109.3475627
7340,11,28,14,19,11,5,88,38.277259172097025,-109.3472932
7341,11,31,14,14,11,6,87,38.277259172097025,-109.3470237
7342,10,31,15,15,11,7,89,38.277259172097025,-109.3467542
7343,9,33,14,15,10,7,88,38.277259172097025,-109.3464847
7344,9,34,14,15,10,6,88,38.277259172097025,-109.3462152
7345,9,36,14,14,10,4,87,38.277259172097025,-109.3459457
7346,8,39,14,11,13,4,89,38.277259172097025,-109.3456762
7347,9,37,14,13,12,3,88,38.277259172097025,-109.3454068
7348,8,36,14,14,11,5,88,38.277259172097025,-109.3451373
7349,7,36,14,15,10,5,87,38.277259172097025,-109.3448678
7350,8,37,14,15,10,4,88,38.277259172097025,-109.3445983
7351,1,48,10,1,13,9,82,38.27698967751179,-109.432184
7352,1,43,10,0,11,10,75,38.27698967751179,-109.4319145
7353,2,41,9,0,10,9,71,38.27698967751179,-109.431645
7354,1,39,9,1,10,9,69,38.27698967751179,-109.4313755
7355,1,37,10,0,11,11,70,38.27698967751179,-109.431106
7356,2,39,10,0,10,10,71,38.27698967751179,-109.4308365
7357,2,39,9,1,11,8,70,38.27698967751179,-109.430567
7358,1,39,10,1,12,8,71,38.27698967751179,-109.4302975
7359,2,40,10,0,11,11,74,38.27698967751179,-109.430028
7360,1,41,10,0,11,11,74,38.27698967751179,-109.4297586
7361,2,43,10,1,12,7,75,38.27698967751179,-109.4294891
7362,2,46,10,3,12,6,79,38.27698967751179,-109.4292196
7363,3,47,11,3,12,6,82,38.27698967751179,-109.4289501
7364,3,47,11,3,13,7,84,38.27698967751179,-109.4286806
7365,3,47,11,2,13,7,83,38.27698967751179,-109.4284111
7366,2,44,11,3,13,6,79,38.27698967751179,-109.4281416
7367,2,41,10,2,10,7,72,38.27698967751179,-109.4278721
7368,3,37,9,3,8,8,68,38.27698967751179,-109.4276026
7369,0,38,11,2,15,7,73,38.27698967751179,-109.4273331
7370,2,38,11,4,23,4,82,38.27698967751179,-109.4270636
7371,0,37,12,0,17,13,79,38.27698967751179,-109.4267941
7372,1,40,12,0,15,13,81,38.27698967751179,-109.4265246
7373,2,46,12,0,16,9,85,38.27698967751179,-109.4262551
7374,3,47,13,3,19,4,89,38.27698967751179,-109.4259856
7375,3,46,13,5,20,2,89,38.27698967751179,-109.4257161
7376,4,45,13,6,20,1,89,38.27698967751179,-109.4254466
7377,4,45,13,7,20,1,90,38.27698967751179,-109.4251771
7378,4,46,13,9,19,1,92,38.27698967751179,-109.4249077
7379,4,45,13,8,20,0,90,38.27698967751179,-109.4246382
7380,4,43,13,9,21,1,91,38.27698967751179,-109.4243687
7381,4,43,12,7,21,1,88,38.27698967751179,-109.4240992
7382,4,45,13,6,21,2,91,38.27698967751179,-109.4238297
7383,4,46,13,6,20,2,91,38.27698967751179,-109.4235602
7384,3,47,13,5,19,3,90,38.27698967751179,-109.4232907
7385,2,48,12,2,17,6,87,38.27698967751179,-109.4230212
7386,2,46,11,0,15,10,84,38.27698967751179,-109.4227517
7387,1,41,11,0,13,13,79,38.27698967751179,-109.4224822
7388,0,33,12,0,11,18,74,38.27698967751179,-109.4222127
7389,0,33,12,0,13,14,72,38.27698967751179,-109.4219432
7390,0,32,12,0,14,14,72,38.27698967751179,-109.4216737
7391,0,29,12,1,12,16,70,38.27698967751179,-109.4214042
7392,1,31,11,0,8,18,69,38.27698967751179,-109.4211347
7393,0,35,11,0,10,16,72,38.27698967751179,-109.4208652
7394,0,36,10,0,9,17,72,38.27698967751179,-109.4205957
7395,0,34,10,0,8,18,70,38.27698967751179,-109.4203262
7396,0,32,11,0,9,17,69,38.27698967751179,-109.4200568
7397,0,28,10,3,10,13,64,38.27698967751179,-109.4197873
7398,0,33,9,4,10,8,64,38.27698967751179,-109.4195178
7399,0,34,9,3,12,8,66,38.27698967751179,-109.4192483
7400,0,33,10,1,12,10,66,38.27698967751179,-109.4189788
7401,0,34,9,0,11,12,66,38.27698967751179,-109.4187093
7402,1,34,10,0,10,14,69,38.27698967751179,-109.4184398
7403,1,37,10,0,10,15,73,38.27698967751179,-109.4181703
7404,2,38,11,0,11,15,77,38.27698967751179,-109.4179008
7405,2,37,11,0,12,14,76,38.27698967751179,-109.4176313
7406,2,38,12,1,14,12,79,38.27698967751179,-109.4173618
7407,3,39,11,1,14,11,79,38.27698967751179,-109.4170923
7408,4,41,11,2,15,8,81,38.27698967751179,-109.4168228
7409,4,42,12,3,16,6,83,38.27698967751179,-109.4165533
7410,3,43,12,3,15,7,83,38.27698967751179,-109.4162838
7411,3,45,12,2,15,6,83,38.27698967751179,-109.4160143
7412,5,44,12,3,17,4,85,38.27698967751179,-109.4157448
7413,4,46,12,4,18,3,87,38.27698967751179,-109.4154753
7414,3,47,12,4,17,4,87,38.27698967751179,-109.4152058
7415,4,45,12,4,16,5,86,38.27698967751179,-109.4149364
7416,4,42,12,3,16,6,83,38.27698967751179,-109.4146669
7417,3,38,11,2,13,10,77,38.27698967751179,-109.4143974
7418,1,34,10,0,10,14,69,38.27698967751179,-109.4141279
7419,1,35,10,0,10,13,69,38.27698967751179,-109.4138584
7420,2,42,10,1,16,6,77,38.27698967751179,-109.4135889
7421,3,45,11,4,17,4,84,38.27698967751179,-109.4133194
7422,7,44,13,6,17,3,90,38.27698967751179,-109.4130499
7423,7,43,13,7,17,3,90,38.27698967751179,-109.4127804
7424,6,43,13,5,16,4,87,38.27698967751179,-109.4125109
7425,6,44,12,4,16,5,87,38.27698967751179,-109.4122414
7426,5,41,11,5,16,5,83,38.27698967751179,-109.4119719
7427,5,41,12,6,16,3,83,38.27698967751179,-109.4117024
7428,5,42,12,6,16,3,84,38.27698967751179,-109.4114329
7429,5,45,12,5,16,4,87,38.27698967751179,-109.4111634
7430,5,49,13,5,17,3,92,38.27698967751179,-109.4108939
7431,5,49,13,5,16,3,91,38.27698967751179,-109.4106244
7432,5,48,13,6,16,3,91,38.27698967751179,-109.4103549
7433,5,48,13,7,17,2,92,38.27698967751179,-109.4100855
7434,4,49,13,5,16,2,89,38.27698967751179,-109.409816
7435,4,49,12,4,17,3,89,38.27698967751179,-109.4095465
7436,4,49,12,4,16,3,88,38.27698967751179,-109.409277
7437,5,48,12,4,16,3,88,38.27698967751179,-109.4090075
7438,5,48,12,4,15,3,87,38.27698967751179,-109.408738
7439,4,45,12,4,15,4,84,38.27698967751179,-109.4084685
7440,5,43,12,6,15,3,84,38.27698967751179,-109.408199
7441,5,42,12,6,15,3,83,38.27698967751179,-109.4079295
7442,4,41,12,7,15,3,82,38.27698967751179,-109.40766
7443,5,38,12,6,14,5,80,38.27698967751179,-109.4073905
7444,6,43,12,5,13,5,84,38.27698967751179,-109.407121
7445,4,41,11,8,12,6,82,38.27698967751179,-109.4068515
7446,1,26,11,1,6,15,60,38.27698967751179,-109.3879869
7447,1,26,12,0,5,18,62,38.27698967751179,-109.3877174
7448,1,26,12,0,5,19,63,38.27698967751179,-109.3874479
7449,1,25,12,0,6,17,61,38.27698967751179,-109.3871784
7450,4,27,12,1,7,13,64,38.27698967751179,-109.3869089
7451,5,23,11,2,6,12,59,38.27698967751179,-109.3866394
7452,6,20,11,3,7,11,58,38.27698967751179,-109.3863699
7453,7,19,10,3,7,10,56,38.27698967751179,-109.3861004
7454,9,24,9,4,3,11,60,38.27698967751179,-109.3858309
7455,3,14,11,4,3,15,50,38.27698967751179,-109.3855614
7456,3,15,14,2,3,22,59,38.27698967751179,-109.3852919
7457,4,21,16,1,3,21,66,38.27698967751179,-109.3850225
7458,7,24,16,2,5,16,70,38.27698967751179,-109.384753
7459,3,21,15,1,5,21,66,38.27698967751179,-109.3844835
7460,3,22,16,0,5,22,68,38.27698967751179,-109.384214
7461,4,24,14,0,5,18,65,38.27698967751179,-109.3839445
7462,3,24,12,0,5,15,59,38.27698967751179,-109.383675
7463,3,28,10,0,7,12,60,38.27698967751179,-109.3834055
7464,2,26,10,0,6,13,57,38.27698967751179,-109.383136
7465,2,29,10,0,7,13,61,38.27698967751179,-109.3828665
7466,2,29,11,0,6,13,61,38.27698967751179,-109.382597
7467,2,24,12,0,5,17,60,38.27698967751179,-109.3823275
7468,1,24,14,0,5,23,67,38.27698967751179,-109.382058
7469,0,23,14,0,5,25,67,38.27698967751179,-109.3817885
7470,0,24,15,0,4,26,69,38.27698967751179,-109.381519
7471,1,25,16,0,3,27,72,38.27698967751179,-109.3812495
7472,1,25,17,0,3,28,74,38.27698967751179,-109.38098
7473,1,23,15,0,3,25,67,38.27698967751179,-109.3807105
7474,1,22,14,1,3,24,65,38.27698967751179,-109.380441
7475,1,24,12,0,4,20,61,38.27698967751179,-109.3801716
7476,1,27,11,1,5,16,61,38.27698967751179,-109.3799021
7477,2,26,11,2,6,14,61,38.27698967751179,-109.3796326
7478,3,21,12,3,5,16,60,38.27698967751179,-109.3793631
7479,4,20,9,2,7,12,54,38.27698967751179,-109.3790936
7480,4,35,5,1,5,8,58,38.27698967751179,-109.3788241
7481,2,44,4,1,7,4,62,38.27698967751179,-109.3785546
7482,1,35,3,0,6,5,50,38.27698967751179,-109.3782851
7483,2,31,4,0,7,5,49,38.27698967751179,-109.3780156
7484,3,31,6,1,8,5,54,38.27698967751179,-109.3777461
7485,2,31,6,1,8,5,53,38.27698967751179,-109.3774766
7486,4,30,7,2,8,6,57,38.27698967751179,-109.3772071
7487,4,24,10,6,7,10,61,38.27698967751179,-109.3769376
7488,4,23,12,6,6,12,63,38.27698967751179,-109.3766681
7489,2,30,12,4,12,10,70,38.27698967751179,-109.3763986
7490,1,40,11,2,13,7,74,38.27698967751179,-109.3761291
7491,2,40,10,3,11,6,72,38.27698967751179,-109.3758596
7492,2,36,10,4,11,8,71,38.27698967751179,-109.3755901
7493,1,32,10,2,10,12,67,38.27698967751179,-109.3753206
7494,2,30,11,2,9,14,68,38.27698967751179,-109.3750512
7495,1,27,11,2,7,17,65,38.27698967751179,-109.3747817
7496,1,33,10,3,11,9,67,38.27698967751179,-109.3745122
7497,1,31,11,2,10,11,66,38.27698967751179,-109.3742427
7498,1,34,10,2,11,9,67,38.27698967751179,-109.3739732
7499,0,37,8,2,10,9,66,38.27698967751179,-109.3737037
7500,1,36,7,3,9,7,63,38.27698967751179,-109.3734342
7501,2,36,7,5,9,8,67,38.27698967751179,-109.3731647
7502,1,35,9,4,10,10,69,38.27698967751179,-109.3728952
7503,1,38,9,1,10,12,71,38.27698967751179,-109.3726257
7504,2,29,11,3,7,14,66,38.27698967751179,-109.3723562
7505,2,17,11,6,6,13,55,38.27698967751179,-109.3720867
7506,4,14,11,13,10,11,63,38.27698967751179,-109.3718172
7507,2,18,13,8,8,17,66,38.27698967751179,-109.3715477
7508,3,28,15,2,9,20,77,38.27698967751179,-109.3712782
7509,3,28,14,3,6,22,76,38.27698967751179,-109.3710087
7510,1,27,14,0,7,23,72,38.27698967751179,-109.3707392
7511,2,25,14,0,9,23,73,38.27698967751179,-109.3704697
7512,3,25,13,5,12,15,73,38.27698967751179,-109.3702003
7513,3,24,13,9,10,12,71,38.27698967751179,-109.3699308
7514,3,22,13,8,9,15,70,38.27698967751179,-109.3696613
7515,5,23,15,7,9,17,76,38.27698967751179,-109.3693918
7516,6,27,14,4,14,14,79,38.27698967751179,-109.3691223
7517,8,29,15,10,10,15,87,38.27698967751179,-109.3688528
7518,9,22,13,18,7,10,79,38.27698967751179,-109.3685833
7519,11,17,12,21,8,7,76,38.27698967751179,-109.3683138
7520,16,28,10,17,9,3,83,38.27698967751179,-109.3680443
7521,15,25,10,20,8,3,81,38.27698967751179,-109.3677748
7522,6,27,12,20,17,2,84,38.27698967751179,-109.3675053
7523,4,31,13,14,21,3,86,38.27698967751179,-109.3672358
7524,3,25,11,16,24,1,80,38.27698967751179,-109.3669663
7525,8,22,10,14,14,2,70,38.27698967751179,-109.3666968
7526,9,17,10,18,14,4,72,38.27698967751179,-109.3664273
7527,6,15,10,24,14,8,77,38.27698967751179,-109.3661578
7528,5,20,10,17,14,9,75,38.27698967751179,-109.3658883
7529,7,23,10,14,12,10,76,38.27698967751179,-109.3656188
7530,1,22,12,5,8,17,65,38.27698967751179,-109.3653493
7531,0,21,15,0,4,26,66,38.27698967751179,-109.3650799
7532,0,21,16,0,3,30,70,38.27698967751179,-109.3648104
7533,0,21,19,0,3,33,76,38.27698967751179,-109.3645409
7534,0,22,21,0,5,33,81,38.27698967751179,-109.3642714
7535,0,22,22,0,6,32,82,38.27698967751179,-109.3640019
7536,0,21,21,2,7,31,82,38.27698967751179,-109.3637324
7537,0,21,21,3,7,30,82,38.27698967751179,-109.3634629
7538,0,22,20,2,6,31,81,38.27698967751179,-109.3631934
7539,0,23,18,2,7,27,77,38.27698967751179,-109.3629239
7540,0,24,18,0,6,31,79,38.27698967751179,-109.3626544
7541,0,23,18,0,4,32,77,38.27698967751179,-109.3623849
7542,0,25,18,0,4,31,78,38.27698967751179,-109.3621154
7543,0,26,19,0,5,31,81,38.27698967751179,-109.3618459
7544,0,25,19,0,5,32,81,38.27698967751179,-109.3615764
7545,0,25,20,0,5,31,81,38.27698967751179,-109.3613069
7546,0,24,20,0,5,32,81,38.27698967751179,-109.3610374
7547,0,23,19,0,4,32,78,38.27698967751179,-109.3607679
7548,0,23,19,0,4,33,79,38.27698967751179,-109.3604984
7549,0,24,18,0,4,32,78,38.27698967751179,-109.360229
7550,0,25,18,0,6,29,78,38.27698967751179,-109.3599595
7551,0,26,17,0,6,28,77,38.27698967751179,-109.35969
7552,0,26,17,0,6,28,77,38.27698967751179,-109.3594205
7553,0,24,16,0,5,28,73,38.27698967751179,-109.359151
7554,0,23,15,0,4,27,69,38.27698967751179,-109.3588815
7555,0,22,15,0,3,26,66,38.27698967751179,-109.358612
7556,1,22,15,0,2,26,66,38.27698967751179,-109.3583425
7557,1,19,16,0,1,27,64,38.27698967751179,-109.358073
7558,1,20,15,0,2,26,64,38.27698967751179,-109.3578035
7559,1,21,15,0,3,25,65,38.27698967751179,-109.357534
7560,1,21,15,0,3,25,65,38.27698967751179,-109.3572645
7561,1,23,15,0,3,24,66,38.27698967751179,-109.356995
7562,1,21,15,0,2,24,63,38.27698967751179,-109.3567255
7563,1,20,14,0,2,24,61,38.27698967751179,-109.356456
7564,1,20,13,0,3,23,60,38.27698967751179,-109.3561865
7565,1,20,13,1,3,21,59,38.27698967751179,-109.355917
7566,0,20,14,2,3,22,61,38.27698967751179,-109.3556475
7567,0,21,15,1,4,23,64,38.27698967751179,-109.355378
7568,1,21,16,3,5,23,69,38.27698967751179,-109.3551086
7569,0,24,17,3,7,25,76,38.27698967751179,-109.3548391
7570,1,27,18,4,7,25,82,38.27698967751179,-109.3545696
7571,1,26,17,6,8,24,82,38.27698967751179,-109.3543001
7572,0,26,19,4,8,25,82,38.27698967751179,-109.3540306
7573,1,27,19,3,7,26,83,38.27698967751179,-109.3537611
7574,1,27,20,1,8,29,86,38.27698967751179,-109.3534916
7575,1,27,20,1,8,29,86,38.27698967751179,-109.3532221
7576,2,25,18,1,7,28,81,38.27698967751179,-109.3529526
7577,1,26,20,0,7,29,83,38.27698967751179,-109.3526831
7578,1,26,20,1,6,29,83,38.27698967751179,-109.3524136
7579,2,24,19,3,6,27,81,38.27698967751179,-109.3521441
7580,3,25,18,5,7,23,81,38.27698967751179,-109.3518746
7581,4,30,18,5,5,22,84,38.27698967751179,-109.3516051
7582,4,29,19,3,5,23,83,38.27698967751179,-109.3513356
7583,4,27,20,5,7,21,84,38.27698967751179,-109.3510661
7584,4,26,21,4,6,23,84,38.27698967751179,-109.3507966
7585,3,24,20,4,7,25,83,38.27698967751179,-109.3505271
7586,2,25,21,2,6,26,82,38.27698967751179,-109.3502577
7587,3,27,20,3,8,24,85,38.27698967751179,-109.3499882
7588,4,28,19,6,10,19,86,38.27698967751179,-109.3497187
7589,6,28,16,12,11,14,87,38.27698967751179,-109.3494492
7590,7,30,16,12,11,11,87,38.27698967751179,-109.3491797
7591,7,29,16,13,11,12,88,38.27698967751179,-109.3489102
7592,7,28,16,13,11,13,88,38.27698967751179,-109.3486407
7593,8,27,15,15,10,10,85,38.27698967751179,-109.3483712
7594,8,28,14,21,9,8,88,38.27698967751179,-109.3481017
7595,10,29,14,18,10,8,89,38.27698967751179,-109.3478322
7596,10,30,14,16,11,8,89,38.27698967751179,-109.3475627
7597,9,29,14,18,11,7,88,38.27698967751179,-109.3472932
7598,11,30,15,15,10,8,89,38.27698967751179,-109.3470237
7599,10,32,14,13,11,7,87,38.27698967751179,-109.3467542
7600,10,32,14,14,11,7,88,38.27698967751179,-109.3464847
7601,10,33,14,14,11,6,88,38.27698967751179,-109.3462152
7602,9,35,14,12,11,5,86,38.27698967751179,-109.3459457
7603,9,37,14,11,13,4,88,38.27698967751179,-109.3456762
7604,8,37,14,14,11,4,88,38.27698967751179,-109.3454068
7605,8,36,14,14,10,5,87,38.27698967751179,-109.3451373
7606,8,36,14,14,10,5,87,38.27698967751179,-109.3448678
7607,8,37,14,14,12,4,89,38.27698967751179,-109.3445983
7608,7,38,14,12,15,4,90,38.27698967751179,-109.3443288
7609,1,48,9,3,12,8,81,38.27672018292655,-109.4324535
7610,2,43,9,2,9,8,73,38.27672018292655,-109.432184
7611,2,36,9,1,8,9,65,38.27672018292655,-109.4319145
7612,1,35,9,1,8,10,64,38.27672018292655,-109.431645
7613,1,35,9,1,8,12,66,38.27672018292655,-109.4313755
7614,1,33,10,1,9,12,66,38.27672018292655,-109.431106
7615,1,32,9,1,8,11,62,38.27672018292655,-109.4308365
7616,1,35,9,2,9,9,65,38.27672018292655,-109.430567
7617,2,38,9,2,10,7,68,38.27672018292655,-109.4302975
7618,2,37,9,1,10,9,68,38.27672018292655,-109.430028
7619,1,35,10,1,9,11,67,38.27672018292655,-109.4297586
7620,1,38,9,1,10,8,67,38.27672018292655,-109.4294891
7621,3,43,10,4,12,4,76,38.27672018292655,-109.4292196
7622,3,46,10,4,13,4,80,38.27672018292655,-109.4289501
7623,2,47,11,2,14,7,83,38.27672018292655,-109.4286806
7624,2,46,11,1,12,10,82,38.27672018292655,-109.4284111
7625,2,39,11,2,10,9,73,38.27672018292655,-109.4281416
7626,2,33,11,3,9,7,65,38.27672018292655,-109.4278721
7627,5,38,11,3,10,7,74,38.27672018292655,-109.4276026
7628,0,34,12,2,23,5,76,38.27672018292655,-109.4273331
7629,1,37,12,0,21,9,80,38.27672018292655,-109.4270636
7630,1,40,12,0,18,10,81,38.27672018292655,-109.4267941
7631,2,44,12,0,18,8,84,38.27672018292655,-109.4265246
7632,3,45,12,2,19,5,86,38.27672018292655,-109.4262551
7633,3,44,12,5,20,3,87,38.27672018292655,-109.4259856
7634,3,43,12,7,20,1,86,38.27672018292655,-109.4257161
7635,4,44,12,6,20,1,87,38.27672018292655,-109.4254466
7636,4,45,12,6,20,2,89,38.27672018292655,-109.4251771
7637,3,47,12,5,19,2,88,38.27672018292655,-109.4249077
7638,4,46,12,6,19,2,89,38.27672018292655,-109.4246382
7639,4,44,12,7,20,1,88,38.27672018292655,-109.4243687
7640,4,43,12,7,20,2,88,38.27672018292655,-109.4240992
7641,4,44,12,6,20,2,88,38.27672018292655,-109.4238297
7642,4,47,13,6,19,2,91,38.27672018292655,-109.4235602
7643,3,47,13,5,19,3,90,38.27672018292655,-109.4232907
7644,3,48,13,3,18,5,90,38.27672018292655,-109.4230212
7645,2,44,12,0,16,11,85,38.27672018292655,-109.4227517
7646,1,35,12,0,11,17,76,38.27672018292655,-109.4224822
7647,0,31,11,0,11,15,68,38.27672018292655,-109.4222127
7648,0,31,11,0,12,13,67,38.27672018292655,-109.4219432
7649,0,31,11,1,12,13,68,38.27672018292655,-109.4216737
7650,0,28,12,1,10,15,66,38.27672018292655,-109.4214042
7651,0,31,11,0,9,17,68,38.27672018292655,-109.4211347
7652,0,37,11,0,11,14,73,38.27672018292655,-109.4208652
7653,0,38,10,0,11,15,74,38.27672018292655,-109.4205957
7654,0,35,11,0,9,17,72,38.27672018292655,-109.4203262
7655,0,30,11,0,9,16,66,38.27672018292655,-109.4200568
7656,0,29,9,7,11,7,63,38.27672018292655,-109.4197873
7657,0,33,9,5,12,7,66,38.27672018292655,-109.4195178
7658,0,34,10,3,13,10,70,38.27672018292655,-109.4192483
7659,0,33,10,0,11,14,68,38.27672018292655,-109.4189788
7660,0,34,10,0,10,14,68,38.27672018292655,-109.4187093
7661,1,35,10,0,11,13,70,38.27672018292655,-109.4184398
7662,1,38,11,0,12,12,74,38.27672018292655,-109.4181703
7663,2,40,11,1,13,10,77,38.27672018292655,-109.4179008
7664,3,39,12,3,14,8,79,38.27672018292655,-109.4176313
7665,4,39,12,2,14,9,80,38.27672018292655,-109.4173618
7666,3,40,12,2,13,10,80,38.27672018292655,-109.4170923
7667,3,41,12,2,14,9,81,38.27672018292655,-109.4168228
7668,3,43,12,4,16,5,83,38.27672018292655,-109.4165533
7669,4,45,12,4,17,4,86,38.27672018292655,-109.4162838
7670,5,46,12,3,16,4,86,38.27672018292655,-109.4160143
7671,5,44,11,3,16,4,83,38.27672018292655,-109.4157448
7672,4,44,11,4,16,4,83,38.27672018292655,-109.4154753
7673,5,44,12,7,16,3,87,38.27672018292655,-109.4152058
7674,5,42,12,7,14,4,84,38.27672018292655,-109.4149364
7675,7,42,13,8,15,3,88,38.27672018292655,-109.4146669
7676,5,41,12,4,15,7,84,38.27672018292655,-109.4143974
7677,3,41,11,1,13,10,79,38.27672018292655,-109.4141279
7678,2,44,11,0,13,10,80,38.27672018292655,-109.4138584
7679,2,46,11,0,14,8,81,38.27672018292655,-109.4135889
7680,6,47,13,6,17,3,92,38.27672018292655,-109.4133194
7681,7,46,13,7,17,2,92,38.27672018292655,-109.4130499
7682,7,46,13,6,18,2,92,38.27672018292655,-109.4127804
7683,6,48,13,5,18,2,92,38.27672018292655,-109.4125109
7684,5,49,12,5,17,3,91,38.27672018292655,-109.4122414
7685,4,45,12,4,16,5,86,38.27672018292655,-109.4119719
7686,6,43,12,5,17,4,87,38.27672018292655,-109.4117024
7687,5,44,12,4,16,5,86,38.27672018292655,-109.4114329
7688,5,48,12,5,16,4,90,38.27672018292655,-109.4111634
7689,6,50,13,4,17,3,93,38.27672018292655,-109.4108939
7690,5,51,13,5,17,2,93,38.27672018292655,-109.4106244
7691,5,51,13,5,17,2,93,38.27672018292655,-109.4103549
7692,5,49,13,6,18,2,93,38.27672018292655,-109.4100855
7693,4,48,13,5,17,2,89,38.27672018292655,-109.409816
7694,4,48,12,5,16,2,87,38.27672018292655,-109.4095465
7695,4,47,12,6,16,2,87,38.27672018292655,-109.409277
7696,4,44,13,7,16,2,86,38.27672018292655,-109.4090075
7697,5,44,13,7,16,2,87,38.27672018292655,-109.408738
7698,5,45,13,6,15,2,86,38.27672018292655,-109.4084685
7699,4,44,12,6,16,2,84,38.27672018292655,-109.408199
7700,4,43,12,6,16,3,84,38.27672018292655,-109.4079295
7701,5,41,12,6,15,4,83,38.27672018292655,-109.40766
7702,4,39,12,5,14,6,80,38.27672018292655,-109.4073905
7703,4,46,11,5,13,5,84,38.27672018292655,-109.407121
7704,5,44,11,6,12,6,84,38.27672018292655,-109.4068515
7705,0,26,11,0,5,17,59,38.27672018292655,-109.3879869
7706,0,24,12,0,4,20,60,38.27672018292655,-109.3877174
7707,1,25,13,0,3,22,64,38.27672018292655,-109.3874479
7708,1,23,13,0,3,22,62,38.27672018292655,-109.3871784
7709,5,25,12,0,4,14,60,38.27672018292655,-109.3869089
7710,4,24,8,2,8,8,54,38.27672018292655,-109.3866394
7711,3,26,8,3,9,6,55,38.27672018292655,-109.3863699
7712,3,27,8,3,9,7,57,38.27672018292655,-109.3861004
7713,6,38,8,5,6,7,70,38.27672018292655,-109.3858309
7714,9,22,11,6,4,9,61,38.27672018292655,-109.3855614
7715,4,13,12,7,6,14,56,38.27672018292655,-109.3852919
7716,5,21,15,2,3,20,66,38.27672018292655,-109.3850225
7717,6,23,16,1,3,20,69,38.27672018292655,-109.384753
7718,2,19,17,1,3,25,67,38.27672018292655,-109.3844835
7719,2,23,15,0,5,22,67,38.27672018292655,-109.384214
7720,3,24,11,0,6,14,58,38.27672018292655,-109.3839445
7721,3,26,10,1,9,9,58,38.27672018292655,-109.383675
7722,4,30,10,1,8,9,62,38.27672018292655,-109.3834055
7723,2,26,10,1,8,11,58,38.27672018292655,-109.383136
7724,3,33,9,0,10,8,63,38.27672018292655,-109.3828665
7725,3,27,10,1,8,11,60,38.27672018292655,-109.382597
7726,2,22,12,1,5,17,59,38.27672018292655,-109.3823275
7727,3,24,14,0,5,21,67,38.27672018292655,-109.382058
7728,1,22,15,0,5,26,69,38.27672018292655,-109.3817885
7729,1,23,16,0,4,27,71,38.27672018292655,-109.381519
7730,1,23,16,0,3,28,71,38.27672018292655,-109.3812495
7731,1,24,16,0,2,27,70,38.27672018292655,-109.38098
7732,2,24,14,1,4,21,66,38.27672018292655,-109.3807105
7733,2,28,12,0,5,18,65,38.27672018292655,-109.380441
7734,2,30,11,0,6,16,65,38.27672018292655,-109.3801716
7735,2,29,10,1,6,15,63,38.27672018292655,-109.3799021
7736,2,25,11,3,5,15,61,38.27672018292655,-109.3796326
7737,5,23,9,4,8,10,59,38.27672018292655,-109.3793631
7738,7,32,6,2,4,7,58,38.27672018292655,-109.3790936
7739,2,39,5,3,7,5,61,38.27672018292655,-109.3788241
7740,2,33,4,1,8,4,52,38.27672018292655,-109.3785546
7741,3,29,5,0,7,6,50,38.27672018292655,-109.3782851
7742,2,29,7,3,7,6,54,38.27672018292655,-109.3780156
7743,2,23,7,3,7,8,50,38.27672018292655,-109.3777461
7744,3,27,8,5,8,9,60,38.27672018292655,-109.3774766
7745,4,23,13,2,5,17,64,38.27672018292655,-109.3772071
7746,4,17,16,4,4,22,67,38.27672018292655,-109.3769376
7747,1,24,16,0,5,27,73,38.27672018292655,-109.3766681
7748,3,30,12,2,10,12,69,38.27672018292655,-109.3763986
7749,2,39,10,3,12,7,73,38.27672018292655,-109.3761291
7750,2,39,9,5,11,6,72,38.27672018292655,-109.3758596
7751,2,28,12,3,10,14,69,38.27672018292655,-109.3755901
7752,3,25,13,2,8,16,67,38.27672018292655,-109.3753206
7753,3,26,13,2,7,17,68,38.27672018292655,-109.3750512
7754,3,23,14,2,5,19,66,38.27672018292655,-109.3747817
7755,3,30,11,4,11,10,69,38.27672018292655,-109.3745122
7756,2,35,11,3,13,8,72,38.27672018292655,-109.3742427
7757,1,40,9,3,11,7,71,38.27672018292655,-109.3739732
7758,0,40,7,2,10,8,67,38.27672018292655,-109.3737037
7759,1,37,8,3,9,8,66,38.27672018292655,-109.3734342
7760,1,37,8,2,9,10,67,38.27672018292655,-109.3731647
7761,1,31,10,3,6,13,64,38.27672018292655,-109.3728952
7762,1,32,10,2,8,14,67,38.27672018292655,-109.3726257
7763,2,19,11,4,5,16,57,38.27672018292655,-109.3723562
7764,5,25,11,6,11,9,67,38.27672018292655,-109.3720867
7765,1,19,10,12,13,9,64,38.27672018292655,-109.3718172
7766,2,22,12,4,10,15,65,38.27672018292655,-109.3715477
7767,1,27,14,1,7,21,71,38.27672018292655,-109.3712782
7768,2,29,16,0,8,24,79,38.27672018292655,-109.3710087
7769,2,30,16,2,6,25,81,38.27672018292655,-109.3707392
7770,3,29,16,1,11,21,81,38.27672018292655,-109.3704697
7771,3,27,16,5,12,19,82,38.27672018292655,-109.3702003
7772,2,24,15,5,9,20,75,38.27672018292655,-109.3699308
7773,2,23,15,4,8,22,74,38.27672018292655,-109.3696613
7774,1,23,18,3,9,26,80,38.27672018292655,-109.3693918
7775,2,27,16,2,12,21,80,38.27672018292655,-109.3691223
7776,5,31,14,4,19,11,84,38.27672018292655,-109.3688528
7777,6,27,14,16,10,12,85,38.27672018292655,-109.3685833
7778,7,16,10,20,8,6,67,38.27672018292655,-109.3683138
7779,11,24,11,19,15,2,82,38.27672018292655,-109.3680443
7780,12,23,11,18,17,2,83,38.27672018292655,-109.3677748
7781,5,23,15,18,22,3,86,38.27672018292655,-109.3675053
7782,5,25,14,15,21,3,83,38.27672018292655,-109.3672358
7783,3,23,12,18,21,0,77,38.27672018292655,-109.3669663
7784,7,12,8,12,14,2,55,38.27672018292655,-109.3666968
7785,11,11,10,20,17,5,74,38.27672018292655,-109.3664273
7786,8,13,12,22,13,8,76,38.27672018292655,-109.3661578
7787,5,15,13,15,10,16,74,38.27672018292655,-109.3658883
7788,7,14,13,11,6,23,74,38.27672018292655,-109.3656188
7789,0,23,19,0,4,34,80,38.27672018292655,-109.3653493
7790,0,22,20,0,5,34,81,38.27672018292655,-109.3650799
7791,0,22,20,0,5,34,81,38.27672018292655,-109.3648104
7792,0,22,21,0,4,33,80,38.27672018292655,-109.3645409
7793,0,23,21,0,6,32,82,38.27672018292655,-109.3642714
7794,0,24,21,0,7,30,82,38.27672018292655,-109.3640019
7795,0,24,20,2,6,29,81,38.27672018292655,-109.3637324
7796,0,23,19,3,6,30,81,38.27672018292655,-109.3634629
7797,0,23,19,2,6,32,82,38.27672018292655,-109.3631934
7798,0,26,19,0,6,32,83,38.27672018292655,-109.3629239
7799,0,24,18,0,4,31,77,38.27672018292655,-109.3626544
7800,1,25,17,0,4,29,76,38.27672018292655,-109.3623849
7801,1,27,16,0,4,26,74,38.27672018292655,-109.3621154
7802,1,27,16,0,5,27,76,38.27672018292655,-109.3618459
7803,0,27,18,0,5,30,80,38.27672018292655,-109.3615764
7804,0,25,18,0,4,31,78,38.27672018292655,-109.3613069
7805,0,22,17,0,4,30,73,38.27672018292655,-109.3610374
7806,0,21,16,0,3,29,69,38.27672018292655,-109.3607679
7807,0,24,16,0,5,26,71,38.27672018292655,-109.3604984
7808,0,27,17,0,6,25,75,38.27672018292655,-109.360229
7809,1,29,17,1,8,23,79,38.27672018292655,-109.3599595
7810,0,28,17,0,8,25,78,38.27672018292655,-109.35969
7811,0,24,16,0,6,26,72,38.27672018292655,-109.3594205
7812,0,20,13,0,3,25,61,38.27672018292655,-109.359151
7813,0,20,12,0,2,22,56,38.27672018292655,-109.3588815
7814,1,21,12,0,3,21,58,38.27672018292655,-109.358612
7815,1,22,12,0,3,20,58,38.27672018292655,-109.3583425
7816,1,22,12,1,3,21,60,38.27672018292655,-109.358073
7817,1,21,13,0,3,21,59,38.27672018292655,-109.3578035
7818,0,20,12,0,3,20,55,38.27672018292655,-109.357534
7819,1,22,11,0,5,17,56,38.27672018292655,-109.3572645
7820,2,25,11,1,5,15,59,38.27672018292655,-109.356995
7821,1,26,10,1,5,16,59,38.27672018292655,-109.3567255
7822,2,25,11,2,5,16,61,38.27672018292655,-109.356456
7823,2,26,10,2,6,14,60,38.27672018292655,-109.3561865
7824,2,29,11,3,8,11,64,38.27672018292655,-109.355917
7825,2,32,11,3,12,8,68,38.27672018292655,-109.3556475
7826,2,28,12,3,9,11,65,38.27672018292655,-109.355378
7827,1,22,13,3,6,16,61,38.27672018292655,-109.3551086
7828,1,18,14,1,3,23,60,38.27672018292655,-109.3548391
7829,1,18,15,0,3,27,64,38.27672018292655,-109.3545696
7830,1,21,16,0,2,29,69,38.27672018292655,-109.3543001
7831,1,20,17,2,5,27,72,38.27672018292655,-109.3540306
7832,2,24,18,4,6,26,80,38.27672018292655,-109.3537611
7833,1,24,20,2,7,29,83,38.27672018292655,-109.3534916
7834,0,23,21,1,6,32,83,38.27672018292655,-109.3532221
7835,0,22,19,0,7,30,78,38.27672018292655,-109.3529526
7836,1,24,20,1,7,29,82,38.27672018292655,-109.3526831
7837,1,25,20,2,7,28,83,38.27672018292655,-109.3524136
7838,2,24,19,4,7,26,82,38.27672018292655,-109.3521441
7839,2,21,20,2,4,31,80,38.27672018292655,-109.3518746
7840,3,27,19,4,4,25,82,38.27672018292655,-109.3516051
7841,5,29,18,4,4,22,82,38.27672018292655,-109.3513356
7842,4,27,18,4,6,21,80,38.27672018292655,-109.3510661
7843,2,27,18,0,7,22,76,38.27672018292655,-109.3507966
7844,2,28,18,0,8,21,77,38.27672018292655,-109.3505271
7845,2,25,19,1,8,26,81,38.27672018292655,-109.3502577
7846,2,25,18,3,9,24,81,38.27672018292655,-109.3499882
7847,3,28,18,2,9,22,82,38.27672018292655,-109.3497187
7848,4,29,18,3,10,22,86,38.27672018292655,-109.3494492
7849,5,29,18,6,8,21,87,38.27672018292655,-109.3491797
7850,4,26,18,4,9,25,86,38.27672018292655,-109.3489102
7851,4,24,19,6,10,23,86,38.27672018292655,-109.3486407
7852,5,24,18,11,11,17,86,38.27672018292655,-109.3483712
7853,8,26,15,18,9,9,85,38.27672018292655,-109.3481017
7854,8,27,15,20,10,8,88,38.27672018292655,-109.3478322
7855,8,28,14,18,12,8,88,38.27672018292655,-109.3475627
7856,9,30,14,16,12,8,89,38.27672018292655,-109.3472932
7857,10,31,15,14,10,8,88,38.27672018292655,-109.3470237
7858,9,33,14,13,12,6,87,38.27672018292655,-109.3467542
7859,10,32,14,14,11,5,86,38.27672018292655,-109.3464847
7860,11,34,13,13,12,4,87,38.27672018292655,-109.3462152
7861,11,36,13,13,12,4,89,38.27672018292655,-109.3459457
7862,10,36,13,14,10,4,87,38.27672018292655,-109.3456762
7863,9,37,14,13,11,5,89,38.27672018292655,-109.3454068
7864,9,37,14,13,12,4,89,38.27672018292655,-109.3451373
7865,7,38,14,12,13,5,89,38.27672018292655,-109.3448678
7866,6,38,14,10,14,5,87,38.27672018292655,-109.3445983
7867,8,37,14,12,15,4,90,38.27672018292655,-109.3443288
7868,13,33,13,16,11,4,90,38.27672018292655,-109.3440593
7869,2,52,9,3,12,7,85,38.27645068834131,-109.432723
7870,2,49,10,1,12,9,83,38.27645068834131,-109.4324535
7871,2,41,9,1,11,8,72,38.27645068834131,-109.432184
7872,2,38,10,2,9,8,69,38.27645068834131,-109.4319145
7873,2,36,10,2,9,9,68,38.27645068834131,-109.431645
7874,1,35,10,2,11,10,69,38.27645068834131,-109.4313755
7875,1,38,10,0,13,10,72,38.27645068834131,-109.431106
7876,1,38,9,0,10,12,70,38.27645068834131,-109.4308365
7877,1,35,9,1,9,11,66,38.27645068834131,-109.430567
7878,1,32,9,2,8,10,62,38.27645068834131,-109.4302975
7879,1,34,8,2,8,8,61,38.27645068834131,-109.430028
7880,2,35,10,3,10,7,67,38.27645068834131,-109.4297586
7881,1,37,9,2,10,9,68,38.27645068834131,-109.4294891
7882,1,38,9,1,11,9,69,38.27645068834131,-109.4292196
7883,1,42,9,1,11,8,72,38.27645068834131,-109.4289501
7884,2,42,10,2,12,8,76,38.27645068834131,-109.4286806
7885,2,41,11,1,11,11,77,38.27645068834131,-109.4284111
7886,2,36,11,2,9,9,69,38.27645068834131,-109.4281416
7887,3,36,11,4,9,7,70,38.27645068834131,-109.4278721
7888,5,39,13,5,14,6,82,38.27645068834131,-109.4276026
7889,3,30,12,4,26,3,78,38.27645068834131,-109.4273331
7890,0,36,12,2,19,9,78,38.27645068834131,-109.4270636
7891,1,41,12,2,18,8,82,38.27645068834131,-109.4267941
7892,2,44,12,2,19,6,85,38.27645068834131,-109.4265246
7893,3,42,12,5,20,4,86,38.27645068834131,-109.4262551
7894,3,43,12,6,21,2,87,38.27645068834131,-109.4259856
7895,3,42,12,6,21,2,86,38.27645068834131,-109.4257161
7896,3,42,12,7,21,2,87,38.27645068834131,-109.4254466
7897,3,42,12,8,20,2,87,38.27645068834131,-109.4251771
7898,3,43,12,4,20,3,85,38.27645068834131,-109.4249077
7899,4,45,12,5,19,3,88,38.27645068834131,-109.4246382
7900,4,44,13,6,20,3,90,38.27645068834131,-109.4243687
7901,4,44,13,7,20,2,90,38.27645068834131,-109.4240992
7902,4,45,13,5,19,3,89,38.27645068834131,-109.4238297
7903,3,48,12,2,17,6,88,38.27645068834131,-109.4235602
7904,2,45,12,1,17,9,86,38.27645068834131,-109.4232907
7905,2,42,13,1,17,10,85,38.27645068834131,-109.4230212
7906,2,38,12,0,14,14,80,38.27645068834131,-109.4227517
7907,1,33,12,0,10,19,75,38.27645068834131,-109.4224822
7908,0,33,10,0,12,14,69,38.27645068834131,-109.4222127
7909,0,34,10,0,11,13,68,38.27645068834131,-109.4219432
7910,0,34,10,0,11,12,67,38.27645068834131,-109.4216737
7911,0,32,10,0,11,12,65,38.27645068834131,-109.4214042
7912,0,34,10,0,11,13,68,38.27645068834131,-109.4211347
7913,0,33,11,0,11,14,69,38.27645068834131,-109.4208652
7914,0,35,10,0,13,13,71,38.27645068834131,-109.4205957
7915,0,35,10,0,11,12,68,38.27645068834131,-109.4203262
7916,1,31,9,3,12,9,65,38.27645068834131,-109.4200568
7917,2,33,9,6,11,6,67,38.27645068834131,-109.4197873
7918,0,35,9,2,11,9,66,38.27645068834131,-109.4195178
7919,1,36,10,1,13,9,70,38.27645068834131,-109.4192483
7920,0,35,10,0,11,13,69,38.27645068834131,-109.4189788
7921,1,36,10,0,10,14,71,38.27645068834131,-109.4187093
7922,1,38,10,0,12,12,73,38.27645068834131,-109.4184398
7923,1,41,10,0,12,11,75,38.27645068834131,-109.4181703
7924,2,42,10,0,12,11,77,38.27645068834131,-109.4179008
7925,3,39,11,1,12,11,77,38.27645068834131,-109.4176313
7926,3,38,12,1,12,12,78,38.27645068834131,-109.4173618
7927,3,40,11,0,12,12,78,38.27645068834131,-109.4170923
7928,3,42,11,1,13,9,79,38.27645068834131,-109.4168228
7929,4,43,12,4,16,5,84,38.27645068834131,-109.4165533
7930,4,44,12,5,17,4,86,38.27645068834131,-109.4162838
7931,5,43,12,4,16,4,84,38.27645068834131,-109.4160143
7932,5,45,12,5,16,3,86,38.27645068834131,-109.4157448
7933,5,45,12,5,16,2,85,38.27645068834131,-109.4154753
7934,5,44,12,5,16,3,85,38.27645068834131,-109.4152058
7935,6,44,13,8,16,2,89,38.27645068834131,-109.4149364
7936,8,42,14,13,15,1,93,38.27645068834131,-109.4146669
7937,8,43,14,10,16,1,92,38.27645068834131,-109.4143974
7938,6,44,13,6,17,4,90,38.27645068834131,-109.4141279
7939,3,45,12,3,16,7,86,38.27645068834131,-109.4138584
7940,3,48,11,2,17,5,86,38.27645068834131,-109.4135889
7941,5,48,13,5,18,2,91,38.27645068834131,-109.4133194
7942,6,47,13,5,18,2,91,38.27645068834131,-109.4130499
7943,5,46,12,5,17,3,88,38.27645068834131,-109.4127804
7944,5,44,12,5,17,3,86,38.27645068834131,-109.4125109
7945,6,45,12,5,16,4,88,38.27645068834131,-109.4122414
7946,6,43,12,3,16,6,86,38.27645068834131,-109.4119719
7947,5,46,13,4,16,6,90,38.27645068834131,-109.4117024
7948,5,49,13,4,17,4,92,38.27645068834131,-109.4114329
7949,5,50,13,5,18,2,93,38.27645068834131,-109.4111634
7950,5,51,13,4,17,2,92,38.27645068834131,-109.4108939
7951,5,52,12,4,17,2,92,38.27645068834131,-109.4106244
7952,5,50,12,5,17,1,90,38.27645068834131,-109.4103549
7953,5,49,13,6,17,1,91,38.27645068834131,-109.4100855
7954,4,47,12,5,18,2,88,38.27645068834131,-109.409816
7955,4,45,12,7,17,2,87,38.27645068834131,-109.4095465
7956,4,44,13,8,17,2,88,38.27645068834131,-109.409277
7957,5,43,13,8,16,2,87,38.27645068834131,-109.4090075
7958,5,43,13,9,15,2,87,38.27645068834131,-109.408738
7959,4,44,13,8,16,2,87,38.27645068834131,-109.4084685
7960,4,41,12,7,17,3,84,38.27645068834131,-109.408199
7961,6,40,12,8,15,3,84,38.27645068834131,-109.4079295
7962,6,39,12,7,14,5,83,38.27645068834131,-109.40766
7963,4,40,11,5,14,6,80,38.27645068834131,-109.4073905
7964,2,48,10,4,13,5,82,38.27645068834131,-109.407121
7965,3,48,10,3,13,6,83,38.27645068834131,-109.4068515
7966,1,25,12,0,5,19,62,38.27645068834131,-109.3879869
7967,1,25,13,0,4,21,64,38.27645068834131,-109.3877174
7968,2,25,13,0,4,21,65,38.27645068834131,-109.3874479
7969,2,24,13,0,4,20,63,38.27645068834131,-109.3871784
7970,3,25,10,1,5,12,56,38.27645068834131,-109.3869089
7971,1,25,8,2,8,7,51,38.27645068834131,-109.3866394
7972,2,23,8,2,8,6,49,38.27645068834131,-109.3863699
7973,4,25,8,3,8,7,55,38.27645068834131,-109.3861004
7974,5,26,9,5,8,7,60,38.27645068834131,-109.3858309
7975,3,18,10,5,10,8,54,38.27645068834131,-109.3855614
7976,4,13,11,6,9,10,53,38.27645068834131,-109.3852919
7977,2,15,12,5,5,17,56,38.27645068834131,-109.3850225
7978,3,20,16,1,3,24,67,38.27645068834131,-109.384753
7979,2,19,19,0,4,28,72,38.27645068834131,-109.3844835
7980,2,21,16,0,4,25,68,38.27645068834131,-109.384214
7981,2,22,12,0,5,17,58,38.27645068834131,-109.3839445
7982,3,26,10,2,8,11,60,38.27645068834131,-109.383675
7983,4,27,10,1,8,9,59,38.27645068834131,-109.3834055
7984,2,26,10,1,8,10,57,38.27645068834131,-109.383136
7985,3,28,10,1,9,9,60,38.27645068834131,-109.3828665
7986,3,24,11,1,6,12,57,38.27645068834131,-109.382597
7987,2,21,11,0,5,17,56,38.27645068834131,-109.3823275
7988,4,22,12,3,5,16,62,38.27645068834131,-109.382058
7989,1,22,14,0,4,22,63,38.27645068834131,-109.3817885
7990,1,24,14,0,3,23,65,38.27645068834131,-109.381519
7991,1,25,14,0,3,23,66,38.27645068834131,-109.3812495
7992,1,25,14,0,4,22,66,38.27645068834131,-109.38098
7993,2,26,12,1,4,20,65,38.27645068834131,-109.3807105
7994,2,31,10,0,6,15,64,38.27645068834131,-109.380441
7995,2,29,10,1,7,14,63,38.27645068834131,-109.3801716
7996,3,27,11,2,6,14,63,38.27645068834131,-109.3799021
7997,4,29,11,1,5,13,63,38.27645068834131,-109.3796326
7998,5,28,8,2,7,8,58,38.27645068834131,-109.3793631
7999,5,40,5,2,5,5,62,38.27645068834131,-109.3790936
8000,1,38,5,2,7,5,58,38.27645068834131,-109.3788241
8001,2,25,5,1,8,5,46,38.27645068834131,-109.3785546
8002,3,30,7,3,8,6,57,38.27645068834131,-109.3782851
8003,2,27,8,4,8,7,56,38.27645068834131,-109.3780156
8004,3,27,9,5,8,10,62,38.27645068834131,-109.3777461
8005,5,20,13,4,2,17,61,38.27645068834131,-109.3774766
8006,3,21,17,2,5,26,74,38.27645068834131,-109.3772071
8007,1,25,18,0,6,28,78,38.27645068834131,-109.3769376
8008,3,26,15,1,6,23,74,38.27645068834131,-109.3766681
8009,3,34,11,2,11,12,73,38.27645068834131,-109.3763986
8010,2,40,11,1,11,10,75,38.27645068834131,-109.3761291
8011,2,35,11,1,10,12,71,38.27645068834131,-109.3758596
8012,2,26,13,2,6,18,67,38.27645068834131,-109.3755901
8013,3,25,13,3,7,17,68,38.27645068834131,-109.3753206
8014,2,25,12,2,6,17,64,38.27645068834131,-109.3750512
8015,2,31,11,1,7,15,67,38.27645068834131,-109.3747817
8016,1,37,10,2,12,9,71,38.27645068834131,-109.3745122
8017,1,38,9,2,12,7,69,38.27645068834131,-109.3742427
8018,1,39,9,4,10,7,70,38.27645068834131,-109.3739732
8019,1,37,10,3,9,9,69,38.27645068834131,-109.3737037
8020,2,31,10,3,9,12,67,38.27645068834131,-109.3734342
8021,2,35,10,1,10,12,70,38.27645068834131,-109.3731647
8022,2,39,10,1,12,10,74,38.27645068834131,-109.3728952
8023,2,25,11,4,7,15,64,38.27645068834131,-109.3726257
8024,1,18,12,6,8,16,61,38.27645068834131,-109.3723562
8025,5,23,9,15,18,1,71,38.27645068834131,-109.3720867
8026,6,26,10,12,14,3,71,38.27645068834131,-109.3718172
8027,1,26,10,3,11,10,61,38.27645068834131,-109.3715477
8028,2,28,12,2,8,14,66,38.27645068834131,-109.3712782
8029,2,29,14,7,5,17,74,38.27645068834131,-109.3710087
8030,4,25,16,8,5,19,77,38.27645068834131,-109.3707392
8031,5,29,15,2,9,18,78,38.27645068834131,-109.3704697
8032,3,27,16,1,8,23,78,38.27645068834131,-109.3702003
8033,3,28,16,2,8,23,80,38.27645068834131,-109.3699308
8034,4,27,16,6,12,17,82,38.27645068834131,-109.3696613
8035,1,24,19,2,8,28,82,38.27645068834131,-109.3693918
8036,2,26,17,3,13,21,82,38.27645068834131,-109.3691223
8037,5,29,16,7,17,11,85,38.27645068834131,-109.3688528
8038,11,26,12,17,22,1,89,38.27645068834131,-109.3685833
8039,13,22,11,25,19,1,91,38.27645068834131,-109.3683138
8040,8,23,11,21,21,1,85,38.27645068834131,-109.3680443
8041,6,19,13,25,20,2,85,38.27645068834131,-109.3677748
8042,6,16,13,17,26,1,79,38.27645068834131,-109.3675053
8043,4,23,11,14,19,0,71,38.27645068834131,-109.3672358
8044,7,13,8,11,14,0,53,38.27645068834131,-109.3669663
8045,10,8,10,19,14,6,67,38.27645068834131,-109.3666968
8046,11,15,10,21,17,4,78,38.27645068834131,-109.3664273
8047,6,23,15,10,14,9,77,38.27645068834131,-109.3661578
8048,1,23,18,2,6,26,76,38.27645068834131,-109.3658883
8049,0,19,20,0,4,34,77,38.27645068834131,-109.3656188
8050,0,19,18,0,3,34,74,38.27645068834131,-109.3653493
8051,0,20,19,0,3,35,77,38.27645068834131,-109.3650799
8052,0,20,21,0,5,35,81,38.27645068834131,-109.3648104
8053,0,21,22,0,5,34,82,38.27645068834131,-109.3645409
8054,0,23,21,0,5,32,81,38.27645068834131,-109.3642714
8055,0,24,19,0,5,29,77,38.27645068834131,-109.3640019
8056,0,22,17,1,6,28,74,38.27645068834131,-109.3637324
8057,0,24,17,2,7,28,78,38.27645068834131,-109.3634629
8058,0,24,18,0,5,32,79,38.27645068834131,-109.3631934
8059,0,23,17,0,4,31,75,38.27645068834131,-109.3629239
8060,0,24,16,0,4,29,73,38.27645068834131,-109.3626544
8061,1,24,15,0,3,26,69,38.27645068834131,-109.3623849
8062,2,26,15,0,3,25,71,38.27645068834131,-109.3621154
8063,0,23,15,0,3,27,68,38.27645068834131,-109.3618459
8064,0,25,16,0,3,28,72,38.27645068834131,-109.3615764
8065,0,24,16,0,4,28,72,38.27645068834131,-109.3613069
8066,0,22,16,0,4,28,70,38.27645068834131,-109.3610374
8067,0,23,14,0,4,24,65,38.27645068834131,-109.3607679
8068,0,24,14,0,6,22,66,38.27645068834131,-109.3604984
8069,0,24,15,0,6,23,68,38.27645068834131,-109.360229
8070,0,23,15,0,5,26,69,38.27645068834131,-109.3599595
8071,0,22,15,0,3,27,67,38.27645068834131,-109.35969
8072,0,22,13,0,1,25,61,38.27645068834131,-109.3594205
8073,0,24,11,0,2,19,56,38.27645068834131,-109.359151
8074,1,24,10,0,5,16,56,38.27645068834131,-109.3588815
8075,1,24,10,1,6,15,57,38.27645068834131,-109.358612
8076,1,26,10,1,6,15,59,38.27645068834131,-109.3583425
8077,2,29,10,1,6,14,62,38.27645068834131,-109.358073
8078,2,23,11,0,5,17,58,38.27645068834131,-109.3578035
8079,1,23,11,1,4,17,57,38.27645068834131,-109.357534
8080,1,26,10,1,5,16,59,38.27645068834131,-109.3572645
8081,1,26,11,2,5,16,61,38.27645068834131,-109.356995
8082,1,20,12,3,4,18,58,38.27645068834131,-109.3567255
8083,1,19,12,2,3,19,56,38.27645068834131,-109.356456
8084,2,21,11,2,4,18,58,38.27645068834131,-109.3561865
8085,2,23,10,1,4,16,56,38.27645068834131,-109.355917
8086,2,26,10,2,5,15,60,38.27645068834131,-109.3556475
8087,1,22,11,2,4,17,57,38.27645068834131,-109.355378
8088,1,16,13,1,3,21,55,38.27645068834131,-109.3551086
8089,1,15,15,0,3,27,61,38.27645068834131,-109.3548391
8090,1,18,17,0,3,31,70,38.27645068834131,-109.3545696
8091,1,20,18,0,2,31,72,38.27645068834131,-109.3543001
8092,1,19,17,0,2,28,67,38.27645068834131,-109.3540306
8093,1,21,17,1,4,29,73,38.27645068834131,-109.3537611
8094,0,23,19,1,5,32,80,38.27645068834131,-109.3534916
8095,0,22,21,0,5,36,84,38.27645068834131,-109.3532221
8096,0,21,22,0,6,35,84,38.27645068834131,-109.3529526
8097,0,21,22,0,6,34,83,38.27645068834131,-109.3526831
8098,2,23,21,3,6,29,84,38.27645068834131,-109.3524136
8099,3,25,20,4,5,28,85,38.27645068834131,-109.3521441
8100,2,26,19,4,5,28,84,38.27645068834131,-109.3518746
8101,5,28,18,4,2,24,81,38.27645068834131,-109.3516051
8102,3,26,16,1,3,23,72,38.27645068834131,-109.3513356
8103,2,24,17,0,2,26,71,38.27645068834131,-109.3510661
8104,1,20,17,0,2,28,68,38.27645068834131,-109.3507966
8105,3,24,17,2,5,22,73,38.27645068834131,-109.3505271
8106,1,20,18,0,3,27,69,38.27645068834131,-109.3502577
8107,0,22,17,0,4,26,69,38.27645068834131,-109.3499882
8108,1,25,17,1,6,23,73,38.27645068834131,-109.3497187
8109,2,26,18,2,7,25,80,38.27645068834131,-109.3494492
8110,3,23,20,3,6,28,83,38.27645068834131,-109.3491797
8111,2,20,21,2,7,33,85,38.27645068834131,-109.3489102
8112,3,19,20,6,8,30,86,38.27645068834131,-109.3486407
8113,5,19,19,10,11,22,86,38.27645068834131,-109.3483712
8114,5,23,17,12,12,17,86,38.27645068834131,-109.3481017
8115,7,23,17,18,11,12,88,38.27645068834131,-109.3478322
8116,7,27,15,20,11,9,89,38.27645068834131,-109.3475627
8117,7,31,14,16,13,8,89,38.27645068834131,-109.3472932
8118,8,33,14,15,13,6,89,38.27645068834131,-109.3470237
8119,8,32,14,15,11,6,86,38.27645068834131,-109.3467542
8120,10,33,14,15,11,5,88,38.27645068834131,-109.3464847
8121,11,35,13,13,12,4,88,38.27645068834131,-109.3462152
8122,11,35,13,13,12,4,88,38.27645068834131,-109.3459457
8123,10,36,13,14,11,4,88,38.27645068834131,-109.3456762
8124,8,38,14,13,14,3,90,38.27645068834131,-109.3454068
8125,7,39,14,12,13,5,90,38.27645068834131,-109.3451373
8126,7,38,15,11,14,5,90,38.27645068834131,-109.3448678
8127,8,36,14,13,15,4,90,38.27645068834131,-109.3445983
8128,12,33,14,15,13,3,90,38.27645068834131,-109.3443288
8129,16,29,13,19,10,3,90,38.27645068834131,-109.3440593
8130,22,27,12,20,9,2,92,38.27645068834131,-109.3437898
8131,2,52,10,2,13,8,87,38.27618119375608,-109.4329925
8132,2,44,11,1,12,10,80,38.27618119375608,-109.432723
8133,1,35,11,0,10,13,70,38.27618119375608,-109.4324535
8134,1,35,10,1,8,12,67,38.27618119375608,-109.432184
8135,2,34,11,2,10,12,71,38.27618119375608,-109.4319145
8136,1,35,11,1,11,12,71,38.27618119375608,-109.431645
8137,1,38,11,1,12,11,74,38.27618119375608,-109.4313755
8138,1,41,10,1,14,9,76,38.27618119375608,-109.431106
8139,1,36,10,0,11,12,70,38.27618119375608,-109.4308365
8140,1,35,11,1,12,11,71,38.27618119375608,-109.430567
8141,1,34,10,2,10,10,67,38.27618119375608,-109.4302975
8142,1,33,9,2,8,10,63,38.27618119375608,-109.430028
8143,1,35,11,1,12,11,71,38.27618119375608,-109.4297586
8144,0,33,10,1,12,12,68,38.27618119375608,-109.4294891
8145,0,37,10,1,11,10,69,38.27618119375608,-109.4292196
8146,1,40,10,1,12,9,73,38.27618119375608,-109.4289501
8147,2,38,11,3,11,7,72,38.27618119375608,-109.4286806
8148,2,37,11,1,10,10,71,38.27618119375608,-109.4284111
8149,2,37,11,3,9,8,70,38.27618119375608,-109.4281416
8150,2,37,11,4,12,7,73,38.27618119375608,-109.4278721
8151,2,36,13,5,16,10,82,38.27618119375608,-109.4276026
8152,1,29,13,3,21,11,78,38.27618119375608,-109.4273331
8153,0,35,12,0,15,15,77,38.27618119375608,-109.4270636
8154,1,42,12,0,17,10,82,38.27618119375608,-109.4267941
8155,2,44,12,1,20,6,85,38.27618119375608,-109.4265246
8156,2,42,12,4,21,5,86,38.27618119375608,-109.4262551
8157,2,43,12,2,19,7,85,38.27618119375608,-109.4259856
8158,2,42,12,3,21,5,85,38.27618119375608,-109.4257161
8159,2,42,12,5,22,3,86,38.27618119375608,-109.4254466
8160,2,41,12,6,21,3,85,38.27618119375608,-109.4251771
8161,2,41,12,4,21,5,85,38.27618119375608,-109.4249077
8162,3,41,13,5,20,4,86,38.27618119375608,-109.4246382
8163,3,42,13,4,20,5,87,38.27618119375608,-109.4243687
8164,3,43,13,5,20,5,89,38.27618119375608,-109.4240992
8165,3,44,13,4,19,5,88,38.27618119375608,-109.4238297
8166,3,45,12,1,17,9,87,38.27618119375608,-109.4235602
8167,2,39,12,0,14,14,81,38.27618119375608,-109.4232907
8168,1,37,12,0,14,15,79,38.27618119375608,-109.4230212
8169,0,36,12,0,11,19,78,38.27618119375608,-109.4227517
8170,0,35,12,0,10,19,76,38.27618119375608,-109.4224822
8171,0,33,11,0,13,15,72,38.27618119375608,-109.4222127
8172,1,34,11,0,14,12,72,38.27618119375608,-109.4219432
8173,0,33,11,0,13,13,70,38.27618119375608,-109.4216737
8174,0,31,10,0,10,14,65,38.27618119375608,-109.4214042
8175,0,30,10,0,10,13,63,38.27618119375608,-109.4211347
8176,1,31,11,0,11,12,66,38.27618119375608,-109.4208652
8177,1,34,10,2,13,9,69,38.27618119375608,-109.4205957
8178,2,35,10,2,12,8,69,38.27618119375608,-109.4203262
8179,2,35,9,3,11,8,68,38.27618119375608,-109.4200568
8180,2,38,9,4,10,6,69,38.27618119375608,-109.4197873
8181,1,40,9,0,13,8,71,38.27618119375608,-109.4195178
8182,1,41,9,0,13,9,73,38.27618119375608,-109.4192483
8183,1,39,10,0,12,11,73,38.27618119375608,-109.4189788
8184,1,38,10,0,12,11,72,38.27618119375608,-109.4187093
8185,1,40,10,0,13,9,73,38.27618119375608,-109.4184398
8186,2,43,10,0,12,11,78,38.27618119375608,-109.4181703
8187,2,44,10,0,11,13,80,38.27618119375608,-109.4179008
8188,2,40,11,0,11,14,78,38.27618119375608,-109.4176313
8189,3,37,12,1,10,14,77,38.27618119375608,-109.4173618
8190,3,39,12,2,12,11,79,38.27618119375608,-109.4170923
8191,4,41,11,1,13,9,79,38.27618119375608,-109.4168228
8192,4,41,12,3,14,6,80,38.27618119375608,-109.4165533
8193,4,42,12,4,15,4,81,38.27618119375608,-109.4162838
8194,5,44,12,5,16,3,85,38.27618119375608,-109.4160143
8195,6,44,13,6,15,2,86,38.27618119375608,-109.4157448
8196,6,45,13,9,16,1,90,38.27618119375608,-109.4154753
8197,6,45,13,9,16,1,90,38.27618119375608,-109.4152058
8198,7,45,13,9,16,1,91,38.27618119375608,-109.4149364
8199,7,44,13,9,16,1,90,38.27618119375608,-109.4146669
8200,8,43,13,7,16,2,89,38.27618119375608,-109.4143974
8201,7,43,13,5,16,4,88,38.27618119375608,-109.4141279
8202,6,44,12,4,16,5,87,38.27618119375608,-109.4138584
8203,5,48,12,4,17,3,89,38.27618119375608,-109.4135889
8204,4,49,12,6,17,2,90,38.27618119375608,-109.4133194
8205,5,48,12,5,17,2,89,38.27618119375608,-109.4130499
8206,5,47,12,5,16,4,89,38.27618119375608,-109.4127804
8207,5,45,12,5,16,4,87,38.27618119375608,-109.4125109
8208,5,44,12,4,17,5,87,38.27618119375608,-109.4122414
8209,6,42,12,3,16,8,87,38.27618119375608,-109.4119719
8210,6,45,13,4,18,4,90,38.27618119375608,-109.4117024
8211,6,48,13,5,19,2,93,38.27618119375608,-109.4114329
8212,5,50,13,5,19,1,93,38.27618119375608,-109.4111634
8213,6,48,13,5,18,1,91,38.27618119375608,-109.4108939
8214,5,48,12,5,19,1,90,38.27618119375608,-109.4106244
8215,5,49,12,5,18,1,90,38.27618119375608,-109.4103549
8216,5,48,13,5,18,2,91,38.27618119375608,-109.4100855
8217,4,46,13,6,18,2,89,38.27618119375608,-109.409816
8218,4,45,13,7,18,2,89,38.27618119375608,-109.4095465
8219,5,45,13,8,17,2,90,38.27618119375608,-109.409277
8220,5,44,13,8,17,2,89,38.27618119375608,-109.4090075
8221,5,44,13,8,16,2,88,38.27618119375608,-109.408738
8222,5,43,13,9,15,3,88,38.27618119375608,-109.4084685
8223,5,41,12,8,16,2,84,38.27618119375608,-109.408199
8224,6,41,12,8,16,3,86,38.27618119375608,-109.4079295
8225,6,41,12,6,15,3,83,38.27618119375608,-109.40766
8226,4,44,11,6,14,4,83,38.27618119375608,-109.4073905
8227,3,49,10,6,12,4,84,38.27618119375608,-109.407121
8228,3,44,10,4,14,5,80,38.27618119375608,-109.4068515
8229,3,25,12,0,5,18,63,38.27618119375608,-109.3879869
8230,3,23,12,0,5,18,61,38.27618119375608,-109.3877174
8231,3,24,12,0,5,18,62,38.27618119375608,-109.3874479
8232,2,28,11,1,5,15,62,38.27618119375608,-109.3871784
8233,1,26,8,1,7,10,53,38.27618119375608,-109.3869089
8234,2,24,8,2,9,7,52,38.27618119375608,-109.3866394
8235,3,22,8,3,9,7,52,38.27618119375608,-109.3863699
8236,6,27,10,5,9,6,63,38.27618119375608,-109.3861004
8237,4,23,11,4,9,10,61,38.27618119375608,-109.3858309
8238,1,16,11,5,11,9,53,38.27618119375608,-109.3855614
8239,3,14,11,7,12,7,54,38.27618119375608,-109.3852919
8240,3,16,11,8,11,11,60,38.27618119375608,-109.3850225
8241,3,20,15,3,4,23,68,38.27618119375608,-109.384753
8242,2,23,18,0,4,29,76,38.27618119375608,-109.3844835
8243,2,22,16,0,3,25,68,38.27618119375608,-109.384214
8244,2,22,14,0,4,21,63,38.27618119375608,-109.3839445
8245,3,24,13,1,5,16,62,38.27618119375608,-109.383675
8246,5,24,13,2,6,14,64,38.27618119375608,-109.3834055
8247,3,25,11,2,6,13,60,38.27618119375608,-109.383136
8248,3,23,12,1,6,15,60,38.27618119375608,-109.3828665
8249,3,22,12,0,5,16,58,38.27618119375608,-109.382597
8250,3,23,11,0,5,15,57,38.27618119375608,-109.3823275
8251,2,21,11,2,6,13,55,38.27618119375608,-109.382058
8252,1,22,12,0,4,19,58,38.27618119375608,-109.3817885
8253,1,24,13,0,4,22,64,38.27618119375608,-109.381519
8254,1,24,13,0,4,22,64,38.27618119375608,-109.3812495
8255,1,27,12,1,5,19,65,38.27618119375608,-109.38098
8256,2,31,10,0,6,14,63,38.27618119375608,-109.3807105
8257,2,33,10,1,8,11,65,38.27618119375608,-109.380441
8258,2,30,10,2,8,12,64,38.27618119375608,-109.3801716
8259,4,28,10,2,6,13,63,38.27618119375608,-109.3799021
8260,6,28,9,1,4,11,59,38.27618119375608,-109.3796326
8261,7,37,5,1,5,5,60,38.27618119375608,-109.3793631
8262,3,42,5,2,7,4,63,38.27618119375608,-109.3790936
8263,2,36,5,2,7,6,58,38.27618119375608,-109.3788241
8264,4,24,6,3,8,7,52,38.27618119375608,-109.3785546
8265,3,27,8,3,6,11,58,38.27618119375608,-109.3782851
8266,1,24,10,3,5,15,58,38.27618119375608,-109.3780156
8267,2,19,15,3,2,24,65,38.27618119375608,-109.3777461
8268,2,17,18,2,3,27,69,38.27618119375608,-109.3774766
8269,3,22,17,2,5,25,74,38.27618119375608,-109.3772071
8270,2,26,15,1,6,22,72,38.27618119375608,-109.3769376
8271,4,31,12,4,9,13,73,38.27618119375608,-109.3766681
8272,3,37,11,2,11,11,75,38.27618119375608,-109.3763986
8273,3,37,11,2,12,11,76,38.27618119375608,-109.3761291
8274,2,26,13,2,6,17,66,38.27618119375608,-109.3758596
8275,3,28,13,1,5,20,70,38.27618119375608,-109.3755901
8276,5,30,12,3,8,14,72,38.27618119375608,-109.3753206
8277,4,33,11,2,9,13,72,38.27618119375608,-109.3750512
8278,2,32,10,1,9,13,67,38.27618119375608,-109.3747817
8279,2,32,11,2,10,12,69,38.27618119375608,-109.3745122
8280,3,28,11,3,11,10,66,38.27618119375608,-109.3742427
8281,3,29,10,3,10,11,66,38.27618119375608,-109.3739732
8282,3,32,10,2,9,12,68,38.27618119375608,-109.3737037
8283,2,37,10,1,12,11,73,38.27618119375608,-109.3734342
8284,1,41,10,0,12,11,75,38.27618119375608,-109.3731647
8285,2,38,10,1,11,11,73,38.27618119375608,-109.3728952
8286,1,26,10,2,7,14,60,38.27618119375608,-109.3726257
8287,1,25,9,12,15,5,67,38.27618119375608,-109.3723562
8288,5,25,8,15,13,1,67,38.27618119375608,-109.3720867
8289,3,25,9,14,14,4,69,38.27618119375608,-109.3718172
8290,2,23,12,4,10,13,64,38.27618119375608,-109.3715477
8291,2,24,13,3,9,16,67,38.27618119375608,-109.3712782
8292,3,29,15,12,4,16,79,38.27618119375608,-109.3710087
8293,3,31,14,9,7,15,79,38.27618119375608,-109.3707392
8294,4,25,15,5,8,17,74,38.27618119375608,-109.3704697
8295,2,25,14,1,9,19,70,38.27618119375608,-109.3702003
8296,4,26,15,6,10,15,76,38.27618119375608,-109.3699308
8297,3,26,15,8,12,17,81,38.27618119375608,-109.3696613
8298,2,26,16,5,11,21,81,38.27618119375608,-109.3693918
8299,5,28,15,9,17,10,84,38.27618119375608,-109.3691223
8300,6,27,14,12,23,4,86,38.27618119375608,-109.3688528
8301,7,28,11,17,26,0,89,38.27618119375608,-109.3685833
8302,5,24,11,20,23,2,85,38.27618119375608,-109.3683138
8303,4,16,12,18,26,1,77,38.27618119375608,-109.3680443
8304,4,16,12,17,27,2,78,38.27618119375608,-109.3677748
8305,3,13,12,16,24,2,70,38.27618119375608,-109.3675053
8306,3,12,11,18,19,2,65,38.27618119375608,-109.3672358
8307,5,14,12,21,22,3,77,38.27618119375608,-109.3669663
8308,5,17,11,14,25,2,74,38.27618119375608,-109.3666968
8309,4,22,12,11,20,7,76,38.27618119375608,-109.3664273
8310,4,26,16,7,10,16,79,38.27618119375608,-109.3661578
8311,0,22,19,0,3,31,75,38.27618119375608,-109.3658883
8312,0,19,20,0,4,34,77,38.27618119375608,-109.3656188
8313,0,21,17,0,3,32,73,38.27618119375608,-109.3653493
8314,0,21,17,0,4,30,72,38.27618119375608,-109.3650799
8315,0,21,19,0,4,33,77,38.27618119375608,-109.3648104
8316,0,22,22,0,6,33,83,38.27618119375608,-109.3645409
8317,0,24,20,1,6,31,82,38.27618119375608,-109.3642714
8318,0,25,18,1,7,27,78,38.27618119375608,-109.3640019
8319,1,24,17,2,7,26,77,38.27618119375608,-109.3637324
8320,0,24,17,0,7,27,75,38.27618119375608,-109.3634629
8321,0,23,16,0,4,30,73,38.27618119375608,-109.3631934
8322,0,24,16,0,4,29,73,38.27618119375608,-109.3629239
8323,0,22,16,0,3,28,69,38.27618119375608,-109.3626544
8324,1,22,15,0,3,27,68,38.27618119375608,-109.3623849
8325,1,23,14,0,3,25,66,38.27618119375608,-109.3621154
8326,0,21,13,0,2,24,60,38.27618119375608,-109.3618459
8327,0,22,13,0,3,22,60,38.27618119375608,-109.3615764
8328,0,21,13,0,3,24,61,38.27618119375608,-109.3613069
8329,0,21,13,0,3,25,62,38.27618119375608,-109.3610374
8330,0,23,13,0,4,23,63,38.27618119375608,-109.3607679
8331,0,21,13,0,3,25,62,38.27618119375608,-109.3604984
8332,0,19,13,0,2,25,59,38.27618119375608,-109.360229
8333,0,18,14,0,1,27,60,38.27618119375608,-109.3599595
8334,0,19,14,0,1,27,61,38.27618119375608,-109.35969
8335,0,25,12,0,2,23,62,38.27618119375608,-109.3594205
8336,0,24,11,0,3,19,57,38.27618119375608,-109.359151
8337,0,21,10,1,3,18,53,38.27618119375608,-109.3588815
8338,1,21,10,1,5,15,53,38.27618119375608,-109.358612
8339,1,27,10,1,6,13,58,38.27618119375608,-109.3583425
8340,1,25,11,0,5,16,58,38.27618119375608,-109.358073
8341,1,19,12,1,3,19,55,38.27618119375608,-109.3578035
8342,1,15,14,1,2,23,56,38.27618119375608,-109.357534
8343,0,15,15,0,2,25,57,38.27618119375608,-109.3572645
8344,1,16,14,1,3,23,58,38.27618119375608,-109.356995
8345,1,16,14,2,3,21,57,38.27618119375608,-109.3567255
8346,2,17,12,3,4,18,56,38.27618119375608,-109.356456
8347,2,21,11,3,4,17,58,38.27618119375608,-109.3561865
8348,2,21,11,2,3,14,53,38.27618119375608,-109.355917
8349,1,24,9,4,6,11,55,38.27618119375608,-109.3556475
8350,2,22,9,4,6,11,54,38.27618119375608,-109.355378
8351,4,16,10,6,4,13,53,38.27618119375608,-109.3551086
8352,3,7,12,6,5,18,51,38.27618119375608,-109.3548391
8353,3,11,13,5,5,22,59,38.27618119375608,-109.3545696
8354,2,14,15,1,3,28,63,38.27618119375608,-109.3543001
8355,2,20,16,0,3,27,68,38.27618119375608,-109.3540306
8356,1,19,18,0,3,31,72,38.27618119375608,-109.3537611
8357,0,19,20,0,4,35,78,38.27618119375608,-109.3534916
8358,0,20,22,0,7,34,83,38.27618119375608,-109.3532221
8359,0,19,22,3,7,32,83,38.27618119375608,-109.3529526
8360,0,19,22,2,8,32,83,38.27618119375608,-109.3526831
8361,1,21,22,1,8,32,85,38.27618119375608,-109.3524136
8362,3,22,20,4,5,30,84,38.27618119375608,-109.3521441
8363,4,20,20,5,7,27,83,38.27618119375608,-109.3518746
8364,5,27,18,3,3,25,81,38.27618119375608,-109.3516051
8365,4,25,16,3,3,24,75,38.27618119375608,-109.3513356
8366,2,23,15,1,4,23,68,38.27618119375608,-109.3510661
8367,1,20,16,1,3,25,66,38.27618119375608,-109.3507966
8368,2,22,17,1,5,24,71,38.27618119375608,-109.3505271
8369,1,22,18,1,6,26,74,38.27618119375608,-109.3502577
8370,1,19,19,0,4,30,73,38.27618119375608,-109.3499882
8371,1,20,19,0,4,31,75,38.27618119375608,-109.3497187
8372,1,24,19,1,6,29,80,38.27618119375608,-109.3494492
8373,2,21,21,2,7,31,84,38.27618119375608,-109.3491797
8374,1,19,21,2,7,34,84,38.27618119375608,-109.3489102
8375,2,18,21,4,7,34,86,38.27618119375608,-109.3486407
8376,3,17,20,6,7,33,86,38.27618119375608,-109.3483712
8377,3,19,19,7,10,27,85,38.27618119375608,-109.3481017
8378,6,20,18,13,12,15,84,38.27618119375608,-109.3478322
8379,6,24,17,18,11,11,87,38.27618119375608,-109.3475627
8380,5,28,15,19,13,9,89,38.27618119375608,-109.3472932
8381,7,31,14,15,13,7,87,38.27618119375608,-109.3470237
8382,8,31,14,16,9,7,85,38.27618119375608,-109.3467542
8383,9,32,14,15,10,6,86,38.27618119375608,-109.3464847
8384,10,34,14,13,11,5,87,38.27618119375608,-109.3462152
8385,10,35,13,13,12,4,87,38.27618119375608,-109.3459457
8386,9,36,13,13,13,4,88,38.27618119375608,-109.3456762
8387,7,38,14,12,14,4,89,38.27618119375608,-109.3454068
8388,9,34,14,14,13,5,89,38.27618119375608,-109.3451373
8389,14,31,14,17,12,3,91,38.27618119375608,-109.3448678
8390,16,28,14,18,11,4,91,38.27618119375608,-109.3445983
8391,17,28,14,19,10,4,92,38.27618119375608,-109.3443288
8392,16,29,13,19,9,3,89,38.27618119375608,-109.3440593
8393,17,29,13,18,10,3,90,38.27618119375608,-109.3437898
8394,20,28,12,19,10,2,91,38.27618119375608,-109.3435203
8395,2,50,11,3,16,5,87,38.27591169917085,-109.433262
8396,2,48,11,3,14,7,85,38.27591169917085,-109.4329925
8397,1,45,11,1,14,9,81,38.27591169917085,-109.432723
8398,1,40,10,0,12,11,74,38.27591169917085,-109.4324535
8399,1,38,10,0,11,10,70,38.27591169917085,-109.432184
8400,2,37,12,1,11,9,72,38.27591169917085,-109.4319145
8401,1,35,12,1,11,11,71,38.27591169917085,-109.431645
8402,1,34,11,2,12,11,71,38.27591169917085,-109.4313755
8403,4,36,12,3,14,8,77,38.27591169917085,-109.431106
8404,2,34,11,2,12,9,70,38.27591169917085,-109.4308365
8405,1,36,11,2,11,9,70,38.27591169917085,-109.430567
8406,1,39,11,1,12,10,74,38.27591169917085,-109.4302975
8407,1,39,11,0,14,10,75,38.27591169917085,-109.430028
8408,0,32,10,1,12,12,67,38.27591169917085,-109.4297586
8409,0,37,9,2,11,9,68,38.27591169917085,-109.4294891
8410,1,40,9,2,10,6,68,38.27591169917085,-109.4292196
8411,3,36,7,4,8,6,64,38.27591169917085,-109.4289501
8412,3,33,8,4,10,5,63,38.27591169917085,-109.4286806
8413,1,32,9,1,9,10,62,38.27591169917085,-109.4284111
8414,3,33,12,7,11,8,74,38.27591169917085,-109.4281416
8415,3,32,13,10,15,7,80,38.27591169917085,-109.4278721
8416,2,32,12,7,21,8,82,38.27591169917085,-109.4276026
8417,0,31,12,3,23,10,79,38.27591169917085,-109.4273331
8418,0,33,13,0,12,19,77,38.27591169917085,-109.4270636
8419,0,39,12,0,14,15,80,38.27591169917085,-109.4267941
8420,2,42,12,0,17,10,83,38.27591169917085,-109.4265246
8421,2,42,12,1,19,8,84,38.27591169917085,-109.4262551
8422,2,40,13,0,16,13,84,38.27591169917085,-109.4259856
8423,1,39,13,0,17,13,83,38.27591169917085,-109.4257161
8424,1,39,12,0,18,11,81,38.27591169917085,-109.4254466
8425,1,39,13,0,18,12,83,38.27591169917085,-109.4251771
8426,1,38,13,0,17,13,82,38.27591169917085,-109.4249077
8427,2,38,13,1,18,11,83,38.27591169917085,-109.4246382
8428,1,38,13,0,17,12,81,38.27591169917085,-109.4243687
8429,1,40,13,0,18,10,82,38.27591169917085,-109.4240992
8430,2,42,13,1,18,9,85,38.27591169917085,-109.4238297
8431,2,43,12,1,16,10,84,38.27591169917085,-109.4235602
8432,2,40,12,0,15,13,82,38.27591169917085,-109.4232907
8433,1,35,12,0,13,17,78,38.27591169917085,-109.4230212
8434,0,33,13,0,10,21,77,38.27591169917085,-109.4227517
8435,1,31,14,0,9,21,76,38.27591169917085,-109.4224822
8436,0,33,12,0,11,17,73,38.27591169917085,-109.4222127
8437,0,34,12,0,13,16,75,38.27591169917085,-109.4219432
8438,0,34,11,0,12,17,74,38.27591169917085,-109.4216737
8439,0,31,11,0,10,17,69,38.27591169917085,-109.4214042
8440,0,30,11,0,11,14,66,38.27591169917085,-109.4211347
8441,1,30,10,1,10,12,64,38.27591169917085,-109.4208652
8442,1,32,10,2,10,10,65,38.27591169917085,-109.4205957
8443,1,33,10,2,11,10,67,38.27591169917085,-109.4203262
8444,1,33,10,1,11,10,66,38.27591169917085,-109.4200568
8445,2,34,10,4,11,7,68,38.27591169917085,-109.4197873
8446,1,38,10,1,12,9,71,38.27591169917085,-109.4195178
8447,1,38,10,0,11,11,71,38.27591169917085,-109.4192483
8448,1,37,10,0,11,12,71,38.27591169917085,-109.4189788
8449,2,35,10,0,9,12,68,38.27591169917085,-109.4187093
8450,1,34,10,0,10,13,68,38.27591169917085,-109.4184398
8451,1,43,10,0,13,11,78,38.27591169917085,-109.4181703
8452,2,46,10,0,12,11,81,38.27591169917085,-109.4179008
8453,2,44,10,1,12,11,80,38.27591169917085,-109.4176313
8454,3,42,12,3,12,10,82,38.27591169917085,-109.4173618
8455,4,40,12,4,13,8,81,38.27591169917085,-109.4170923
8456,4,41,12,3,13,7,80,38.27591169917085,-109.4168228
8457,4,41,11,3,13,7,79,38.27591169917085,-109.4165533
8458,5,42,11,3,14,5,80,38.27591169917085,-109.4162838
8459,6,44,12,4,15,3,84,38.27591169917085,-109.4160143
8460,6,43,13,6,15,2,85,38.27591169917085,-109.4157448
8461,6,44,13,7,15,3,88,38.27591169917085,-109.4154753
8462,6,44,13,7,15,2,87,38.27591169917085,-109.4152058
8463,6,44,13,8,15,2,88,38.27591169917085,-109.4149364
8464,7,44,13,9,15,1,89,38.27591169917085,-109.4146669
8465,7,41,13,8,16,3,88,38.27591169917085,-109.4143974
8466,6,41,13,5,16,4,85,38.27591169917085,-109.4141279
8467,5,46,13,5,17,2,88,38.27591169917085,-109.4138584
8468,5,49,13,6,17,1,91,38.27591169917085,-109.4135889
8469,5,47,13,7,17,1,90,38.27591169917085,-109.4133194
8470,6,46,13,8,17,1,91,38.27591169917085,-109.4130499
8471,5,46,13,6,17,2,89,38.27591169917085,-109.4127804
8472,4,46,12,5,16,4,87,38.27591169917085,-109.4125109
8473,4,45,13,4,17,5,88,38.27591169917085,-109.4122414
8474,4,46,13,3,16,7,89,38.27591169917085,-109.4119719
8475,3,47,12,3,18,5,88,38.27591169917085,-109.4117024
8476,3,48,12,4,19,3,89,38.27591169917085,-109.4114329
8477,5,48,12,5,18,1,89,38.27591169917085,-109.4111634
8478,5,49,12,6,18,1,91,38.27591169917085,-109.4108939
8479,4,49,12,5,17,2,89,38.27591169917085,-109.4106244
8480,5,49,12,5,16,2,89,38.27591169917085,-109.4103549
8481,5,49,12,5,17,2,90,38.27591169917085,-109.4100855
8482,4,48,12,4,17,3,88,38.27591169917085,-109.409816
8483,4,44,13,6,18,2,87,38.27591169917085,-109.4095465
8484,4,44,13,9,18,1,89,38.27591169917085,-109.409277
8485,5,44,13,8,16,2,88,38.27591169917085,-109.4090075
8486,5,44,12,8,16,3,88,38.27591169917085,-109.408738
8487,5,43,13,7,17,3,88,38.27591169917085,-109.4084685
8488,5,43,12,6,16,4,86,38.27591169917085,-109.408199
8489,4,44,11,5,15,4,83,38.27591169917085,-109.4079295
8490,4,45,11,5,15,3,83,38.27591169917085,-109.40766
8491,3,46,10,5,14,3,81,38.27591169917085,-109.4073905
8492,4,46,11,6,12,4,83,38.27591169917085,-109.407121
8493,4,39,11,7,13,6,80,38.27591169917085,-109.4068515
8494,3,22,12,0,4,18,59,38.27591169917085,-109.3879869
8495,5,29,11,0,6,13,64,38.27591169917085,-109.3877174
8496,3,34,9,2,5,11,64,38.27591169917085,-109.3874479
8497,3,35,8,1,5,9,61,38.27591169917085,-109.3871784
8498,2,32,7,1,7,6,55,38.27591169917085,-109.3869089
8499,2,24,7,2,7,6,48,38.27591169917085,-109.3866394
8500,3,23,9,3,9,7,54,38.27591169917085,-109.3863699
8501,3,27,11,4,8,10,63,38.27591169917085,-109.3861004
8502,3,19,13,2,6,16,59,38.27591169917085,-109.3858309
8503,2,20,12,6,14,8,62,38.27591169917085,-109.3855614
8504,1,16,9,10,14,6,56,38.27591169917085,-109.3852919
8505,2,16,10,6,13,9,56,38.27591169917085,-109.3850225
8506,1,16,14,3,4,24,62,38.27591169917085,-109.384753
8507,2,20,17,0,2,27,68,38.27591169917085,-109.3844835
8508,2,21,15,1,2,24,65,38.27591169917085,-109.384214
8509,3,21,14,1,3,21,63,38.27591169917085,-109.3839445
8510,5,22,13,1,4,17,62,38.27591169917085,-109.383675
8511,7,24,13,2,6,11,63,38.27591169917085,-109.3834055
8512,4,24,12,3,7,12,62,38.27591169917085,-109.383136
8513,3,21,13,1,5,17,60,38.27591169917085,-109.3828665
8514,3,22,13,0,5,19,62,38.27591169917085,-109.382597
8515,3,24,12,0,6,17,62,38.27591169917085,-109.3823275
8516,2,23,11,0,7,16,59,38.27591169917085,-109.382058
8517,1,23,12,0,5,20,61,38.27591169917085,-109.3817885
8518,2,21,13,1,3,22,62,38.27591169917085,-109.381519
8519,2,20,13,3,5,19,62,38.27591169917085,-109.3812495
8520,4,25,11,2,8,14,64,38.27591169917085,-109.38098
8521,2,32,9,1,7,11,62,38.27591169917085,-109.3807105
8522,1,32,10,2,10,10,65,38.27591169917085,-109.380441
8523,2,28,9,3,8,10,60,38.27591169917085,-109.3801716
8524,4,24,8,2,7,9,54,38.27591169917085,-109.3799021
8525,4,32,6,1,6,7,56,38.27591169917085,-109.3796326
8526,2,41,5,1,8,4,61,38.27591169917085,-109.3793631
8527,2,36,4,1,8,4,55,38.27591169917085,-109.3790936
8528,2,34,5,3,8,6,58,38.27591169917085,-109.3788241
8529,5,28,6,2,5,8,54,38.27591169917085,-109.3785546
8530,5,27,9,3,5,12,61,38.27591169917085,-109.3782851
8531,3,20,10,3,3,17,56,38.27591169917085,-109.3780156
8532,2,21,15,3,3,23,67,38.27591169917085,-109.3777461
8533,3,22,15,3,5,21,69,38.27591169917085,-109.3774766
8534,3,26,13,4,6,16,68,38.27591169917085,-109.3772071
8535,4,27,12,5,9,12,69,38.27591169917085,-109.3769376
8536,6,35,12,4,11,7,75,38.27591169917085,-109.3766681
8537,4,39,11,3,12,8,77,38.27591169917085,-109.3763986
8538,3,35,11,2,11,10,72,38.27591169917085,-109.3761291
8539,2,27,13,0,5,19,66,38.27591169917085,-109.3758596
8540,6,29,14,3,7,15,74,38.27591169917085,-109.3755901
8541,8,33,13,6,9,10,79,38.27591169917085,-109.3753206
8542,6,34,12,5,10,10,77,38.27591169917085,-109.3750512
8543,4,31,12,3,9,12,71,38.27591169917085,-109.3747817
8544,3,24,14,2,5,20,68,38.27591169917085,-109.3745122
8545,2,17,14,2,4,21,60,38.27591169917085,-109.3742427
8546,4,21,12,4,6,15,62,38.27591169917085,-109.3739732
8547,4,30,11,3,9,11,68,38.27591169917085,-109.3737037
8548,2,34,10,2,11,10,69,38.27591169917085,-109.3734342
8549,2,36,10,1,12,10,71,38.27591169917085,-109.3731647
8550,2,25,10,4,9,11,61,38.27591169917085,-109.3728952
8551,1,22,10,7,11,9,60,38.27591169917085,-109.3726257
8552,3,26,8,11,14,2,64,38.27591169917085,-109.3723562
8553,4,32,7,14,10,0,67,38.27591169917085,-109.3720867
8554,5,30,10,9,12,7,73,38.27591169917085,-109.3718172
8555,5,26,13,1,10,18,73,38.27591169917085,-109.3715477
8556,3,27,14,0,10,20,74,38.27591169917085,-109.3712782
8557,4,31,15,12,6,14,82,38.27591169917085,-109.3710087
8558,4,34,12,9,10,12,81,38.27591169917085,-109.3707392
8559,4,30,13,4,10,17,78,38.27591169917085,-109.3704697
8560,3,29,15,1,9,20,77,38.27591169917085,-109.3702003
8561,3,27,15,0,9,22,76,38.27591169917085,-109.3699308
8562,3,27,17,0,12,24,83,38.27591169917085,-109.3696613
8563,2,28,17,3,13,19,82,38.27591169917085,-109.3693918
8564,10,28,16,6,16,7,83,38.27591169917085,-109.3691223
8565,6,25,15,12,25,1,84,38.27591169917085,-109.3688528
8566,3,24,13,15,25,1,81,38.27591169917085,-109.3685833
8567,4,20,14,20,18,1,77,38.27591169917085,-109.3683138
8568,1,17,14,14,17,8,71,38.27591169917085,-109.3680443
8569,1,15,12,16,20,4,68,38.27591169917085,-109.3677748
8570,3,16,11,18,24,2,74,38.27591169917085,-109.3675053
8571,2,19,10,25,15,5,76,38.27591169917085,-109.3672358
8572,0,21,12,14,17,8,72,38.27591169917085,-109.3669663
8573,1,23,11,11,13,9,68,38.27591169917085,-109.3666968
8574,1,25,13,6,10,17,72,38.27591169917085,-109.3664273
8575,1,25,19,0,9,26,80,38.27591169917085,-109.3661578
8576,0,22,19,0,3,34,78,38.27591169917085,-109.3658883
8577,0,22,18,0,4,33,77,38.27591169917085,-109.3656188
8578,0,24,18,0,5,31,78,38.27591169917085,-109.3653493
8579,0,24,18,0,6,30,78,38.27591169917085,-109.3650799
8580,0,24,19,0,6,29,78,38.27591169917085,-109.3648104
8581,0,23,21,0,7,31,82,38.27591169917085,-109.3645409
8582,1,23,19,1,7,30,81,38.27591169917085,-109.3642714
8583,0,24,19,1,7,29,80,38.27591169917085,-109.3640019
8584,0,26,18,0,6,30,80,38.27591169917085,-109.3637324
8585,0,24,17,0,4,30,75,38.27591169917085,-109.3634629
8586,0,23,17,0,3,31,74,38.27591169917085,-109.3631934
8587,0,24,18,0,4,31,77,38.27591169917085,-109.3629239
8588,0,22,17,0,4,31,74,38.27591169917085,-109.3626544
8589,1,20,16,0,3,29,69,38.27591169917085,-109.3623849
8590,1,20,15,0,2,28,66,38.27591169917085,-109.3621154
8591,0,21,14,0,2,26,63,38.27591169917085,-109.3618459
8592,0,24,12,0,3,21,60,38.27591169917085,-109.3615764
8593,0,22,12,0,3,21,58,38.27591169917085,-109.3613069
8594,0,22,12,0,3,21,58,38.27591169917085,-109.3610374
8595,1,22,11,0,3,21,58,38.27591169917085,-109.3607679
8596,1,21,12,0,3,22,59,38.27591169917085,-109.3604984
8597,0,19,13,0,2,23,57,38.27591169917085,-109.360229
8598,0,18,13,0,1,25,57,38.27591169917085,-109.3599595
8599,0,20,13,0,1,24,58,38.27591169917085,-109.35969
8600,0,26,12,0,2,22,62,38.27591169917085,-109.3594205
8601,0,22,11,0,2,20,55,38.27591169917085,-109.359151
8602,0,19,12,0,2,21,54,38.27591169917085,-109.3588815
8603,0,20,11,0,3,19,53,38.27591169917085,-109.358612
8604,1,23,11,0,5,15,55,38.27591169917085,-109.3583425
8605,1,20,11,1,4,17,54,38.27591169917085,-109.358073
8606,2,20,11,2,6,14,55,38.27591169917085,-109.3578035
8607,3,16,12,3,5,16,55,38.27591169917085,-109.357534
8608,3,15,11,2,3,17,51,38.27591169917085,-109.3572645
8609,5,22,9,1,1,14,52,38.27591169917085,-109.356995
8610,3,22,8,1,3,12,49,38.27591169917085,-109.3567255
8611,3,25,8,4,7,8,55,38.27591169917085,-109.356456
8612,3,25,8,5,8,8,57,38.27591169917085,-109.3561865
8613,3,26,7,6,9,6,57,38.27591169917085,-109.355917
8614,4,37,7,8,9,3,68,38.27591169917085,-109.3556475
8615,4,33,7,9,8,3,64,38.27591169917085,-109.355378
8616,5,21,9,9,7,7,58,38.27591169917085,-109.3551086
8617,3,10,11,6,5,13,48,38.27591169917085,-109.3548391
8618,3,10,12,7,6,17,55,38.27591169917085,-109.3545696
8619,2,12,14,3,4,24,59,38.27591169917085,-109.3543001
8620,1,18,16,1,2,28,66,38.27591169917085,-109.3540306
8621,1,18,18,1,2,31,71,38.27591169917085,-109.3537611
8622,1,19,19,0,3,33,75,38.27591169917085,-109.3534916
8623,1,21,19,1,4,31,77,38.27591169917085,-109.3532221
8624,0,23,21,1,6,32,83,38.27591169917085,-109.3529526
8625,0,21,22,1,7,33,84,38.27591169917085,-109.3526831
8626,0,20,22,1,7,34,84,38.27591169917085,-109.3524136
8627,2,20,21,2,5,32,82,38.27591169917085,-109.3521441
8628,2,21,20,2,7,32,84,38.27591169917085,-109.3518746
8629,2,24,18,2,4,30,80,38.27591169917085,-109.3516051
8630,3,24,18,3,3,28,79,38.27591169917085,-109.3513356
8631,3,23,18,1,7,25,77,38.27591169917085,-109.3510661
8632,3,25,18,3,10,24,83,38.27591169917085,-109.3507966
8633,5,26,18,7,12,19,87,38.27591169917085,-109.3505271
8634,4,27,18,6,10,20,85,38.27591169917085,-109.3502577
8635,2,22,20,0,6,30,80,38.27591169917085,-109.3499882
8636,1,20,21,0,5,34,81,38.27591169917085,-109.3497187
8637,1,22,21,0,6,32,82,38.27591169917085,-109.3494492
8638,1,21,22,1,8,32,85,38.27591169917085,-109.3491797
8639,2,19,21,3,5,33,83,38.27591169917085,-109.3489102
8640,2,18,20,3,6,33,82,38.27591169917085,-109.3486407
8641,1,17,21,4,8,35,86,38.27591169917085,-109.3483712
8642,2,18,19,5,10,31,85,38.27591169917085,-109.3481017
8643,5,20,18,10,12,20,85,38.27591169917085,-109.3478322
8644,5,23,19,12,11,16,86,38.27591169917085,-109.3475627
8645,5,26,17,14,11,14,87,38.27591169917085,-109.3472932
8646,5,27,16,13,12,14,87,38.27591169917085,-109.3470237
8647,7,28,16,16,10,11,88,38.27591169917085,-109.3467542
8648,9,30,14,16,10,6,85,38.27591169917085,-109.3464847
8649,9,34,14,14,11,5,87,38.27591169917085,-109.3462152
8650,10,35,13,14,12,4,88,38.27591169917085,-109.3459457
8651,11,34,13,14,12,4,88,38.27591169917085,-109.3456762
8652,12,32,14,15,11,5,89,38.27591169917085,-109.3454068
8653,18,27,13,20,10,3,91,38.27591169917085,-109.3451373
8654,22,24,13,23,8,2,92,38.27591169917085,-109.3448678
8655,21,24,13,23,9,3,93,38.27591169917085,-109.3445983
8656,16,27,13,21,9,4,90,38.27591169917085,-109.3443288
8657,12,32,14,15,9,5,87,38.27591169917085,-109.3440593
8658,9,35,14,13,12,4,87,38.27591169917085,-109.3437898
8659,12,34,14,14,12,3,89,38.27591169917085,-109.3435203
8660,14,31,13,19,10,3,90,38.27591169917085,-109.3432508
8661,1,45,11,0,14,11,82,38.27564220458561,-109.4335315
8662,1,43,10,0,13,11,78,38.27564220458561,-109.433262
8663,1,43,10,0,12,10,76,38.27564220458561,-109.4329925
8664,1,41,10,1,13,9,75,38.27564220458561,-109.432723
8665,1,37,11,2,12,9,72,38.27564220458561,-109.4324535
8666,1,36,11,1,11,11,71,38.27564220458561,-109.432184
8667,1,35,11,1,10,12,70,38.27564220458561,-109.4319145
8668,1,33,11,1,11,13,70,38.27564220458561,-109.431645
8669,1,34,11,0,12,14,72,38.27564220458561,-109.4313755
8670,1,38,11,0,14,11,75,38.27564220458561,-109.431106
8671,2,39,11,2,13,7,74,38.27564220458561,-109.4308365
8672,1,39,11,2,11,8,72,38.27564220458561,-109.430567
8673,1,40,11,1,12,9,74,38.27564220458561,-109.4302975
8674,1,39,12,1,14,9,76,38.27564220458561,-109.430028
8675,2,37,11,3,14,8,75,38.27564220458561,-109.4297586
8676,2,41,10,6,12,4,75,38.27564220458561,-109.4294891
8677,2,40,9,2,9,5,67,38.27564220458561,-109.4292196
8678,2,33,7,5,9,4,60,38.27564220458561,-109.4289501
8679,4,25,9,8,12,4,62,38.27564220458561,-109.4286806
8680,2,33,12,8,11,10,76,38.27564220458561,-109.4284111
8681,8,23,12,19,7,13,82,38.27564220458561,-109.4281416
8682,7,22,11,23,12,7,82,38.27564220458561,-109.4278721
8683,1,25,12,14,24,6,82,38.27564220458561,-109.4276026
8684,0,34,13,2,20,13,82,38.27564220458561,-109.4273331
8685,0,35,13,0,13,17,78,38.27564220458561,-109.4270636
8686,0,35,12,0,12,18,77,38.27564220458561,-109.4267941
8687,0,38,13,0,15,15,81,38.27564220458561,-109.4265246
8688,1,40,12,0,16,12,81,38.27564220458561,-109.4262551
8689,2,38,12,0,15,14,81,38.27564220458561,-109.4259856
8690,1,34,14,0,13,19,81,38.27564220458561,-109.4257161
8691,1,33,15,0,11,22,82,38.27564220458561,-109.4254466
8692,1,33,14,0,10,22,80,38.27564220458561,-109.4251771
8693,0,34,13,0,11,20,78,38.27564220458561,-109.4249077
8694,1,33,13,0,12,20,79,38.27564220458561,-109.4246382
8695,0,32,13,0,11,21,77,38.27564220458561,-109.4243687
8696,1,36,12,0,13,16,78,38.27564220458561,-109.4240992
8697,2,40,12,0,15,12,81,38.27564220458561,-109.4238297
8698,2,39,12,0,16,11,80,38.27564220458561,-109.4235602
8699,2,40,12,0,16,12,82,38.27564220458561,-109.4232907
8700,1,37,12,0,13,16,79,38.27564220458561,-109.4230212
8701,1,33,12,0,11,19,76,38.27564220458561,-109.4227517
8702,1,31,13,0,10,21,76,38.27564220458561,-109.4224822
8703,1,32,13,0,10,19,75,38.27564220458561,-109.4222127
8704,0,33,12,0,10,20,75,38.27564220458561,-109.4219432
8705,0,33,12,0,10,19,74,38.27564220458561,-109.4216737
8706,1,32,11,0,11,17,72,38.27564220458561,-109.4214042
8707,0,31,11,0,11,15,68,38.27564220458561,-109.4211347
8708,1,29,11,1,9,15,66,38.27564220458561,-109.4208652
8709,1,29,11,2,10,14,67,38.27564220458561,-109.4205957
8710,1,31,11,0,11,13,67,38.27564220458561,-109.4203262
8711,1,32,10,0,12,12,67,38.27564220458561,-109.4200568
8712,1,32,10,2,12,11,68,38.27564220458561,-109.4197873
8713,1,34,10,0,12,11,68,38.27564220458561,-109.4195178
8714,1,36,10,1,13,10,71,38.27564220458561,-109.4192483
8715,1,34,11,0,12,12,70,38.27564220458561,-109.4189788
8716,0,34,10,0,9,15,68,38.27564220458561,-109.4187093
8717,1,33,10,0,10,14,68,38.27564220458561,-109.4184398
8718,1,37,10,0,11,13,72,38.27564220458561,-109.4181703
8719,2,45,10,0,10,14,81,38.27564220458561,-109.4179008
8720,2,47,10,0,12,12,83,38.27564220458561,-109.4176313
8721,3,45,11,1,12,10,82,38.27564220458561,-109.4173618
8722,3,42,11,1,11,11,79,38.27564220458561,-109.4170923
8723,3,41,11,2,11,10,78,38.27564220458561,-109.4168228
8724,4,41,12,3,12,8,80,38.27564220458561,-109.4165533
8725,6,42,12,4,13,5,82,38.27564220458561,-109.4162838
8726,6,44,13,5,15,2,85,38.27564220458561,-109.4160143
8727,6,45,13,7,15,1,87,38.27564220458561,-109.4157448
8728,6,44,13,7,15,2,87,38.27564220458561,-109.4154753
8729,6,43,13,7,15,3,87,38.27564220458561,-109.4152058
8730,7,41,13,9,15,2,87,38.27564220458561,-109.4149364
8731,8,40,13,11,15,1,88,38.27564220458561,-109.4146669
8732,6,39,12,6,14,4,81,38.27564220458561,-109.4143974
8733,6,40,12,5,15,3,81,38.27564220458561,-109.4141279
8734,6,42,12,5,16,2,83,38.27564220458561,-109.4138584
8735,6,45,13,5,17,2,88,38.27564220458561,-109.4135889
8736,6,46,13,6,17,2,90,38.27564220458561,-109.4133194
8737,6,49,13,5,17,2,92,38.27564220458561,-109.4130499
8738,5,49,12,5,16,3,90,38.27564220458561,-109.4127804
8739,4,48,12,5,16,3,88,38.27564220458561,-109.4125109
8740,4,48,13,4,17,4,90,38.27564220458561,-109.4122414
8741,4,50,13,2,17,5,91,38.27564220458561,-109.4119719
8742,5,49,13,5,18,3,93,38.27564220458561,-109.4117024
8743,5,50,13,5,18,2,93,38.27564220458561,-109.4114329
8744,5,50,13,5,18,2,93,38.27564220458561,-109.4111634
8745,5,49,13,5,18,2,92,38.27564220458561,-109.4108939
8746,4,49,13,5,18,2,91,38.27564220458561,-109.4106244
8747,4,50,12,5,17,2,90,38.27564220458561,-109.4103549
8748,5,48,12,6,18,1,90,38.27564220458561,-109.4100855
8749,5,46,12,7,19,1,90,38.27564220458561,-109.409816
8750,4,46,12,5,18,2,87,38.27564220458561,-109.4095465
8751,4,46,12,7,17,2,88,38.27564220458561,-109.409277
8752,4,45,13,8,17,2,89,38.27564220458561,-109.4090075
8753,5,44,13,10,17,1,90,38.27564220458561,-109.408738
8754,5,43,13,10,18,1,90,38.27564220458561,-109.4084685
8755,4,42,12,6,15,4,83,38.27564220458561,-109.408199
8756,3,46,10,4,14,5,82,38.27564220458561,-109.4079295
8757,3,45,10,5,15,4,82,38.27564220458561,-109.40766
8758,4,41,11,7,14,4,81,38.27564220458561,-109.4073905
8759,7,39,12,7,12,6,83,38.27564220458561,-109.407121
8760,4,38,11,7,12,7,79,38.27564220458561,-109.4068515
8761,2,22,13,1,4,17,59,38.27564220458561,-109.3879869
8762,2,24,9,1,4,15,55,38.27564220458561,-109.3877174
8763,1,27,7,0,6,9,50,38.27564220458561,-109.3874479
8764,2,31,7,0,7,6,53,38.27564220458561,-109.3871784
8765,2,29,6,0,7,6,50,38.27564220458561,-109.3869089
8766,4,24,7,1,8,6,50,38.27564220458561,-109.3866394
8767,4,28,9,3,8,7,59,38.27564220458561,-109.3863699
8768,3,32,12,3,12,10,72,38.27564220458561,-109.3861004
8769,3,23,15,3,9,20,73,38.27564220458561,-109.3858309
8770,0,19,12,3,16,11,61,38.27564220458561,-109.3855614
8771,2,17,10,9,14,5,57,38.27564220458561,-109.3852919
8772,1,18,9,5,13,10,56,38.27564220458561,-109.3850225
8773,2,18,11,2,6,17,56,38.27564220458561,-109.384753
8774,5,33,12,2,5,14,71,38.27564220458561,-109.3844835
8775,5,27,10,1,5,14,62,38.27564220458561,-109.384214
8776,6,30,9,2,5,10,62,38.27564220458561,-109.3839445
8777,6,33,8,2,5,8,62,38.27564220458561,-109.383675
8778,6,32,8,2,6,7,61,38.27564220458561,-109.3834055
8779,6,29,9,2,7,7,60,38.27564220458561,-109.383136
8780,6,20,12,3,9,10,60,38.27564220458561,-109.3828665
8781,3,20,13,2,5,17,60,38.27564220458561,-109.382597
8782,3,24,13,0,6,19,65,38.27564220458561,-109.3823275
8783,1,22,12,0,8,19,62,38.27564220458561,-109.382058
8784,1,23,12,0,5,19,60,38.27564220458561,-109.3817885
8785,2,20,12,3,6,16,59,38.27564220458561,-109.381519
8786,6,22,11,2,7,12,60,38.27564220458561,-109.3812495
8787,5,24,10,3,7,10,59,38.27564220458561,-109.38098
8788,3,27,9,3,8,8,58,38.27564220458561,-109.3807105
8789,4,27,8,3,9,7,58,38.27564220458561,-109.380441
8790,4,26,8,2,9,6,55,38.27564220458561,-109.3801716
8791,2,29,7,2,8,6,54,38.27564220458561,-109.3799021
8792,2,37,6,3,7,5,60,38.27564220458561,-109.3796326
8793,2,30,6,0,8,6,52,38.27564220458561,-109.3793631
8794,1,31,5,0,8,6,51,38.27564220458561,-109.3790936
8795,1,33,5,0,8,6,53,38.27564220458561,-109.3788241
8796,2,41,5,3,8,4,63,38.27564220458561,-109.3785546
8797,1,38,6,3,8,6,62,38.27564220458561,-109.3782851
8798,1,33,8,3,8,8,61,38.27564220458561,-109.3780156
8799,2,29,11,4,8,14,68,38.27564220458561,-109.3777461
8800,3,24,15,3,6,20,71,38.27564220458561,-109.3774766
8801,5,29,14,3,7,16,74,38.27564220458561,-109.3772071
8802,4,28,12,5,8,12,69,38.27564220458561,-109.3769376
8803,8,35,12,4,12,6,77,38.27564220458561,-109.3766681
8804,5,35,12,4,13,7,76,38.27564220458561,-109.3763986
8805,5,31,13,3,10,11,73,38.27564220458561,-109.3761291
8806,5,30,13,2,8,16,74,38.27564220458561,-109.3758596
8807,9,30,14,8,10,10,81,38.27564220458561,-109.3755901
8808,9,31,14,8,11,8,81,38.27564220458561,-109.3753206
8809,8,35,13,7,12,7,82,38.27564220458561,-109.3750512
8810,6,33,12,5,10,11,77,38.27564220458561,-109.3747817
8811,3,24,13,3,5,19,67,38.27564220458561,-109.3745122
8812,4,21,14,2,3,20,64,38.27564220458561,-109.3742427
8813,4,26,12,2,6,15,65,38.27564220458561,-109.3739732
8814,2,33,10,1,10,11,67,38.27564220458561,-109.3737037
8815,2,36,10,1,11,9,69,38.27564220458561,-109.3734342
8816,2,23,11,2,5,15,58,38.27564220458561,-109.3731647
8817,1,28,12,1,11,17,70,38.27564220458561,-109.3728952
8818,3,27,10,11,16,3,70,38.27564220458561,-109.3726257
8819,4,31,8,11,11,1,66,38.27564220458561,-109.3723562
8820,2,34,6,15,9,1,67,38.27564220458561,-109.3720867
8821,7,34,11,7,13,5,77,38.27564220458561,-109.3718172
8822,1,31,13,0,8,17,70,38.27564220458561,-109.3715477
8823,1,32,14,0,4,23,74,38.27564220458561,-109.3712782
8824,4,28,14,2,9,17,74,38.27564220458561,-109.3710087
8825,2,30,15,0,10,21,78,38.27564220458561,-109.3707392
8826,1,27,17,0,8,28,81,38.27564220458561,-109.3704697
8827,3,28,17,2,11,21,82,38.27564220458561,-109.3702003
8828,5,27,17,5,11,18,83,38.27564220458561,-109.3699308
8829,4,28,17,4,13,18,84,38.27564220458561,-109.3696613
8830,5,30,16,7,17,12,87,38.27564220458561,-109.3693918
8831,7,21,13,18,19,5,83,38.27564220458561,-109.3691223
8832,6,20,13,18,20,3,80,38.27564220458561,-109.3688528
8833,5,17,12,19,23,3,79,38.27564220458561,-109.3685833
8834,6,17,12,16,21,4,76,38.27564220458561,-109.3683138
8835,4,16,13,18,22,5,78,38.27564220458561,-109.3680443
8836,4,16,12,17,20,3,72,38.27564220458561,-109.3677748
8837,5,22,10,10,22,3,72,38.27564220458561,-109.3675053
8838,2,25,12,9,17,7,72,38.27564220458561,-109.3672358
8839,1,29,15,1,8,22,76,38.27564220458561,-109.3669663
8840,0,28,17,0,7,26,78,38.27564220458561,-109.3666968
8841,1,24,19,0,6,31,81,38.27564220458561,-109.3664273
8842,0,21,18,0,4,32,75,38.27564220458561,-109.3661578
8843,0,20,17,0,3,32,72,38.27564220458561,-109.3658883
8844,0,22,17,0,3,30,72,38.27564220458561,-109.3656188
8845,0,26,18,0,4,31,79,38.27564220458561,-109.3653493
8846,0,25,18,0,5,30,78,38.27564220458561,-109.3650799
8847,0,25,18,0,6,30,79,38.27564220458561,-109.3648104
8848,0,27,19,1,6,30,83,38.27564220458561,-109.3645409
8849,0,26,19,0,6,32,83,38.27564220458561,-109.3642714
8850,0,24,17,0,5,32,78,38.27564220458561,-109.3640019
8851,0,22,16,0,4,29,71,38.27564220458561,-109.3637324
8852,0,22,15,0,3,28,68,38.27564220458561,-109.3634629
8853,0,22,17,0,2,31,72,38.27564220458561,-109.3631934
8854,0,24,18,0,3,32,77,38.27564220458561,-109.3629239
8855,0,22,18,0,3,33,76,38.27564220458561,-109.3626544
8856,0,21,18,0,3,32,74,38.27564220458561,-109.3623849
8857,0,22,17,0,3,31,73,38.27564220458561,-109.3621154
8858,0,23,17,0,5,29,74,38.27564220458561,-109.3618459
8859,0,23,16,0,4,29,72,38.27564220458561,-109.3615764
8860,1,23,15,0,4,26,69,38.27564220458561,-109.3613069
8861,1,22,15,0,3,26,67,38.27564220458561,-109.3610374
8862,1,22,15,0,2,27,67,38.27564220458561,-109.3607679
8863,0,21,14,0,2,27,64,38.27564220458561,-109.3604984
8864,0,20,15,0,2,28,65,38.27564220458561,-109.360229
8865,0,20,14,0,2,27,63,38.27564220458561,-109.3599595
8866,0,22,13,0,2,24,61,38.27564220458561,-109.35969
8867,0,27,11,0,3,21,62,38.27564220458561,-109.3594205
8868,0,23,12,0,3,22,60,38.27564220458561,-109.359151
8869,0,20,13,0,2,24,59,38.27564220458561,-109.3588815
8870,1,19,13,0,2,23,58,38.27564220458561,-109.358612
8871,1,19,12,0,3,18,53,38.27564220458561,-109.3583425
8872,1,19,11,2,4,17,54,38.27564220458561,-109.358073
8873,5,23,10,3,5,10,56,38.27564220458561,-109.3578035
8874,2,24,9,4,5,10,54,38.27564220458561,-109.357534
8875,2,23,8,5,7,9,54,38.27564220458561,-109.3572645
8876,2,31,7,3,7,7,57,38.27564220458561,-109.356995
8877,2,33,7,5,8,6,61,38.27564220458561,-109.3567255
8878,2,34,7,5,8,5,61,38.27564220458561,-109.356456
8879,2,33,7,4,7,5,58,38.27564220458561,-109.3561865
8880,3,36,7,4,9,4,63,38.27564220458561,-109.355917
8881,6,34,9,8,9,4,70,38.27564220458561,-109.3556475
8882,5,25,9,8,8,5,60,38.27564220458561,-109.355378
8883,3,21,10,6,7,7,54,38.27564220458561,-109.3551086
8884,2,16,10,6,7,8,49,38.27564220458561,-109.3548391
8885,2,11,11,8,8,12,52,38.27564220458561,-109.3545696
8886,5,15,12,6,5,15,58,38.27564220458561,-109.3543001
8887,3,15,15,3,3,25,64,38.27564220458561,-109.3540306
8888,1,17,18,1,4,31,72,38.27564220458561,-109.3537611
8889,0,19,20,0,4,34,77,38.27564220458561,-109.3534916
8890,0,19,20,0,3,34,76,38.27564220458561,-109.3532221
8891,2,25,20,1,3,30,81,38.27564220458561,-109.3529526
8892,2,25,19,1,2,30,79,38.27564220458561,-109.3526831
8893,2,23,19,2,3,31,80,38.27564220458561,-109.3524136
8894,1,21,20,1,5,33,81,38.27564220458561,-109.3521441
8895,1,19,21,0,5,35,81,38.27564220458561,-109.3518746
8896,1,21,18,1,2,32,75,38.27564220458561,-109.3516051
8897,1,20,18,1,3,31,74,38.27564220458561,-109.3513356
8898,1,22,19,1,6,30,79,38.27564220458561,-109.3510661
8899,1,24,20,2,9,28,84,38.27564220458561,-109.3507966
8900,0,25,21,3,10,25,84,38.27564220458561,-109.3505271
8901,2,20,21,6,9,25,83,38.27564220458561,-109.3502577
8902,2,20,22,4,5,29,82,38.27564220458561,-109.3499882
8903,2,20,22,2,5,30,81,38.27564220458561,-109.3497187
8904,3,20,21,3,5,30,82,38.27564220458561,-109.3494492
8905,3,22,20,3,6,30,84,38.27564220458561,-109.3491797
8906,3,22,20,3,6,31,85,38.27564220458561,-109.3489102
8907,3,21,20,4,6,30,84,38.27564220458561,-109.3486407
8908,2,20,21,3,9,32,87,38.27564220458561,-109.3483712
8909,2,19,20,5,9,29,84,38.27564220458561,-109.3481017
8910,5,20,19,8,10,24,86,38.27564220458561,-109.3478322
8911,3,22,19,10,11,21,86,38.27564220458561,-109.3475627
8912,3,23,19,10,11,20,86,38.27564220458561,-109.3472932
8913,4,24,18,10,12,18,86,38.27564220458561,-109.3470237
8914,5,26,17,13,13,15,89,38.27564220458561,-109.3467542
8915,7,27,15,18,11,9,87,38.27564220458561,-109.3464847
8916,10,30,14,18,10,5,87,38.27564220458561,-109.3462152
8917,11,32,13,16,11,4,87,38.27564220458561,-109.3459457
8918,14,32,13,15,11,4,89,38.27564220458561,-109.3456762
8919,16,29,13,17,9,5,89,38.27564220458561,-109.3454068
8920,22,26,13,22,8,3,94,38.27564220458561,-109.3451373
8921,22,25,12,23,8,3,93,38.27564220458561,-109.3448678
8922,17,26,13,23,8,4,91,38.27564220458561,-109.3445983
8923,13,30,13,18,9,5,88,38.27564220458561,-109.3443288
8924,7,37,14,12,11,6,87,38.27564220458561,-109.3440593
8925,7,39,14,11,13,5,89,38.27564220458561,-109.3437898
8926,8,37,14,12,11,5,87,38.27564220458561,-109.3435203
8927,8,34,14,17,9,5,87,38.27564220458561,-109.3432508
8928,7,34,13,19,9,4,86,38.27564220458561,-109.3429813
8929,1,48,10,0,13,10,82,38.275372710000376,-109.433801
8930,1,49,10,0,13,11,84,38.275372710000376,-109.4335315
8931,1,45,10,0,12,11,79,38.275372710000376,-109.433262
8932,1,42,10,0,12,9,74,38.275372710000376,-109.4329925
8933,1,39,10,0,11,9,70,38.275372710000376,-109.432723
8934,1,38,11,0,11,10,71,38.275372710000376,-109.4324535
8935,0,38,10,0,11,11,70,38.275372710000376,-109.432184
8936,1,40,11,0,11,11,74,38.275372710000376,-109.4319145
8937,1,40,11,0,12,12,76,38.275372710000376,-109.431645
8938,2,38,11,0,12,12,75,38.275372710000376,-109.4313755
8939,2,39,10,1,11,11,74,38.275372710000376,-109.431106
8940,1,42,10,0,11,10,74,38.275372710000376,-109.4308365
8941,2,39,11,2,9,8,71,38.275372710000376,-109.430567
8942,2,35,11,3,9,8,68,38.275372710000376,-109.4302975
8943,1,35,11,3,10,8,68,38.275372710000376,-109.430028
8944,1,38,11,1,12,9,72,38.275372710000376,-109.4297586
8945,2,38,11,5,11,5,72,38.275372710000376,-109.4294891
8946,2,31,10,4,10,6,63,38.275372710000376,-109.4292196
8947,4,27,10,8,13,4,66,38.275372710000376,-109.4289501
8948,16,27,12,13,15,2,85,38.275372710000376,-109.4286806
8949,7,20,13,20,14,12,86,38.275372710000376,-109.4284111
8950,3,26,11,21,16,10,87,38.275372710000376,-109.4281416
8951,4,24,12,17,12,13,82,38.275372710000376,-109.4278721
8952,0,33,14,5,18,14,84,38.275372710000376,-109.4276026
8953,0,34,13,0,17,16,80,38.275372710000376,-109.4273331
8954,0,32,13,0,13,20,78,38.275372710000376,-109.4270636
8955,0,31,13,0,11,21,76,38.275372710000376,-109.4267941
8956,0,35,13,0,13,18,79,38.275372710000376,-109.4265246
8957,0,38,12,0,15,15,80,38.275372710000376,-109.4262551
8958,2,37,13,0,15,14,81,38.275372710000376,-109.4259856
8959,1,32,14,0,13,20,80,38.275372710000376,-109.4257161
8960,1,32,15,0,11,24,83,38.275372710000376,-109.4254466
8961,1,33,14,0,9,23,80,38.275372710000376,-109.4251771
8962,0,35,12,0,11,19,77,38.275372710000376,-109.4249077
8963,1,34,13,0,10,21,79,38.275372710000376,-109.4246382
8964,1,32,14,0,11,21,79,38.275372710000376,-109.4243687
8965,1,35,13,0,12,18,79,38.275372710000376,-109.4240992
8966,1,37,12,0,14,15,79,38.275372710000376,-109.4238297
8967,1,37,13,0,15,13,79,38.275372710000376,-109.4235602
8968,2,41,12,0,15,12,82,38.275372710000376,-109.4232907
8969,2,43,11,0,15,12,83,38.275372710000376,-109.4230212
8970,1,42,12,0,15,12,82,38.275372710000376,-109.4227517
8971,2,41,12,0,15,12,82,38.275372710000376,-109.4224822
8972,1,38,12,0,13,15,79,38.275372710000376,-109.4222127
8973,1,37,12,0,11,17,78,38.275372710000376,-109.4219432
8974,1,37,11,0,11,16,76,38.275372710000376,-109.4216737
8975,1,39,11,0,12,14,77,38.275372710000376,-109.4214042
8976,1,37,10,0,12,14,74,38.275372710000376,-109.4211347
8977,0,31,11,0,12,15,69,38.275372710000376,-109.4208652
8978,0,32,12,1,13,14,72,38.275372710000376,-109.4205957
8979,0,32,11,0,13,13,69,38.275372710000376,-109.4203262
8980,1,32,11,1,12,12,69,38.275372710000376,-109.4200568
8981,0,31,11,1,12,12,67,38.275372710000376,-109.4197873
8982,1,37,10,0,13,10,71,38.275372710000376,-109.4195178
8983,1,36,11,0,15,11,74,38.275372710000376,-109.4192483
8984,1,34,11,0,12,15,73,38.275372710000376,-109.4189788
8985,0,33,11,0,10,16,70,38.275372710000376,-109.4187093
8986,0,28,12,0,10,17,67,38.275372710000376,-109.4184398
8987,1,29,12,0,8,18,68,38.275372710000376,-109.4181703
8988,1,35,10,0,7,18,71,38.275372710000376,-109.4179008
8989,1,40,10,0,11,13,75,38.275372710000376,-109.4176313
8990,2,40,11,1,13,10,77,38.275372710000376,-109.4173618
8991,2,39,10,1,11,12,75,38.275372710000376,-109.4170923
8992,3,41,11,3,12,9,79,38.275372710000376,-109.4168228
8993,5,43,12,6,13,5,84,38.275372710000376,-109.4165533
8994,8,43,13,9,14,2,89,38.275372710000376,-109.4162838
8995,8,44,13,9,15,1,90,38.275372710000376,-109.4160143
8996,7,44,14,9,15,1,90,38.275372710000376,-109.4157448
8997,7,44,13,8,15,2,89,38.275372710000376,-109.4154753
8998,7,43,13,8,15,2,88,38.275372710000376,-109.4152058
8999,8,42,13,9,15,2,89,38.275372710000376,-109.4149364
9000,8,40,13,11,15,1,88,38.275372710000376,-109.4146669
9001,5,40,12,6,14,4,81,38.275372710000376,-109.4143974
9002,7,40,13,7,15,2,84,38.275372710000376,-109.4141279
9003,8,42,13,8,16,1,88,38.275372710000376,-109.4138584
9004,7,46,13,7,16,1,90,38.275372710000376,-109.4135889
9005,5,48,12,5,16,2,88,38.275372710000376,-109.4133194
9006,5,49,12,5,16,2,89,38.275372710000376,-109.4130499
9007,6,48,13,5,16,2,90,38.275372710000376,-109.4127804
9008,7,47,13,6,16,2,91,38.275372710000376,-109.4125109
9009,6,47,13,6,17,2,91,38.275372710000376,-109.4122414
9010,5,50,13,4,17,2,91,38.275372710000376,-109.4119719
9011,5,50,13,4,18,2,92,38.275372710000376,-109.4117024
9012,5,50,12,4,19,2,92,38.275372710000376,-109.4114329
9013,5,50,12,3,18,2,90,38.275372710000376,-109.4111634
9014,6,48,12,5,18,1,90,38.275372710000376,-109.4108939
9015,5,50,13,5,18,2,93,38.275372710000376,-109.4106244
9016,4,51,12,5,18,2,92,38.275372710000376,-109.4103549
9017,4,49,12,6,18,1,90,38.275372710000376,-109.4100855
9018,4,48,12,6,17,1,88,38.275372710000376,-109.409816
9019,5,51,12,5,16,2,91,38.275372710000376,-109.4095465
9020,4,48,12,5,16,2,87,38.275372710000376,-109.409277
9021,5,45,13,7,17,2,89,38.275372710000376,-109.4090075
9022,5,43,13,8,17,2,88,38.275372710000376,-109.408738
9023,5,43,13,8,18,2,89,38.275372710000376,-109.4084685
9024,5,41,12,8,17,3,86,38.275372710000376,-109.408199
9025,3,45,11,8,15,2,84,38.275372710000376,-109.4079295
9026,4,44,11,8,14,3,84,38.275372710000376,-109.40766
9027,7,38,12,10,13,3,83,38.275372710000376,-109.4073905
9028,10,36,13,9,12,4,84,38.275372710000376,-109.407121
9029,3,42,11,4,12,8,80,38.275372710000376,-109.4068515
9030,1,25,11,1,4,16,58,38.275372710000376,-109.3879869
9031,0,30,8,0,8,8,54,38.275372710000376,-109.3877174
9032,1,29,7,0,7,7,51,38.275372710000376,-109.3874479
9033,3,33,7,0,8,5,56,38.275372710000376,-109.3871784
9034,1,28,6,0,9,7,51,38.275372710000376,-109.3869089
9035,3,28,8,1,8,7,55,38.275372710000376,-109.3866394
9036,5,31,10,4,7,8,65,38.275372710000376,-109.3863699
9037,5,24,13,3,7,14,66,38.275372710000376,-109.3861004
9038,4,24,14,4,9,14,69,38.275372710000376,-109.3858309
9039,0,17,12,0,15,13,57,38.275372710000376,-109.3855614
9040,2,19,10,9,11,6,57,38.275372710000376,-109.3852919
9041,3,20,8,6,9,7,53,38.275372710000376,-109.3850225
9042,3,29,8,2,6,9,57,38.275372710000376,-109.384753
9043,3,36,7,4,6,6,62,38.275372710000376,-109.3844835
9044,3,35,7,3,6,5,59,38.275372710000376,-109.384214
9045,4,38,6,3,6,4,61,38.275372710000376,-109.3839445
9046,4,36,6,3,6,4,59,38.275372710000376,-109.383675
9047,3,30,7,4,7,4,55,38.275372710000376,-109.3834055
9048,6,31,8,5,7,5,62,38.275372710000376,-109.383136
9049,7,21,9,3,7,7,54,38.275372710000376,-109.3828665
9050,4,20,11,5,7,11,58,38.275372710000376,-109.382597
9051,4,23,12,3,6,16,64,38.275372710000376,-109.3823275
9052,4,26,12,2,8,14,66,38.275372710000376,-109.382058
9053,2,23,11,1,7,14,58,38.275372710000376,-109.3817885
9054,4,23,10,1,7,12,57,38.275372710000376,-109.381519
9055,4,24,9,2,7,9,55,38.275372710000376,-109.3812495
9056,3,25,8,2,9,7,54,38.275372710000376,-109.38098
9057,3,28,7,2,8,5,53,38.275372710000376,-109.3807105
9058,2,29,7,2,8,6,54,38.275372710000376,-109.380441
9059,2,32,6,1,8,5,54,38.275372710000376,-109.3801716
9060,1,30,6,0,8,5,50,38.275372710000376,-109.3799021
9061,1,29,5,0,8,6,49,38.275372710000376,-109.3796326
9062,1,30,5,0,8,7,51,38.275372710000376,-109.3793631
9063,0,41,5,0,8,6,60,38.275372710000376,-109.3790936
9064,0,47,6,1,8,5,67,38.275372710000376,-109.3788241
9065,0,46,6,0,8,5,65,38.275372710000376,-109.3785546
9066,0,42,6,0,8,6,62,38.275372710000376,-109.3782851
9067,2,34,9,3,10,8,66,38.275372710000376,-109.3780156
9068,2,25,13,4,7,17,68,38.275372710000376,-109.3777461
9069,3,23,17,2,6,24,75,38.275372710000376,-109.3774766
9070,5,25,16,3,5,21,75,38.275372710000376,-109.3772071
9071,3,27,12,3,7,15,67,38.275372710000376,-109.3769376
9072,5,34,12,4,13,7,75,38.275372710000376,-109.3766681
9073,4,30,13,3,10,12,72,38.275372710000376,-109.3763986
9074,5,29,15,2,7,17,75,38.275372710000376,-109.3761291
9075,7,31,14,5,11,12,80,38.275372710000376,-109.3758596
9076,10,31,14,9,12,7,83,38.275372710000376,-109.3755901
9077,11,29,15,9,11,8,83,38.275372710000376,-109.3753206
9078,9,34,14,7,12,7,83,38.275372710000376,-109.3750512
9079,6,32,12,5,10,10,75,38.275372710000376,-109.3747817
9080,5,25,13,4,6,17,70,38.275372710000376,-109.3745122
9081,4,22,12,3,3,19,63,38.275372710000376,-109.3742427
9082,3,32,10,1,8,13,67,38.275372710000376,-109.3739732
9083,1,37,10,1,10,11,70,38.275372710000376,-109.3737037
9084,1,31,11,1,9,13,66,38.275372710000376,-109.3734342
9085,2,26,15,2,8,21,74,38.275372710000376,-109.3731647
9086,1,25,12,4,10,17,69,38.275372710000376,-109.3728952
9087,2,26,11,6,12,10,67,38.275372710000376,-109.3726257
9088,1,31,7,6,9,7,61,38.275372710000376,-109.3723562
9089,2,33,8,13,12,3,71,38.275372710000376,-109.3720867
9090,1,29,11,1,11,15,68,38.275372710000376,-109.3718172
9091,2,29,14,0,5,25,75,38.275372710000376,-109.3715477
9092,2,29,13,0,5,25,74,38.275372710000376,-109.3712782
9093,1,28,14,0,9,22,74,38.275372710000376,-109.3710087
9094,3,27,16,4,11,18,79,38.275372710000376,-109.3707392
9095,3,27,18,2,15,21,86,38.275372710000376,-109.3704697
9096,5,27,18,6,15,17,88,38.275372710000376,-109.3702003
9097,7,24,18,10,15,14,88,38.275372710000376,-109.3699308
9098,8,23,16,13,17,10,87,38.275372710000376,-109.3696613
9099,3,22,14,19,21,6,85,38.275372710000376,-109.3693918
9100,6,17,13,16,19,9,80,38.275372710000376,-109.3691223
9101,8,11,11,22,19,4,75,38.275372710000376,-109.3688528
9102,5,11,11,20,22,7,76,38.275372710000376,-109.3685833
9103,4,17,11,17,23,4,76,38.275372710000376,-109.3683138
9104,4,19,11,19,19,3,75,38.275372710000376,-109.3680443
9105,2,20,10,17,17,3,69,38.275372710000376,-109.3677748
9106,3,25,11,9,19,4,71,38.275372710000376,-109.3675053
9107,5,28,16,5,6,19,79,38.275372710000376,-109.3672358
9108,1,22,14,0,3,25,65,38.275372710000376,-109.3669663
9109,1,21,16,0,3,28,69,38.275372710000376,-109.3666968
9110,0,20,15,0,3,27,65,38.275372710000376,-109.3664273
9111,0,19,14,0,2,27,62,38.275372710000376,-109.3661578
9112,0,20,15,0,2,27,64,38.275372710000376,-109.3658883
9113,0,19,15,0,3,27,64,38.275372710000376,-109.3656188
9114,0,20,13,0,2,25,60,38.275372710000376,-109.3653493
9115,0,19,14,0,2,28,63,38.275372710000376,-109.3650799
9116,0,19,15,0,2,29,65,38.275372710000376,-109.3648104
9117,0,20,16,0,1,29,66,38.275372710000376,-109.3645409
9118,0,17,16,0,1,30,64,38.275372710000376,-109.3642714
9119,0,18,15,0,2,28,63,38.275372710000376,-109.3640019
9120,0,19,15,0,2,28,64,38.275372710000376,-109.3637324
9121,0,19,16,0,1,30,66,38.275372710000376,-109.3634629
9122,0,19,16,0,0,31,66,38.275372710000376,-109.3631934
9123,0,22,16,0,1,30,69,38.275372710000376,-109.3629239
9124,0,22,17,0,3,31,73,38.275372710000376,-109.3626544
9125,0,22,17,0,3,32,74,38.275372710000376,-109.3623849
9126,0,24,17,0,5,30,76,38.275372710000376,-109.3621154
9127,0,26,18,0,6,29,79,38.275372710000376,-109.3618459
9128,0,24,17,0,4,33,78,38.275372710000376,-109.3615764
9129,0,26,18,0,4,32,80,38.275372710000376,-109.3613069
9130,1,26,17,0,5,28,77,38.275372710000376,-109.3610374
9131,0,25,17,0,5,29,76,38.275372710000376,-109.3607679
9132,0,23,17,0,4,30,74,38.275372710000376,-109.3604984
9133,0,25,17,0,4,30,76,38.275372710000376,-109.360229
9134,0,23,16,0,3,29,71,38.275372710000376,-109.3599595
9135,0,20,14,0,1,27,62,38.275372710000376,-109.35969
9136,0,24,12,0,2,22,60,38.275372710000376,-109.3594205
9137,0,20,13,0,3,22,58,38.275372710000376,-109.359151
9138,0,19,13,0,3,21,56,38.275372710000376,-109.3588815
9139,0,20,12,1,3,19,55,38.275372710000376,-109.358612
9140,1,25,10,3,5,14,58,38.275372710000376,-109.3583425
9141,2,25,8,4,7,9,55,38.275372710000376,-109.358073
9142,2,27,8,3,8,7,55,38.275372710000376,-109.3578035
9143,2,30,6,4,8,6,56,38.275372710000376,-109.357534
9144,1,34,6,4,8,5,58,38.275372710000376,-109.3572645
9145,2,35,6,3,8,5,59,38.275372710000376,-109.356995
9146,2,34,6,3,8,5,58,38.275372710000376,-109.3567255
9147,3,35,8,5,9,4,64,38.275372710000376,-109.356456
9148,4,39,9,6,9,5,72,38.275372710000376,-109.3561865
9149,4,32,10,6,9,5,66,38.275372710000376,-109.355917
9150,8,33,15,3,5,8,72,38.275372710000376,-109.3556475
9151,11,24,15,9,4,13,76,38.275372710000376,-109.355378
9152,5,29,11,8,6,8,67,38.275372710000376,-109.3551086
9153,2,35,7,7,8,6,65,38.275372710000376,-109.3548391
9154,2,32,7,7,9,6,63,38.275372710000376,-109.3545696
9155,5,12,12,9,12,9,59,38.275372710000376,-109.3543001
9156,2,13,12,5,5,20,57,38.275372710000376,-109.3540306
9157,1,18,17,2,5,29,72,38.275372710000376,-109.3537611
9158,0,19,21,0,6,35,81,38.275372710000376,-109.3534916
9159,0,19,22,0,5,36,82,38.275372710000376,-109.3532221
9160,0,21,21,0,4,35,81,38.275372710000376,-109.3529526
9161,1,21,19,0,3,33,77,38.275372710000376,-109.3526831
9162,2,21,18,2,3,30,76,38.275372710000376,-109.3524136
9163,2,21,18,2,2,30,75,38.275372710000376,-109.3521441
9164,1,18,18,0,1,32,70,38.275372710000376,-109.3518746
9165,2,21,16,1,1,28,69,38.275372710000376,-109.3516051
9166,1,21,17,1,2,29,71,38.275372710000376,-109.3513356
9167,1,22,18,2,4,30,77,38.275372710000376,-109.3510661
9168,1,22,21,2,8,31,85,38.275372710000376,-109.3507966
9169,0,23,20,3,9,28,83,38.275372710000376,-109.3505271
9170,1,19,20,5,7,31,83,38.275372710000376,-109.3502577
9171,0,21,21,3,6,31,82,38.275372710000376,-109.3499882
9172,1,21,23,3,5,29,82,38.275372710000376,-109.3497187
9173,2,20,23,2,5,31,83,38.275372710000376,-109.3494492
9174,2,18,22,3,4,32,81,38.275372710000376,-109.3491797
9175,2,21,21,3,5,31,83,38.275372710000376,-109.3489102
9176,2,21,21,3,7,31,85,38.275372710000376,-109.3486407
9177,2,22,20,2,7,29,82,38.275372710000376,-109.3483712
9178,2,24,19,4,7,25,81,38.275372710000376,-109.3481017
9179,2,25,20,4,7,26,84,38.275372710000376,-109.3478322
9180,2,22,21,4,8,27,84,38.275372710000376,-109.3475627
9181,2,20,21,5,9,27,84,38.275372710000376,-109.3472932
9182,3,21,20,6,10,25,85,38.275372710000376,-109.3470237
9183,5,22,19,10,11,19,86,38.275372710000376,-109.3467542
9184,6,25,16,18,13,12,90,38.275372710000376,-109.3464847
9185,7,28,15,17,12,10,89,38.275372710000376,-109.3462152
9186,9,31,14,15,12,8,89,38.275372710000376,-109.3459457
9187,10,30,14,16,12,6,88,38.275372710000376,-109.3456762
9188,11,26,13,21,10,6,87,38.275372710000376,-109.3454068
9189,12,26,13,22,10,6,89,38.275372710000376,-109.3451373
9190,13,26,13,21,9,5,87,38.275372710000376,-109.3448678
9191,11,29,13,20,9,5,87,38.275372710000376,-109.3445983
9192,8,33,14,16,11,5,87,38.275372710000376,-109.3443288
9193,6,40,14,10,12,5,87,38.275372710000376,-109.3440593
9194,6,38,14,13,14,4,89,38.275372710000376,-109.3437898
9195,8,35,14,15,12,4,88,38.275372710000376,-109.3435203
9196,8,33,14,17,10,5,87,38.275372710000376,-109.3432508
9197,8,34,14,18,9,4,87,38.275372710000376,-109.3429813
9198,7,36,13,15,13,3,87,38.275372710000376,-109.3427118
9199,2,51,10,0,14,8,85,38.275103215415136,-109.4340705
9200,1,50,10,0,14,9,84,38.275103215415136,-109.433801
9201,1,45,11,0,14,9,80,38.275103215415136,-109.4335315
9202,1,41,10,0,12,10,74,38.275103215415136,-109.433262
9203,1,37,10,0,11,10,69,38.275103215415136,-109.4329925
9204,1,37,10,0,9,9,66,38.275103215415136,-109.432723
9205,2,40,10,1,8,8,69,38.275103215415136,-109.4324535
9206,2,39,11,2,9,8,71,38.275103215415136,-109.432184
9207,2,40,12,1,13,9,77,38.275103215415136,-109.4319145
9208,2,40,12,1,14,10,79,38.275103215415136,-109.431645
9209,2,40,12,2,13,8,77,38.275103215415136,-109.4313755
9210,3,35,11,5,9,7,70,38.275103215415136,-109.431106
9211,2,28,10,3,8,8,59,38.275103215415136,-109.4308365
9212,1,30,9,2,8,8,58,38.275103215415136,-109.430567
9213,2,31,9,2,8,7,59,38.275103215415136,-109.4302975
9214,2,31,9,2,7,9,60,38.275103215415136,-109.430028
9215,2,34,11,4,10,8,69,38.275103215415136,-109.4297586
9216,3,34,11,6,10,5,69,38.275103215415136,-109.4294891
9217,2,27,12,7,11,8,67,38.275103215415136,-109.4292196
9218,2,36,14,8,9,16,85,38.275103215415136,-109.4289501
9219,3,28,15,6,13,20,85,38.275103215415136,-109.4286806
9220,2,24,12,8,17,17,80,38.275103215415136,-109.4284111
9221,1,31,12,7,17,12,80,38.275103215415136,-109.4281416
9222,0,34,13,4,15,15,81,38.275103215415136,-109.4278721
9223,0,33,13,0,14,18,78,38.275103215415136,-109.4276026
9224,0,31,13,0,12,19,75,38.275103215415136,-109.4273331
9225,0,32,12,0,12,19,75,38.275103215415136,-109.4270636
9226,0,33,12,0,12,18,75,38.275103215415136,-109.4267941
9227,0,34,12,0,13,18,77,38.275103215415136,-109.4265246
9228,0,34,12,0,12,19,77,38.275103215415136,-109.4262551
9229,1,32,14,0,14,18,79,38.275103215415136,-109.4259856
9230,0,33,13,0,13,19,78,38.275103215415136,-109.4257161
9231,1,35,14,0,13,19,82,38.275103215415136,-109.4254466
9232,1,35,13,0,11,20,80,38.275103215415136,-109.4251771
9233,1,35,12,0,11,19,78,38.275103215415136,-109.4249077
9234,1,33,14,0,10,22,80,38.275103215415136,-109.4246382
9235,0,31,15,0,11,21,78,38.275103215415136,-109.4243687
9236,1,33,13,0,13,19,79,38.275103215415136,-109.4240992
9237,1,36,13,0,14,16,80,38.275103215415136,-109.4238297
9238,1,39,13,0,16,13,82,38.275103215415136,-109.4235602
9239,2,42,12,1,15,11,83,38.275103215415136,-109.4232907
9240,2,45,11,0,16,9,83,38.275103215415136,-109.4230212
9241,3,46,12,1,17,7,86,38.275103215415136,-109.4227517
9242,3,48,12,2,17,7,89,38.275103215415136,-109.4224822
9243,2,47,11,1,15,10,86,38.275103215415136,-109.4222127
9244,2,44,11,0,14,12,83,38.275103215415136,-109.4219432
9245,2,42,11,0,14,13,82,38.275103215415136,-109.4216737
9246,1,39,11,0,14,13,78,38.275103215415136,-109.4214042
9247,1,35,11,0,12,14,73,38.275103215415136,-109.4211347
9248,1,30,12,0,11,15,69,38.275103215415136,-109.4208652
9249,1,30,12,2,12,13,70,38.275103215415136,-109.4205957
9250,1,31,11,2,13,12,70,38.275103215415136,-109.4203262
9251,1,31,11,2,13,11,69,38.275103215415136,-109.4200568
9252,1,31,11,2,13,11,69,38.275103215415136,-109.4197873
9253,1,33,11,0,12,13,70,38.275103215415136,-109.4195178
9254,0,33,11,0,12,14,70,38.275103215415136,-109.4192483
9255,1,36,11,0,12,14,74,38.275103215415136,-109.4189788
9256,1,39,11,0,13,14,78,38.275103215415136,-109.4187093
9257,1,32,11,0,9,18,71,38.275103215415136,-109.4184398
9258,1,30,12,0,7,20,70,38.275103215415136,-109.4181703
9259,1,36,10,0,7,18,72,38.275103215415136,-109.4179008
9260,1,41,10,0,11,13,76,38.275103215415136,-109.4176313
9261,2,42,11,0,13,11,79,38.275103215415136,-109.4173618
9262,2,46,10,0,13,9,80,38.275103215415136,-109.4170923
9263,4,45,11,3,13,6,82,38.275103215415136,-109.4168228
9264,6,43,13,7,14,3,86,38.275103215415136,-109.4165533
9265,8,42,14,10,14,1,89,38.275103215415136,-109.4162838
9266,9,43,13,10,16,1,92,38.275103215415136,-109.4160143
9267,10,41,13,10,16,0,90,38.275103215415136,-109.4157448
9268,10,41,13,10,16,0,90,38.275103215415136,-109.4154753
9269,8,41,13,10,16,1,89,38.275103215415136,-109.4152058
9270,7,41,13,9,15,3,88,38.275103215415136,-109.4149364
9271,5,41,12,6,15,3,82,38.275103215415136,-109.4146669
9272,4,43,12,6,15,3,83,38.275103215415136,-109.4143974
9273,6,42,12,7,15,2,84,38.275103215415136,-109.4141279
9274,7,42,13,9,16,1,88,38.275103215415136,-109.4138584
9275,7,45,13,8,17,1,91,38.275103215415136,-109.4135889
9276,5,47,12,6,16,2,88,38.275103215415136,-109.4133194
9277,6,48,13,6,15,2,90,38.275103215415136,-109.4130499
9278,7,47,13,7,14,2,90,38.275103215415136,-109.4127804
9279,9,45,13,8,15,1,91,38.275103215415136,-109.4125109
9280,8,45,14,8,17,0,92,38.275103215415136,-109.4122414
9281,6,47,13,5,18,2,91,38.275103215415136,-109.4119719
9282,5,47,12,5,19,2,90,38.275103215415136,-109.4117024
9283,5,47,12,4,19,2,89,38.275103215415136,-109.4114329
9284,5,47,12,5,18,2,89,38.275103215415136,-109.4111634
9285,5,48,13,6,18,2,92,38.275103215415136,-109.4108939
9286,5,48,12,5,18,2,90,38.275103215415136,-109.4106244
9287,5,48,13,6,18,1,91,38.275103215415136,-109.4103549
9288,5,48,13,5,18,1,90,38.275103215415136,-109.4100855
9289,5,49,12,5,18,2,91,38.275103215415136,-109.409816
9290,4,49,13,5,18,1,90,38.275103215415136,-109.4095465
9291,5,46,13,7,18,1,90,38.275103215415136,-109.409277
9292,6,45,13,7,17,1,89,38.275103215415136,-109.4090075
9293,6,43,13,7,18,2,89,38.275103215415136,-109.408738
9294,6,43,12,7,18,1,87,38.275103215415136,-109.4084685
9295,4,46,11,5,17,2,85,38.275103215415136,-109.408199
9296,3,48,11,5,16,3,86,38.275103215415136,-109.4079295
9297,6,43,12,7,15,3,86,38.275103215415136,-109.40766
9298,10,37,13,12,14,2,88,38.275103215415136,-109.4073905
9299,11,35,13,13,14,1,87,38.275103215415136,-109.407121
9300,8,36,12,6,13,6,81,38.275103215415136,-109.4068515
9301,4,31,9,2,8,6,60,38.275103215415136,-109.3879869
9302,1,30,8,1,8,6,54,38.275103215415136,-109.3877174
9303,1,28,7,0,8,6,50,38.275103215415136,-109.3874479
9304,3,33,7,0,8,5,56,38.275103215415136,-109.3871784
9305,1,31,6,0,9,7,54,38.275103215415136,-109.3869089
9306,2,30,9,3,9,8,61,38.275103215415136,-109.3866394
9307,4,28,11,4,7,13,67,38.275103215415136,-109.3863699
9308,3,17,13,4,5,18,60,38.275103215415136,-109.3861004
9309,2,19,11,4,7,11,54,38.275103215415136,-109.3858309
9310,2,19,11,5,12,9,58,38.275103215415136,-109.3855614
9311,2,15,10,10,10,5,52,38.275103215415136,-109.3852919
9312,3,30,8,6,6,5,58,38.275103215415136,-109.3850225
9313,1,35,5,3,7,4,55,38.275103215415136,-109.384753
9314,1,37,5,1,7,4,55,38.275103215415136,-109.3844835
9315,2,31,6,1,7,5,52,38.275103215415136,-109.384214
9316,2,26,7,2,7,6,50,38.275103215415136,-109.3839445
9317,2,27,7,2,7,7,52,38.275103215415136,-109.383675
9318,2,28,8,1,7,7,53,38.275103215415136,-109.3834055
9319,6,27,9,4,7,5,58,38.275103215415136,-109.383136
9320,5,25,9,4,5,6,54,38.275103215415136,-109.3828665
9321,6,20,10,4,7,6,53,38.275103215415136,-109.382597
9322,4,18,11,5,8,10,56,38.275103215415136,-109.3823275
9323,4,20,11,4,7,13,59,38.275103215415136,-109.382058
9324,3,22,11,2,8,12,58,38.275103215415136,-109.3817885
9325,4,26,9,1,5,11,56,38.275103215415136,-109.381519
9326,2,26,7,1,8,6,50,38.275103215415136,-109.3812495
9327,2,30,6,0,8,5,51,38.275103215415136,-109.38098
9328,2,34,5,0,8,5,54,38.275103215415136,-109.3807105
9329,1,29,5,0,8,6,49,38.275103215415136,-109.380441
9330,1,28,6,0,8,6,49,38.275103215415136,-109.3801716
9331,1,30,6,0,8,5,50,38.275103215415136,-109.3799021
9332,0,33,5,0,8,6,52,38.275103215415136,-109.3796326
9333,0,33,5,0,8,7,53,38.275103215415136,-109.3793631
9334,0,39,6,0,9,6,60,38.275103215415136,-109.3790936
9335,0,41,6,0,10,5,62,38.275103215415136,-109.3788241
9336,0,40,6,0,10,6,62,38.275103215415136,-109.3785546
9337,1,37,7,1,10,7,63,38.275103215415136,-109.3782851
9338,2,27,10,4,9,12,64,38.275103215415136,-109.3780156
9339,3,23,14,3,7,18,68,38.275103215415136,-109.3777461
9340,2,23,16,2,5,23,71,38.275103215415136,-109.3774766
9341,3,22,15,3,5,23,71,38.275103215415136,-109.3772071
9342,2,27,11,2,7,15,64,38.275103215415136,-109.3769376
9343,3,31,12,3,10,13,72,38.275103215415136,-109.3766681
9344,4,28,14,2,8,17,73,38.275103215415136,-109.3763986
9345,5,30,15,3,7,18,78,38.275103215415136,-109.3761291
9346,7,31,15,6,9,13,81,38.275103215415136,-109.3758596
9347,9,30,16,7,10,11,83,38.275103215415136,-109.3755901
9348,9,31,16,7,10,9,82,38.275103215415136,-109.3753206
9349,7,33,14,5,10,10,79,38.275103215415136,-109.3750512
9350,5,28,12,4,9,13,71,38.275103215415136,-109.3747817
9351,4,25,12,3,7,16,67,38.275103215415136,-109.3745122
9352,3,28,12,1,7,16,67,38.275103215415136,-109.3742427
9353,2,33,11,1,8,14,69,38.275103215415136,-109.3739732
9354,2,26,11,1,5,17,62,38.275103215415136,-109.3737037
9355,1,22,13,0,6,22,64,38.275103215415136,-109.3734342
9356,1,26,15,3,13,20,78,38.275103215415136,-109.3731647
9357,0,28,14,1,10,21,74,38.275103215415136,-109.3728952
9358,1,26,10,0,8,16,61,38.275103215415136,-109.3726257
9359,2,29,8,7,11,5,62,38.275103215415136,-109.3723562
9360,3,34,7,13,12,3,72,38.275103215415136,-109.3720867
9361,2,33,12,2,7,20,76,38.275103215415136,-109.3718172
9362,2,32,12,3,6,18,73,38.275103215415136,-109.3715477
9363,3,31,12,6,7,16,75,38.275103215415136,-109.3712782
9364,2,31,12,10,7,14,76,38.275103215415136,-109.3710087
9365,5,32,14,11,15,8,85,38.275103215415136,-109.3707392
9366,8,30,14,16,12,5,85,38.275103215415136,-109.3704697
9367,10,23,14,22,15,3,87,38.275103215415136,-109.3702003
9368,12,19,13,26,16,1,87,38.275103215415136,-109.3699308
9369,6,19,12,24,22,1,84,38.275103215415136,-109.3696613
9370,2,18,13,13,19,12,77,38.275103215415136,-109.3693918
9371,4,9,13,22,17,10,75,38.275103215415136,-109.3691223
9372,3,6,11,17,17,7,61,38.275103215415136,-109.3688528
9373,9,14,9,16,21,2,71,38.275103215415136,-109.3685833
9374,6,21,10,18,20,2,77,38.275103215415136,-109.3683138
9375,3,22,9,15,16,1,66,38.275103215415136,-109.3680443
9376,3,29,10,12,14,2,70,38.275103215415136,-109.3677748
9377,0,28,12,2,9,17,68,38.275103215415136,-109.3675053
9378,1,22,14,0,3,23,63,38.275103215415136,-109.3672358
9379,2,19,13,0,3,20,57,38.275103215415136,-109.3669663
9380,3,17,15,1,1,24,61,38.275103215415136,-109.3666968
9381,3,21,14,0,3,23,64,38.275103215415136,-109.3664273
9382,2,22,14,0,3,23,64,38.275103215415136,-109.3661578
9383,2,22,14,0,2,23,63,38.275103215415136,-109.3658883
9384,1,19,13,0,2,23,58,38.275103215415136,-109.3656188
9385,1,19,11,0,2,19,52,38.275103215415136,-109.3653493
9386,1,19,12,1,3,20,56,38.275103215415136,-109.3650799
9387,0,19,13,0,3,22,57,38.275103215415136,-109.3648104
9388,1,20,13,0,2,24,60,38.275103215415136,-109.3645409
9389,0,22,12,0,3,22,59,38.275103215415136,-109.3642714
9390,1,20,13,0,4,21,59,38.275103215415136,-109.3640019
9391,1,18,14,0,2,24,59,38.275103215415136,-109.3637324
9392,1,17,15,0,2,28,63,38.275103215415136,-109.3634629
9393,1,17,16,0,1,30,65,38.275103215415136,-109.3631934
9394,0,19,16,0,1,29,65,38.275103215415136,-109.3629239
9395,0,19,16,0,2,29,66,38.275103215415136,-109.3626544
9396,0,20,16,0,2,31,69,38.275103215415136,-109.3623849
9397,0,21,17,0,2,32,72,38.275103215415136,-109.3621154
9398,0,21,17,0,2,32,72,38.275103215415136,-109.3618459
9399,0,22,17,0,4,32,75,38.275103215415136,-109.3615764
9400,0,23,18,0,3,35,79,38.275103215415136,-109.3613069
9401,0,25,18,0,4,33,80,38.275103215415136,-109.3610374
9402,0,25,17,0,3,33,78,38.275103215415136,-109.3607679
9403,0,22,17,0,2,32,73,38.275103215415136,-109.3604984
9404,0,21,17,0,1,33,72,38.275103215415136,-109.360229
9405,0,19,16,0,0,30,65,38.275103215415136,-109.3599595
9406,0,18,14,0,1,26,59,38.275103215415136,-109.35969
9407,0,18,13,1,2,21,55,38.275103215415136,-109.3594205
9408,0,16,12,2,4,18,52,38.275103215415136,-109.359151
9409,0,23,10,5,7,12,57,38.275103215415136,-109.3588815
9410,1,29,10,4,8,11,63,38.275103215415136,-109.358612
9411,2,29,10,3,6,12,62,38.275103215415136,-109.3583425
9412,2,27,8,4,7,8,56,38.275103215415136,-109.358073
9413,1,28,6,3,8,6,52,38.275103215415136,-109.3578035
9414,2,29,6,3,9,5,54,38.275103215415136,-109.357534
9415,2,37,8,4,10,6,67,38.275103215415136,-109.3572645
9416,3,37,8,5,9,7,69,38.275103215415136,-109.356995
9417,4,42,8,7,10,5,76,38.275103215415136,-109.3567255
9418,4,39,10,7,11,6,77,38.275103215415136,-109.356456
9419,6,31,9,9,10,5,70,38.275103215415136,-109.3561865
9420,7,27,9,11,10,7,71,38.275103215415136,-109.355917
9421,11,20,11,13,9,9,73,38.275103215415136,-109.3556475
9422,12,28,13,6,7,13,79,38.275103215415136,-109.355378
9423,6,29,10,4,19,5,73,38.275103215415136,-109.3551086
9424,4,24,9,14,16,1,68,38.275103215415136,-109.3548391
9425,3,20,9,16,16,1,65,38.275103215415136,-109.3545696
9426,2,18,11,8,12,11,62,38.275103215415136,-109.3543001
9427,2,20,14,3,6,21,66,38.275103215415136,-109.3540306
9428,1,19,17,2,4,28,71,38.275103215415136,-109.3537611
9429,0,19,20,1,4,34,78,38.275103215415136,-109.3534916
9430,0,17,22,0,5,38,82,38.275103215415136,-109.3532221
9431,0,17,22,0,3,39,81,38.275103215415136,-109.3529526
9432,1,18,20,0,1,36,76,38.275103215415136,-109.3526831
9433,1,19,19,0,2,35,76,38.275103215415136,-109.3524136
9434,1,19,19,0,2,33,74,38.275103215415136,-109.3521441
9435,2,20,17,1,2,28,70,38.275103215415136,-109.3518746
9436,2,25,14,3,3,22,69,38.275103215415136,-109.3516051
9437,2,25,13,3,5,20,68,38.275103215415136,-109.3513356
9438,3,24,16,2,6,24,75,38.275103215415136,-109.3510661
9439,1,26,21,2,7,28,85,38.275103215415136,-109.3507966
9440,0,20,20,4,6,32,82,38.275103215415136,-109.3505271
9441,0,20,19,5,5,33,82,38.275103215415136,-109.3502577
9442,1,21,20,4,6,31,83,38.275103215415136,-109.3499882
9443,0,22,20,3,7,30,82,38.275103215415136,-109.3497187
9444,0,21,21,3,7,32,84,38.275103215415136,-109.3494492
9445,0,19,21,3,6,34,83,38.275103215415136,-109.3491797
9446,2,20,22,2,5,31,82,38.275103215415136,-109.3489102
9447,1,21,23,2,5,33,85,38.275103215415136,-109.3486407
9448,2,24,21,5,6,27,85,38.275103215415136,-109.3483712
9449,3,26,19,8,7,20,83,38.275103215415136,-109.3481017
9450,0,27,19,1,5,26,78,38.275103215415136,-109.3478322
9451,1,27,20,3,7,27,85,38.275103215415136,-109.3475627
9452,1,24,20,4,8,27,84,38.275103215415136,-109.3472932
9453,2,22,20,5,9,28,86,38.275103215415136,-109.3470237
9454,3,21,19,5,9,27,84,38.275103215415136,-109.3467542
9455,4,22,18,8,12,21,85,38.275103215415136,-109.3464847
9456,5,24,17,8,11,20,85,38.275103215415136,-109.3462152
9457,5,25,17,10,12,18,87,38.275103215415136,-109.3459457
9458,7,25,15,14,13,14,88,38.275103215415136,-109.3456762
9459,7,24,15,21,13,8,88,38.275103215415136,-109.3454068
9460,6,26,15,21,13,7,88,38.275103215415136,-109.3451373
9461,8,29,14,17,10,7,85,38.275103215415136,-109.3448678
9462,8,32,14,16,9,6,85,38.275103215415136,-109.3445983
9463,7,35,14,13,12,6,87,38.275103215415136,-109.3443288
9464,6,40,14,10,11,6,87,38.275103215415136,-109.3440593
9465,7,36,14,14,12,5,88,38.275103215415136,-109.3437898
9466,8,33,14,15,11,5,86,38.275103215415136,-109.3435203
9467,9,33,14,16,10,5,87,38.275103215415136,-109.3432508
9468,9,34,14,16,10,4,87,38.275103215415136,-109.3429813
9469,7,36,14,14,12,4,87,38.275103215415136,-109.3427118
9470,7,36,14,14,13,4,88,38.275103215415136,-109.3424423
9471,2,51,11,0,15,7,86,38.27483372,-109.43434
9472,2,49,11,0,15,7,84,38.27483372,-109.4340705
9473,2,48,11,0,14,7,82,38.27483372,-109.433801
9474,2,44,10,0,12,8,76,38.27483372,-109.4335315
9475,2,41,10,0,10,11,74,38.27483372,-109.433262
9476,2,40,10,0,10,12,74,38.27483372,-109.4329925
9477,2,42,10,0,11,11,76,38.27483372,-109.432723
9478,2,43,10,0,11,8,74,38.27483372,-109.4324535
9479,2,45,11,4,10,5,77,38.27483372,-109.432184
9480,2,42,12,2,14,9,81,38.27483372,-109.4319145
9481,2,39,12,0,13,12,78,38.27483372,-109.431645
9482,2,38,12,0,11,12,75,38.27483372,-109.4313755
9483,3,37,11,1,7,10,69,38.27483372,-109.431106
9484,3,31,10,3,7,9,63,38.27483372,-109.4308365
9485,2,27,10,3,8,8,58,38.27483372,-109.430567
9486,2,28,10,3,8,9,60,38.27483372,-109.4302975
9487,2,32,10,2,9,10,65,38.27483372,-109.430028
9488,2,38,10,3,12,7,72,38.27483372,-109.4297586
9489,5,33,14,15,5,12,84,38.27483372,-109.4294891
9490,3,31,12,17,11,10,84,38.27483372,-109.4292196
9491,0,30,14,7,13,19,83,38.27483372,-109.4289501
9492,1,25,16,5,13,22,82,38.27483372,-109.4286806
9493,1,30,11,8,23,7,80,38.27483372,-109.4284111
9494,0,34,10,2,23,8,77,38.27483372,-109.4281416
9495,0,35,11,0,20,10,76,38.27483372,-109.4278721
9496,0,32,12,0,13,14,71,38.27483372,-109.4276026
9497,0,29,12,0,9,18,68,38.27483372,-109.4273331
9498,0,30,12,0,8,18,68,38.27483372,-109.4270636
9499,0,33,11,0,10,18,72,38.27483372,-109.4267941
9500,0,35,11,0,11,17,74,38.27483372,-109.4265246
9501,0,37,12,0,12,17,78,38.27483372,-109.4262551
9502,0,35,12,0,13,17,77,38.27483372,-109.4259856
9503,0,34,13,0,12,19,78,38.27483372,-109.4257161
9504,1,34,14,0,11,21,81,38.27483372,-109.4254466
9505,1,33,14,0,10,23,81,38.27483372,-109.4251771
9506,0,31,14,0,8,25,78,38.27483372,-109.4249077
9507,1,30,14,0,9,24,78,38.27483372,-109.4246382
9508,1,31,15,0,10,23,80,38.27483372,-109.4243687
9509,1,32,14,0,10,22,79,38.27483372,-109.4240992
9510,1,34,13,0,11,20,79,38.27483372,-109.4238297
9511,1,38,12,0,14,16,81,38.27483372,-109.4235602
9512,3,43,12,1,16,9,84,38.27483372,-109.4232907
9513,3,46,12,1,17,8,87,38.27483372,-109.4230212
9514,3,47,12,1,17,8,88,38.27483372,-109.4227517
9515,3,47,12,1,16,9,88,38.27483372,-109.4224822
9516,2,48,11,0,14,11,86,38.27483372,-109.4222127
9517,2,42,11,0,14,12,81,38.27483372,-109.4219432
9518,2,41,12,0,15,11,81,38.27483372,-109.4216737
9519,3,41,12,1,17,9,83,38.27483372,-109.4214042
9520,2,38,13,1,16,11,81,38.27483372,-109.4211347
9521,1,33,13,0,11,17,75,38.27483372,-109.4208652
9522,1,33,12,0,11,16,73,38.27483372,-109.4205957
9523,1,32,11,1,14,12,71,38.27483372,-109.4203262
9524,1,34,10,2,13,9,69,38.27483372,-109.4200568
9525,2,34,10,1,12,9,68,38.27483372,-109.4197873
9526,2,34,10,0,13,9,68,38.27483372,-109.4195178
9527,0,33,10,0,11,13,67,38.27483372,-109.4192483
9528,0,35,10,0,11,15,71,38.27483372,-109.4189788
9529,1,36,10,0,9,16,72,38.27483372,-109.4187093
9530,1,32,11,0,8,17,69,38.27483372,-109.4184398
9531,0,30,11,0,9,17,67,38.27483372,-109.4181703
9532,0,34,10,0,8,16,68,38.27483372,-109.4179008
9533,1,37,11,0,10,16,75,38.27483372,-109.4176313
9534,2,38,11,0,12,13,76,38.27483372,-109.4173618
9535,3,43,11,0,12,10,79,38.27483372,-109.4170923
9536,3,44,11,1,14,8,81,38.27483372,-109.4168228
9537,3,44,11,3,16,5,82,38.27483372,-109.4165533
9538,6,42,12,6,16,3,85,38.27483372,-109.4162838
9539,10,42,13,8,16,1,90,38.27483372,-109.4160143
9540,12,39,13,11,16,0,91,38.27483372,-109.4157448
9541,12,38,13,12,15,0,90,38.27483372,-109.4154753
9542,11,37,13,12,16,1,90,38.27483372,-109.4152058
9543,6,39,13,8,15,3,84,38.27483372,-109.4149364
9544,4,46,13,8,16,1,88,38.27483372,-109.4146669
9545,4,45,12,8,17,0,86,38.27483372,-109.4143974
9546,6,44,12,8,17,0,87,38.27483372,-109.4141279
9547,7,44,13,8,17,0,89,38.27483372,-109.4138584
9548,6,45,13,7,17,1,89,38.27483372,-109.4135889
9549,6,46,13,7,17,1,90,38.27483372,-109.4133194
9550,7,47,13,6,15,2,90,38.27483372,-109.4130499
9551,8,45,14,7,15,2,91,38.27483372,-109.4127804
9552,8,44,13,6,16,2,89,38.27483372,-109.4125109
9553,7,43,13,7,18,1,89,38.27483372,-109.4122414
9554,6,46,13,6,18,1,90,38.27483372,-109.4119719
9555,6,47,12,6,18,1,90,38.27483372,-109.4117024
9556,5,48,12,6,18,1,90,38.27483372,-109.4114329
9557,5,47,13,6,18,1,90,38.27483372,-109.4111634
9558,5,48,12,6,18,1,90,38.27483372,-109.4108939
9559,5,49,12,5,18,2,91,38.27483372,-109.4106244
9560,5,48,13,6,18,1,91,38.27483372,-109.4103549
9561,5,47,13,6,18,1,90,38.27483372,-109.4100855
9562,5,47,12,5,18,2,89,38.27483372,-109.409816
9563,5,46,13,6,18,0,88,38.27483372,-109.4095465
9564,5,45,13,8,18,1,90,38.27483372,-109.409277
9565,5,44,13,8,18,1,89,38.27483372,-109.4090075
9566,6,44,12,7,18,0,87,38.27483372,-109.408738
9567,7,46,12,6,18,0,89,38.27483372,-109.4084685
9568,4,46,11,4,17,2,84,38.27483372,-109.408199
9569,6,45,12,5,15,3,86,38.27483372,-109.4079295
9570,9,39,12,7,13,5,85,38.27483372,-109.40766
9571,10,36,13,10,13,4,86,38.27483372,-109.4073905
9572,11,33,13,13,13,2,85,38.27483372,-109.407121
9573,11,28,13,11,12,5,80,38.27483372,-109.4068515
9574,3,32,7,6,7,6,61,38.27483372,-109.3879869
9575,2,26,5,4,7,6,50,38.27483372,-109.3877174
9576,2,32,5,4,8,4,55,38.27483372,-109.3874479
9577,3,34,6,4,9,3,59,38.27483372,-109.3871784
9578,1,40,7,2,9,7,66,38.27483372,-109.3869089
9579,2,38,8,4,9,8,69,38.27483372,-109.3866394
9580,4,24,14,4,6,18,70,38.27483372,-109.3863699
9581,2,20,13,3,4,19,61,38.27483372,-109.3861004
9582,1,28,10,1,9,11,60,38.27483372,-109.3858309
9583,1,24,10,5,10,9,59,38.27483372,-109.3855614
9584,1,24,9,6,7,9,56,38.27483372,-109.3852919
9585,1,36,6,6,5,6,60,38.27483372,-109.3850225
9586,1,35,5,1,7,5,54,38.27483372,-109.384753
9587,2,34,5,0,8,5,54,38.27483372,-109.3844835
9588,2,23,6,1,8,7,47,38.27483372,-109.384214
9589,3,25,8,2,9,7,54,38.27483372,-109.3839445
9590,2,33,9,4,9,7,64,38.27483372,-109.383675
9591,2,33,10,2,11,10,68,38.27483372,-109.3834055
9592,5,26,11,2,11,7,62,38.27483372,-109.383136
9593,2,22,10,4,10,8,56,38.27483372,-109.3828665
9594,4,19,10,7,11,4,55,38.27483372,-109.382597
9595,6,14,10,7,11,5,53,38.27483372,-109.3823275
9596,2,12,11,6,6,13,50,38.27483372,-109.382058
9597,2,22,10,3,6,12,55,38.27483372,-109.3817885
9598,3,26,8,2,7,7,53,38.27483372,-109.381519
9599,2,26,7,1,7,6,49,38.27483372,-109.3812495
9600,1,27,6,0,7,5,46,38.27483372,-109.38098
9601,2,25,5,0,8,7,47,38.27483372,-109.3807105
9602,1,26,6,0,8,8,49,38.27483372,-109.380441
9603,1,32,6,0,8,7,54,38.27483372,-109.3801716
9604,1,37,6,0,8,7,59,38.27483372,-109.3799021
9605,1,37,7,0,9,6,60,38.27483372,-109.3796326
9606,1,36,7,1,10,6,61,38.27483372,-109.3793631
9607,3,35,9,4,10,6,67,38.27483372,-109.3790936
9608,4,33,10,5,9,8,69,38.27483372,-109.3788241
9609,3,31,11,5,10,8,68,38.27483372,-109.3785546
9610,2,29,11,4,11,10,67,38.27483372,-109.3782851
9611,2,30,11,2,9,14,68,38.27483372,-109.3780156
9612,2,23,15,3,6,21,70,38.27483372,-109.3777461
9613,3,22,17,2,6,25,75,38.27483372,-109.3774766
9614,4,24,17,2,6,24,77,38.27483372,-109.3772071
9615,3,27,13,2,7,17,69,38.27483372,-109.3769376
9616,3,28,13,2,7,19,72,38.27483372,-109.3766681
9617,4,29,14,2,7,18,74,38.27483372,-109.3763986
9618,7,33,15,3,9,13,80,38.27483372,-109.3761291
9619,8,34,15,5,10,10,82,38.27483372,-109.3758596
9620,8,34,15,5,10,11,83,38.27483372,-109.3755901
9621,6,33,13,3,11,11,77,38.27483372,-109.3753206
9622,4,35,12,1,9,14,75,38.27483372,-109.3750512
9623,4,33,12,2,8,15,74,38.27483372,-109.3747817
9624,3,29,11,2,8,14,67,38.27483372,-109.3745122
9625,2,33,10,1,9,13,68,38.27483372,-109.3742427
9626,2,27,11,2,7,16,65,38.27483372,-109.3739732
9627,1,20,13,1,5,22,62,38.27483372,-109.3737037
9628,1,26,14,2,10,21,74,38.27483372,-109.3734342
9629,3,28,13,5,12,14,75,38.27483372,-109.3731647
9630,3,35,12,1,9,14,74,38.27483372,-109.3728952
9631,1,32,8,3,10,10,64,38.27483372,-109.3726257
9632,2,30,7,10,10,4,63,38.27483372,-109.3723562
9633,4,30,9,11,15,3,72,38.27483372,-109.3720867
9634,3,27,11,4,11,13,69,38.27483372,-109.3718172
9635,2,30,13,7,10,8,70,38.27483372,-109.3715477
9636,5,35,13,10,16,1,80,38.27483372,-109.3712782
9637,9,38,12,12,14,1,86,38.27483372,-109.3710087
9638,2,41,12,15,9,7,86,38.27483372,-109.3707392
9639,5,33,13,19,8,6,84,38.27483372,-109.3704697
9640,7,27,12,21,18,1,86,38.27483372,-109.3702003
9641,6,18,13,20,26,5,88,38.27483372,-109.3699308
9642,4,16,13,20,26,4,83,38.27483372,-109.3696613
9643,1,10,13,13,13,14,64,38.27483372,-109.3693918
9644,1,5,10,4,5,17,42,38.27483372,-109.3691223
9645,0,13,12,9,15,12,61,38.27483372,-109.3688528
9646,4,23,10,14,15,7,73,38.27483372,-109.3685833
9647,6,27,10,14,12,5,74,38.27483372,-109.3683138
9648,2,31,11,7,12,10,73,38.27483372,-109.3680443
9649,0,29,10,0,9,19,67,38.27483372,-109.3677748
9650,0,21,12,0,5,21,59,38.27483372,-109.3675053
9651,4,20,12,3,6,14,59,38.27483372,-109.3672358
9652,4,21,11,4,7,11,58,38.27483372,-109.3669663
9653,2,13,12,2,3,18,50,38.27483372,-109.3666968
9654,1,15,13,0,3,21,53,38.27483372,-109.3664273
9655,2,14,13,3,4,17,53,38.27483372,-109.3661578
9656,4,13,11,4,5,13,50,38.27483372,-109.3658883
9657,4,18,11,5,6,12,56,38.27483372,-109.3656188
9658,2,20,11,2,5,15,55,38.27483372,-109.3653493
9659,2,21,12,1,4,17,57,38.27483372,-109.3650799
9660,2,21,12,1,4,17,57,38.27483372,-109.3648104
9661,1,21,12,1,5,17,57,38.27483372,-109.3645409
9662,2,24,11,0,5,16,58,38.27483372,-109.3642714
9663,2,20,12,0,4,19,57,38.27483372,-109.3640019
9664,1,19,13,0,3,23,59,38.27483372,-109.3637324
9665,1,19,15,0,2,27,64,38.27483372,-109.3634629
9666,1,19,16,0,2,29,67,38.27483372,-109.3631934
9667,0,18,16,0,2,31,67,38.27483372,-109.3629239
9668,0,19,16,0,2,30,67,38.27483372,-109.3626544
9669,1,19,16,0,2,29,67,38.27483372,-109.3623849
9670,0,18,16,0,2,29,65,38.27483372,-109.3621154
9671,0,17,16,0,1,29,63,38.27483372,-109.3618459
9672,1,18,16,0,1,29,65,38.27483372,-109.3615764
9673,0,16,17,0,1,29,63,38.27483372,-109.3613069
9674,0,16,16,0,1,30,63,38.27483372,-109.3610374
9675,1,17,16,0,1,29,64,38.27483372,-109.3607679
9676,2,17,16,1,2,28,66,38.27483372,-109.3604984
9677,1,16,16,0,1,29,63,38.27483372,-109.360229
9678,1,19,14,0,1,25,60,38.27483372,-109.3599595
9679,1,22,12,0,2,21,58,38.27483372,-109.35969
9680,1,24,11,0,3,19,58,38.27483372,-109.3594205
9681,1,25,10,3,6,15,60,38.27483372,-109.359151
9682,1,24,11,3,5,15,59,38.27483372,-109.3588815
9683,2,21,12,5,5,14,59,38.27483372,-109.358612
9684,5,26,10,1,3,14,59,38.27483372,-109.3583425
9685,2,31,6,3,8,7,57,38.27483372,-109.358073
9686,3,28,8,2,9,6,56,38.27483372,-109.3578035
9687,3,23,8,5,10,8,57,38.27483372,-109.357534
9688,3,28,11,6,9,8,65,38.27483372,-109.3572645
9689,5,28,10,5,9,10,67,38.27483372,-109.356995
9690,6,28,9,6,9,10,68,38.27483372,-109.3567255
9691,4,31,9,4,7,11,66,38.27483372,-109.356456
9692,3,32,11,3,7,14,70,38.27483372,-109.3561865
9693,2,30,15,3,6,19,75,38.27483372,-109.355917
9694,3,28,14,2,8,19,74,38.27483372,-109.3556475
9695,3,27,14,4,17,10,75,38.27483372,-109.355378
9696,2,30,14,3,10,14,73,38.27483372,-109.3551086
9697,5,20,14,9,14,12,74,38.27483372,-109.3548391
9698,0,18,12,7,16,9,62,38.27483372,-109.3545696
9699,1,18,13,5,9,17,63,38.27483372,-109.3543001
9700,3,19,15,3,5,23,68,38.27483372,-109.3540306
9701,4,17,15,3,4,24,67,38.27483372,-109.3537611
9702,2,16,17,2,3,29,69,38.27483372,-109.3534916
9703,1,17,19,0,3,35,75,38.27483372,-109.3532221
9704,1,18,19,0,3,33,74,38.27483372,-109.3529526
9705,0,18,20,0,3,36,77,38.27483372,-109.3526831
9706,0,19,21,0,3,36,79,38.27483372,-109.3524136
9707,0,19,19,0,3,35,76,38.27483372,-109.3521441
9708,1,20,18,0,2,31,72,38.27483372,-109.3518746
9709,3,24,16,2,2,26,73,38.27483372,-109.3516051
9710,3,25,15,2,7,21,73,38.27483372,-109.3513356
9711,2,28,17,3,13,17,80,38.27483372,-109.3510661
9712,0,21,19,2,11,27,80,38.27483372,-109.3507966
9713,1,16,19,2,7,37,82,38.27483372,-109.3505271
9714,0,17,20,1,5,39,82,38.27483372,-109.3502577
9715,1,19,19,4,6,34,83,38.27483372,-109.3499882
9716,1,19,19,5,7,30,81,38.27483372,-109.3497187
9717,1,20,19,4,7,31,82,38.27483372,-109.3494492
9718,0,20,20,3,6,34,83,38.27483372,-109.3491797
9719,0,21,21,2,5,35,84,38.27483372,-109.3489102
9720,2,21,22,3,4,30,82,38.27483372,-109.3486407
9721,2,21,22,4,5,28,82,38.27483372,-109.3483712
9722,3,23,20,6,5,26,83,38.27483372,-109.3481017
9723,1,26,20,3,5,25,80,38.27483372,-109.3478322
9724,0,25,20,1,7,28,81,38.27483372,-109.3475627
9725,1,26,19,4,6,25,81,38.27483372,-109.3472932
9726,1,27,19,5,6,25,83,38.27483372,-109.3470237
9727,1,26,20,3,6,30,86,38.27483372,-109.3467542
9728,1,22,20,3,7,31,84,38.27483372,-109.3464847
9729,2,20,20,4,8,30,84,38.27483372,-109.3462152
9730,3,19,19,7,9,27,84,38.27483372,-109.3459457
9731,5,20,17,9,11,22,84,38.27483372,-109.3456762
9732,7,21,17,10,12,17,84,38.27483372,-109.3454068
9733,5,26,16,13,13,13,86,38.27483372,-109.3451373
9734,7,30,15,13,11,10,86,38.27483372,-109.3448678
9735,8,32,14,14,10,7,85,38.27483372,-109.3445983
9736,7,35,14,13,11,7,87,38.27483372,-109.3443288
9737,6,39,14,9,12,7,87,38.27483372,-109.3440593
9738,7,37,13,12,11,6,86,38.27483372,-109.3437898
9739,8,35,13,14,10,5,85,38.27483372,-109.3435203
9740,9,34,14,14,11,5,87,38.27483372,-109.3432508
9741,7,35,14,14,14,3,87,38.27483372,-109.3429813
9742,7,36,14,13,13,4,87,38.27483372,-109.3427118
9743,8,34,15,15,11,5,88,38.27483372,-109.3424423
9744,9,33,15,16,11,5,89,38.27483372,-109.3421728
9745,2,51,11,1,15,7,87,38.274564226244664,-109.4346095
9746,2,50,11,0,15,8,86,38.274564226244664,-109.43434
9747,2,47,11,0,15,8,83,38.274564226244664,-109.4340705
9748,2,42,11,0,14,9,78,38.274564226244664,-109.433801
9749,2,38,11,0,12,12,75,38.274564226244664,-109.4335315
9750,2,41,11,0,11,13,78,38.274564226244664,-109.433262
9751,1,41,11,0,11,12,76,38.274564226244664,-109.4329925
9752,1,39,11,0,11,11,73,38.274564226244664,-109.432723
9753,1,38,11,1,12,9,72,38.274564226244664,-109.4324535
9754,2,43,12,1,15,8,81,38.274564226244664,-109.432184
9755,1,45,12,0,14,10,82,38.274564226244664,-109.4319145
9756,1,39,12,0,13,12,77,38.274564226244664,-109.431645
9757,1,36,12,0,11,13,73,38.274564226244664,-109.4313755
9758,3,36,12,2,9,10,72,38.274564226244664,-109.431106
9759,4,37,12,4,10,7,74,38.274564226244664,-109.4308365
9760,2,34,11,5,10,8,70,38.274564226244664,-109.430567
9761,2,34,11,5,11,9,72,38.274564226244664,-109.4302975
9762,2,33,11,4,13,11,74,38.274564226244664,-109.430028
9763,4,31,12,11,7,15,80,38.274564226244664,-109.4297586
9764,11,25,11,16,7,12,82,38.274564226244664,-109.4294891
9765,4,28,11,15,22,4,84,38.274564226244664,-109.4292196
9766,0,25,14,14,21,8,82,38.274564226244664,-109.4289501
9767,0,30,11,8,19,11,79,38.274564226244664,-109.4286806
9768,0,32,11,4,20,7,74,38.274564226244664,-109.4284111
9769,0,31,10,6,15,8,70,38.274564226244664,-109.4281416
9770,0,32,10,4,13,8,67,38.274564226244664,-109.4278721
9771,0,34,10,1,12,10,67,38.274564226244664,-109.4276026
9772,0,34,10,0,10,15,69,38.274564226244664,-109.4273331
9773,0,33,11,0,11,16,71,38.274564226244664,-109.4270636
9774,0,34,11,0,10,17,72,38.274564226244664,-109.4267941
9775,0,33,11,0,9,19,72,38.274564226244664,-109.4265246
9776,0,33,12,0,10,19,74,38.274564226244664,-109.4262551
9777,1,35,13,0,13,17,79,38.274564226244664,-109.4259856
9778,0,32,14,0,12,22,80,38.274564226244664,-109.4257161
9779,0,31,16,0,12,23,82,38.274564226244664,-109.4254466
9780,0,31,16,0,11,25,83,38.274564226244664,-109.4251771
9781,0,31,15,0,8,27,81,38.274564226244664,-109.4249077
9782,0,29,15,0,7,29,80,38.274564226244664,-109.4246382
9783,0,30,14,0,7,24,75,38.274564226244664,-109.4243687
9784,0,31,12,0,7,22,72,38.274564226244664,-109.4240992
9785,1,33,12,0,9,20,75,38.274564226244664,-109.4238297
9786,2,38,12,0,13,16,81,38.274564226244664,-109.4235602
9787,2,42,12,0,16,10,82,38.274564226244664,-109.4232907
9788,2,45,11,0,15,11,84,38.274564226244664,-109.4230212
9789,2,45,11,0,14,12,84,38.274564226244664,-109.4227517
9790,2,44,11,0,13,13,83,38.274564226244664,-109.4224822
9791,1,44,11,0,12,13,81,38.274564226244664,-109.4222127
9792,1,44,11,0,14,13,83,38.274564226244664,-109.4219432
9793,2,44,11,0,15,12,84,38.274564226244664,-109.4216737
9794,3,44,13,2,16,9,87,38.274564226244664,-109.4214042
9795,4,42,14,3,18,8,89,38.274564226244664,-109.4211347
9796,2,38,14,1,16,13,84,38.274564226244664,-109.4208652
9797,1,36,13,0,14,15,79,38.274564226244664,-109.4205957
9798,1,36,12,0,14,14,77,38.274564226244664,-109.4203262
9799,1,34,11,2,14,11,73,38.274564226244664,-109.4200568
9800,1,31,11,3,13,10,69,38.274564226244664,-109.4197873
9801,2,32,10,2,13,8,67,38.274564226244664,-109.4195178
9802,1,36,9,0,11,11,68,38.274564226244664,-109.4192483
9803,1,35,10,0,10,14,70,38.274564226244664,-109.4189788
9804,0,33,11,0,11,15,70,38.274564226244664,-109.4187093
9805,0,30,12,0,11,17,70,38.274564226244664,-109.4184398
9806,1,29,12,3,10,14,69,38.274564226244664,-109.4181703
9807,0,29,11,1,10,14,65,38.274564226244664,-109.4179008
9808,1,35,11,0,12,13,72,38.274564226244664,-109.4176313
9809,3,38,12,0,13,12,78,38.274564226244664,-109.4173618
9810,5,38,13,3,13,10,82,38.274564226244664,-109.4170923
9811,4,39,12,3,15,7,80,38.274564226244664,-109.4168228
9812,4,39,12,3,15,7,80,38.274564226244664,-109.4165533
9813,5,39,12,3,15,7,81,38.274564226244664,-109.4162838
9814,6,40,13,5,16,5,85,38.274564226244664,-109.4160143
9815,9,40,13,8,17,2,89,38.274564226244664,-109.4157448
9816,10,41,13,10,16,0,90,38.274564226244664,-109.4154753
9817,10,41,14,10,16,1,92,38.274564226244664,-109.4152058
9818,9,42,13,9,16,1,90,38.274564226244664,-109.4149364
9819,5,46,13,6,17,1,88,38.274564226244664,-109.4146669
9820,6,45,13,7,17,1,89,38.274564226244664,-109.4143974
9821,8,45,13,8,18,0,92,38.274564226244664,-109.4141279
9822,7,46,13,8,18,0,92,38.274564226244664,-109.4138584
9823,6,47,13,6,18,1,91,38.274564226244664,-109.4135889
9824,6,47,14,7,18,1,93,38.274564226244664,-109.4133194
9825,6,46,14,7,18,1,92,38.274564226244664,-109.4130499
9826,6,46,13,6,18,1,90,38.274564226244664,-109.4127804
9827,6,46,13,6,18,1,90,38.274564226244664,-109.4125109
9828,6,45,13,6,18,1,89,38.274564226244664,-109.4122414
9829,5,46,12,5,18,1,87,38.274564226244664,-109.4119719
9830,5,47,12,5,18,1,88,38.274564226244664,-109.4117024
9831,5,45,12,6,18,1,87,38.274564226244664,-109.4114329
9832,6,43,13,7,17,1,87,38.274564226244664,-109.4111634
9833,6,44,13,7,17,2,89,38.274564226244664,-109.4108939
9834,5,46,13,6,17,2,89,38.274564226244664,-109.4106244
9835,6,46,13,7,18,1,91,38.274564226244664,-109.4103549
9836,6,46,13,6,18,1,90,38.274564226244664,-109.4100855
9837,6,46,13,5,17,2,89,38.274564226244664,-109.409816
9838,5,45,12,6,17,1,86,38.274564226244664,-109.4095465
9839,6,44,13,7,17,1,88,38.274564226244664,-109.409277
9840,6,44,13,7,18,1,89,38.274564226244664,-109.4090075
9841,5,47,12,7,18,0,89,38.274564226244664,-109.408738
9842,5,49,12,7,17,0,90,38.274564226244664,-109.4084685
9843,6,46,12,5,16,2,87,38.274564226244664,-109.408199
9844,10,38,13,10,13,3,87,38.274564226244664,-109.4079295
9845,15,35,14,13,12,2,91,38.274564226244664,-109.40766
9846,18,33,14,13,12,2,92,38.274564226244664,-109.4073905
9847,16,29,14,14,12,2,87,38.274564226244664,-109.407121
9848,17,25,14,14,11,3,84,38.274564226244664,-109.4068515
9849,3,33,7,6,7,5,61,38.274564226244664,-109.3879869
9850,2,27,5,4,7,6,51,38.274564226244664,-109.3877174
9851,2,29,5,4,8,4,52,38.274564226244664,-109.3874479
9852,3,37,6,4,9,3,62,38.274564226244664,-109.3871784
9853,0,40,8,2,10,7,67,38.274564226244664,-109.3869089
9854,2,38,9,3,9,10,71,38.274564226244664,-109.3866394
9855,3,23,15,3,4,22,70,38.274564226244664,-109.3863699
9856,2,20,14,2,4,21,63,38.274564226244664,-109.3861004
9857,2,34,9,2,7,11,65,38.274564226244664,-109.3858309
9858,2,30,10,3,7,11,63,38.274564226244664,-109.3855614
9859,3,32,10,5,5,11,66,38.274564226244664,-109.3852919
9860,3,35,7,6,8,7,66,38.274564226244664,-109.3850225
9861,4,43,7,4,8,5,71,38.274564226244664,-109.384753
9862,3,40,7,3,9,5,67,38.274564226244664,-109.3844835
9863,2,31,8,5,10,7,63,38.274564226244664,-109.384214
9864,2,37,11,3,13,6,72,38.274564226244664,-109.3839445
9865,2,41,12,0,15,8,78,38.274564226244664,-109.383675
9866,1,31,12,0,11,14,69,38.274564226244664,-109.3834055
9867,4,24,12,1,7,16,64,38.274564226244664,-109.383136
9868,1,18,13,4,7,16,59,38.274564226244664,-109.3828665
9869,1,16,12,5,11,11,56,38.274564226244664,-109.382597
9870,2,13,9,7,12,7,50,38.274564226244664,-109.3823275
9871,2,15,10,4,7,11,49,38.274564226244664,-109.382058
9872,2,26,8,2,6,10,54,38.274564226244664,-109.3817885
9873,1,28,7,1,7,6,50,38.274564226244664,-109.381519
9874,1,25,6,0,8,6,46,38.274564226244664,-109.3812495
9875,3,21,7,1,8,6,46,38.274564226244664,-109.38098
9876,4,21,8,3,7,8,51,38.274564226244664,-109.3807105
9877,2,28,8,3,7,9,57,38.274564226244664,-109.380441
9878,2,34,8,2,8,8,62,38.274564226244664,-109.3801716
9879,1,37,8,2,8,8,64,38.274564226244664,-109.3799021
9880,1,38,9,2,8,9,67,38.274564226244664,-109.3796326
9881,2,32,10,3,9,10,66,38.274564226244664,-109.3793631
9882,3,31,11,2,10,12,69,38.274564226244664,-109.3790936
9883,3,24,13,3,6,17,66,38.274564226244664,-109.3788241
9884,3,21,15,3,6,19,67,38.274564226244664,-109.3785546
9885,5,25,15,5,9,16,75,38.274564226244664,-109.3782851
9886,3,26,13,2,7,18,69,38.274564226244664,-109.3780156
9887,3,28,14,1,7,20,73,38.274564226244664,-109.3777461
9888,3,26,16,1,6,23,75,38.274564226244664,-109.3774766
9889,2,23,16,1,6,25,73,38.274564226244664,-109.3772071
9890,3,23,15,2,6,23,72,38.274564226244664,-109.3769376
9891,3,25,15,1,6,22,72,38.274564226244664,-109.3766681
9892,4,29,15,1,8,18,75,38.274564226244664,-109.3763986
9893,7,34,15,4,11,11,82,38.274564226244664,-109.3761291
9894,11,34,15,6,12,8,86,38.274564226244664,-109.3758596
9895,8,37,15,4,11,9,84,38.274564226244664,-109.3755901
9896,4,31,12,2,8,14,71,38.274564226244664,-109.3753206
9897,3,29,11,2,7,16,68,38.274564226244664,-109.3750512
9898,3,31,11,1,7,15,68,38.274564226244664,-109.3747817
9899,1,37,10,0,10,12,70,38.274564226244664,-109.3745122
9900,1,35,10,1,12,11,70,38.274564226244664,-109.3742427
9901,2,25,12,0,6,19,64,38.274564226244664,-109.3739732
9902,2,29,14,2,9,21,77,38.274564226244664,-109.3737037
9903,2,28,14,2,10,19,75,38.274564226244664,-109.3734342
9904,3,24,13,4,8,15,67,38.274564226244664,-109.3731647
9905,3,21,12,4,8,17,65,38.274564226244664,-109.3728952
9906,6,23,11,10,9,8,67,38.274564226244664,-109.3726257
9907,2,20,10,11,12,7,62,38.274564226244664,-109.3723562
9908,5,28,12,11,6,10,72,38.274564226244664,-109.3720867
9909,4,38,13,12,6,6,79,38.274564226244664,-109.3718172
9910,1,24,7,1,9,9,51,38.274564226244664,-109.3715477
9911,4,23,11,1,11,12,62,38.274564226244664,-109.3712782
9912,4,30,12,9,7,10,72,38.274564226244664,-109.3710087
9913,1,28,11,7,14,9,70,38.274564226244664,-109.3707392
9914,6,26,13,15,17,5,82,38.274564226244664,-109.3704697
9915,4,21,13,22,18,4,82,38.274564226244664,-109.3702003
9916,8,18,12,19,25,4,86,38.274564226244664,-109.3699308
9917,7,11,11,21,17,8,75,38.274564226244664,-109.3696613
9918,3,4,8,27,14,8,64,38.274564226244664,-109.3693918
9919,2,16,11,17,12,14,72,38.274564226244664,-109.3691223
9920,4,22,10,12,11,14,73,38.274564226244664,-109.3688528
9921,5,31,10,9,12,6,73,38.274564226244664,-109.3685833
9922,8,31,10,10,11,5,75,38.274564226244664,-109.3683138
9923,4,28,10,4,9,9,64,38.274564226244664,-109.3680443
9924,3,24,10,1,7,12,57,38.274564226244664,-109.3677748
9925,4,24,9,2,6,8,53,38.274564226244664,-109.3675053
9926,6,25,7,5,6,6,55,38.274564226244664,-109.3672358
9927,4,26,6,6,6,6,54,38.274564226244664,-109.3669663
9928,4,29,7,5,4,7,56,38.274564226244664,-109.3666968
9929,6,24,6,6,5,6,53,38.274564226244664,-109.3664273
9930,5,21,6,6,7,6,51,38.274564226244664,-109.3661578
9931,4,21,7,7,8,6,53,38.274564226244664,-109.3658883
9932,5,23,7,7,6,6,54,38.274564226244664,-109.3656188
9933,7,13,9,8,9,5,51,38.274564226244664,-109.3653493
9934,2,16,13,3,4,18,56,38.274564226244664,-109.3650799
9935,2,19,14,0,2,22,59,38.274564226244664,-109.3648104
9936,2,20,14,0,2,21,59,38.274564226244664,-109.3645409
9937,2,21,14,0,3,21,61,38.274564226244664,-109.3642714
9938,1,20,14,0,3,24,62,38.274564226244664,-109.3640019
9939,1,21,13,0,3,24,62,38.274564226244664,-109.3637324
9940,1,20,13,0,2,23,59,38.274564226244664,-109.3634629
9941,2,18,14,0,2,25,61,38.274564226244664,-109.3631934
9942,0,19,16,0,2,29,66,38.274564226244664,-109.3629239
9943,1,19,15,0,2,29,66,38.274564226244664,-109.3626544
9944,1,18,15,0,1,28,63,38.274564226244664,-109.3623849
9945,1,17,16,0,1,29,64,38.274564226244664,-109.3621154
9946,0,18,16,0,0,30,64,38.274564226244664,-109.3618459
9947,0,22,14,0,1,26,63,38.274564226244664,-109.3615764
9948,0,21,14,0,1,26,62,38.274564226244664,-109.3613069
9949,1,19,14,0,2,25,61,38.274564226244664,-109.3610374
9950,2,18,14,1,2,24,61,38.274564226244664,-109.3607679
9951,2,15,14,2,3,24,60,38.274564226244664,-109.3604984
9952,2,17,14,0,2,24,59,38.274564226244664,-109.360229
9953,1,21,13,0,2,24,61,38.274564226244664,-109.3599595
9954,0,21,14,0,2,23,60,38.274564226244664,-109.35969
9955,1,21,15,0,2,24,63,38.274564226244664,-109.3594205
9956,1,19,15,1,3,24,63,38.274564226244664,-109.359151
9957,0,16,14,0,2,24,56,38.274564226244664,-109.3588815
9958,4,23,9,3,4,12,55,38.274564226244664,-109.358612
9959,5,26,8,3,8,7,57,38.274564226244664,-109.3583425
9960,2,29,6,2,8,5,52,38.274564226244664,-109.358073
9961,3,29,10,3,8,5,58,38.274564226244664,-109.3578035
9962,3,30,11,6,9,8,67,38.274564226244664,-109.357534
9963,2,24,15,3,6,19,69,38.274564226244664,-109.3572645
9964,5,26,15,1,6,21,74,38.274564226244664,-109.356995
9965,4,26,17,0,8,24,79,38.274564226244664,-109.3567255
9966,6,27,17,0,6,24,80,38.274564226244664,-109.356456
9967,4,26,19,0,9,26,84,38.274564226244664,-109.3561865
9968,1,23,19,1,11,26,81,38.274564226244664,-109.355917
9969,5,25,17,3,13,21,84,38.274564226244664,-109.3556475
9970,8,27,16,5,12,13,81,38.274564226244664,-109.355378
9971,2,26,14,7,17,14,80,38.274564226244664,-109.3551086
9972,0,17,14,2,16,16,65,38.274564226244664,-109.3548391
9973,0,17,14,3,12,18,64,38.274564226244664,-109.3545696
9974,2,23,13,5,10,14,67,38.274564226244664,-109.3543001
9975,1,22,19,1,4,28,75,38.274564226244664,-109.3540306
9976,1,19,16,2,4,26,68,38.274564226244664,-109.3537611
9977,1,20,15,3,5,25,69,38.274564226244664,-109.3534916
9978,1,23,17,2,5,28,76,38.274564226244664,-109.3532221
9979,0,21,20,0,3,35,79,38.274564226244664,-109.3529526
9980,0,21,20,0,4,36,81,38.274564226244664,-109.3526831
9981,0,21,20,0,4,36,81,38.274564226244664,-109.3524136
9982,0,21,21,0,4,36,82,38.274564226244664,-109.3521441
9983,0,21,21,0,5,34,81,38.274564226244664,-109.3518746
9984,1,23,20,0,4,32,80,38.274564226244664,-109.3516051
9985,1,25,17,0,5,26,74,38.274564226244664,-109.3513356
9986,1,26,16,2,7,24,76,38.274564226244664,-109.3510661
9987,1,22,15,3,9,26,76,38.274564226244664,-109.3507966
9988,1,18,17,5,7,33,81,38.274564226244664,-109.3505271
9989,1,16,19,3,5,39,83,38.274564226244664,-109.3502577
9990,0,18,20,2,5,37,82,38.274564226244664,-109.3499882
9991,0,18,19,4,6,33,80,38.274564226244664,-109.3497187
9992,0,19,19,3,6,34,81,38.274564226244664,-109.3494492
9993,0,20,20,2,5,35,82,38.274564226244664,-109.3491797
9994,0,22,20,2,7,32,83,38.274564226244664,-109.3489102
9995,1,22,20,5,7,28,83,38.274564226244664,-109.3486407
9996,1,20,20,5,7,30,83,38.274564226244664,-109.3483712
9997,1,21,20,4,7,32,85,38.274564226244664,-109.3481017
9998,0,25,20,0,7,30,82,38.274564226244664,-109.3478322
9999,0,24,21,0,6,32,83,38.274564226244664,-109.3475627
10000,0,25,19,1,5,29,79,38.274564226244664,-109.3472932
10001,0,24,16,0,4,25,69,38.274564226244664,-109.3470237
10002,0,21,14,0,4,22,61,38.274564226244664,-109.3467542
10003,0,21,16,0,3,28,68,38.274564226244664,-109.3464847
10004,1,22,20,2,6,33,84,38.274564226244664,-109.3462152
10005,2,18,20,4,7,33,84,38.274564226244664,-109.3459457
10006,3,17,20,6,7,32,85,38.274564226244664,-109.3456762
10007,4,17,20,8,10,26,85,38.274564226244664,-109.3454068
10008,7,27,18,9,9,19,89,38.274564226244664,-109.3451373
10009,9,29,15,12,11,13,89,38.274564226244664,-109.3448678
10010,9,32,15,15,10,8,89,38.274564226244664,-109.3445983
10011,8,34,14,13,11,7,87,38.274564226244664,-109.3443288
10012,7,38,14,9,12,7,87,38.274564226244664,-109.3440593
10013,6,37,14,10,12,7,86,38.274564226244664,-109.3437898
10014,8,37,14,14,10,5,88,38.274564226244664,-109.3435203
10015,8,36,14,15,10,4,87,38.274564226244664,-109.3432508
10016,6,37,14,13,14,3,87,38.274564226244664,-109.3429813
10017,6,36,14,13,14,4,87,38.274564226244664,-109.3427118
10018,7,33,14,14,12,6,86,38.274564226244664,-109.3424423
10019,9,31,16,16,11,6,89,38.274564226244664,-109.3421728
10020,9,32,16,16,10,6,89,38.274564226244664,-109.3419033
10021,3,54,12,2,17,4,92,38.27429473165943,-109.434879
10022,2,52,12,3,17,4,90,38.27429473165943,-109.4346095
10023,2,52,10,1,14,7,86,38.27429473165943,-109.43434
10024,2,49,11,1,14,7,84,38.27429473165943,-109.4340705
10025,2,45,12,1,15,8,83,38.27429473165943,-109.433801
10026,2,42,12,0,13,12,81,38.27429473165943,-109.4335315
10027,1,42,11,0,14,10,78,38.27429473165943,-109.433262
10028,1,39,11,0,11,10,72,38.27429473165943,-109.4329925
10029,1,38,11,0,9,11,70,38.27429473165943,-109.432723
10030,2,38,10,0,8,13,71,38.27429473165943,-109.4324535
10031,3,36,11,0,11,12,73,38.27429473165943,-109.432184
10032,2,38,10,0,11,13,74,38.27429473165943,-109.4319145
10033,2,40,11,0,12,13,78,38.27429473165943,-109.431645
10034,2,39,12,0,11,12,76,38.27429473165943,-109.4313755
10035,2,37,12,2,9,9,71,38.27429473165943,-109.431106
10036,3,35,11,3,8,9,69,38.27429473165943,-109.4308365
10037,3,29,13,10,11,9,75,38.27429473165943,-109.430567
10038,2,25,12,17,12,12,80,38.27429473165943,-109.4302975
10039,0,28,13,13,16,13,83,38.27429473165943,-109.430028
10040,1,32,11,13,21,5,83,38.27429473165943,-109.4297586
10041,0,34,11,11,23,5,84,38.27429473165943,-109.4294891
10042,0,31,12,7,18,11,79,38.27429473165943,-109.4292196
10043,0,31,12,6,17,11,77,38.27429473165943,-109.4289501
10044,0,33,11,4,15,10,73,38.27429473165943,-109.4286806
10045,1,35,11,3,16,8,74,38.27429473165943,-109.4284111
10046,1,35,10,0,14,10,70,38.27429473165943,-109.4281416
10047,1,34,10,0,14,11,70,38.27429473165943,-109.4278721
10048,0,33,11,0,12,12,68,38.27429473165943,-109.4276026
10049,0,35,11,0,12,14,72,38.27429473165943,-109.4273331
10050,1,36,11,0,13,13,74,38.27429473165943,-109.4270636
10051,0,36,11,0,11,15,73,38.27429473165943,-109.4267941
10052,0,34,11,0,12,16,73,38.27429473165943,-109.4265246
10053,0,32,12,0,15,16,75,38.27429473165943,-109.4262551
10054,0,33,11,1,19,10,74,38.27429473165943,-109.4259856
10055,0,30,12,3,19,11,75,38.27429473165943,-109.4257161
10056,0,30,14,0,14,19,77,38.27429473165943,-109.4254466
10057,0,30,14,0,10,23,77,38.27429473165943,-109.4251771
10058,2,33,12,0,11,19,77,38.27429473165943,-109.4249077
10059,1,34,11,0,9,20,75,38.27429473165943,-109.4246382
10060,0,33,11,0,9,20,73,38.27429473165943,-109.4243687
10061,0,33,11,0,8,18,70,38.27429473165943,-109.4240992
10062,1,33,11,0,8,19,72,38.27429473165943,-109.4238297
10063,2,35,13,0,10,19,79,38.27429473165943,-109.4235602
10064,2,36,12,1,12,16,79,38.27429473165943,-109.4232907
10065,2,40,11,0,12,14,79,38.27429473165943,-109.4230212
10066,2,42,11,0,13,14,82,38.27429473165943,-109.4227517
10067,1,42,11,0,13,14,81,38.27429473165943,-109.4224822
10068,2,43,11,0,14,12,82,38.27429473165943,-109.4222127
10069,2,43,11,0,14,12,82,38.27429473165943,-109.4219432
10070,2,42,11,0,13,13,81,38.27429473165943,-109.4216737
10071,2,42,12,1,14,12,83,38.27429473165943,-109.4214042
10072,3,42,13,2,16,10,86,38.27429473165943,-109.4211347
10073,2,40,13,2,17,10,84,38.27429473165943,-109.4208652
10074,2,38,12,1,15,13,81,38.27429473165943,-109.4205957
10075,2,38,12,0,15,13,80,38.27429473165943,-109.4203262
10076,1,37,13,0,15,14,80,38.27429473165943,-109.4200568
10077,1,33,12,0,13,16,75,38.27429473165943,-109.4197873
10078,1,30,12,1,12,14,70,38.27429473165943,-109.4195178
10079,1,31,11,0,10,15,68,38.27429473165943,-109.4192483
10080,0,30,11,0,11,15,67,38.27429473165943,-109.4189788
10081,0,31,12,0,11,16,70,38.27429473165943,-109.4187093
10082,0,34,12,0,12,17,75,38.27429473165943,-109.4184398
10083,0,33,12,0,15,13,73,38.27429473165943,-109.4181703
10084,1,32,11,0,14,11,69,38.27429473165943,-109.4179008
10085,1,33,11,1,14,11,71,38.27429473165943,-109.4176313
10086,4,34,13,2,14,12,79,38.27429473165943,-109.4173618
10087,5,36,14,4,15,10,84,38.27429473165943,-109.4170923
10088,5,36,13,6,16,7,83,38.27429473165943,-109.4168228
10089,3,35,12,4,14,9,77,38.27429473165943,-109.4165533
10090,3,35,12,3,12,11,76,38.27429473165943,-109.4162838
10091,4,37,13,5,14,7,80,38.27429473165943,-109.4160143
10092,4,38,12,5,15,6,80,38.27429473165943,-109.4157448
10093,8,41,13,7,17,1,87,38.27429473165943,-109.4154753
10094,9,43,14,8,18,0,92,38.27429473165943,-109.4152058
10095,9,43,14,9,17,0,92,38.27429473165943,-109.4149364
10096,9,44,14,10,17,0,94,38.27429473165943,-109.4146669
10097,9,44,13,9,17,0,92,38.27429473165943,-109.4143974
10098,8,46,14,8,17,1,94,38.27429473165943,-109.4141279
10099,9,45,13,7,16,1,91,38.27429473165943,-109.4138584
10100,9,46,13,7,15,2,92,38.27429473165943,-109.4135889
10101,6,50,13,6,17,2,94,38.27429473165943,-109.4133194
10102,6,48,13,6,18,2,93,38.27429473165943,-109.4130499
10103,6,47,13,5,18,1,90,38.27429473165943,-109.4127804
10104,7,46,13,6,19,1,92,38.27429473165943,-109.4125109
10105,7,46,13,7,18,0,91,38.27429473165943,-109.4122414
10106,5,47,13,5,19,1,90,38.27429473165943,-109.4119719
10107,6,46,12,5,18,1,88,38.27429473165943,-109.4117024
10108,6,44,12,7,18,1,88,38.27429473165943,-109.4114329
10109,7,43,13,8,18,1,90,38.27429473165943,-109.4111634
10110,7,43,13,8,17,1,89,38.27429473165943,-109.4108939
10111,7,44,13,6,18,1,89,38.27429473165943,-109.4106244
10112,7,44,12,5,19,2,89,38.27429473165943,-109.4103549
10113,6,44,12,5,18,2,87,38.27429473165943,-109.4100855
10114,6,44,12,6,17,2,87,38.27429473165943,-109.409816
10115,6,43,12,8,17,1,87,38.27429473165943,-109.4095465
10116,6,43,13,8,18,1,89,38.27429473165943,-109.409277
10117,5,47,12,6,17,1,88,38.27429473165943,-109.4090075
10118,4,50,11,5,17,1,88,38.27429473165943,-109.408738
10119,4,48,11,6,18,0,87,38.27429473165943,-109.4084685
10120,7,43,12,5,15,3,85,38.27429473165943,-109.408199
10121,11,38,13,12,12,2,88,38.27429473165943,-109.4079295
10122,18,35,14,15,11,1,94,38.27429473165943,-109.40766
10123,24,30,14,17,9,0,94,38.27429473165943,-109.4073905
10124,24,30,15,15,10,1,95,38.27429473165943,-109.407121
10125,16,31,14,15,12,1,89,38.27429473165943,-109.4068515
10126,3,36,6,5,7,6,63,38.27429473165943,-109.3879869
10127,1,30,5,2,8,5,51,38.27429473165943,-109.3877174
10128,3,34,6,3,9,4,59,38.27429473165943,-109.3874479
10129,3,37,7,5,9,3,64,38.27429473165943,-109.3871784
10130,1,37,9,3,10,9,69,38.27429473165943,-109.3869089
10131,1,29,11,3,6,15,65,38.27429473165943,-109.3866394
10132,3,23,16,3,4,25,74,38.27429473165943,-109.3863699
10133,2,24,14,2,4,21,67,38.27429473165943,-109.3861004
10134,2,36,10,1,9,12,70,38.27429473165943,-109.3858309
10135,2,32,11,3,8,10,66,38.27429473165943,-109.3855614
10136,4,33,12,3,7,11,70,38.27429473165943,-109.3852919
10137,3,36,9,5,10,8,71,38.27429473165943,-109.3850225
10138,2,46,8,4,10,5,75,38.27429473165943,-109.384753
10139,0,48,8,2,11,6,75,38.27429473165943,-109.3844835
10140,1,40,11,4,14,5,75,38.27429473165943,-109.384214
10141,2,34,11,4,14,7,72,38.27429473165943,-109.3839445
10142,3,36,12,0,15,12,78,38.27429473165943,-109.383675
10143,2,33,13,0,12,15,75,38.27429473165943,-109.3834055
10144,3,29,14,1,10,18,75,38.27429473165943,-109.383136
10145,3,25,15,3,8,20,74,38.27429473165943,-109.3828665
10146,1,19,13,1,9,16,59,38.27429473165943,-109.382597
10147,1,16,10,5,10,9,51,38.27429473165943,-109.3823275
10148,3,22,8,5,7,7,52,38.27429473165943,-109.382058
10149,1,33,7,2,6,6,55,38.27429473165943,-109.3817885
10150,1,34,6,0,7,5,53,38.27429473165943,-109.381519
10151,2,25,6,0,8,6,47,38.27429473165943,-109.3812495
10152,3,16,8,3,7,8,45,38.27429473165943,-109.38098
10153,3,22,11,4,6,12,58,38.27429473165943,-109.3807105
10154,3,32,12,4,8,10,69,38.27429473165943,-109.380441
10155,3,32,10,4,8,9,66,38.27429473165943,-109.3801716
10156,3,30,10,4,8,10,65,38.27429473165943,-109.3799021
10157,3,31,11,4,10,10,69,38.27429473165943,-109.3796326
10158,3,37,11,2,10,9,72,38.27429473165943,-109.3793631
10159,2,37,11,4,13,7,74,38.27429473165943,-109.3790936
10160,2,30,11,4,10,10,67,38.27429473165943,-109.3788241
10161,3,23,13,3,7,18,67,38.27429473165943,-109.3785546
10162,3,21,15,1,4,25,69,38.27429473165943,-109.3782851
10163,3,21,14,1,3,23,65,38.27429473165943,-109.3780156
10164,3,26,13,2,6,18,68,38.27429473165943,-109.3777461
10165,3,23,14,2,6,20,68,38.27429473165943,-109.3774766
10166,2,24,16,1,6,23,72,38.27429473165943,-109.3772071
10167,4,27,17,1,7,26,82,38.27429473165943,-109.3769376
10168,4,31,16,1,9,22,83,38.27429473165943,-109.3766681
10169,5,32,15,2,9,18,81,38.27429473165943,-109.3763986
10170,6,35,15,4,11,12,83,38.27429473165943,-109.3761291
10171,7,35,14,4,11,10,81,38.27429473165943,-109.3758596
10172,4,32,13,3,9,13,74,38.27429473165943,-109.3755901
10173,3,24,13,2,5,19,66,38.27429473165943,-109.3753206
10174,3,27,11,2,7,15,65,38.27429473165943,-109.3750512
10175,2,36,10,1,11,10,70,38.27429473165943,-109.3747817
10176,1,45,10,0,14,8,78,38.27429473165943,-109.3745122
10177,3,36,10,2,11,9,71,38.27429473165943,-109.3742427
10178,2,33,12,1,11,14,73,38.27429473165943,-109.3739732
10179,2,29,14,1,11,18,75,38.27429473165943,-109.3737037
10180,3,25,16,2,8,23,77,38.27429473165943,-109.3734342
10181,3,23,17,3,7,27,80,38.27429473165943,-109.3731647
10182,3,21,18,4,6,30,82,38.27429473165943,-109.3728952
10183,5,19,12,12,9,13,70,38.27429473165943,-109.3726257
10184,4,23,11,14,15,7,74,38.27429473165943,-109.3723562
10185,5,25,12,9,15,10,76,38.27429473165943,-109.3720867
10186,2,29,12,0,9,19,71,38.27429473165943,-109.3718172
10187,2,24,13,2,12,19,72,38.27429473165943,-109.3715477
10188,2,25,13,7,15,15,77,38.27429473165943,-109.3712782
10189,3,27,14,13,17,10,84,38.27429473165943,-109.3710087
10190,3,28,13,14,18,5,81,38.27429473165943,-109.3707392
10191,0,29,10,8,15,7,69,38.27429473165943,-109.3704697
10192,3,19,10,9,15,5,61,38.27429473165943,-109.3702003
10193,2,21,12,11,17,10,73,38.27429473165943,-109.3699308
10194,3,19,13,10,15,14,74,38.27429473165943,-109.3696613
10195,4,20,11,17,11,11,74,38.27429473165943,-109.3693918
10196,4,23,11,8,10,18,74,38.27429473165943,-109.3691223
10197,4,29,12,7,9,14,75,38.27429473165943,-109.3688528
10198,3,36,9,6,7,5,66,38.27429473165943,-109.3685833
10199,4,38,8,4,7,4,65,38.27429473165943,-109.3683138
10200,4,37,8,4,7,5,65,38.27429473165943,-109.3680443
10201,2,35,7,5,8,4,61,38.27429473165943,-109.3677748
10202,4,43,4,4,7,3,65,38.27429473165943,-109.3675053
10203,3,39,5,5,7,2,61,38.27429473165943,-109.3672358
10204,2,34,5,4,7,3,55,38.27429473165943,-109.3669663
10205,3,38,5,4,6,4,60,38.27429473165943,-109.3666968
10206,3,31,6,6,7,4,57,38.27429473165943,-109.3664273
10207,4,25,7,7,9,4,56,38.27429473165943,-109.3661578
10208,3,28,9,6,9,7,62,38.27429473165943,-109.3658883
10209,7,30,9,6,6,4,62,38.27429473165943,-109.3656188
10210,6,16,10,5,7,6,50,38.27429473165943,-109.3653493
10211,4,10,11,5,7,12,49,38.27429473165943,-109.3650799
10212,2,16,12,3,4,18,55,38.27429473165943,-109.3648104
10213,2,19,14,0,2,23,60,38.27429473165943,-109.3645409
10214,3,22,17,0,3,27,72,38.27429473165943,-109.3642714
10215,1,20,14,0,3,24,62,38.27429473165943,-109.3640019
10216,1,20,12,0,2,21,56,38.27429473165943,-109.3637324
10217,1,20,12,0,2,20,55,38.27429473165943,-109.3634629
10218,2,20,13,0,2,22,59,38.27429473165943,-109.3631934
10219,2,21,15,0,2,27,67,38.27429473165943,-109.3629239
10220,0,19,15,0,2,28,64,38.27429473165943,-109.3626544
10221,0,20,16,0,2,30,68,38.27429473165943,-109.3623849
10222,0,21,16,0,2,30,69,38.27429473165943,-109.3621154
10223,0,21,15,0,0,29,65,38.27429473165943,-109.3618459
10224,1,22,15,1,1,27,67,38.27429473165943,-109.3615764
10225,0,20,16,0,1,28,65,38.27429473165943,-109.3613069
10226,1,18,16,0,1,28,64,38.27429473165943,-109.3610374
10227,2,18,15,0,2,26,63,38.27429473165943,-109.3607679
10228,1,17,15,0,2,25,60,38.27429473165943,-109.3604984
10229,2,19,13,1,3,20,58,38.27429473165943,-109.360229
10230,1,18,13,0,2,22,56,38.27429473165943,-109.3599595
10231,1,19,14,0,2,24,60,38.27429473165943,-109.35969
10232,2,20,15,0,3,24,64,38.27429473165943,-109.3594205
10233,1,20,16,0,2,27,66,38.27429473165943,-109.359151
10234,2,17,14,2,3,21,59,38.27429473165943,-109.3588815
10235,5,21,7,3,7,8,51,38.27429473165943,-109.358612
10236,3,22,6,2,8,6,47,38.27429473165943,-109.3583425
10237,3,32,7,4,9,5,60,38.27429473165943,-109.358073
10238,1,29,8,3,10,8,59,38.27429473165943,-109.3578035
10239,0,32,9,3,10,10,64,38.27429473165943,-109.357534
10240,7,25,14,9,7,18,80,38.27429473165943,-109.3572645
10241,7,21,16,2,5,29,80,38.27429473165943,-109.356995
10242,3,30,19,0,8,27,87,38.27429473165943,-109.3567255
10243,4,25,18,1,7,28,83,38.27429473165943,-109.356456
10244,5,28,17,3,8,23,84,38.27429473165943,-109.3561865
10245,3,32,18,1,11,20,85,38.27429473165943,-109.355917
10246,3,27,16,4,13,16,79,38.27429473165943,-109.3556475
10247,3,21,16,7,16,14,77,38.27429473165943,-109.355378
10248,2,21,15,5,17,15,75,38.27429473165943,-109.3551086
10249,0,19,15,1,16,16,67,38.27429473165943,-109.3548391
10250,1,22,16,4,11,17,71,38.27429473165943,-109.3545696
10251,3,26,18,2,9,22,80,38.27429473165943,-109.3543001
10252,3,26,20,0,7,25,81,38.27429473165943,-109.3540306
10253,3,22,18,3,8,23,77,38.27429473165943,-109.3537611
10254,2,24,16,4,9,22,77,38.27429473165943,-109.3534916
10255,1,25,16,3,7,26,78,38.27429473165943,-109.3532221
10256,1,16,18,0,2,32,69,38.27429473165943,-109.3529526
10257,1,17,18,0,3,32,71,38.27429473165943,-109.3526831
10258,0,16,19,0,3,34,72,38.27429473165943,-109.3524136
10259,0,16,20,0,3,35,74,38.27429473165943,-109.3521441
10260,0,18,19,0,3,34,74,38.27429473165943,-109.3518746
10261,1,20,17,0,2,32,72,38.27429473165943,-109.3516051
10262,2,20,15,0,3,27,67,38.27429473165943,-109.3513356
10263,1,26,17,0,6,26,76,38.27429473165943,-109.3510661
10264,2,26,15,0,7,24,74,38.27429473165943,-109.3507966
10265,3,22,14,8,8,22,77,38.27429473165943,-109.3505271
10266,1,20,19,3,6,31,80,38.27429473165943,-109.3502577
10267,1,18,20,3,6,35,83,38.27429473165943,-109.3499882
10268,0,18,20,3,5,35,81,38.27429473165943,-109.3497187
10269,1,20,22,3,4,32,82,38.27429473165943,-109.3494492
10270,1,21,21,3,7,31,84,38.27429473165943,-109.3491797
10271,1,21,20,4,6,31,83,38.27429473165943,-109.3489102
10272,1,22,19,6,9,27,84,38.27429473165943,-109.3486407
10273,1,23,20,5,8,28,85,38.27429473165943,-109.3483712
10274,0,23,20,3,9,29,84,38.27429473165943,-109.3481017
10275,0,25,19,2,8,28,82,38.27429473165943,-109.3478322
10276,0,24,20,1,9,28,82,38.27429473165943,-109.3475627
10277,0,24,20,0,7,30,81,38.27429473165943,-109.3472932
10278,1,24,17,0,4,28,74,38.27429473165943,-109.3470237
10279,0,24,14,0,3,24,65,38.27429473165943,-109.3467542
10280,0,21,13,3,4,18,59,38.27429473165943,-109.3464847
10281,1,19,14,3,4,22,63,38.27429473165943,-109.3462152
10282,1,18,19,1,4,32,75,38.27429473165943,-109.3459457
10283,2,18,21,3,6,34,84,38.27429473165943,-109.3456762
10284,4,19,19,7,8,28,85,38.27429473165943,-109.3454068
10285,7,28,16,10,9,17,87,38.27429473165943,-109.3451373
10286,8,29,15,14,10,12,88,38.27429473165943,-109.3448678
10287,9,31,14,14,11,8,87,38.27429473165943,-109.3445983
10288,8,33,14,12,11,9,87,38.27429473165943,-109.3443288
10289,7,34,14,10,12,10,87,38.27429473165943,-109.3440593
10290,9,33,14,13,12,8,89,38.27429473165943,-109.3437898
10291,9,33,14,15,11,6,88,38.27429473165943,-109.3435203
10292,8,35,14,16,11,4,88,38.27429473165943,-109.3432508
10293,8,37,14,15,12,4,90,38.27429473165943,-109.3429813
10294,6,37,13,11,13,5,85,38.27429473165943,-109.3427118
10295,6,33,14,14,13,5,85,38.27429473165943,-109.3424423
10296,8,30,14,19,10,4,85,38.27429473165943,-109.3421728
10297,10,30,16,20,9,4,89,38.27429473165943,-109.3419033
10298,9,32,16,16,9,6,88,38.27429473165943,-109.3416338
10299,3,53,12,3,18,2,91,38.27402524,-109.4351484
10300,3,53,12,4,18,2,92,38.27402524,-109.434879
10301,3,54,11,1,15,5,89,38.27402524,-109.4346095
10302,3,54,11,3,14,4,89,38.27402524,-109.43434
10303,2,52,11,3,14,4,86,38.27402524,-109.4340705
10304,2,48,11,1,14,6,82,38.27402524,-109.433801
10305,2,41,11,0,11,12,77,38.27402524,-109.4335315
10306,2,41,11,0,11,11,76,38.27402524,-109.433262
10307,2,39,10,0,8,11,70,38.27402524,-109.4329925
10308,1,38,10,1,8,10,68,38.27402524,-109.432723
10309,2,38,10,2,10,9,71,38.27402524,-109.4324535
10310,2,38,11,1,11,10,73,38.27402524,-109.432184
10311,1,38,11,2,11,9,72,38.27402524,-109.4319145
10312,2,41,11,2,10,8,74,38.27402524,-109.431645
10313,2,40,12,3,10,7,74,38.27402524,-109.4313755
10314,3,36,11,4,9,7,70,38.27402524,-109.431106
10315,2,31,11,4,8,9,65,38.27402524,-109.4308365
10316,2,27,13,8,12,9,71,38.27402524,-109.430567
10317,2,25,13,10,12,13,75,38.27402524,-109.4302975
10318,1,27,12,8,14,13,75,38.27402524,-109.430028
10319,0,32,10,7,13,9,71,38.27402524,-109.4297586
10320,1,35,11,3,14,11,75,38.27402524,-109.4294891
10321,0,35,11,2,13,11,72,38.27402524,-109.4292196
10322,0,35,11,1,12,11,70,38.27402524,-109.4289501
10323,1,35,10,1,12,10,69,38.27402524,-109.4286806
10324,2,33,11,3,15,8,72,38.27402524,-109.4284111
10325,0,30,11,5,13,10,69,38.27402524,-109.4281416
10326,1,34,11,5,12,8,71,38.27402524,-109.4278721
10327,2,37,11,4,13,8,75,38.27402524,-109.4276026
10328,2,37,11,0,15,10,75,38.27402524,-109.4273331
10329,1,36,11,0,13,13,74,38.27402524,-109.4270636
10330,1,35,11,0,12,15,74,38.27402524,-109.4267941
10331,1,33,11,0,12,13,70,38.27402524,-109.4265246
10332,1,31,11,1,14,10,68,38.27402524,-109.4262551
10333,1,33,10,1,15,8,68,38.27402524,-109.4259856
10334,0,33,11,1,19,9,73,38.27402524,-109.4257161
10335,0,33,12,0,14,15,74,38.27402524,-109.4254466
10336,0,35,11,0,10,18,74,38.27402524,-109.4251771
10337,1,41,10,0,11,16,79,38.27402524,-109.4249077
10338,1,45,10,0,11,14,81,38.27402524,-109.4246382
10339,1,42,11,0,11,14,79,38.27402524,-109.4243687
10340,1,35,10,0,9,14,69,38.27402524,-109.4240992
10341,1,32,10,0,7,17,67,38.27402524,-109.4238297
10342,2,28,14,0,5,23,72,38.27402524,-109.4235602
10343,2,34,12,2,9,19,78,38.27402524,-109.4232907
10344,2,42,11,0,12,14,81,38.27402524,-109.4230212
10345,2,45,11,0,14,12,84,38.27402524,-109.4227517
10346,2,45,12,0,15,11,85,38.27402524,-109.4224822
10347,3,44,12,1,17,9,86,38.27402524,-109.4222127
10348,2,45,12,2,17,8,86,38.27402524,-109.4219432
10349,2,43,12,1,16,10,84,38.27402524,-109.4216737
10350,2,41,11,0,14,12,80,38.27402524,-109.4214042
10351,2,40,11,1,14,12,80,38.27402524,-109.4211347
10352,2,43,12,1,16,10,84,38.27402524,-109.4208652
10353,2,43,11,0,13,12,81,38.27402524,-109.4205957
10354,2,44,11,0,14,11,82,38.27402524,-109.4203262
10355,2,43,12,1,15,11,84,38.27402524,-109.4200568
10356,2,40,12,0,14,13,81,38.27402524,-109.4197873
10357,1,38,12,0,12,15,78,38.27402524,-109.4195178
10358,0,33,12,0,10,20,75,38.27402524,-109.4192483
10359,0,29,13,0,9,22,73,38.27402524,-109.4189788
10360,0,28,14,0,10,21,73,38.27402524,-109.4187093
10361,0,29,14,0,12,20,75,38.27402524,-109.4184398
10362,0,34,12,0,16,11,73,38.27402524,-109.4181703
10363,2,35,12,1,17,9,76,38.27402524,-109.4179008
10364,3,34,12,3,17,8,77,38.27402524,-109.4176313
10365,5,32,14,7,16,8,82,38.27402524,-109.4173618
10366,6,33,13,9,15,5,81,38.27402524,-109.4170923
10367,5,37,13,9,15,4,83,38.27402524,-109.4168228
10368,6,37,13,8,15,4,83,38.27402524,-109.4165533
10369,9,38,13,9,16,2,87,38.27402524,-109.4162838
10370,10,39,14,11,16,0,90,38.27402524,-109.4160143
10371,9,42,14,8,17,1,91,38.27402524,-109.4157448
10372,9,42,14,10,17,0,92,38.27402524,-109.4154753
10373,9,42,14,11,17,0,93,38.27402524,-109.4152058
10374,10,42,14,11,16,0,93,38.27402524,-109.4149364
10375,10,42,14,10,16,0,92,38.27402524,-109.4146669
10376,10,42,14,10,17,0,93,38.27402524,-109.4143974
10377,9,44,13,8,18,0,92,38.27402524,-109.4141279
10378,9,45,13,8,16,1,92,38.27402524,-109.4138584
10379,8,44,13,8,15,2,90,38.27402524,-109.4135889
10380,6,49,12,6,17,1,91,38.27402524,-109.4133194
10381,6,50,12,5,17,1,91,38.27402524,-109.4130499
10382,6,50,13,4,18,1,92,38.27402524,-109.4127804
10383,7,48,13,5,18,1,92,38.27402524,-109.4125109
10384,8,46,13,7,18,0,92,38.27402524,-109.4122414
10385,7,46,13,8,18,0,92,38.27402524,-109.4119719
10386,7,44,13,7,18,1,90,38.27402524,-109.4117024
10387,7,45,12,7,18,1,90,38.27402524,-109.4114329
10388,6,45,12,6,17,1,87,38.27402524,-109.4111634
10389,6,45,13,6,17,2,89,38.27402524,-109.4108939
10390,6,45,13,5,19,2,90,38.27402524,-109.4106244
10391,6,45,13,5,18,2,89,38.27402524,-109.4103549
10392,6,45,12,6,17,2,88,38.27402524,-109.4100855
10393,6,45,12,6,18,1,88,38.27402524,-109.409816
10394,5,45,13,7,17,1,88,38.27402524,-109.4095465
10395,6,44,12,8,18,0,88,38.27402524,-109.409277
10396,4,50,12,6,17,1,90,38.27402524,-109.4090075
10397,4,51,11,6,17,1,90,38.27402524,-109.408738
10398,7,44,12,7,18,0,88,38.27402524,-109.4084685
10399,7,44,13,6,16,2,88,38.27402524,-109.408199
10400,10,39,13,11,13,2,88,38.27402524,-109.4079295
10401,17,36,15,15,12,0,95,38.27402524,-109.40766
10402,22,33,15,17,10,0,97,38.27402524,-109.4073905
10403,20,33,15,16,11,0,95,38.27402524,-109.407121
10404,14,35,15,16,12,1,93,38.27402524,-109.4068515
10405,1,31,6,4,7,6,55,38.27402524,-109.3879869
10406,1,34,6,3,9,5,58,38.27402524,-109.3877174
10407,2,38,7,4,10,5,66,38.27402524,-109.3874479
10408,4,40,10,6,9,5,74,38.27402524,-109.3871784
10409,6,36,14,5,9,11,81,38.27402524,-109.3869089
10410,5,36,14,3,10,12,80,38.27402524,-109.3866394
10411,3,32,14,3,7,17,76,38.27402524,-109.3863699
10412,2,29,13,2,6,19,71,38.27402524,-109.3861004
10413,2,32,11,1,8,14,68,38.27402524,-109.3858309
10414,3,40,10,0,12,8,73,38.27402524,-109.3855614
10415,2,39,12,2,12,7,74,38.27402524,-109.3852919
10416,1,39,10,3,10,8,71,38.27402524,-109.3850225
10417,2,40,10,4,10,8,74,38.27402524,-109.384753
10418,1,38,11,1,12,10,73,38.27402524,-109.3844835
10419,1,30,11,2,11,11,66,38.27402524,-109.384214
10420,3,33,12,0,12,14,74,38.27402524,-109.3839445
10421,3,32,12,0,11,14,72,38.27402524,-109.383675
10422,3,31,11,0,11,13,69,38.27402524,-109.3834055
10423,4,33,12,1,13,10,73,38.27402524,-109.383136
10424,4,26,13,4,7,16,70,38.27402524,-109.3828665
10425,3,20,13,2,7,16,61,38.27402524,-109.382597
10426,4,13,10,7,7,10,51,38.27402524,-109.3823275
10427,3,29,8,3,5,6,54,38.27402524,-109.382058
10428,1,40,6,1,6,5,59,38.27402524,-109.3817885
10429,2,40,3,0,7,3,55,38.27402524,-109.381519
10430,3,27,5,2,8,4,49,38.27402524,-109.3812495
10431,5,20,7,4,7,6,49,38.27402524,-109.38098
10432,3,23,12,4,6,13,61,38.27402524,-109.3807105
10433,4,26,13,6,9,9,67,38.27402524,-109.380441
10434,3,29,13,5,8,11,69,38.27402524,-109.3801716
10435,4,29,14,4,8,14,73,38.27402524,-109.3799021
10436,3,27,13,3,7,16,69,38.27402524,-109.3796326
10437,4,31,12,4,9,11,71,38.27402524,-109.3793631
10438,3,33,10,3,11,9,69,38.27402524,-109.3790936
10439,3,34,10,3,11,9,70,38.27402524,-109.3788241
10440,3,27,11,3,9,12,65,38.27402524,-109.3785546
10441,3,20,13,3,6,19,64,38.27402524,-109.3782851
10442,3,23,12,1,5,19,63,38.27402524,-109.3780156
10443,2,26,11,2,6,16,63,38.27402524,-109.3777461
10444,2,22,12,1,5,19,61,38.27402524,-109.3774766
10445,2,22,14,2,5,21,66,38.27402524,-109.3772071
10446,5,30,15,3,8,18,79,38.27402524,-109.3769376
10447,4,33,14,2,10,17,80,38.27402524,-109.3766681
10448,3,32,13,2,10,15,75,38.27402524,-109.3763986
10449,3,32,13,2,9,15,74,38.27402524,-109.3761291
10450,4,29,13,2,8,15,71,38.27402524,-109.3758596
10451,3,26,12,2,7,16,66,38.27402524,-109.3755901
10452,3,24,12,2,5,17,63,38.27402524,-109.3753206
10453,2,26,11,2,6,16,63,38.27402524,-109.3750512
10454,2,29,11,1,8,14,65,38.27402524,-109.3747817
10455,2,28,12,1,9,14,66,38.27402524,-109.3745122
10456,1,27,12,2,10,17,69,38.27402524,-109.3742427
10457,3,39,12,2,16,9,81,38.27402524,-109.3739732
10458,4,32,12,3,14,11,76,38.27402524,-109.3737037
10459,3,25,15,2,8,20,73,38.27402524,-109.3734342
10460,6,28,17,4,9,21,85,38.27402524,-109.3731647
10461,10,22,14,11,7,15,79,38.27402524,-109.3728952
10462,6,20,10,12,16,4,68,38.27402524,-109.3726257
10463,4,23,11,14,17,5,74,38.27402524,-109.3723562
10464,3,25,12,9,10,14,73,38.27402524,-109.3720867
10465,4,32,14,1,10,19,80,38.27402524,-109.3718172
10466,3,30,14,1,11,20,79,38.27402524,-109.3715477
10467,1,28,14,7,15,14,79,38.27402524,-109.3712782
10468,1,26,13,13,20,7,80,38.27402524,-109.3710087
10469,2,19,10,8,19,6,64,38.27402524,-109.3707392
10470,0,11,4,2,10,1,28,38.27402524,-109.3704697
10471,3,14,10,6,11,12,56,38.27402524,-109.3702003
10472,3,20,10,8,13,11,65,38.27402524,-109.3699308
10473,2,27,12,8,15,9,73,38.27402524,-109.3696613
10474,2,31,12,6,13,7,71,38.27402524,-109.3693918
10475,3,36,10,7,11,4,71,38.27402524,-109.3691223
10476,3,42,8,4,9,3,69,38.27402524,-109.3688528
10477,2,39,6,3,8,3,61,38.27402524,-109.3685833
10478,0,36,5,4,8,3,56,38.27402524,-109.3683138
10479,0,34,4,3,8,3,52,38.27402524,-109.3680443
10480,0,34,4,3,8,3,52,38.27402524,-109.3677748
10481,2,44,4,3,8,2,63,38.27402524,-109.3675053
10482,3,34,5,2,8,3,55,38.27402524,-109.3672358
10483,4,24,7,3,9,5,52,38.27402524,-109.3669663
10484,3,28,7,4,8,4,54,38.27402524,-109.3666968
10485,5,29,11,6,14,3,68,38.27402524,-109.3664273
10486,5,26,10,8,13,4,66,38.27402524,-109.3661578
10487,3,18,7,6,13,3,50,38.27402524,-109.3658883
10488,24,23,11,7,7,3,75,38.27402524,-109.3656188
10489,19,24,13,5,9,4,74,38.27402524,-109.3653493
10490,6,20,9,9,9,4,57,38.27402524,-109.3650799
10491,4,19,10,5,10,9,57,38.27402524,-109.3648104
10492,1,17,12,2,4,19,55,38.27402524,-109.3645409
10493,3,23,16,1,3,27,73,38.27402524,-109.3642714
10494,2,21,13,0,3,22,61,38.27402524,-109.3640019
10495,1,21,12,0,3,21,58,38.27402524,-109.3637324
10496,1,20,12,0,2,22,57,38.27402524,-109.3634629
10497,0,20,13,0,2,25,60,38.27402524,-109.3631934
10498,1,22,15,0,3,29,70,38.27402524,-109.3629239
10499,0,20,15,0,2,29,66,38.27402524,-109.3626544
10500,0,19,16,0,2,31,68,38.27402524,-109.3623849
10501,1,21,16,0,2,30,70,38.27402524,-109.3621154
10502,0,23,14,1,1,27,66,38.27402524,-109.3618459
10503,1,25,14,2,3,26,71,38.27402524,-109.3615764
10504,0,20,16,0,1,30,67,38.27402524,-109.3613069
10505,0,17,16,0,1,29,63,38.27402524,-109.3610374
10506,1,18,15,0,2,24,60,38.27402524,-109.3607679
10507,2,19,13,0,2,21,57,38.27402524,-109.3604984
10508,2,19,12,1,4,17,55,38.27402524,-109.360229
10509,1,17,12,1,4,19,54,38.27402524,-109.3599595
10510,2,18,13,1,4,18,56,38.27402524,-109.35969
10511,4,19,14,2,6,17,62,38.27402524,-109.3594205
10512,1,19,16,1,3,23,63,38.27402524,-109.359151
10513,11,24,9,2,0,15,61,38.27402524,-109.3588815
10514,5,19,7,3,4,9,47,38.27402524,-109.358612
10515,3,20,7,3,7,6,46,38.27402524,-109.3583425
10516,4,29,10,5,8,7,63,38.27402524,-109.358073
10517,4,26,11,6,7,8,62,38.27402524,-109.3578035
10518,3,36,13,5,8,13,78,38.27402524,-109.357534
10519,6,25,16,4,5,22,78,38.27402524,-109.3572645
10520,6,21,17,0,5,30,79,38.27402524,-109.356995
10521,1,25,18,0,11,26,81,38.27402524,-109.3567255
10522,2,26,15,0,8,24,75,38.27402524,-109.356456
10523,4,33,14,6,5,18,80,38.27402524,-109.3561865
10524,5,36,11,0,12,12,76,38.27402524,-109.355917
10525,6,31,14,3,17,6,77,38.27402524,-109.3556475
10526,2,28,13,10,17,7,77,38.27402524,-109.355378
10527,7,18,11,13,21,1,71,38.27402524,-109.3551086
10528,2,15,12,14,15,4,62,38.27402524,-109.3548391
10529,1,14,14,8,6,22,65,38.27402524,-109.3545696
10530,0,21,19,1,4,29,74,38.27402524,-109.3543001
10531,0,22,19,0,4,31,76,38.27402524,-109.3540306
10532,0,22,17,0,4,27,70,38.27402524,-109.3537611
10533,0,15,13,2,4,24,58,38.27402524,-109.3534916
10534,1,10,12,4,4,20,51,38.27402524,-109.3532221
10535,5,10,12,3,4,17,51,38.27402524,-109.3529526
10536,4,9,12,4,4,17,50,38.27402524,-109.3526831
10537,3,7,13,5,4,19,51,38.27402524,-109.3524136
10538,2,7,13,5,4,20,51,38.27402524,-109.3521441
10539,2,9,13,5,4,19,52,38.27402524,-109.3518746
10540,2,14,13,4,4,20,57,38.27402524,-109.3516051
10541,2,18,14,0,2,26,62,38.27402524,-109.3513356
10542,3,21,14,2,4,25,69,38.27402524,-109.3510661
10543,2,24,13,5,8,20,72,38.27402524,-109.3507966
10544,2,18,13,8,8,19,68,38.27402524,-109.3505271
10545,2,23,15,5,7,24,76,38.27402524,-109.3502577
10546,1,21,19,5,5,29,80,38.27402524,-109.3499882
10547,0,20,21,4,7,30,82,38.27402524,-109.3497187
10548,2,21,22,3,3,32,83,38.27402524,-109.3494492
10549,4,19,21,1,2,31,78,38.27402524,-109.3491797
10550,4,19,20,2,3,30,78,38.27402524,-109.3489102
10551,1,23,20,3,7,28,82,38.27402524,-109.3486407
10552,1,23,20,3,8,28,83,38.27402524,-109.3483712
10553,1,25,20,3,7,28,84,38.27402524,-109.3481017
10554,0,24,19,3,8,28,82,38.27402524,-109.3478322
10555,0,24,19,3,10,25,81,38.27402524,-109.3475627
10556,1,24,19,2,10,26,82,38.27402524,-109.3472932
10557,0,22,19,0,6,31,78,38.27402524,-109.3470237
10558,0,23,18,0,3,30,74,38.27402524,-109.3467542
10559,1,23,14,1,4,19,62,38.27402524,-109.3464847
10560,2,20,13,6,6,15,62,38.27402524,-109.3462152
10561,1,18,15,3,4,23,64,38.27402524,-109.3459457
10562,1,21,20,3,7,32,84,38.27402524,-109.3456762
10563,4,23,18,5,8,27,85,38.27402524,-109.3454068
10564,6,29,17,7,9,19,87,38.27402524,-109.3451373
10565,5,29,16,9,11,15,85,38.27402524,-109.3448678
10566,5,28,15,8,11,16,83,38.27402524,-109.3445983
10567,7,28,15,9,9,16,84,38.27402524,-109.3443288
10568,10,27,14,13,10,10,84,38.27402524,-109.3440593
10569,12,29,14,16,9,7,87,38.27402524,-109.3437898
10570,12,32,14,17,10,4,89,38.27402524,-109.3435203
10571,11,33,14,17,10,4,89,38.27402524,-109.3432508
10572,9,34,14,18,10,4,89,38.27402524,-109.3429813
10573,7,35,14,14,14,5,89,38.27402524,-109.3427118
10574,7,32,14,16,13,4,86,38.27402524,-109.3424423
10575,7,30,14,17,10,5,83,38.27402524,-109.3421728
10576,8,31,14,17,9,5,84,38.27402524,-109.3419033
10577,10,35,16,16,7,6,90,38.27402524,-109.3416338
10578,12,33,16,17,8,4,90,38.27402524,-109.3413643
10579,4,54,12,4,17,2,93,38.27375574248896,-109.4354179
10580,4,53,12,4,16,2,91,38.27375574248896,-109.4351484
10581,4,53,12,5,16,2,92,38.27375574248896,-109.434879
10582,3,51,12,6,15,2,89,38.27375574248896,-109.4346095
10583,3,50,12,5,13,3,86,38.27375574248896,-109.43434
10584,3,48,11,4,13,4,83,38.27375574248896,-109.4340705
10585,3,47,10,2,13,6,81,38.27375574248896,-109.433801
10586,3,44,10,0,12,9,78,38.27375574248896,-109.4335315
10587,4,42,11,0,8,12,77,38.27375574248896,-109.433262
10588,3,41,11,0,10,10,75,38.27375574248896,-109.4329925
10589,3,42,11,3,11,6,76,38.27375574248896,-109.432723
10590,3,45,11,4,10,5,78,38.27375574248896,-109.4324535
10591,2,47,9,0,11,7,76,38.27375574248896,-109.432184
10592,4,44,10,4,10,5,77,38.27375574248896,-109.4319145
10593,4,42,10,6,10,4,76,38.27375574248896,-109.431645
10594,3,39,10,5,10,4,71,38.27375574248896,-109.4313755
10595,3,35,10,5,9,4,66,38.27375574248896,-109.431106
10596,5,29,10,7,11,4,66,38.27375574248896,-109.4308365
10597,2,31,10,4,11,9,67,38.27375574248896,-109.430567
10598,1,28,11,2,10,14,66,38.27375574248896,-109.4302975
10599,1,31,11,2,11,14,70,38.27375574248896,-109.430028
10600,2,36,10,3,12,10,73,38.27375574248896,-109.4297586
10601,2,37,11,2,14,9,75,38.27375574248896,-109.4294891
10602,1,40,10,0,14,10,75,38.27375574248896,-109.4292196
10603,1,40,9,0,12,10,72,38.27375574248896,-109.4289501
10604,1,35,10,0,13,11,70,38.27375574248896,-109.4286806
10605,2,32,11,8,16,5,74,38.27375574248896,-109.4284111
10606,1,29,10,4,12,10,66,38.27375574248896,-109.4281416
10607,1,34,10,3,11,8,67,38.27375574248896,-109.4278721
10608,1,41,9,4,11,5,71,38.27375574248896,-109.4276026
10609,2,37,11,2,14,6,72,38.27375574248896,-109.4273331
10610,1,37,12,0,12,14,76,38.27375574248896,-109.4270636
10611,0,35,11,0,12,16,74,38.27375574248896,-109.4267941
10612,0,32,11,1,14,12,70,38.27375574248896,-109.4265246
10613,1,33,11,4,15,7,71,38.27375574248896,-109.4262551
10614,2,32,11,3,14,7,69,38.27375574248896,-109.4259856
10615,0,30,10,0,12,11,63,38.27375574248896,-109.4257161
10616,0,33,10,0,10,12,65,38.27375574248896,-109.4254466
10617,0,37,10,0,11,11,69,38.27375574248896,-109.4251771
10618,1,38,11,0,13,11,74,38.27375574248896,-109.4249077
10619,1,40,11,0,11,13,76,38.27375574248896,-109.4246382
10620,1,38,10,0,10,14,73,38.27375574248896,-109.4243687
10621,1,36,10,0,10,13,70,38.27375574248896,-109.4240992
10622,1,35,11,0,10,14,71,38.27375574248896,-109.4238297
10623,1,31,12,0,6,20,70,38.27375574248896,-109.4235602
10624,2,37,12,0,9,18,78,38.27375574248896,-109.4232907
10625,2,43,11,0,13,13,82,38.27375574248896,-109.4230212
10626,3,45,12,1,14,10,85,38.27375574248896,-109.4227517
10627,3,45,12,2,16,8,86,38.27375574248896,-109.4224822
10628,4,44,13,2,18,6,87,38.27375574248896,-109.4222127
10629,3,46,13,2,18,5,87,38.27375574248896,-109.4219432
10630,3,45,12,2,17,7,86,38.27375574248896,-109.4216737
10631,2,43,11,1,16,10,83,38.27375574248896,-109.4214042
10632,2,42,11,0,14,11,80,38.27375574248896,-109.4211347
10633,2,42,11,0,15,10,80,38.27375574248896,-109.4208652
10634,2,39,11,0,13,13,78,38.27375574248896,-109.4205957
10635,2,39,11,0,13,13,78,38.27375574248896,-109.4203262
10636,2,39,11,0,13,13,78,38.27375574248896,-109.4200568
10637,1,38,11,0,12,14,76,38.27375574248896,-109.4197873
10638,1,37,11,0,12,14,75,38.27375574248896,-109.4195178
10639,1,34,12,0,10,18,75,38.27375574248896,-109.4192483
10640,0,33,13,0,10,20,76,38.27375574248896,-109.4189788
10641,0,32,14,0,11,21,78,38.27375574248896,-109.4187093
10642,0,31,13,0,13,18,75,38.27375574248896,-109.4184398
10643,1,36,12,3,17,9,78,38.27375574248896,-109.4181703
10644,1,37,11,2,16,9,76,38.27375574248896,-109.4179008
10645,4,38,12,5,16,5,80,38.27375574248896,-109.4176313
10646,7,40,13,9,16,2,87,38.27375574248896,-109.4173618
10647,6,41,13,9,16,1,86,38.27375574248896,-109.4170923
10648,6,42,14,10,17,1,90,38.27375574248896,-109.4168228
10649,7,43,13,10,17,1,91,38.27375574248896,-109.4165533
10650,9,43,13,10,17,0,92,38.27375574248896,-109.4162838
10651,9,42,13,11,17,0,92,38.27375574248896,-109.4160143
10652,7,43,13,8,18,1,90,38.27375574248896,-109.4157448
10653,9,42,14,11,17,0,93,38.27375574248896,-109.4154753
10654,11,41,14,12,15,0,93,38.27375574248896,-109.4152058
10655,11,39,15,13,15,0,93,38.27375574248896,-109.4149364
10656,11,37,15,13,16,0,92,38.27375574248896,-109.4146669
10657,11,40,14,12,16,0,93,38.27375574248896,-109.4143974
10658,11,42,14,9,17,0,93,38.27375574248896,-109.4141279
10659,10,42,14,9,16,1,92,38.27375574248896,-109.4138584
10660,10,42,14,9,14,1,90,38.27375574248896,-109.4135889
10661,10,45,14,8,16,1,94,38.27375574248896,-109.4133194
10662,10,46,13,8,16,1,94,38.27375574248896,-109.4130499
10663,10,46,13,8,16,1,94,38.27375574248896,-109.4127804
10664,9,46,13,7,17,1,93,38.27375574248896,-109.4125109
10665,7,46,13,7,18,0,91,38.27375574248896,-109.4122414
10666,8,46,13,7,17,1,92,38.27375574248896,-109.4119719
10667,7,47,13,7,17,1,92,38.27375574248896,-109.4117024
10668,6,46,12,6,18,1,89,38.27375574248896,-109.4114329
10669,5,46,12,6,18,1,88,38.27375574248896,-109.4111634
10670,5,47,13,5,17,2,89,38.27375574248896,-109.4108939
10671,5,47,12,5,17,2,88,38.27375574248896,-109.4106244
10672,5,48,12,5,18,1,89,38.27375574248896,-109.4103549
10673,6,47,13,6,18,1,91,38.27375574248896,-109.4100855
10674,6,45,13,7,18,1,90,38.27375574248896,-109.409816
10675,6,44,13,6,18,1,88,38.27375574248896,-109.4095465
10676,5,48,12,6,18,0,89,38.27375574248896,-109.409277
10677,4,51,11,6,17,0,89,38.27375574248896,-109.4090075
10678,5,50,12,6,17,0,90,38.27375574248896,-109.408738
10679,7,43,13,8,18,0,89,38.27375574248896,-109.4084685
10680,7,44,13,8,18,1,91,38.27375574248896,-109.408199
10681,10,41,13,8,14,2,88,38.27375574248896,-109.4079295
10682,13,39,14,12,12,1,91,38.27375574248896,-109.40766
10683,16,37,15,14,12,0,94,38.27375574248896,-109.4073905
10684,14,36,15,16,12,1,94,38.27375574248896,-109.407121
10685,11,36,14,16,12,1,90,38.27375574248896,-109.4068515
10686,2,35,6,3,8,5,59,38.27375574248896,-109.3879869
10687,1,36,7,3,9,5,61,38.27375574248896,-109.3877174
10688,1,39,8,3,10,6,67,38.27375574248896,-109.3874479
10689,6,30,12,3,5,14,70,38.27375574248896,-109.3871784
10690,7,31,15,5,7,15,80,38.27375574248896,-109.3869089
10691,4,27,15,4,5,19,74,38.27375574248896,-109.3866394
10692,3,26,14,3,5,20,71,38.27375574248896,-109.3863699
10693,2,26,13,1,4,22,68,38.27375574248896,-109.3861004
10694,2,28,13,0,4,21,68,38.27375574248896,-109.3858309
10695,4,34,11,0,8,13,70,38.27375574248896,-109.3855614
10696,1,41,11,0,11,11,75,38.27375574248896,-109.3852919
10697,3,38,11,1,9,13,75,38.27375574248896,-109.3850225
10698,4,34,13,2,8,15,76,38.27375574248896,-109.384753
10699,2,31,13,1,7,18,72,38.27375574248896,-109.3844835
10700,3,34,12,0,11,13,73,38.27375574248896,-109.384214
10701,3,31,13,0,10,15,72,38.27375574248896,-109.3839445
10702,2,30,12,0,9,15,68,38.27375574248896,-109.383675
10703,2,34,12,1,11,10,70,38.27375574248896,-109.3834055
10704,3,41,11,2,12,9,78,38.27375574248896,-109.383136
10705,5,31,12,3,10,11,72,38.27375574248896,-109.3828665
10706,4,21,12,5,6,15,63,38.27375574248896,-109.382597
10707,6,12,11,7,7,10,53,38.27375574248896,-109.3823275
10708,5,39,7,4,2,6,63,38.27375574248896,-109.382058
10709,3,46,4,3,6,2,64,38.27375574248896,-109.3817885
10710,1,38,3,0,7,3,52,38.27375574248896,-109.381519
10711,2,24,5,2,9,5,47,38.27375574248896,-109.3812495
10712,4,23,8,5,7,7,54,38.27375574248896,-109.38098
10713,3,18,14,4,5,18,62,38.27375574248896,-109.3807105
10714,4,16,16,4,5,20,65,38.27375574248896,-109.380441
10715,3,18,15,4,5,20,65,38.27375574248896,-109.3801716
10716,3,19,14,4,5,20,65,38.27375574248896,-109.3799021
10717,2,19,14,4,5,21,65,38.27375574248896,-109.3796326
10718,2,19,14,4,5,20,64,38.27375574248896,-109.3793631
10719,3,26,11,3,7,15,65,38.27375574248896,-109.3790936
10720,3,33,10,2,10,9,67,38.27375574248896,-109.3788241
10721,4,32,11,2,10,10,69,38.27375574248896,-109.3785546
10722,3,25,12,2,6,17,65,38.27375574248896,-109.3782851
10723,2,26,12,1,6,17,64,38.27375574248896,-109.3780156
10724,2,28,11,1,8,14,64,38.27375574248896,-109.3777461
10725,2,26,11,2,9,13,63,38.27375574248896,-109.3774766
10726,3,26,12,3,9,12,65,38.27375574248896,-109.3772071
10727,3,25,11,3,9,13,64,38.27375574248896,-109.3769376
10728,4,33,13,1,11,14,76,38.27375574248896,-109.3766681
10729,3,33,13,2,9,16,76,38.27375574248896,-109.3763986
10730,3,28,13,2,6,19,71,38.27375574248896,-109.3761291
10731,4,26,13,1,5,18,67,38.27375574248896,-109.3758596
10732,2,30,11,2,7,14,66,38.27375574248896,-109.3755901
10733,2,30,11,3,10,11,67,38.27375574248896,-109.3753206
10734,3,23,12,3,7,16,64,38.27375574248896,-109.3750512
10735,2,18,15,3,4,23,65,38.27375574248896,-109.3747817
10736,2,23,17,2,8,25,77,38.27375574248896,-109.3745122
10737,2,28,15,3,12,23,83,38.27375574248896,-109.3742427
10738,1,30,14,1,10,21,77,38.27375574248896,-109.3739732
10739,4,30,13,0,7,19,73,38.27375574248896,-109.3737037
10740,8,27,15,3,7,17,77,38.27375574248896,-109.3734342
10741,8,22,14,7,8,15,74,38.27375574248896,-109.3731647
10742,6,22,9,11,12,5,65,38.27375574248896,-109.3728952
10743,3,24,7,16,12,1,63,38.27375574248896,-109.3726257
10744,4,26,9,13,19,3,74,38.27375574248896,-109.3723562
10745,3,26,12,7,11,13,72,38.27375574248896,-109.3720867
10746,4,34,12,2,14,11,77,38.27375574248896,-109.3718172
10747,2,28,13,8,13,11,75,38.27375574248896,-109.3715477
10748,3,30,13,12,22,2,82,38.27375574248896,-109.3712782
10749,3,20,12,11,20,2,68,38.27375574248896,-109.3710087
10750,3,13,7,8,12,3,46,38.27375574248896,-109.3707392
10751,4,14,9,16,12,2,57,38.27375574248896,-109.3704697
10752,6,27,8,11,15,2,69,38.27375574248896,-109.3702003
10753,6,35,9,8,16,3,77,38.27375574248896,-109.3699308
10754,4,42,10,7,12,5,80,38.27375574248896,-109.3696613
10755,4,44,9,4,9,4,74,38.27375574248896,-109.3693918
10756,2,41,7,4,10,3,67,38.27375574248896,-109.3691223
10757,0,36,5,5,9,2,57,38.27375574248896,-109.3688528
10758,0,33,4,3,8,3,51,38.27375574248896,-109.3685833
10759,0,32,4,1,8,3,48,38.27375574248896,-109.3683138
10760,2,32,5,0,6,4,49,38.27375574248896,-109.3680443
10761,2,27,6,2,8,5,50,38.27375574248896,-109.3677748
10762,3,23,7,2,9,6,50,38.27375574248896,-109.3675053
10763,2,24,9,4,8,7,54,38.27375574248896,-109.3672358
10764,2,29,10,4,8,10,63,38.27375574248896,-109.3669663
10765,2,30,11,5,12,10,70,38.27375574248896,-109.3666968
10766,4,24,12,5,12,12,69,38.27375574248896,-109.3664273
10767,2,26,13,6,16,13,76,38.27375574248896,-109.3661578
10768,7,25,15,9,10,11,77,38.27375574248896,-109.3658883
10769,10,22,14,9,11,7,73,38.27375574248896,-109.3656188
10770,8,17,13,11,15,4,68,38.27375574248896,-109.3653493
10771,5,24,9,12,10,2,62,38.27375574248896,-109.3650799
10772,4,24,9,7,8,5,57,38.27375574248896,-109.3648104
10773,2,18,12,5,7,14,58,38.27375574248896,-109.3645409
10774,3,20,16,0,3,27,69,38.27375574248896,-109.3642714
10775,1,20,15,0,3,28,67,38.27375574248896,-109.3640019
10776,0,20,14,0,2,25,61,38.27375574248896,-109.3637324
10777,0,21,13,0,2,24,60,38.27375574248896,-109.3634629
10778,0,21,13,0,3,25,62,38.27375574248896,-109.3631934
10779,1,21,16,0,2,30,70,38.27375574248896,-109.3629239
10780,0,20,15,0,1,28,64,38.27375574248896,-109.3626544
10781,1,19,15,0,1,28,64,38.27375574248896,-109.3623849
10782,1,20,15,0,1,28,65,38.27375574248896,-109.3621154
10783,0,23,15,1,2,27,68,38.27375574248896,-109.3618459
10784,1,24,14,1,2,26,68,38.27375574248896,-109.3615764
10785,0,20,15,0,1,28,64,38.27375574248896,-109.3613069
10786,0,19,15,0,1,27,62,38.27375574248896,-109.3610374
10787,1,18,14,0,1,26,60,38.27375574248896,-109.3607679
10788,1,20,15,0,1,26,63,38.27375574248896,-109.3604984
10789,2,18,15,0,1,24,60,38.27375574248896,-109.360229
10790,1,16,13,0,3,21,54,38.27375574248896,-109.3599595
10791,3,17,12,4,5,14,55,38.27375574248896,-109.35969
10792,8,19,13,4,7,10,61,38.27375574248896,-109.3594205
10793,4,19,13,4,5,14,59,38.27375574248896,-109.359151
10794,10,30,7,5,3,6,61,38.27375574248896,-109.3588815
10795,6,19,7,2,5,9,48,38.27375574248896,-109.358612
10796,9,21,8,4,6,7,55,38.27375574248896,-109.3583425
10797,7,24,13,3,5,13,65,38.27375574248896,-109.358073
10798,3,19,16,1,3,24,66,38.27375574248896,-109.3578035
10799,2,29,16,2,5,23,77,38.27375574248896,-109.357534
10800,2,28,17,1,5,28,81,38.27375574248896,-109.3572645
10801,3,21,18,2,7,29,80,38.27375574248896,-109.356995
10802,2,22,18,2,9,29,82,38.27375574248896,-109.3567255
10803,7,25,16,0,6,26,80,38.27375574248896,-109.356456
10804,7,25,14,6,6,22,80,38.27375574248896,-109.3561865
10805,5,33,14,6,11,15,84,38.27375574248896,-109.355917
10806,5,30,12,5,18,4,74,38.27375574248896,-109.3556475
10807,0,25,11,6,15,8,65,38.27375574248896,-109.355378
10808,7,19,10,19,17,0,72,38.27375574248896,-109.3551086
10809,4,16,10,15,17,2,64,38.27375574248896,-109.3548391
10810,2,17,13,8,8,20,68,38.27375574248896,-109.3545696
10811,0,19,18,0,4,31,72,38.27375574248896,-109.3543001
10812,0,20,16,0,3,29,68,38.27375574248896,-109.3540306
10813,0,17,13,0,3,23,56,38.27375574248896,-109.3537611
10814,3,21,13,4,4,17,62,38.27375574248896,-109.3534916
10815,6,20,13,4,5,16,64,38.27375574248896,-109.3532221
10816,3,15,12,6,5,16,57,38.27375574248896,-109.3529526
10817,3,14,11,8,7,11,54,38.27375574248896,-109.3526831
10818,5,9,11,7,6,12,50,38.27375574248896,-109.3524136
10819,6,7,11,6,6,12,48,38.27375574248896,-109.3521441
10820,5,8,12,7,6,13,51,38.27375574248896,-109.3518746
10821,6,8,12,9,8,12,55,38.27375574248896,-109.3516051
10822,2,12,13,5,4,23,59,38.27375574248896,-109.3513356
10823,2,21,15,3,5,26,72,38.27375574248896,-109.3510661
10824,2,21,14,8,7,25,77,38.27375574248896,-109.3507966
10825,3,17,13,8,8,23,72,38.27375574248896,-109.3505271
10826,4,17,14,12,6,24,77,38.27375574248896,-109.3502577
10827,0,17,18,2,2,33,72,38.27375574248896,-109.3499882
10828,1,16,19,2,4,31,73,38.27375574248896,-109.3497187
10829,2,16,19,3,5,30,75,38.27375574248896,-109.3494492
10830,3,17,18,6,3,27,74,38.27375574248896,-109.3491797
10831,5,19,19,7,4,24,78,38.27375574248896,-109.3489102
10832,4,20,19,6,4,24,77,38.27375574248896,-109.3486407
10833,1,21,19,1,6,29,77,38.27375574248896,-109.3483712
10834,1,22,20,1,7,31,82,38.27375574248896,-109.3481017
10835,1,24,20,2,7,31,85,38.27375574248896,-109.3478322
10836,0,27,19,1,7,30,84,38.27375574248896,-109.3475627
10837,0,24,19,1,7,30,81,38.27375574248896,-109.3472932
10838,1,23,20,1,7,30,82,38.27375574248896,-109.3470237
10839,2,23,20,1,5,30,81,38.27375574248896,-109.3467542
10840,1,21,18,0,3,29,72,38.27375574248896,-109.3464847
10841,1,16,14,2,3,20,56,38.27375574248896,-109.3462152
10842,1,15,14,4,3,20,57,38.27375574248896,-109.3459457
10843,2,16,17,3,4,26,68,38.27375574248896,-109.3456762
10844,2,20,19,1,6,34,82,38.27375574248896,-109.3454068
10845,2,23,18,0,4,29,76,38.27375574248896,-109.3451373
10846,1,23,17,2,6,27,76,38.27375574248896,-109.3448678
10847,2,22,17,3,7,27,78,38.27375574248896,-109.3445983
10848,8,23,16,7,8,23,85,38.27375574248896,-109.3443288
10849,14,23,15,16,6,12,86,38.27375574248896,-109.3440593
10850,14,28,14,23,6,4,89,38.27375574248896,-109.3437898
10851,14,30,14,23,6,3,90,38.27375574248896,-109.3435203
10852,12,31,15,23,7,3,91,38.27375574248896,-109.3432508
10853,11,30,14,23,10,2,90,38.27375574248896,-109.3429813
10854,8,32,14,14,14,6,88,38.27375574248896,-109.3427118
10855,6,30,15,13,12,8,84,38.27375574248896,-109.3424423
10856,6,30,14,13,11,7,81,38.27375574248896,-109.3421728
10857,6,32,14,14,10,5,81,38.27375574248896,-109.3419033
10858,9,33,15,15,9,5,86,38.27375574248896,-109.3416338
10859,12,33,16,17,8,4,90,38.27375574248896,-109.3413643
10860,3,50,12,5,17,3,90,38.27348624790372,-109.4354179
10861,3,50,12,4,16,3,88,38.27348624790372,-109.4351484
10862,4,51,12,4,15,3,89,38.27348624790372,-109.434879
10863,4,52,12,4,16,2,90,38.27348624790372,-109.4346095
10864,4,51,12,4,16,2,89,38.27348624790372,-109.43434
10865,3,49,12,2,17,5,88,38.27348624790372,-109.4340705
10866,3,45,11,0,16,8,83,38.27348624790372,-109.433801
10867,3,43,11,0,14,11,82,38.27348624790372,-109.4335315
10868,2,40,11,0,11,13,77,38.27348624790372,-109.433262
10869,3,38,12,0,11,12,76,38.27348624790372,-109.4329925
10870,3,44,11,1,11,7,77,38.27348624790372,-109.432723
10871,6,46,10,5,9,2,78,38.27348624790372,-109.4324535
10872,7,42,9,7,10,2,77,38.27348624790372,-109.432184
10873,3,46,10,2,10,6,77,38.27348624790372,-109.4319145
10874,3,44,10,3,10,5,75,38.27348624790372,-109.431645
10875,3,39,10,3,9,5,69,38.27348624790372,-109.4313755
10876,3,35,9,3,8,6,64,38.27348624790372,-109.431106
10877,6,29,10,6,10,4,65,38.27348624790372,-109.4308365
10878,2,35,11,5,13,8,74,38.27348624790372,-109.430567
10879,1,33,12,4,13,13,76,38.27348624790372,-109.4302975
10880,0,31,12,8,18,10,79,38.27348624790372,-109.430028
10881,1,31,11,8,18,8,77,38.27348624790372,-109.4297586
10882,2,37,11,0,12,13,75,38.27348624790372,-109.4294891
10883,0,36,11,0,13,14,74,38.27348624790372,-109.4292196
10884,0,35,11,0,13,14,73,38.27348624790372,-109.4289501
10885,0,33,12,1,13,14,73,38.27348624790372,-109.4286806
10886,0,31,11,3,17,12,74,38.27348624790372,-109.4284111
10887,1,30,11,2,13,11,68,38.27348624790372,-109.4281416
10888,0,34,9,0,11,10,64,38.27348624790372,-109.4278721
10889,0,39,9,1,12,7,68,38.27348624790372,-109.4276026
10890,1,34,11,4,15,7,72,38.27348624790372,-109.4273331
10891,0,32,12,1,13,15,73,38.27348624790372,-109.4270636
10892,0,30,11,2,13,12,68,38.27348624790372,-109.4267941
10893,0,32,11,1,13,12,69,38.27348624790372,-109.4265246
10894,0,33,11,0,14,12,70,38.27348624790372,-109.4262551
10895,0,32,11,1,14,11,69,38.27348624790372,-109.4259856
10896,0,30,10,5,9,10,64,38.27348624790372,-109.4257161
10897,1,39,9,5,8,6,68,38.27348624790372,-109.4254466
10898,1,41,8,4,9,6,69,38.27348624790372,-109.4251771
10899,1,39,9,2,10,7,68,38.27348624790372,-109.4249077
10900,1,38,9,2,10,7,67,38.27348624790372,-109.4246382
10901,1,38,10,1,11,9,70,38.27348624790372,-109.4243687
10902,1,39,11,0,11,10,72,38.27348624790372,-109.4240992
10903,1,37,11,0,11,12,72,38.27348624790372,-109.4238297
10904,1,34,11,0,10,16,72,38.27348624790372,-109.4235602
10905,2,40,11,0,11,16,80,38.27348624790372,-109.4232907
10906,3,42,12,1,14,10,82,38.27348624790372,-109.4230212
10907,4,43,12,4,16,7,86,38.27348624790372,-109.4227517
10908,4,44,12,5,17,5,87,38.27348624790372,-109.4224822
10909,5,45,13,4,19,4,90,38.27348624790372,-109.4222127
10910,4,47,12,3,19,4,89,38.27348624790372,-109.4219432
10911,3,45,12,3,18,6,87,38.27348624790372,-109.4216737
10912,3,44,12,2,17,8,86,38.27348624790372,-109.4214042
10913,2,40,12,0,15,11,80,38.27348624790372,-109.4211347
10914,2,36,12,0,12,14,76,38.27348624790372,-109.4208652
10915,1,34,12,0,9,18,74,38.27348624790372,-109.4205957
10916,1,34,12,0,10,19,76,38.27348624790372,-109.4203262
10917,1,33,12,0,10,17,73,38.27348624790372,-109.4200568
10918,1,32,12,0,10,18,73,38.27348624790372,-109.4197873
10919,0,32,12,0,9,20,73,38.27348624790372,-109.4195178
10920,1,30,13,0,7,22,73,38.27348624790372,-109.4192483
10921,0,29,14,0,9,22,74,38.27348624790372,-109.4189788
10922,0,35,13,0,15,16,79,38.27348624790372,-109.4187093
10923,1,37,12,0,17,12,79,38.27348624790372,-109.4184398
10924,3,42,12,5,19,4,85,38.27348624790372,-109.4181703
10925,5,45,13,6,19,2,90,38.27348624790372,-109.4179008
10926,6,45,13,9,18,1,92,38.27348624790372,-109.4176313
10927,7,44,13,10,17,0,91,38.27348624790372,-109.4173618
10928,6,45,13,8,17,1,90,38.27348624790372,-109.4170923
10929,6,45,12,7,18,1,89,38.27348624790372,-109.4168228
10930,7,44,13,7,18,1,90,38.27348624790372,-109.4165533
10931,7,43,13,7,18,1,89,38.27348624790372,-109.4162838
10932,7,43,13,8,18,1,90,38.27348624790372,-109.4160143
10933,8,44,13,7,17,1,90,38.27348624790372,-109.4157448
10934,8,44,13,8,16,1,90,38.27348624790372,-109.4154753
10935,9,43,13,9,16,1,91,38.27348624790372,-109.4152058
10936,11,40,14,11,15,0,91,38.27348624790372,-109.4149364
10937,13,36,14,13,14,0,90,38.27348624790372,-109.4146669
10938,15,38,14,11,14,0,92,38.27348624790372,-109.4143974
10939,11,43,13,8,16,0,91,38.27348624790372,-109.4141279
10940,9,45,13,7,16,1,91,38.27348624790372,-109.4138584
10941,8,45,14,7,16,1,91,38.27348624790372,-109.4135889
10942,7,47,13,7,18,1,93,38.27348624790372,-109.4133194
10943,7,49,13,6,18,1,94,38.27348624790372,-109.4130499
10944,7,48,13,6,18,0,92,38.27348624790372,-109.4127804
10945,8,46,13,7,17,0,91,38.27348624790372,-109.4125109
10946,8,46,13,8,17,0,92,38.27348624790372,-109.4122414
10947,7,48,13,7,18,0,93,38.27348624790372,-109.4119719
10948,6,49,13,6,18,1,93,38.27348624790372,-109.4117024
10949,5,49,13,6,18,1,92,38.27348624790372,-109.4114329
10950,5,46,13,6,18,2,90,38.27348624790372,-109.4111634
10951,5,44,13,5,17,3,87,38.27348624790372,-109.4108939
10952,5,47,12,5,17,2,88,38.27348624790372,-109.4106244
10953,5,48,12,6,18,1,90,38.27348624790372,-109.4103549
10954,6,46,13,6,18,1,90,38.27348624790372,-109.4100855
10955,6,45,13,6,19,1,90,38.27348624790372,-109.409816
10956,5,47,12,6,18,0,88,38.27348624790372,-109.4095465
10957,6,51,11,6,16,0,90,38.27348624790372,-109.409277
10958,5,49,12,6,17,0,89,38.27348624790372,-109.4090075
10959,5,47,13,7,18,0,90,38.27348624790372,-109.408738
10960,7,44,13,8,18,0,90,38.27348624790372,-109.4084685
10961,7,44,13,7,17,1,89,38.27348624790372,-109.408199
10962,7,44,13,6,16,2,88,38.27348624790372,-109.4079295
10963,7,43,13,7,15,3,88,38.27348624790372,-109.40766
10964,6,41,13,9,13,3,85,38.27348624790372,-109.4073905
10965,6,39,13,11,13,2,84,38.27348624790372,-109.407121
10966,7,40,14,13,13,2,89,38.27348624790372,-109.4068515
10967,1,47,7,3,9,3,70,38.27348624790372,-109.3879869
10968,1,37,7,3,10,6,64,38.27348624790372,-109.3877174
10969,0,38,8,2,9,7,64,38.27348624790372,-109.3874479
10970,3,37,10,1,8,12,71,38.27348624790372,-109.3871784
10971,4,29,14,3,7,18,75,38.27348624790372,-109.3869089
10972,3,24,16,3,4,23,73,38.27348624790372,-109.3866394
10973,1,21,16,1,3,27,69,38.27348624790372,-109.3863699
10974,1,23,15,0,3,27,69,38.27348624790372,-109.3861004
10975,2,26,13,0,4,24,69,38.27348624790372,-109.3858309
10976,1,31,11,0,7,17,67,38.27348624790372,-109.3855614
10977,2,31,12,1,8,17,71,38.27348624790372,-109.3852919
10978,3,28,14,1,6,20,72,38.27348624790372,-109.3850225
10979,3,28,14,0,5,22,72,38.27348624790372,-109.384753
10980,1,31,12,0,7,17,68,38.27348624790372,-109.3844835
10981,3,34,11,0,11,12,71,38.27348624790372,-109.384214
10982,2,32,12,0,10,13,69,38.27348624790372,-109.3839445
10983,3,34,11,0,12,11,71,38.27348624790372,-109.383675
10984,3,40,11,0,11,10,75,38.27348624790372,-109.3834055
10985,3,38,11,1,10,10,73,38.27348624790372,-109.383136
10986,4,31,11,3,8,12,69,38.27348624790372,-109.3828665
10987,5,25,12,4,7,12,65,38.27348624790372,-109.382597
10988,3,17,11,5,6,12,54,38.27348624790372,-109.3823275
10989,2,35,7,6,3,8,61,38.27348624790372,-109.382058
10990,3,41,5,4,6,3,62,38.27348624790372,-109.3817885
10991,1,37,4,1,8,3,54,38.27348624790372,-109.381519
10992,2,26,5,2,9,5,49,38.27348624790372,-109.3812495
10993,5,24,8,4,8,7,56,38.27348624790372,-109.38098
10994,7,23,16,4,6,16,72,38.27348624790372,-109.3807105
10995,5,20,18,3,4,24,74,38.27348624790372,-109.380441
10996,3,21,17,2,3,25,71,38.27348624790372,-109.3801716
10997,3,22,15,2,5,22,69,38.27348624790372,-109.3799021
10998,3,23,14,2,6,20,68,38.27348624790372,-109.3796326
10999,3,21,15,2,4,23,68,38.27348624790372,-109.3793631
11000,2,23,12,1,4,20,62,38.27348624790372,-109.3790936
11001,2,30,10,2,8,12,64,38.27348624790372,-109.3788241
11002,2,32,10,3,10,10,67,38.27348624790372,-109.3785546
11003,3,31,10,2,8,12,66,38.27348624790372,-109.3782851
11004,2,24,11,2,6,17,62,38.27348624790372,-109.3780156
11005,2,26,11,1,6,16,62,38.27348624790372,-109.3777461
11006,2,27,11,1,9,13,63,38.27348624790372,-109.3774766
11007,2,27,12,2,9,12,64,38.27348624790372,-109.3772071
11008,1,22,12,3,7,17,62,38.27348624790372,-109.3769376
11009,3,38,12,0,11,12,76,38.27348624790372,-109.3766681
11010,3,36,12,2,8,15,76,38.27348624790372,-109.3763986
11011,3,30,12,3,6,17,71,38.27348624790372,-109.3761291
11012,3,29,12,2,6,16,68,38.27348624790372,-109.3758596
11013,2,33,10,3,9,12,69,38.27348624790372,-109.3755901
11014,2,23,13,4,7,17,66,38.27348624790372,-109.3753206
11015,2,18,16,4,5,23,68,38.27348624790372,-109.3750512
11016,2,22,17,3,8,25,77,38.27348624790372,-109.3747817
11017,1,25,18,5,11,23,83,38.27348624790372,-109.3745122
11018,1,29,16,3,12,22,83,38.27348624790372,-109.3742427
11019,4,27,14,2,7,19,73,38.27348624790372,-109.3739732
11020,7,28,15,2,6,18,76,38.27348624790372,-109.3737037
11021,8,24,15,5,6,18,76,38.27348624790372,-109.3734342
11022,7,19,12,11,8,13,70,38.27348624790372,-109.3731647
11023,4,21,8,15,9,2,59,38.27348624790372,-109.3728952
11024,2,28,6,15,10,0,61,38.27348624790372,-109.3726257
11025,2,32,9,14,17,1,75,38.27348624790372,-109.3723562
11026,5,30,11,6,14,10,76,38.27348624790372,-109.3720867
11027,3,32,13,3,14,12,77,38.27348624790372,-109.3718172
11028,1,33,13,8,22,7,84,38.27348624790372,-109.3715477
11029,3,26,13,11,24,4,81,38.27348624790372,-109.3712782
11030,3,16,9,11,18,2,59,38.27348624790372,-109.3710087
11031,2,16,8,12,13,5,56,38.27348624790372,-109.3707392
11032,4,28,10,8,18,3,71,38.27348624790372,-109.3704697
11033,4,39,10,9,11,1,74,38.27348624790372,-109.3702003
11034,4,45,8,6,8,1,72,38.27348624790372,-109.3699308
11035,2,43,7,5,9,2,68,38.27348624790372,-109.3696613
11036,0,40,6,4,9,3,62,38.27348624790372,-109.3693918
11037,0,32,5,3,9,4,53,38.27348624790372,-109.3691223
11038,2,30,6,2,8,4,52,38.27348624790372,-109.3688528
11039,2,26,5,1,7,5,46,38.27348624790372,-109.3685833
11040,2,23,6,0,8,5,44,38.27348624790372,-109.3683138
11041,5,21,8,4,11,4,53,38.27348624790372,-109.3680443
11042,5,27,10,7,10,6,65,38.27348624790372,-109.3677748
11043,3,31,10,5,10,7,66,38.27348624790372,-109.3675053
11044,2,32,11,4,10,10,69,38.27348624790372,-109.3672358
11045,2,29,11,3,11,12,68,38.27348624790372,-109.3669663
11046,7,26,13,8,13,11,78,38.27348624790372,-109.3666968
11047,3,25,15,9,15,15,82,38.27348624790372,-109.3664273
11048,2,21,14,9,16,14,76,38.27348624790372,-109.3661578
11049,0,16,13,6,17,13,65,38.27348624790372,-109.3658883
11050,1,9,8,6,15,4,43,38.27348624790372,-109.3656188
11051,4,14,10,17,16,3,64,38.27348624790372,-109.3653493
11052,1,21,10,14,13,3,62,38.27348624790372,-109.3650799
11053,1,20,10,7,9,9,56,38.27348624790372,-109.3648104
11054,0,20,12,1,4,20,57,38.27348624790372,-109.3645409
11055,1,20,17,0,3,31,72,38.27348624790372,-109.3642714
11056,0,21,18,0,3,32,74,38.27348624790372,-109.3640019
11057,0,20,15,0,2,28,65,38.27348624790372,-109.3637324
11058,1,20,14,0,2,25,62,38.27348624790372,-109.3634629
11059,1,22,14,0,3,25,65,38.27348624790372,-109.3631934
11060,2,21,15,0,3,27,68,38.27348624790372,-109.3629239
11061,1,20,14,0,1,27,63,38.27348624790372,-109.3626544
11062,0,20,14,0,1,27,62,38.27348624790372,-109.3623849
11063,0,20,14,0,1,27,62,38.27348624790372,-109.3621154
11064,0,21,14,1,1,27,64,38.27348624790372,-109.3618459
11065,1,24,12,1,2,22,62,38.27348624790372,-109.3615764
11066,0,25,12,0,3,21,61,38.27348624790372,-109.3613069
11067,0,24,12,0,3,21,60,38.27348624790372,-109.3610374
11068,0,20,13,0,2,23,58,38.27348624790372,-109.3607679
11069,1,18,15,0,2,25,61,38.27348624790372,-109.3604984
11070,3,12,13,3,3,20,54,38.27348624790372,-109.360229
11071,5,17,10,3,2,15,52,38.27348624790372,-109.3599595
11072,8,20,9,3,4,11,55,38.27348624790372,-109.35969
11073,8,23,8,4,5,7,55,38.27348624790372,-109.3594205
11074,4,32,5,5,7,4,57,38.27348624790372,-109.359151
11075,5,33,5,3,7,3,56,38.27348624790372,-109.3588815
11076,3,16,5,5,6,7,42,38.27348624790372,-109.358612
11077,11,21,9,3,5,8,57,38.27348624790372,-109.3583425
11078,8,25,14,3,5,13,68,38.27348624790372,-109.358073
11079,3,23,15,1,4,21,67,38.27348624790372,-109.3578035
11080,2,24,16,0,5,24,71,38.27348624790372,-109.357534
11081,3,23,19,0,9,30,84,38.27348624790372,-109.3572645
11082,1,22,20,1,9,29,82,38.27348624790372,-109.356995
11083,3,23,18,2,6,31,83,38.27348624790372,-109.3567255
11084,2,25,17,2,6,28,80,38.27348624790372,-109.356456
11085,2,28,16,0,12,21,79,38.27348624790372,-109.3561865
11086,4,30,15,5,15,12,81,38.27348624790372,-109.355917
11087,3,25,12,12,23,3,78,38.27348624790372,-109.3556475
11088,0,18,14,13,12,10,67,38.27348624790372,-109.355378
11089,0,12,12,8,19,8,59,38.27348624790372,-109.3551086
11090,1,15,13,8,14,11,62,38.27348624790372,-109.3548391
11091,1,19,14,5,7,20,66,38.27348624790372,-109.3545696
11092,1,17,14,0,2,25,59,38.27348624790372,-109.3543001
11093,2,19,13,2,4,18,58,38.27348624790372,-109.3540306
11094,1,23,11,4,7,12,58,38.27348624790372,-109.3537611
11095,3,20,9,3,5,12,52,38.27348624790372,-109.3534916
11096,2,24,8,3,6,11,54,38.27348624790372,-109.3532221
11097,3,31,8,3,7,9,61,38.27348624790372,-109.3529526
11098,3,24,9,4,6,10,56,38.27348624790372,-109.3526831
11099,4,20,9,5,10,7,55,38.27348624790372,-109.3524136
11100,6,14,11,7,10,7,55,38.27348624790372,-109.3521441
11101,6,10,12,12,11,7,58,38.27348624790372,-109.3518746
11102,3,18,12,13,12,20,78,38.27348624790372,-109.3516051
11103,1,18,13,14,13,22,81,38.27348624790372,-109.3513356
11104,3,18,13,14,12,21,81,38.27348624790372,-109.3510661
11105,5,22,14,10,7,18,76,38.27348624790372,-109.3507966
11106,6,19,13,12,7,17,74,38.27348624790372,-109.3505271
11107,8,16,14,17,3,19,77,38.27348624790372,-109.3502577
11108,3,8,14,6,4,26,61,38.27348624790372,-109.3499882
11109,3,10,16,3,3,27,62,38.27348624790372,-109.3497187
11110,3,12,17,2,2,27,63,38.27348624790372,-109.3494492
11111,3,12,18,4,2,27,66,38.27348624790372,-109.3491797
11112,4,16,18,7,3,25,73,38.27348624790372,-109.3489102
11113,3,18,18,5,3,25,72,38.27348624790372,-109.3486407
11114,4,22,19,4,5,24,78,38.27348624790372,-109.3483712
11115,2,23,19,2,6,30,82,38.27348624790372,-109.3481017
11116,2,24,20,3,6,31,86,38.27348624790372,-109.3478322
11117,0,24,20,0,6,34,84,38.27348624790372,-109.3475627
11118,0,21,20,0,4,36,81,38.27348624790372,-109.3472932
11119,0,20,19,0,4,35,78,38.27348624790372,-109.3470237
11120,1,21,19,1,4,30,76,38.27348624790372,-109.3467542
11121,2,21,19,1,4,28,75,38.27348624790372,-109.3464847
11122,2,18,15,1,3,23,62,38.27348624790372,-109.3462152
11123,2,14,14,3,3,19,55,38.27348624790372,-109.3459457
11124,1,14,14,3,3,20,55,38.27348624790372,-109.3456762
11125,1,19,17,1,3,29,70,38.27348624790372,-109.3454068
11126,1,20,18,0,3,32,74,38.27348624790372,-109.3451373
11127,1,23,19,0,5,32,80,38.27348624790372,-109.3448678
11128,1,22,19,2,8,32,84,38.27348624790372,-109.3445983
11129,5,21,19,3,9,29,86,38.27348624790372,-109.3443288
11130,13,21,16,19,6,13,88,38.27348624790372,-109.3440593
11131,16,29,16,24,2,6,93,38.27348624790372,-109.3437898
11132,16,30,15,24,2,4,91,38.27348624790372,-109.3435203
11133,14,30,15,25,5,3,92,38.27348624790372,-109.3432508
11134,10,29,15,20,11,5,90,38.27348624790372,-109.3429813
11135,5,30,15,10,14,10,84,38.27348624790372,-109.3427118
11136,7,29,15,13,12,9,85,38.27348624790372,-109.3424423
11137,7,30,15,13,11,8,84,38.27348624790372,-109.3421728
11138,7,31,15,15,10,6,84,38.27348624790372,-109.3419033
11139,10,32,16,18,9,4,89,38.27348624790372,-109.3416338
11140,10,34,15,17,9,5,90,38.27348624790372,-109.3413643
11141,11,34,15,21,8,3,92,38.27348624790372,-109.3410948
11142,3,50,12,3,16,3,87,38.273216753318486,-109.4356874
11143,3,47,12,3,15,4,84,38.273216753318486,-109.4354179
11144,3,47,12,4,15,4,85,38.273216753318486,-109.4351484
11145,4,49,12,4,14,4,87,38.273216753318486,-109.434879
11146,4,51,12,5,15,3,90,38.273216753318486,-109.4346095
11147,4,51,12,4,16,3,90,38.273216753318486,-109.43434
11148,4,47,12,1,18,5,87,38.273216753318486,-109.4340705
11149,3,45,13,0,17,8,86,38.273216753318486,-109.433801
11150,2,44,13,0,17,8,84,38.273216753318486,-109.4335315
11151,2,43,12,0,16,9,82,38.273216753318486,-109.433262
11152,3,39,11,0,14,10,77,38.273216753318486,-109.4329925
11153,3,36,10,3,9,8,69,38.273216753318486,-109.432723
11154,3,36,8,4,8,4,63,38.273216753318486,-109.4324535
11155,5,35,9,4,9,3,65,38.273216753318486,-109.432184
11156,3,38,9,2,8,7,67,38.273216753318486,-109.4319145
11157,2,39,9,2,9,7,68,38.273216753318486,-109.431645
11158,3,38,10,3,9,6,69,38.273216753318486,-109.4313755
11159,5,37,10,4,10,6,72,38.273216753318486,-109.431106
11160,3,33,11,7,14,7,75,38.273216753318486,-109.4308365
11161,2,31,12,4,15,13,77,38.273216753318486,-109.430567
11162,1,33,13,4,17,14,82,38.273216753318486,-109.4302975
11163,1,34,12,5,18,12,82,38.273216753318486,-109.430028
11164,0,33,11,3,15,14,76,38.273216753318486,-109.4297586
11165,0,36,12,0,13,15,76,38.273216753318486,-109.4294891
11166,1,37,11,0,13,14,76,38.273216753318486,-109.4292196
11167,1,38,11,0,12,14,76,38.273216753318486,-109.4289501
11168,1,37,11,0,11,16,76,38.273216753318486,-109.4286806
11169,1,34,12,2,12,15,76,38.273216753318486,-109.4284111
11170,2,32,12,1,13,12,72,38.273216753318486,-109.4281416
11171,1,34,10,0,11,12,68,38.273216753318486,-109.4278721
11172,0,36,9,0,12,10,67,38.273216753318486,-109.4276026
11173,0,33,10,3,15,8,69,38.273216753318486,-109.4273331
11174,1,33,11,2,15,11,73,38.273216753318486,-109.4270636
11175,0,33,10,1,11,12,67,38.273216753318486,-109.4267941
11176,0,37,10,0,11,12,70,38.273216753318486,-109.4265246
11177,1,39,10,0,13,12,75,38.273216753318486,-109.4262551
11178,0,35,10,0,11,13,69,38.273216753318486,-109.4259856
11179,0,34,9,3,8,9,63,38.273216753318486,-109.4257161
11180,2,40,8,6,8,5,69,38.273216753318486,-109.4254466
11181,2,43,8,3,8,6,70,38.273216753318486,-109.4251771
11182,1,41,8,1,8,7,66,38.273216753318486,-109.4249077
11183,1,38,8,2,9,5,63,38.273216753318486,-109.4246382
11184,2,37,9,3,9,6,66,38.273216753318486,-109.4243687
11185,1,38,10,1,10,9,69,38.273216753318486,-109.4240992
11186,1,37,10,0,11,12,71,38.273216753318486,-109.4238297
11187,2,37,10,0,11,13,73,38.273216753318486,-109.4235602
11188,3,43,11,0,13,12,82,38.273216753318486,-109.4232907
11189,4,43,12,3,16,8,86,38.273216753318486,-109.4230212
11190,5,43,13,5,17,5,88,38.273216753318486,-109.4227517
11191,5,43,13,5,18,4,88,38.273216753318486,-109.4224822
11192,5,46,13,4,19,3,90,38.273216753318486,-109.4222127
11193,3,47,12,4,19,3,88,38.273216753318486,-109.4219432
11194,4,45,12,4,18,4,87,38.273216753318486,-109.4216737
11195,3,43,12,2,17,8,85,38.273216753318486,-109.4214042
11196,2,41,12,0,14,12,81,38.273216753318486,-109.4211347
11197,2,35,12,0,10,18,77,38.273216753318486,-109.4208652
11198,0,32,13,0,7,23,75,38.273216753318486,-109.4205957
11199,0,33,12,0,8,20,73,38.273216753318486,-109.4203262
11200,1,35,12,0,11,16,75,38.273216753318486,-109.4200568
11201,2,37,12,0,12,15,78,38.273216753318486,-109.4197873
11202,4,31,16,0,10,23,84,38.273216753318486,-109.4195178
11203,1,29,15,1,9,20,75,38.273216753318486,-109.4192483
11204,1,29,13,1,9,19,72,38.273216753318486,-109.4189788
11205,1,36,12,1,18,11,79,38.273216753318486,-109.4187093
11206,3,43,12,2,18,6,84,38.273216753318486,-109.4184398
11207,5,45,13,5,19,2,89,38.273216753318486,-109.4181703
11208,6,45,13,6,18,1,89,38.273216753318486,-109.4179008
11209,6,45,13,7,18,1,90,38.273216753318486,-109.4176313
11210,7,45,12,8,17,0,89,38.273216753318486,-109.4173618
11211,7,44,12,8,17,0,88,38.273216753318486,-109.4170923
11212,7,45,12,7,19,0,90,38.273216753318486,-109.4168228
11213,6,45,13,7,18,1,90,38.273216753318486,-109.4165533
11214,6,45,13,7,18,1,90,38.273216753318486,-109.4162838
11215,6,45,13,7,17,1,89,38.273216753318486,-109.4160143
11216,7,46,13,7,17,1,91,38.273216753318486,-109.4157448
11217,7,45,13,7,17,1,90,38.273216753318486,-109.4154753
11218,8,44,13,8,17,1,91,38.273216753318486,-109.4152058
11219,10,41,13,9,16,0,89,38.273216753318486,-109.4149364
11220,13,38,14,11,14,0,90,38.273216753318486,-109.4146669
11221,13,40,13,9,14,0,89,38.273216753318486,-109.4143974
11222,9,44,13,8,16,1,91,38.273216753318486,-109.4141279
11223,8,46,13,7,16,1,91,38.273216753318486,-109.4138584
11224,8,45,13,7,16,1,90,38.273216753318486,-109.4135889
11225,8,46,13,6,17,1,91,38.273216753318486,-109.4133194
11226,7,48,13,6,17,1,92,38.273216753318486,-109.4130499
11227,7,48,13,7,18,1,94,38.273216753318486,-109.4127804
11228,9,45,13,9,17,0,93,38.273216753318486,-109.4125109
11229,10,42,13,10,17,0,92,38.273216753318486,-109.4122414
11230,8,45,13,8,18,1,93,38.273216753318486,-109.4119719
11231,6,49,12,6,18,1,92,38.273216753318486,-109.4117024
11232,6,49,13,6,18,1,93,38.273216753318486,-109.4114329
11233,5,46,13,7,18,2,91,38.273216753318486,-109.4111634
11234,5,45,13,7,17,2,89,38.273216753318486,-109.4108939
11235,5,45,13,7,18,1,89,38.273216753318486,-109.4106244
11236,6,46,12,6,18,1,89,38.273216753318486,-109.4103549
11237,6,46,12,5,18,1,88,38.273216753318486,-109.4100855
11238,5,45,12,5,18,1,86,38.273216753318486,-109.409816
11239,4,48,11,6,17,0,86,38.273216753318486,-109.4095465
11240,5,52,11,6,17,0,91,38.273216753318486,-109.409277
11241,5,47,12,6,18,0,88,38.273216753318486,-109.4090075
11242,6,44,13,7,19,1,90,38.273216753318486,-109.408738
11243,7,44,13,8,19,0,91,38.273216753318486,-109.4084685
11244,6,44,13,7,18,1,89,38.273216753318486,-109.408199
11245,6,44,12,6,18,2,88,38.273216753318486,-109.4079295
11246,6,44,12,6,18,2,88,38.273216753318486,-109.40766
11247,6,45,12,6,18,2,89,38.273216753318486,-109.4073905
11248,6,45,13,7,17,2,90,38.273216753318486,-109.407121
11249,5,43,13,8,16,1,86,38.273216753318486,-109.4068515
11250,3,44,7,5,10,3,72,38.273216753318486,-109.3879869
11251,2,39,8,4,10,4,67,38.273216753318486,-109.3877174
11252,1,40,8,3,9,8,69,38.273216753318486,-109.3874479
11253,2,32,12,2,9,15,72,38.273216753318486,-109.3871784
11254,2,27,14,2,6,20,71,38.273216753318486,-109.3869089
11255,2,26,15,1,5,23,72,38.273216753318486,-109.3866394
11256,1,23,16,0,3,28,71,38.273216753318486,-109.3863699
11257,1,24,15,0,2,27,69,38.273216753318486,-109.3861004
11258,1,29,12,0,5,20,67,38.273216753318486,-109.3858309
11259,2,33,11,0,8,16,70,38.273216753318486,-109.3855614
11260,1,24,14,3,5,22,69,38.273216753318486,-109.3852919
11261,1,25,15,1,4,25,71,38.273216753318486,-109.3850225
11262,2,28,14,0,5,22,71,38.273216753318486,-109.384753
11263,2,31,12,1,10,15,71,38.273216753318486,-109.3844835
11264,3,32,11,1,12,10,69,38.273216753318486,-109.384214
11265,2,32,11,1,11,11,68,38.273216753318486,-109.3839445
11266,2,32,11,1,11,11,68,38.273216753318486,-109.383675
11267,3,33,11,0,10,12,69,38.273216753318486,-109.3834055
11268,2,31,12,1,7,15,68,38.273216753318486,-109.383136
11269,3,32,11,3,8,13,70,38.273216753318486,-109.3828665
11270,3,31,10,3,7,12,66,38.273216753318486,-109.382597
11271,2,27,10,3,6,11,59,38.273216753318486,-109.3823275
11272,1,28,8,5,4,9,55,38.273216753318486,-109.382058
11273,2,34,5,7,7,4,59,38.273216753318486,-109.3817885
11274,3,35,5,3,8,3,57,38.273216753318486,-109.381519
11275,3,27,6,2,8,5,51,38.273216753318486,-109.3812495
11276,6,26,8,4,7,7,58,38.273216753318486,-109.38098
11277,12,21,12,3,1,19,68,38.273216753318486,-109.3807105
11278,5,21,16,4,4,21,71,38.273216753318486,-109.380441
11279,3,22,15,3,4,23,70,38.273216753318486,-109.3801716
11280,3,25,14,2,5,20,69,38.273216753318486,-109.3799021
11281,3,26,13,2,6,18,68,38.273216753318486,-109.3796326
11282,2,25,14,1,6,21,69,38.273216753318486,-109.3793631
11283,2,24,13,1,6,21,67,38.273216753318486,-109.3790936
11284,1,24,11,1,6,18,61,38.273216753318486,-109.3788241
11285,2,28,10,2,7,14,63,38.273216753318486,-109.3785546
11286,2,29,10,3,9,11,64,38.273216753318486,-109.3782851
11287,2,27,11,3,8,13,64,38.273216753318486,-109.3780156
11288,1,24,11,1,6,17,60,38.273216753318486,-109.3777461
11289,1,23,11,1,6,17,59,38.273216753318486,-109.3774766
11290,1,23,11,1,6,17,59,38.273216753318486,-109.3772071
11291,2,25,11,1,5,16,60,38.273216753318486,-109.3769376
11292,1,40,10,1,12,10,74,38.273216753318486,-109.3766681
11293,2,38,11,2,10,12,75,38.273216753318486,-109.3763986
11294,2,31,11,2,7,15,68,38.273216753318486,-109.3761291
11295,2,23,12,2,5,19,63,38.273216753318486,-109.3758596
11296,2,22,13,3,5,20,65,38.273216753318486,-109.3755901
11297,2,19,14,2,4,23,64,38.273216753318486,-109.3753206
11298,2,18,16,2,4,26,68,38.273216753318486,-109.3750512
11299,2,23,16,3,8,23,75,38.273216753318486,-109.3747817
11300,3,29,16,5,12,18,83,38.273216753318486,-109.3745122
11301,3,30,15,7,13,16,84,38.273216753318486,-109.3742427
11302,5,28,16,6,11,14,80,38.273216753318486,-109.3739732
11303,7,28,15,6,8,15,79,38.273216753318486,-109.3737037
11304,6,22,14,7,7,15,71,38.273216753318486,-109.3734342
11305,7,15,11,12,9,11,65,38.273216753318486,-109.3731647
11306,3,20,8,15,9,2,57,38.273216753318486,-109.3728952
11307,2,29,9,16,14,1,71,38.273216753318486,-109.3726257
11308,0,32,9,7,12,7,67,38.273216753318486,-109.3723562
11309,2,32,10,4,14,9,71,38.273216753318486,-109.3720867
11310,7,32,11,14,14,2,80,38.273216753318486,-109.3718172
11311,2,31,12,12,22,3,82,38.273216753318486,-109.3715477
11312,5,19,11,12,21,3,71,38.273216753318486,-109.3712782
11313,5,18,9,12,20,2,66,38.273216753318486,-109.3710087
11314,5,23,10,9,16,3,66,38.273216753318486,-109.3707392
11315,7,32,11,4,14,5,73,38.273216753318486,-109.3704697
11316,3,34,8,4,8,5,62,38.273216753318486,-109.3702003
11317,1,32,6,5,9,3,56,38.273216753318486,-109.3699308
11318,0,33,6,3,9,3,54,38.273216753318486,-109.3696613
11319,0,33,6,1,9,4,53,38.273216753318486,-109.3693918
11320,2,29,6,1,7,5,50,38.273216753318486,-109.3691223
11321,1,25,6,0,8,6,46,38.273216753318486,-109.3688528
11322,1,23,5,0,9,6,44,38.273216753318486,-109.3685833
11323,2,24,7,2,9,6,50,38.273216753318486,-109.3683138
11324,3,28,9,5,9,7,61,38.273216753318486,-109.3680443
11325,2,34,11,4,10,10,71,38.273216753318486,-109.3677748
11326,1,33,11,2,11,12,70,38.273216753318486,-109.3675053
11327,1,30,11,2,13,11,68,38.273216753318486,-109.3672358
11328,2,24,13,6,13,14,72,38.273216753318486,-109.3669663
11329,4,24,18,7,12,17,82,38.273216753318486,-109.3666968
11330,3,20,14,9,14,13,73,38.273216753318486,-109.3664273
11331,2,18,15,10,14,10,69,38.273216753318486,-109.3661578
11332,5,12,12,12,17,3,61,38.273216753318486,-109.3658883
11333,4,9,9,15,18,1,56,38.273216753318486,-109.3656188
11334,5,15,11,19,13,4,67,38.273216753318486,-109.3653493
11335,2,22,12,9,10,13,68,38.273216753318486,-109.3650799
11336,0,20,14,1,4,26,65,38.273216753318486,-109.3648104
11337,0,22,17,0,4,30,73,38.273216753318486,-109.3645409
11338,0,24,18,0,5,30,77,38.273216753318486,-109.3642714
11339,0,25,19,0,4,31,79,38.273216753318486,-109.3640019
11340,0,24,18,0,4,31,77,38.273216753318486,-109.3637324
11341,0,24,17,0,4,29,74,38.273216753318486,-109.3634629
11342,0,23,16,0,3,28,70,38.273216753318486,-109.3631934
11343,1,21,14,1,2,26,65,38.273216753318486,-109.3629239
11344,0,20,15,0,1,28,64,38.273216753318486,-109.3626544
11345,0,21,14,0,1,27,63,38.273216753318486,-109.3623849
11346,1,21,13,1,1,26,63,38.273216753318486,-109.3621154
11347,1,24,12,1,2,22,62,38.273216753318486,-109.3618459
11348,1,28,11,1,5,16,62,38.273216753318486,-109.3615764
11349,1,27,11,0,4,17,60,38.273216753318486,-109.3613069
11350,1,27,10,0,5,16,59,38.273216753318486,-109.3610374
11351,0,23,11,1,4,18,57,38.273216753318486,-109.3607679
11352,2,22,12,2,3,18,59,38.273216753318486,-109.3604984
11353,5,22,9,3,7,9,55,38.273216753318486,-109.360229
11354,4,33,5,5,7,5,59,38.273216753318486,-109.3599595
11355,2,39,4,4,7,4,60,38.273216753318486,-109.35969
11356,2,35,5,2,6,4,54,38.273216753318486,-109.3594205
11357,3,33,4,0,7,3,50,38.273216753318486,-109.359151
11358,4,29,5,1,8,4,51,38.273216753318486,-109.3588815
11359,4,17,6,3,6,7,43,38.273216753318486,-109.358612
11360,4,26,8,2,6,10,56,38.273216753318486,-109.3583425
11361,3,29,11,4,7,10,64,38.273216753318486,-109.358073
11362,3,26,13,3,7,15,67,38.273216753318486,-109.3578035
11363,2,24,16,2,5,23,72,38.273216753318486,-109.357534
11364,0,25,18,3,9,27,82,38.273216753318486,-109.3572645
11365,3,23,20,3,11,27,87,38.273216753318486,-109.356995
11366,5,28,18,2,7,25,85,38.273216753318486,-109.3567255
11367,2,28,18,0,10,23,81,38.273216753318486,-109.356456
11368,6,33,14,3,11,12,79,38.273216753318486,-109.3561865
11369,5,33,12,7,16,6,79,38.273216753318486,-109.355917
11370,3,25,13,10,20,5,76,38.273216753318486,-109.3556475
11371,1,16,13,14,16,6,66,38.273216753318486,-109.355378
11372,0,16,14,8,15,11,64,38.273216753318486,-109.3551086
11373,2,22,15,6,9,21,75,38.273216753318486,-109.3548391
11374,2,21,14,5,6,19,67,38.273216753318486,-109.3545696
11375,4,26,11,2,6,12,61,38.273216753318486,-109.3543001
11376,2,31,7,3,9,7,59,38.273216753318486,-109.3540306
11377,2,35,7,3,9,6,62,38.273216753318486,-109.3537611
11378,2,29,7,2,9,7,56,38.273216753318486,-109.3534916
11379,2,29,8,3,9,8,59,38.273216753318486,-109.3532221
11380,2,34,9,3,11,8,67,38.273216753318486,-109.3529526
11381,3,25,10,6,10,8,62,38.273216753318486,-109.3526831
11382,3,17,9,8,9,6,52,38.273216753318486,-109.3524136
11383,3,16,8,8,12,5,52,38.273216753318486,-109.3521441
11384,9,23,12,7,12,3,66,38.273216753318486,-109.3518746
11385,1,24,16,1,8,19,69,38.273216753318486,-109.3516051
11386,1,19,15,11,10,28,84,38.273216753318486,-109.3513356
11387,3,19,14,10,10,26,82,38.273216753318486,-109.3510661
11388,1,18,12,3,4,25,63,38.273216753318486,-109.3507966
11389,0,15,11,4,4,23,57,38.273216753318486,-109.3505271
11390,3,10,13,6,5,21,58,38.273216753318486,-109.3502577
11391,4,7,13,9,6,17,56,38.273216753318486,-109.3499882
11392,4,7,14,8,6,18,57,38.273216753318486,-109.3497187
11393,3,8,14,6,5,20,56,38.273216753318486,-109.3494492
11394,4,11,15,5,4,21,60,38.273216753318486,-109.3491797
11395,3,13,16,6,3,23,64,38.273216753318486,-109.3489102
11396,2,18,16,4,3,24,67,38.273216753318486,-109.3486407
11397,3,21,17,3,5,23,72,38.273216753318486,-109.3483712
11398,4,24,18,4,5,23,78,38.273216753318486,-109.3481017
11399,3,25,18,4,5,25,80,38.273216753318486,-109.3478322
11400,2,21,19,3,5,28,78,38.273216753318486,-109.3475627
11401,1,20,19,0,4,32,76,38.273216753318486,-109.3472932
11402,1,20,18,0,3,32,74,38.273216753318486,-109.3470237
11403,1,20,18,0,4,29,72,38.273216753318486,-109.3467542
11404,1,21,19,1,3,29,74,38.273216753318486,-109.3464847
11405,2,22,16,0,1,25,66,38.273216753318486,-109.3462152
11406,1,15,13,2,3,18,52,38.273216753318486,-109.3459457
11407,2,17,12,4,5,12,52,38.273216753318486,-109.3456762
11408,0,14,15,3,3,23,58,38.273216753318486,-109.3454068
11409,1,20,19,0,5,33,78,38.273216753318486,-109.3451373
11410,1,22,20,2,6,34,85,38.273216753318486,-109.3448678
11411,2,20,20,3,6,36,87,38.273216753318486,-109.3445983
11412,1,20,21,1,8,35,86,38.273216753318486,-109.3443288
11413,10,21,17,12,7,20,87,38.273216753318486,-109.3440593
11414,17,28,16,23,0,8,92,38.273216753318486,-109.3437898
11415,15,29,15,26,1,5,91,38.273216753318486,-109.3435203
11416,12,29,15,24,5,5,90,38.273216753318486,-109.3432508
11417,9,30,15,13,13,8,88,38.273216753318486,-109.3429813
11418,5,29,15,11,13,11,84,38.273216753318486,-109.3427118
11419,7,29,15,13,13,9,86,38.273216753318486,-109.3424423
11420,7,29,15,13,11,9,84,38.273216753318486,-109.3421728
11421,7,29,16,14,10,8,84,38.273216753318486,-109.3419033
11422,11,33,17,17,9,5,92,38.273216753318486,-109.3416338
11423,7,32,15,15,10,6,85,38.273216753318486,-109.3413643
11424,8,33,14,18,11,3,87,38.273216753318486,-109.3410948
11425,10,36,15,20,9,3,93,38.273216753318486,-109.3408253
11426,3,54,11,2,17,3,90,38.272947258733254,-109.4359569
11427,3,53,12,3,17,2,90,38.272947258733254,-109.4356874
11428,3,48,11,3,16,2,83,38.272947258733254,-109.4354179
11429,3,46,11,3,13,4,80,38.272947258733254,-109.4351484
11430,3,46,11,3,13,5,81,38.272947258733254,-109.434879
11431,3,49,11,4,13,4,84,38.272947258733254,-109.4346095
11432,3,52,12,3,15,4,89,38.272947258733254,-109.43434
11433,3,48,13,3,18,3,88,38.272947258733254,-109.4340705
11434,3,45,13,4,18,4,87,38.272947258733254,-109.433801
11435,3,45,13,2,17,6,86,38.272947258733254,-109.4335315
11436,2,46,11,1,14,8,82,38.272947258733254,-109.433262
11437,2,41,11,1,11,9,75,38.272947258733254,-109.4329925
11438,2,38,11,2,9,8,70,38.272947258733254,-109.432723
11439,4,37,10,3,7,7,68,38.272947258733254,-109.4324535
11440,8,31,12,6,9,4,70,38.272947258733254,-109.432184
11441,4,31,9,3,8,9,64,38.272947258733254,-109.4319145
11442,3,30,10,4,10,8,65,38.272947258733254,-109.431645
11443,2,32,11,4,9,10,68,38.272947258733254,-109.4313755
11444,3,40,11,2,11,12,79,38.272947258733254,-109.431106
11445,3,35,12,3,14,13,80,38.272947258733254,-109.4308365
11446,0,31,13,3,18,14,79,38.272947258733254,-109.430567
11447,1,35,11,5,19,10,81,38.272947258733254,-109.4302975
11448,3,38,12,6,16,10,85,38.272947258733254,-109.430028
11449,1,38,11,0,13,14,77,38.272947258733254,-109.4297586
11450,1,38,12,0,11,17,79,38.272947258733254,-109.4294891
11451,1,37,11,0,10,16,75,38.272947258733254,-109.4292196
11452,1,36,11,0,10,16,74,38.272947258733254,-109.4289501
11453,1,34,11,0,10,15,71,38.272947258733254,-109.4286806
11454,1,30,11,3,8,15,68,38.272947258733254,-109.4284111
11455,3,34,11,3,12,8,71,38.272947258733254,-109.4281416
11456,1,38,10,1,11,9,70,38.272947258733254,-109.4278721
11457,1,37,9,1,10,9,67,38.272947258733254,-109.4276026
11458,2,35,9,3,10,8,67,38.272947258733254,-109.4273331
11459,2,34,10,3,11,8,68,38.272947258733254,-109.4270636
11460,1,40,9,3,11,6,70,38.272947258733254,-109.4267941
11461,1,43,9,2,12,6,73,38.272947258733254,-109.4265246
11462,1,45,9,0,13,6,74,38.272947258733254,-109.4262551
11463,0,44,8,0,12,8,72,38.272947258733254,-109.4259856
11464,1,42,7,2,6,7,65,38.272947258733254,-109.4257161
11465,2,41,7,5,7,4,66,38.272947258733254,-109.4254466
11466,3,39,7,4,9,4,66,38.272947258733254,-109.4251771
11467,2,38,7,3,10,4,64,38.272947258733254,-109.4249077
11468,1,39,8,2,10,5,65,38.272947258733254,-109.4246382
11469,3,38,10,5,10,5,71,38.272947258733254,-109.4243687
11470,2,39,10,2,8,8,69,38.272947258733254,-109.4240992
11471,2,39,10,0,10,10,71,38.272947258733254,-109.4238297
11472,2,39,10,0,12,11,74,38.272947258733254,-109.4235602
11473,3,44,12,1,14,10,84,38.272947258733254,-109.4232907
11474,4,43,12,3,17,7,86,38.272947258733254,-109.4230212
11475,5,42,13,4,18,5,87,38.272947258733254,-109.4227517
11476,5,43,13,4,18,4,87,38.272947258733254,-109.4224822
11477,4,46,12,4,18,3,87,38.272947258733254,-109.4222127
11478,4,47,12,4,19,3,89,38.272947258733254,-109.4219432
11479,3,45,13,4,18,5,88,38.272947258733254,-109.4216737
11480,3,43,12,2,17,7,84,38.272947258733254,-109.4214042
11481,2,41,12,1,15,11,82,38.272947258733254,-109.4211347
11482,1,36,12,0,10,16,75,38.272947258733254,-109.4208652
11483,1,34,12,0,8,18,73,38.272947258733254,-109.4205957
11484,1,35,12,0,10,17,75,38.272947258733254,-109.4203262
11485,1,37,12,0,11,16,77,38.272947258733254,-109.4200568
11486,5,32,14,6,6,19,82,38.272947258733254,-109.4197873
11487,1,30,14,0,9,20,74,38.272947258733254,-109.4195178
11488,3,27,15,4,11,17,77,38.272947258733254,-109.4192483
11489,4,37,12,3,17,8,81,38.272947258733254,-109.4189788
11490,5,42,12,5,18,4,86,38.272947258733254,-109.4187093
11491,5,46,12,4,19,2,88,38.272947258733254,-109.4184398
11492,6,45,13,5,18,1,88,38.272947258733254,-109.4181703
11493,6,45,13,6,18,1,89,38.272947258733254,-109.4179008
11494,6,45,13,7,18,1,90,38.272947258733254,-109.4176313
11495,6,44,13,8,18,1,90,38.272947258733254,-109.4173618
11496,8,43,13,8,17,0,89,38.272947258733254,-109.4170923
11497,8,42,13,9,17,0,89,38.272947258733254,-109.4168228
11498,9,43,13,9,17,0,91,38.272947258733254,-109.4165533
11499,8,44,13,8,17,1,91,38.272947258733254,-109.4162838
11500,7,46,13,7,16,1,90,38.272947258733254,-109.4160143
11501,8,46,13,6,15,1,89,38.272947258733254,-109.4157448
11502,9,44,13,7,16,1,90,38.272947258733254,-109.4154753
11503,8,44,13,8,17,1,91,38.272947258733254,-109.4152058
11504,7,44,14,9,17,0,91,38.272947258733254,-109.4149364
11505,7,44,13,10,16,0,90,38.272947258733254,-109.4146669
11506,9,44,13,8,17,0,91,38.272947258733254,-109.4143974
11507,8,45,13,7,17,1,91,38.272947258733254,-109.4141279
11508,8,43,13,8,16,2,90,38.272947258733254,-109.4138584
11509,8,41,13,9,15,2,88,38.272947258733254,-109.4135889
11510,8,41,13,9,16,2,89,38.272947258733254,-109.4133194
11511,7,45,13,7,17,1,90,38.272947258733254,-109.4130499
11512,8,45,13,8,16,1,91,38.272947258733254,-109.4127804
11513,10,44,13,9,16,0,92,38.272947258733254,-109.4125109
11514,10,43,13,9,16,0,91,38.272947258733254,-109.4122414
11515,8,46,13,8,17,0,92,38.272947258733254,-109.4119719
11516,5,50,13,6,17,1,92,38.272947258733254,-109.4117024
11517,5,49,13,6,18,2,93,38.272947258733254,-109.4114329
11518,5,46,13,7,18,1,90,38.272947258733254,-109.4111634
11519,5,45,12,7,18,1,88,38.272947258733254,-109.4108939
11520,5,47,12,6,18,0,88,38.272947258733254,-109.4106244
11521,6,48,12,6,18,0,90,38.272947258733254,-109.4103549
11522,6,48,12,6,17,0,89,38.272947258733254,-109.4100855
11523,6,46,11,7,16,0,86,38.272947258733254,-109.409816
11524,6,48,11,8,16,0,89,38.272947258733254,-109.4095465
11525,6,50,12,6,18,0,92,38.272947258733254,-109.409277
11526,6,46,13,7,19,1,92,38.272947258733254,-109.4090075
11527,5,44,13,7,19,1,89,38.272947258733254,-109.408738
11528,5,44,13,7,19,2,90,38.272947258733254,-109.4084685
11529,5,45,13,6,19,2,90,38.272947258733254,-109.408199
11530,5,44,13,7,18,2,89,38.272947258733254,-109.4079295
11531,5,44,13,7,18,2,89,38.272947258733254,-109.40766
11532,6,46,12,6,18,1,89,38.272947258733254,-109.4073905
11533,6,47,13,7,18,0,91,38.272947258733254,-109.407121
11534,6,47,12,6,17,1,89,38.272947258733254,-109.4068515
11535,3,39,8,6,10,5,71,38.272947258733254,-109.3879869
11536,2,40,10,5,11,6,74,38.272947258733254,-109.3877174
11537,3,42,11,3,14,6,79,38.272947258733254,-109.3874479
11538,3,38,12,2,12,11,78,38.272947258733254,-109.3871784
11539,3,36,13,2,10,15,79,38.272947258733254,-109.3869089
11540,1,26,15,0,5,23,70,38.272947258733254,-109.3866394
11541,1,25,15,0,4,24,69,38.272947258733254,-109.3863699
11542,2,28,14,1,5,22,72,38.272947258733254,-109.3861004
11543,2,31,12,1,8,17,71,38.272947258733254,-109.3858309
11544,2,34,11,0,9,15,71,38.272947258733254,-109.3855614
11545,1,25,13,2,5,22,68,38.272947258733254,-109.3852919
11546,1,24,14,0,4,24,67,38.272947258733254,-109.3850225
11547,1,27,13,0,4,23,68,38.272947258733254,-109.384753
11548,1,28,12,0,7,18,66,38.272947258733254,-109.3844835
11549,2,28,11,2,10,12,65,38.272947258733254,-109.384214
11550,1,28,11,2,8,13,63,38.272947258733254,-109.3839445
11551,1,29,11,1,9,14,65,38.272947258733254,-109.383675
11552,3,30,11,1,9,15,69,38.272947258733254,-109.3834055
11553,3,34,11,2,8,14,72,38.272947258733254,-109.383136
11554,3,35,10,3,8,12,71,38.272947258733254,-109.3828665
11555,3,30,10,3,7,13,66,38.272947258733254,-109.382597
11556,8,28,12,11,8,9,76,38.272947258733254,-109.3823275
11557,4,34,10,6,7,4,65,38.272947258733254,-109.382058
11558,4,35,7,5,9,5,65,38.272947258733254,-109.3817885
11559,6,27,7,5,9,3,57,38.272947258733254,-109.381519
11560,5,28,7,5,8,5,58,38.272947258733254,-109.3812495
11561,5,24,9,4,4,13,59,38.272947258733254,-109.38098
11562,10,21,13,2,1,21,68,38.272947258733254,-109.3807105
11563,6,21,15,3,4,21,70,38.272947258733254,-109.380441
11564,3,23,14,3,4,21,68,38.272947258733254,-109.3801716
11565,3,28,13,3,7,18,72,38.272947258733254,-109.3799021
11566,4,30,13,3,8,16,74,38.272947258733254,-109.3796326
11567,2,23,15,1,5,23,69,38.272947258733254,-109.3793631
11568,1,23,16,0,4,27,71,38.272947258733254,-109.3790936
11569,1,23,15,0,4,24,67,38.272947258733254,-109.3788241
11570,1,23,14,0,3,24,65,38.272947258733254,-109.3785546
11571,2,22,13,1,4,22,64,38.272947258733254,-109.3782851
11572,2,24,11,2,6,16,61,38.272947258733254,-109.3780156
11573,2,23,11,3,6,17,62,38.272947258733254,-109.3777461
11574,1,20,13,2,4,21,61,38.272947258733254,-109.3774766
11575,2,21,14,1,5,22,65,38.272947258733254,-109.3772071
11576,4,27,12,2,6,15,66,38.272947258733254,-109.3769376
11577,1,44,10,0,14,10,79,38.272947258733254,-109.3766681
11578,2,44,10,0,12,10,78,38.272947258733254,-109.3763986
11579,3,31,12,3,8,15,72,38.272947258733254,-109.3761291
11580,2,22,13,4,5,19,65,38.272947258733254,-109.3758596
11581,3,22,13,5,6,19,68,38.272947258733254,-109.3755901
11582,2,23,14,3,5,21,68,38.272947258733254,-109.3753206
11583,2,21,15,3,4,23,68,38.272947258733254,-109.3750512
11584,3,23,15,3,6,23,73,38.272947258733254,-109.3747817
11585,3,28,15,3,9,21,79,38.272947258733254,-109.3745122
11586,3,23,16,4,7,22,75,38.272947258733254,-109.3742427
11587,6,30,15,5,10,14,80,38.272947258733254,-109.3739732
11588,10,31,14,8,11,7,81,38.272947258733254,-109.3737037
11589,12,24,13,9,10,6,74,38.272947258733254,-109.3734342
11590,9,16,11,12,11,6,65,38.272947258733254,-109.3731647
11591,9,23,9,20,9,7,77,38.272947258733254,-109.3728952
11592,7,23,12,14,7,13,76,38.272947258733254,-109.3726257
11593,1,29,12,2,11,16,71,38.272947258733254,-109.3723562
11594,1,33,11,3,11,12,71,38.272947258733254,-109.3720867
11595,9,34,11,10,17,0,81,38.272947258733254,-109.3718172
11596,5,26,12,11,16,1,71,38.272947258733254,-109.3715477
11597,6,20,11,9,13,1,60,38.272947258733254,-109.3712782
11598,7,26,11,9,7,2,62,38.272947258733254,-109.3710087
11599,4,32,8,5,7,5,61,38.272947258733254,-109.3707392
11600,3,28,8,5,8,6,58,38.272947258733254,-109.3704697
11601,2,30,7,3,6,7,55,38.272947258733254,-109.3702003
11602,2,32,7,3,7,5,56,38.272947258733254,-109.3699308
11603,2,35,6,2,7,4,56,38.272947258733254,-109.3696613
11604,2,33,6,1,6,5,53,38.272947258733254,-109.3693918
11605,1,27,6,0,8,6,48,38.272947258733254,-109.3691223
11606,0,23,6,0,8,7,44,38.272947258733254,-109.3688528
11607,1,22,7,2,8,8,48,38.272947258733254,-109.3685833
11608,1,29,10,4,8,9,61,38.272947258733254,-109.3683138
11609,1,33,10,2,9,13,68,38.272947258733254,-109.3680443
11610,2,38,11,1,14,9,75,38.272947258733254,-109.3677748
11611,1,27,11,2,12,14,67,38.272947258733254,-109.3675053
11612,1,26,13,4,13,15,72,38.272947258733254,-109.3672358
11613,6,28,17,6,12,17,86,38.272947258733254,-109.3669663
11614,5,26,18,8,9,15,81,38.272947258733254,-109.3666968
11615,2,20,13,8,15,11,69,38.272947258733254,-109.3664273
11616,4,14,11,12,17,3,61,38.272947258733254,-109.3661578
11617,3,10,10,21,16,1,61,38.272947258733254,-109.3658883
11618,3,13,9,19,14,2,60,38.272947258733254,-109.3656188
11619,6,18,11,14,12,6,67,38.272947258733254,-109.3653493
11620,2,21,15,2,5,25,70,38.272947258733254,-109.3650799
11621,0,22,17,0,4,30,73,38.272947258733254,-109.3648104
11622,1,24,17,0,6,28,76,38.272947258733254,-109.3645409
11623,0,26,17,0,7,26,76,38.272947258733254,-109.3642714
11624,0,27,18,0,7,27,79,38.272947258733254,-109.3640019
11625,1,26,18,1,6,28,80,38.272947258733254,-109.3637324
11626,1,25,17,1,5,29,78,38.272947258733254,-109.3634629
11627,0,21,16,0,3,29,69,38.272947258733254,-109.3631934
11628,0,22,13,0,2,25,62,38.272947258733254,-109.3629239
11629,0,22,13,1,2,25,63,38.272947258733254,-109.3626544
11630,0,21,13,1,1,25,61,38.272947258733254,-109.3623849
11631,1,24,13,0,2,23,63,38.272947258733254,-109.3621154
11632,1,27,12,0,4,18,62,38.272947258733254,-109.3618459
11633,1,25,11,2,6,14,59,38.272947258733254,-109.3615764
11634,1,21,11,0,3,18,54,38.272947258733254,-109.3613069
11635,1,23,11,2,5,16,58,38.272947258733254,-109.3610374
11636,1,23,10,4,6,13,57,38.272947258733254,-109.3607679
11637,2,21,8,3,9,9,52,38.272947258733254,-109.3604984
11638,2,24,7,3,8,6,50,38.272947258733254,-109.360229
11639,2,25,6,1,8,5,47,38.272947258733254,-109.3599595
11640,3,31,5,0,9,3,51,38.272947258733254,-109.35969
11641,3,28,5,2,8,5,51,38.272947258733254,-109.3594205
11642,5,20,6,1,7,5,44,38.272947258733254,-109.359151
11643,7,26,9,5,8,3,58,38.272947258733254,-109.3588815
11644,5,26,9,5,7,5,57,38.272947258733254,-109.358612
11645,3,25,8,3,7,10,56,38.272947258733254,-109.3583425
11646,2,31,11,3,9,12,68,38.272947258733254,-109.358073
11647,3,22,14,2,6,20,67,38.272947258733254,-109.3578035
11648,1,21,18,1,5,29,75,38.272947258733254,-109.357534
11649,3,22,20,0,9,30,84,38.272947258733254,-109.3572645
11650,6,22,17,3,6,28,82,38.272947258733254,-109.356995
11651,5,29,16,0,9,25,84,38.272947258733254,-109.3567255
11652,1,29,14,0,12,17,73,38.272947258733254,-109.356456
11653,8,32,12,2,13,10,77,38.272947258733254,-109.3561865
11654,4,29,12,8,19,3,75,38.272947258733254,-109.355917
11655,5,20,13,8,17,5,68,38.272947258733254,-109.3556475
11656,4,17,9,4,15,3,52,38.272947258733254,-109.355378
11657,1,16,10,6,14,8,55,38.272947258733254,-109.3551086
11658,3,22,12,5,5,12,59,38.272947258733254,-109.3548391
11659,6,19,10,2,5,12,54,38.272947258733254,-109.3545696
11660,3,22,7,4,10,6,52,38.272947258733254,-109.3543001
11661,2,36,6,3,9,5,61,38.272947258733254,-109.3540306
11662,3,33,9,5,9,7,66,38.272947258733254,-109.3537611
11663,3,29,9,6,8,9,64,38.272947258733254,-109.3534916
11664,4,26,14,5,6,18,73,38.272947258733254,-109.3532221
11665,4,24,15,8,8,18,77,38.272947258733254,-109.3529526
11666,3,27,15,8,13,13,79,38.272947258733254,-109.3526831
11667,1,19,13,12,12,11,68,38.272947258733254,-109.3524136
11668,1,15,11,10,14,9,60,38.272947258733254,-109.3521441
11669,4,17,12,5,12,11,61,38.272947258733254,-109.3518746
11670,3,24,16,1,8,22,74,38.272947258733254,-109.3516051
11671,4,20,15,7,6,27,79,38.272947258733254,-109.3513356
11672,6,22,16,6,5,25,80,38.272947258733254,-109.3510661
11673,2,17,14,3,3,26,65,38.272947258733254,-109.3507966
11674,1,14,12,3,3,24,57,38.272947258733254,-109.3505271
11675,3,12,13,5,4,21,58,38.272947258733254,-109.3502577
11676,4,7,13,6,5,18,53,38.272947258733254,-109.3499882
11677,4,7,12,6,5,17,51,38.272947258733254,-109.3497187
11678,5,8,12,6,7,15,53,38.272947258733254,-109.3494492
11679,6,10,13,6,6,14,55,38.272947258733254,-109.3491797
11680,2,15,15,4,4,20,60,38.272947258733254,-109.3489102
11681,1,18,16,0,1,27,63,38.272947258733254,-109.3486407
11682,1,20,17,0,2,27,67,38.272947258733254,-109.3483712
11683,2,21,17,2,3,25,70,38.272947258733254,-109.3481017
11684,2,22,17,2,3,27,73,38.272947258733254,-109.3478322
11685,3,22,18,4,5,26,78,38.272947258733254,-109.3475627
11686,1,20,18,1,4,31,75,38.272947258733254,-109.3472932
11687,1,19,18,0,3,32,73,38.272947258733254,-109.3470237
11688,1,20,18,0,3,30,72,38.272947258733254,-109.3467542
11689,2,22,19,1,5,28,77,38.272947258733254,-109.3464847
11690,2,22,18,0,2,27,71,38.272947258733254,-109.3462152
11691,1,14,14,3,4,19,55,38.272947258733254,-109.3459457
11692,3,17,14,6,7,12,59,38.272947258733254,-109.3456762
11693,0,20,14,2,5,18,59,38.272947258733254,-109.3454068
11694,0,20,17,1,4,29,71,38.272947258733254,-109.3451373
11695,1,24,20,2,6,32,85,38.272947258733254,-109.3448678
11696,1,20,20,3,7,34,85,38.272947258733254,-109.3445983
11697,1,20,20,1,8,35,85,38.272947258733254,-109.3443288
11698,3,21,19,5,10,27,85,38.272947258733254,-109.3440593
11699,12,24,16,25,2,11,90,38.272947258733254,-109.3437898
11700,12,28,16,24,4,8,92,38.272947258733254,-109.3435203
11701,11,28,15,21,9,7,91,38.272947258733254,-109.3432508
11702,10,28,15,15,13,8,89,38.272947258733254,-109.3429813
11703,8,29,15,14,15,6,87,38.272947258733254,-109.3427118
11704,7,28,15,15,13,7,85,38.272947258733254,-109.3424423
11705,5,27,15,12,10,10,79,38.272947258733254,-109.3421728
11706,6,28,15,12,9,11,81,38.272947258733254,-109.3419033
11707,10,32,16,15,9,7,89,38.272947258733254,-109.3416338
11708,7,32,16,12,10,8,85,38.272947258733254,-109.3413643
11709,6,32,14,13,11,6,82,38.272947258733254,-109.3410948
11710,8,34,14,17,10,4,87,38.272947258733254,-109.3408253
11711,12,34,15,21,7,2,91,38.272947258733254,-109.3405558
11712,3,54,12,3,17,2,91,38.272677764148014,-109.4362264
11713,3,52,12,2,17,3,89,38.272677764148014,-109.4359569
11714,3,54,12,3,17,3,92,38.272677764148014,-109.4356874
11715,3,52,11,3,16,3,88,38.272677764148014,-109.4354179
11716,3,50,11,3,15,3,85,38.272677764148014,-109.4351484
11717,3,48,12,4,16,3,86,38.272677764148014,-109.434879
11718,3,46,12,4,16,4,85,38.272677764148014,-109.4346095
11719,3,48,12,3,15,5,86,38.272677764148014,-109.43434
11720,3,46,12,2,15,7,85,38.272677764148014,-109.4340705
11721,2,44,11,0,15,9,81,38.272677764148014,-109.433801
11722,2,44,11,0,13,10,80,38.272677764148014,-109.4335315
11723,2,44,11,2,10,7,76,38.272677764148014,-109.433262
11724,3,36,10,4,9,5,67,38.272677764148014,-109.4329925
11725,3,29,10,5,9,5,61,38.272677764148014,-109.432723
11726,4,27,10,6,9,6,62,38.272677764148014,-109.4324535
11727,4,29,12,8,13,7,73,38.272677764148014,-109.432184
11728,10,28,14,11,15,8,86,38.272677764148014,-109.4319145
11729,10,27,13,11,15,9,85,38.272677764148014,-109.431645
11730,8,27,14,10,10,13,82,38.272677764148014,-109.4313755
11731,3,31,13,5,10,17,79,38.272677764148014,-109.431106
11732,1,34,13,6,18,13,85,38.272677764148014,-109.4308365
11733,1,34,13,9,22,7,86,38.272677764148014,-109.430567
11734,0,34,12,6,20,9,81,38.272677764148014,-109.4302975
11735,0,34,12,3,16,11,76,38.272677764148014,-109.430028
11736,1,37,12,0,15,12,77,38.272677764148014,-109.4297586
11737,0,35,12,0,13,15,75,38.272677764148014,-109.4294891
11738,0,34,13,0,11,19,77,38.272677764148014,-109.4292196
11739,0,35,12,0,10,19,76,38.272677764148014,-109.4289501
11740,0,34,11,0,12,16,73,38.272677764148014,-109.4286806
11741,1,30,11,2,13,11,68,38.272677764148014,-109.4284111
11742,2,34,10,1,14,9,70,38.272677764148014,-109.4281416
11743,2,38,10,0,12,9,71,38.272677764148014,-109.4278721
11744,2,36,9,0,10,9,66,38.272677764148014,-109.4276026
11745,2,36,9,3,10,7,67,38.272677764148014,-109.4273331
11746,1,34,9,3,9,9,65,38.272677764148014,-109.4270636
11747,2,35,8,3,9,7,64,38.272677764148014,-109.4267941
11748,1,37,8,3,9,6,64,38.272677764148014,-109.4265246
11749,1,38,8,3,9,6,65,38.272677764148014,-109.4262551
11750,1,38,7,2,9,7,64,38.272677764148014,-109.4259856
11751,1,39,7,1,8,7,63,38.272677764148014,-109.4257161
11752,2,38,7,2,9,5,63,38.272677764148014,-109.4254466
11753,1,37,7,2,10,5,62,38.272677764148014,-109.4251771
11754,1,38,8,2,10,5,64,38.272677764148014,-109.4249077
11755,2,41,9,4,10,4,70,38.272677764148014,-109.4246382
11756,4,39,11,5,12,4,75,38.272677764148014,-109.4243687
11757,4,42,11,3,11,6,77,38.272677764148014,-109.4240992
11758,3,43,10,2,12,8,78,38.272677764148014,-109.4238297
11759,3,42,11,1,13,9,79,38.272677764148014,-109.4235602
11760,4,45,13,2,16,6,86,38.272677764148014,-109.4232907
11761,4,45,13,3,17,5,87,38.272677764148014,-109.4230212
11762,5,45,12,4,18,3,87,38.272677764148014,-109.4227517
11763,4,47,12,4,18,2,87,38.272677764148014,-109.4224822
11764,4,48,12,4,18,2,88,38.272677764148014,-109.4222127
11765,5,47,12,5,18,2,89,38.272677764148014,-109.4219432
11766,4,45,12,4,18,4,87,38.272677764148014,-109.4216737
11767,4,45,13,4,18,5,89,38.272677764148014,-109.4214042
11768,3,44,13,3,17,7,87,38.272677764148014,-109.4211347
11769,2,42,11,0,13,12,80,38.272677764148014,-109.4208652
11770,1,39,11,0,11,14,76,38.272677764148014,-109.4205957
11771,1,36,11,0,13,13,74,38.272677764148014,-109.4203262
11772,1,35,12,0,13,15,76,38.272677764148014,-109.4200568
11773,4,31,14,3,8,20,80,38.272677764148014,-109.4197873
11774,7,32,14,7,9,14,83,38.272677764148014,-109.4195178
11775,9,30,13,7,5,13,77,38.272677764148014,-109.4192483
11776,6,41,12,6,18,3,86,38.272677764148014,-109.4189788
11777,8,43,13,8,18,1,91,38.272677764148014,-109.4187093
11778,7,45,13,6,19,0,90,38.272677764148014,-109.4184398
11779,6,46,13,4,18,2,89,38.272677764148014,-109.4181703
11780,7,46,13,6,18,1,91,38.272677764148014,-109.4179008
11781,7,44,13,8,17,1,90,38.272677764148014,-109.4176313
11782,9,43,13,9,17,0,91,38.272677764148014,-109.4173618
11783,10,42,13,9,17,0,91,38.272677764148014,-109.4170923
11784,12,41,13,10,16,0,92,38.272677764148014,-109.4168228
11785,11,40,13,11,15,0,90,38.272677764148014,-109.4165533
11786,10,40,13,11,14,1,89,38.272677764148014,-109.4162838
11787,9,41,12,10,14,1,87,38.272677764148014,-109.4160143
11788,10,44,13,7,14,0,88,38.272677764148014,-109.4157448
11789,9,44,13,6,16,0,88,38.272677764148014,-109.4154753
11790,8,46,13,7,16,0,90,38.272677764148014,-109.4152058
11791,7,48,13,8,16,0,92,38.272677764148014,-109.4149364
11792,8,45,13,9,16,0,91,38.272677764148014,-109.4146669
11793,11,40,14,11,14,1,91,38.272677764148014,-109.4143974
11794,12,42,13,9,15,1,92,38.272677764148014,-109.4141279
11795,12,41,13,9,15,1,91,38.272677764148014,-109.4138584
11796,12,40,14,10,15,1,92,38.272677764148014,-109.4135889
11797,10,40,14,10,15,1,90,38.272677764148014,-109.4133194
11798,7,45,13,7,17,1,90,38.272677764148014,-109.4130499
11799,9,46,13,7,17,1,93,38.272677764148014,-109.4127804
11800,10,44,13,8,16,1,92,38.272677764148014,-109.4125109
11801,10,42,13,9,16,1,91,38.272677764148014,-109.4122414
11802,9,45,13,9,17,0,93,38.272677764148014,-109.4119719
11803,7,47,13,8,17,1,93,38.272677764148014,-109.4117024
11804,6,46,13,8,17,1,91,38.272677764148014,-109.4114329
11805,5,44,13,8,17,1,88,38.272677764148014,-109.4111634
11806,6,44,12,7,18,1,88,38.272677764148014,-109.4108939
11807,5,47,12,5,18,1,88,38.272677764148014,-109.4106244
11808,5,50,11,5,18,0,89,38.272677764148014,-109.4103549
11809,6,52,11,7,14,0,90,38.272677764148014,-109.4100855
11810,7,52,11,9,13,0,92,38.272677764148014,-109.409816
11811,6,51,11,6,16,0,90,38.272677764148014,-109.4095465
11812,5,50,13,5,19,0,92,38.272677764148014,-109.409277
11813,6,47,13,7,18,0,91,38.272677764148014,-109.4090075
11814,6,45,13,8,18,0,90,38.272677764148014,-109.408738
11815,6,44,13,8,18,1,90,38.272677764148014,-109.4084685
11816,5,45,12,6,18,2,88,38.272677764148014,-109.408199
11817,5,45,13,7,19,1,90,38.272677764148014,-109.4079295
11818,6,46,13,7,19,1,92,38.272677764148014,-109.40766
11819,6,46,12,7,18,1,90,38.272677764148014,-109.4073905
11820,7,46,12,6,18,1,90,38.272677764148014,-109.407121
11821,6,47,13,7,18,0,91,38.272677764148014,-109.4068515
11822,2,38,11,6,10,7,74,38.272677764148014,-109.3879869
11823,3,31,12,3,7,14,70,38.272677764148014,-109.3877174
11824,2,38,11,0,10,14,75,38.272677764148014,-109.3874479
11825,4,44,11,0,12,10,81,38.272677764148014,-109.3871784
11826,3,41,12,1,11,13,81,38.272677764148014,-109.3869089
11827,2,32,13,0,8,18,73,38.272677764148014,-109.3866394
11828,1,27,13,1,6,20,68,38.272677764148014,-109.3863699
11829,1,27,13,0,6,21,68,38.272677764148014,-109.3861004
11830,1,28,13,0,7,20,69,38.272677764148014,-109.3858309
11831,2,31,12,1,10,15,71,38.272677764148014,-109.3855614
11832,1,26,13,0,5,21,66,38.272677764148014,-109.3852919
11833,1,24,13,0,4,23,65,38.272677764148014,-109.3850225
11834,1,23,14,0,3,24,65,38.272677764148014,-109.384753
11835,2,24,14,0,3,24,67,38.272677764148014,-109.3844835
11836,0,27,12,0,6,19,64,38.272677764148014,-109.384214
11837,1,29,12,0,8,16,66,38.272677764148014,-109.3839445
11838,3,31,12,1,9,14,70,38.272677764148014,-109.383675
11839,5,34,12,3,10,11,75,38.272677764148014,-109.3834055
11840,5,39,12,5,10,8,79,38.272677764148014,-109.383136
11841,4,36,10,4,8,10,72,38.272677764148014,-109.3828665
11842,2,33,10,3,9,11,68,38.272677764148014,-109.382597
11843,6,34,13,8,6,10,77,38.272677764148014,-109.3823275
11844,4,29,11,6,7,8,65,38.272677764148014,-109.382058
11845,6,36,8,6,10,3,69,38.272677764148014,-109.3817885
11846,9,23,9,9,8,5,63,38.272677764148014,-109.381519
11847,13,22,8,7,6,8,64,38.272677764148014,-109.3812495
11848,9,25,14,6,4,15,73,38.272677764148014,-109.38098
11849,7,25,15,3,4,20,74,38.272677764148014,-109.3807105
11850,6,25,15,3,5,18,72,38.272677764148014,-109.380441
11851,4,24,15,2,5,20,70,38.272677764148014,-109.3801716
11852,4,26,13,3,6,16,68,38.272677764148014,-109.3799021
11853,4,30,12,4,9,12,71,38.272677764148014,-109.3796326
11854,3,27,13,4,8,15,70,38.272677764148014,-109.3793631
11855,2,21,14,2,3,23,65,38.272677764148014,-109.3790936
11856,2,21,14,1,4,23,65,38.272677764148014,-109.3788241
11857,2,22,14,1,4,24,67,38.272677764148014,-109.3785546
11858,2,23,14,1,4,23,67,38.272677764148014,-109.3782851
11859,2,26,12,1,6,18,65,38.272677764148014,-109.3780156
11860,4,30,12,1,8,14,69,38.272677764148014,-109.3777461
11861,3,24,14,2,5,19,67,38.272677764148014,-109.3774766
11862,3,21,16,1,4,25,70,38.272677764148014,-109.3772071
11863,5,25,15,4,3,22,74,38.272677764148014,-109.3769376
11864,1,41,11,0,10,13,76,38.272677764148014,-109.3766681
11865,2,41,10,1,11,11,76,38.272677764148014,-109.3763986
11866,2,37,10,1,9,12,71,38.272677764148014,-109.3761291
11867,1,30,11,2,7,15,66,38.272677764148014,-109.3758596
11868,1,28,10,2,7,15,63,38.272677764148014,-109.3755901
11869,1,27,12,0,4,19,63,38.272677764148014,-109.3753206
11870,1,25,14,1,6,21,68,38.272677764148014,-109.3750512
11871,2,27,14,3,9,19,74,38.272677764148014,-109.3747817
11872,6,32,15,6,8,16,83,38.272677764148014,-109.3745122
11873,4,29,15,4,7,18,77,38.272677764148014,-109.3742427
11874,4,32,13,3,9,13,74,38.272677764148014,-109.3739732
11875,5,27,12,5,9,12,70,38.272677764148014,-109.3737037
11876,5,19,13,8,8,12,65,38.272677764148014,-109.3734342
11877,11,23,11,12,13,3,73,38.272677764148014,-109.3731647
11878,11,19,12,18,8,9,77,38.272677764148014,-109.3728952
11879,5,24,14,4,3,19,69,38.272677764148014,-109.3726257
11880,2,26,13,0,10,18,69,38.272677764148014,-109.3723562
11881,1,28,12,5,15,9,70,38.272677764148014,-109.3720867
11882,6,29,12,8,20,0,75,38.272677764148014,-109.3718172
11883,8,16,10,9,12,0,55,38.272677764148014,-109.3715477
11884,3,35,9,5,6,7,65,38.272677764148014,-109.3712782
11885,2,42,8,5,9,5,71,38.272677764148014,-109.3710087
11886,2,47,7,4,10,5,75,38.272677764148014,-109.3707392
11887,3,47,8,6,9,4,77,38.272677764148014,-109.3704697
11888,4,44,8,6,9,4,75,38.272677764148014,-109.3702003
11889,4,43,8,6,10,4,75,38.272677764148014,-109.3699308
11890,3,37,7,4,9,5,65,38.272677764148014,-109.3696613
11891,4,34,7,4,9,5,63,38.272677764148014,-109.3693918
11892,2,27,6,1,8,6,50,38.272677764148014,-109.3691223
11893,1,23,8,2,9,7,50,38.272677764148014,-109.3688528
11894,1,29,10,4,8,10,62,38.272677764148014,-109.3685833
11895,1,31,11,1,10,14,68,38.272677764148014,-109.3683138
11896,1,24,12,1,7,20,65,38.272677764148014,-109.3680443
11897,2,26,13,2,11,17,71,38.272677764148014,-109.3677748
11898,2,26,14,4,13,16,75,38.272677764148014,-109.3675053
11899,4,27,15,6,15,15,82,38.272677764148014,-109.3672358
11900,10,26,17,8,13,11,85,38.272677764148014,-109.3669663
11901,5,29,14,12,19,3,82,38.272677764148014,-109.3666968
11902,2,23,12,11,21,4,73,38.272677764148014,-109.3664273
11903,3,12,9,15,17,1,57,38.272677764148014,-109.3661578
11904,3,15,10,20,13,1,62,38.272677764148014,-109.3658883
11905,1,21,9,12,15,4,62,38.272677764148014,-109.3656188
11906,6,24,12,10,12,7,71,38.272677764148014,-109.3653493
11907,1,23,18,0,4,30,76,38.272677764148014,-109.3650799
11908,0,22,17,0,3,31,73,38.272677764148014,-109.3648104
11909,0,23,15,0,4,28,70,38.272677764148014,-109.3645409
11910,0,24,16,0,4,28,72,38.272677764148014,-109.3642714
11911,0,24,17,0,3,30,74,38.272677764148014,-109.3640019
11912,2,23,16,0,3,30,74,38.272677764148014,-109.3637324
11913,2,22,16,0,3,27,70,38.272677764148014,-109.3634629
11914,1,22,15,1,2,26,67,38.272677764148014,-109.3631934
11915,0,22,13,0,1,24,60,38.272677764148014,-109.3629239
11916,0,23,12,0,2,24,61,38.272677764148014,-109.3626544
11917,0,24,12,0,2,23,61,38.272677764148014,-109.3623849
11918,1,25,12,1,3,20,62,38.272677764148014,-109.3621154
11919,2,22,13,2,4,18,61,38.272677764148014,-109.3618459
11920,1,18,14,1,3,21,58,38.272677764148014,-109.3615764
11921,1,18,13,1,3,20,56,38.272677764148014,-109.3613069
11922,4,21,11,5,6,13,60,38.272677764148014,-109.3610374
11923,4,21,8,3,8,8,52,38.272677764148014,-109.3607679
11924,2,22,7,3,7,6,47,38.272677764148014,-109.3604984
11925,3,22,7,2,8,5,47,38.272677764148014,-109.360229
11926,2,18,6,0,8,7,41,38.272677764148014,-109.3599595
11927,2,21,7,1,7,7,45,38.272677764148014,-109.35969
11928,2,26,8,3,7,8,54,38.272677764148014,-109.3594205
11929,3,28,9,5,8,8,61,38.272677764148014,-109.359151
11930,2,27,11,3,6,14,63,38.272677764148014,-109.3588815
11931,2,30,11,1,7,16,67,38.272677764148014,-109.358612
11932,1,33,11,0,9,16,70,38.272677764148014,-109.3583425
11933,2,31,11,1,9,15,69,38.272677764148014,-109.358073
11934,2,18,16,2,3,25,66,38.272677764148014,-109.3578035
11935,1,19,21,0,5,36,82,38.272677764148014,-109.357534
11936,1,20,20,1,5,35,82,38.272677764148014,-109.3572645
11937,1,25,18,0,9,29,82,38.272677764148014,-109.356995
11938,3,29,17,1,11,23,84,38.272677764148014,-109.3567255
11939,4,32,15,1,16,13,81,38.272677764148014,-109.356456
11940,7,29,14,5,17,9,81,38.272677764148014,-109.3561865
11941,1,26,13,10,20,5,75,38.272677764148014,-109.355917
11942,5,20,13,12,17,2,69,38.272677764148014,-109.3556475
11943,4,16,9,7,15,1,52,38.272677764148014,-109.355378
11944,5,18,10,10,7,8,58,38.272677764148014,-109.3551086
11945,8,28,8,5,5,7,61,38.272677764148014,-109.3548391
11946,3,24,6,6,8,5,52,38.272677764148014,-109.3545696
11947,3,18,7,5,6,7,46,38.272677764148014,-109.3543001
11948,5,26,9,4,8,7,59,38.272677764148014,-109.3540306
11949,3,45,10,4,8,10,80,38.272677764148014,-109.3537611
11950,3,37,11,3,6,15,75,38.272677764148014,-109.3534916
11951,1,22,14,2,4,23,66,38.272677764148014,-109.3532221
11952,7,22,16,5,8,19,77,38.272677764148014,-109.3529526
11953,4,24,14,10,8,17,77,38.272677764148014,-109.3526831
11954,1,17,11,5,12,10,56,38.272677764148014,-109.3524136
11955,6,17,12,6,15,6,62,38.272677764148014,-109.3521441
11956,6,21,15,3,14,11,70,38.272677764148014,-109.3518746
11957,1,24,17,1,10,22,75,38.272677764148014,-109.3516051
11958,4,22,16,4,10,21,77,38.272677764148014,-109.3513356
11959,2,24,16,2,8,22,74,38.272677764148014,-109.3510661
11960,2,18,15,1,2,26,64,38.272677764148014,-109.3507966
11961,2,15,13,2,3,23,58,38.272677764148014,-109.3505271
11962,3,14,13,3,3,22,58,38.272677764148014,-109.3502577
11963,2,13,13,4,3,21,56,38.272677764148014,-109.3499882
11964,2,11,13,5,4,19,54,38.272677764148014,-109.3497187
11965,2,10,13,5,4,18,52,38.272677764148014,-109.3494492
11966,2,14,13,4,4,18,55,38.272677764148014,-109.3491797
11967,1,14,12,3,3,20,53,38.272677764148014,-109.3489102
11968,1,15,15,0,1,26,58,38.272677764148014,-109.3486407
11969,1,16,16,0,1,29,63,38.272677764148014,-109.3483712
11970,1,17,17,2,2,28,67,38.272677764148014,-109.3481017
11971,3,20,17,5,3,25,73,38.272677764148014,-109.3478322
11972,2,20,18,5,3,27,75,38.272677764148014,-109.3475627
11973,2,19,18,3,2,29,73,38.272677764148014,-109.3472932
11974,1,18,18,2,3,30,72,38.272677764148014,-109.3470237
11975,1,19,18,1,4,30,73,38.272677764148014,-109.3467542
11976,2,22,19,2,5,29,79,38.272677764148014,-109.3464847
11977,3,23,19,3,5,27,80,38.272677764148014,-109.3462152
11978,1,20,16,1,3,25,66,38.272677764148014,-109.3459457
11979,0,19,14,1,4,21,59,38.272677764148014,-109.3456762
11980,0,23,13,2,7,17,62,38.272677764148014,-109.3454068
11981,1,26,14,1,6,20,68,38.272677764148014,-109.3451373
11982,0,24,14,1,5,22,66,38.272677764148014,-109.3448678
11983,0,24,17,2,4,27,74,38.272677764148014,-109.3445983
11984,0,26,19,2,6,31,84,38.272677764148014,-109.3443288
11985,1,25,19,3,7,29,84,38.272677764148014,-109.3440593
11986,8,24,16,18,5,16,87,38.272677764148014,-109.3437898
11987,12,25,16,18,7,12,90,38.272677764148014,-109.3435203
11988,14,25,17,16,8,11,91,38.272677764148014,-109.3432508
11989,13,25,17,17,10,10,92,38.272677764148014,-109.3429813
11990,9,28,15,16,15,6,89,38.272677764148014,-109.3427118
11991,7,29,15,13,13,8,85,38.272677764148014,-109.3424423
11992,5,27,15,11,11,10,79,38.272677764148014,-109.3421728
11993,5,27,15,11,10,11,79,38.272677764148014,-109.3419033
11994,9,30,15,12,10,9,85,38.272677764148014,-109.3416338
11995,7,30,15,14,10,7,83,38.272677764148014,-109.3413643
11996,7,31,14,15,11,5,83,38.272677764148014,-109.3410948
11997,9,34,15,18,10,4,90,38.272677764148014,-109.3408253
11998,13,32,15,22,8,2,92,38.272677764148014,-109.3405558
11999,13,32,14,21,7,3,90,38.272677764148014,-109.3402864
12000,3,53,11,1,17,3,88,38.27240826956278,-109.4364959
12001,3,51,11,2,17,4,88,38.27240826956278,-109.4362264
12002,2,49,11,3,15,6,86,38.27240826956278,-109.4359569
12003,2,47,12,3,16,5,85,38.27240826956278,-109.4356874
12004,3,49,12,4,16,3,87,38.27240826956278,-109.4354179
12005,3,51,11,3,15,3,86,38.27240826956278,-109.4351484
12006,3,49,11,3,14,4,84,38.27240826956278,-109.434879
12007,3,46,11,2,14,6,82,38.27240826956278,-109.4346095
12008,3,46,11,2,12,7,81,38.27240826956278,-109.43434
12009,2,40,11,0,12,10,75,38.27240826956278,-109.4340705
12010,2,38,11,1,10,10,72,38.27240826956278,-109.433801
12011,2,40,10,2,9,7,70,38.27240826956278,-109.4335315
12012,1,36,9,1,9,8,64,38.27240826956278,-109.433262
12013,2,29,9,3,9,7,59,38.27240826956278,-109.4329925
12014,4,28,11,9,12,4,68,38.27240826956278,-109.432723
12015,5,27,12,18,20,2,84,38.27240826956278,-109.4324535
12016,11,19,13,14,34,1,92,38.27240826956278,-109.432184
12017,8,19,12,25,25,3,92,38.27240826956278,-109.4319145
12018,8,25,13,15,16,10,87,38.27240826956278,-109.431645
12019,3,29,14,9,13,17,85,38.27240826956278,-109.4313755
12020,1,31,15,5,15,18,85,38.27240826956278,-109.431106
12021,2,34,13,8,20,7,84,38.27240826956278,-109.4308365
12022,0,35,14,3,18,13,83,38.27240826956278,-109.430567
12023,0,34,14,0,14,18,80,38.27240826956278,-109.4302975
12024,0,35,14,0,13,19,81,38.27240826956278,-109.430028
12025,0,35,12,0,12,17,76,38.27240826956278,-109.4297586
12026,0,37,12,0,12,16,77,38.27240826956278,-109.4294891
12027,0,36,13,0,11,18,78,38.27240826956278,-109.4292196
12028,0,34,14,0,12,21,81,38.27240826956278,-109.4289501
12029,0,32,14,0,13,20,79,38.27240826956278,-109.4286806
12030,1,33,12,0,13,15,74,38.27240826956278,-109.4284111
12031,1,35,11,0,12,14,73,38.27240826956278,-109.4281416
12032,2,36,10,0,12,13,73,38.27240826956278,-109.4278721
12033,1,35,10,0,11,13,70,38.27240826956278,-109.4276026
12034,1,32,10,0,10,13,66,38.27240826956278,-109.4273331
12035,1,35,10,0,10,13,69,38.27240826956278,-109.4270636
12036,2,35,10,1,10,12,70,38.27240826956278,-109.4267941
12037,2,32,10,2,7,12,65,38.27240826956278,-109.4265246
12038,1,32,9,2,8,10,62,38.27240826956278,-109.4262551
12039,2,35,9,4,9,6,65,38.27240826956278,-109.4259856
12040,2,38,8,2,10,6,66,38.27240826956278,-109.4257161
12041,2,40,9,3,12,6,72,38.27240826956278,-109.4254466
12042,3,41,9,2,10,7,72,38.27240826956278,-109.4251771
12043,3,40,10,2,11,7,73,38.27240826956278,-109.4249077
12044,3,43,10,3,14,5,78,38.27240826956278,-109.4246382
12045,3,45,11,3,14,4,80,38.27240826956278,-109.4243687
12046,4,44,10,2,13,7,80,38.27240826956278,-109.4240992
12047,3,43,11,1,12,9,79,38.27240826956278,-109.4238297
12048,3,45,11,2,14,8,83,38.27240826956278,-109.4235602
12049,4,47,13,4,16,4,88,38.27240826956278,-109.4232907
12050,4,49,13,4,18,2,90,38.27240826956278,-109.4230212
12051,5,48,12,4,18,2,89,38.27240826956278,-109.4227517
12052,4,49,12,4,18,2,89,38.27240826956278,-109.4224822
12053,4,49,12,4,18,2,89,38.27240826956278,-109.4222127
12054,4,48,12,5,18,2,89,38.27240826956278,-109.4219432
12055,5,46,12,4,18,2,87,38.27240826956278,-109.4216737
12056,5,46,12,4,19,2,88,38.27240826956278,-109.4214042
12057,4,46,13,4,18,4,89,38.27240826956278,-109.4211347
12058,3,44,12,2,16,8,85,38.27240826956278,-109.4208652
12059,2,41,11,0,13,11,78,38.27240826956278,-109.4205957
12060,2,40,11,0,13,11,77,38.27240826956278,-109.4203262
12061,2,37,11,0,14,11,75,38.27240826956278,-109.4200568
12062,2,33,11,0,12,12,70,38.27240826956278,-109.4197873
12063,1,29,9,2,15,8,64,38.27240826956278,-109.4195178
12064,3,36,11,3,16,6,75,38.27240826956278,-109.4192483
12065,8,40,12,8,17,1,86,38.27240826956278,-109.4189788
12066,11,41,13,10,16,0,91,38.27240826956278,-109.4187093
12067,10,40,13,10,17,0,90,38.27240826956278,-109.4184398
12068,8,44,13,8,17,0,90,38.27240826956278,-109.4181703
12069,7,44,12,8,16,0,87,38.27240826956278,-109.4179008
12070,8,42,12,10,15,0,87,38.27240826956278,-109.4176313
12071,9,41,13,11,15,0,89,38.27240826956278,-109.4173618
12072,8,41,13,10,15,0,87,38.27240826956278,-109.4170923
12073,5,44,12,9,15,0,85,38.27240826956278,-109.4168228
12074,6,40,12,10,13,1,82,38.27240826956278,-109.4165533
12075,7,40,12,10,12,1,82,38.27240826956278,-109.4162838
12076,9,38,13,11,12,1,84,38.27240826956278,-109.4160143
12077,16,32,14,11,11,2,86,38.27240826956278,-109.4157448
12078,13,36,13,12,13,1,88,38.27240826956278,-109.4154753
12079,10,40,13,12,14,0,89,38.27240826956278,-109.4152058
12080,11,42,13,11,15,0,92,38.27240826956278,-109.4149364
12081,13,40,14,11,14,0,92,38.27240826956278,-109.4146669
12082,12,39,14,12,14,0,91,38.27240826956278,-109.4143974
12083,11,41,14,11,14,1,92,38.27240826956278,-109.4141279
12084,9,42,14,10,15,1,91,38.27240826956278,-109.4138584
12085,9,43,14,8,16,1,91,38.27240826956278,-109.4135889
12086,10,42,14,8,15,1,90,38.27240826956278,-109.4133194
12087,9,44,13,7,17,1,91,38.27240826956278,-109.4130499
12088,9,44,13,7,16,1,90,38.27240826956278,-109.4127804
12089,10,43,13,8,15,1,90,38.27240826956278,-109.4125109
12090,12,42,13,8,15,1,91,38.27240826956278,-109.4122414
12091,11,41,13,8,16,1,90,38.27240826956278,-109.4119719
12092,8,45,13,8,17,1,92,38.27240826956278,-109.4117024
12093,6,46,13,8,16,1,90,38.27240826956278,-109.4114329
12094,6,48,13,7,17,1,92,38.27240826956278,-109.4111634
12095,6,48,13,6,18,1,92,38.27240826956278,-109.4108939
12096,5,49,12,4,19,2,91,38.27240826956278,-109.4106244
12097,5,52,10,4,16,1,88,38.27240826956278,-109.4103549
12098,6,53,10,6,14,1,90,38.27240826956278,-109.4100855
12099,6,53,11,6,15,1,92,38.27240826956278,-109.409816
12100,5,51,12,5,17,1,91,38.27240826956278,-109.4095465
12101,8,48,12,8,16,0,92,38.27240826956278,-109.409277
12102,9,45,13,9,16,0,92,38.27240826956278,-109.4090075
12103,8,46,13,8,17,0,92,38.27240826956278,-109.408738
12104,6,47,13,7,17,1,91,38.27240826956278,-109.4084685
12105,7,47,13,6,17,1,91,38.27240826956278,-109.408199
12106,6,47,13,7,18,1,92,38.27240826956278,-109.4079295
12107,6,46,13,7,18,1,91,38.27240826956278,-109.40766
12108,7,45,13,7,18,0,90,38.27240826956278,-109.4073905
12109,8,45,13,7,18,0,91,38.27240826956278,-109.407121
12110,8,45,13,8,17,0,91,38.27240826956278,-109.4068515
12111,2,40,11,1,11,11,76,38.27240826956278,-109.3879869
12112,3,27,14,2,6,19,71,38.27240826956278,-109.3877174
12113,2,26,13,0,5,20,66,38.27240826956278,-109.3874479
12114,2,33,12,0,8,16,71,38.27240826956278,-109.3871784
12115,2,36,12,0,9,17,76,38.27240826956278,-109.3869089
12116,2,36,12,0,10,16,76,38.27240826956278,-109.3866394
12117,2,30,12,0,6,18,68,38.27240826956278,-109.3863699
12118,1,27,12,0,6,20,66,38.27240826956278,-109.3861004
12119,1,27,12,0,6,20,66,38.27240826956278,-109.3858309
12120,1,27,12,1,8,18,67,38.27240826956278,-109.3855614
12121,1,24,14,0,5,23,67,38.27240826956278,-109.3852919
12122,0,23,13,0,5,25,66,38.27240826956278,-109.3850225
12123,0,23,14,0,5,25,67,38.27240826956278,-109.384753
12124,1,25,14,0,5,24,69,38.27240826956278,-109.3844835
12125,1,28,12,0,5,21,67,38.27240826956278,-109.384214
12126,3,29,13,0,8,17,70,38.27240826956278,-109.3839445
12127,6,34,13,5,11,9,78,38.27240826956278,-109.383675
12128,9,38,14,10,12,3,86,38.27240826956278,-109.3834055
12129,7,40,13,8,10,4,82,38.27240826956278,-109.383136
12130,4,42,10,4,9,7,76,38.27240826956278,-109.3828665
12131,2,41,11,1,11,9,75,38.27240826956278,-109.382597
12132,5,35,12,8,7,9,76,38.27240826956278,-109.3823275
12133,7,30,11,8,8,5,69,38.27240826956278,-109.382058
12134,13,35,11,6,9,2,76,38.27240826956278,-109.3817885
12135,15,27,10,7,6,5,70,38.27240826956278,-109.381519
12136,15,26,15,11,7,5,79,38.27240826956278,-109.3812495
12137,11,27,15,8,8,9,78,38.27240826956278,-109.38098
12138,8,27,15,6,7,13,76,38.27240826956278,-109.3807105
12139,8,31,16,7,9,12,83,38.27240826956278,-109.380441
12140,5,31,14,4,8,14,76,38.27240826956278,-109.3801716
12141,5,32,13,3,9,13,75,38.27240826956278,-109.3799021
12142,5,34,12,2,9,12,74,38.27240826956278,-109.3796326
12143,4,33,12,2,10,12,73,38.27240826956278,-109.3793631
12144,3,26,13,3,7,17,69,38.27240826956278,-109.3790936
12145,1,21,13,1,3,22,61,38.27240826956278,-109.3788241
12146,2,21,13,1,4,22,63,38.27240826956278,-109.3785546
12147,2,24,14,1,5,21,67,38.27240826956278,-109.3782851
12148,2,22,14,1,5,22,66,38.27240826956278,-109.3780156
12149,2,22,14,2,4,22,66,38.27240826956278,-109.3777461
12150,2,20,16,1,3,26,68,38.27240826956278,-109.3774766
12151,2,20,15,1,2,26,66,38.27240826956278,-109.3772071
12152,4,29,13,3,4,20,73,38.27240826956278,-109.3769376
12153,1,49,11,0,12,10,83,38.27240826956278,-109.3766681
12154,2,43,10,0,11,11,77,38.27240826956278,-109.3763986
12155,1,33,9,0,7,14,64,38.27240826956278,-109.3761291
12156,0,21,10,3,7,13,54,38.27240826956278,-109.3758596
12157,8,30,13,10,10,2,73,38.27240826956278,-109.3755901
12158,6,27,11,8,12,4,68,38.27240826956278,-109.3753206
12159,1,28,11,3,12,10,65,38.27240826956278,-109.3750512
12160,2,32,12,6,15,7,74,38.27240826956278,-109.3747817
12161,3,29,12,6,12,10,72,38.27240826956278,-109.3745122
12162,3,22,13,5,6,17,66,38.27240826956278,-109.3742427
12163,5,28,13,4,10,13,73,38.27240826956278,-109.3739732
12164,2,24,12,3,9,16,66,38.27240826956278,-109.3737037
12165,1,20,11,6,11,12,61,38.27240826956278,-109.3734342
12166,4,25,11,12,16,3,71,38.27240826956278,-109.3731647
12167,5,25,14,6,13,13,76,38.27240826956278,-109.3728952
12168,3,27,14,1,3,21,69,38.27240826956278,-109.3726257
12169,2,31,13,0,12,13,71,38.27240826956278,-109.3723562
12170,0,25,8,2,19,4,58,38.27240826956278,-109.3720867
12171,5,19,8,9,9,0,50,38.27240826956278,-109.3718172
12172,3,39,8,5,10,4,69,38.27240826956278,-109.3715477
12173,2,39,8,5,10,6,70,38.27240826956278,-109.3712782
12174,2,42,8,5,10,6,73,38.27240826956278,-109.3710087
12175,3,44,8,5,9,6,75,38.27240826956278,-109.3707392
12176,4,42,8,6,9,6,75,38.27240826956278,-109.3704697
12177,4,45,8,6,10,5,78,38.27240826956278,-109.3702003
12178,4,43,8,7,11,4,77,38.27240826956278,-109.3699308
12179,4,45,8,7,11,4,79,38.27240826956278,-109.3696613
12180,4,37,9,9,10,6,75,38.27240826956278,-109.3693918
12181,3,47,8,5,9,6,78,38.27240826956278,-109.3691223
12182,4,32,10,6,10,7,69,38.27240826956278,-109.3688528
12183,3,30,12,4,8,14,71,38.27240826956278,-109.3685833
12184,3,31,14,2,6,20,76,38.27240826956278,-109.3683138
12185,4,23,16,0,8,25,76,38.27240826956278,-109.3680443
12186,3,26,15,0,8,21,73,38.27240826956278,-109.3677748
12187,3,27,16,5,12,18,81,38.27240826956278,-109.3675053
12188,5,28,17,7,13,17,87,38.27240826956278,-109.3672358
12189,5,31,15,8,18,8,85,38.27240826956278,-109.3669663
12190,4,25,14,11,21,2,77,38.27240826956278,-109.3666968
12191,2,18,9,7,19,3,58,38.27240826956278,-109.3664273
12192,3,13,9,17,13,1,56,38.27240826956278,-109.3661578
12193,2,18,10,19,11,1,61,38.27240826956278,-109.3658883
12194,0,28,10,7,16,5,66,38.27240826956278,-109.3656188
12195,1,24,13,3,8,20,69,38.27240826956278,-109.3653493
12196,1,21,20,0,3,32,77,38.27240826956278,-109.3650799
12197,0,23,19,0,3,32,77,38.27240826956278,-109.3648104
12198,0,25,17,0,4,29,75,38.27240826956278,-109.3645409
12199,0,26,18,0,4,30,78,38.27240826956278,-109.3642714
12200,0,24,17,0,3,32,76,38.27240826956278,-109.3640019
12201,1,21,16,0,2,32,72,38.27240826956278,-109.3637324
12202,2,20,16,0,1,29,68,38.27240826956278,-109.3634629
12203,1,20,15,0,1,27,64,38.27240826956278,-109.3631934
12204,1,20,15,0,1,27,64,38.27240826956278,-109.3629239
12205,0,22,13,0,1,26,62,38.27240826956278,-109.3626544
12206,0,24,12,0,2,22,60,38.27240826956278,-109.3623849
12207,1,23,12,1,3,20,60,38.27240826956278,-109.3621154
12208,1,17,14,2,3,21,58,38.27240826956278,-109.3618459
12209,0,12,14,3,3,21,53,38.27240826956278,-109.3615764
12210,3,13,12,5,5,14,52,38.27240826956278,-109.3613069
12211,3,19,9,4,7,9,51,38.27240826956278,-109.3610374
12212,2,20,8,3,7,7,47,38.27240826956278,-109.3607679
12213,2,16,7,2,7,7,41,38.27240826956278,-109.3604984
12214,3,14,8,2,7,8,42,38.27240826956278,-109.360229
12215,3,14,9,5,7,9,47,38.27240826956278,-109.3599595
12216,2,20,11,4,6,12,55,38.27240826956278,-109.35969
12217,2,26,11,4,6,14,63,38.27240826956278,-109.3594205
12218,2,31,12,3,8,12,68,38.27240826956278,-109.359151
12219,2,31,12,2,10,12,69,38.27240826956278,-109.3588815
12220,2,29,12,0,9,15,67,38.27240826956278,-109.358612
12221,2,26,12,0,7,19,66,38.27240826956278,-109.3583425
12222,1,23,14,0,4,24,66,38.27240826956278,-109.358073
12223,1,23,17,0,4,32,77,38.27240826956278,-109.3578035
12224,2,25,18,1,6,32,84,38.27240826956278,-109.357534
12225,1,24,19,2,7,31,84,38.27240826956278,-109.3572645
12226,1,26,18,3,9,29,86,38.27240826956278,-109.356995
12227,0,24,17,4,12,24,81,38.27240826956278,-109.3567255
12228,2,25,13,10,17,9,76,38.27240826956278,-109.356456
12229,3,20,13,14,19,7,76,38.27240826956278,-109.3561865
12230,1,17,13,10,19,8,68,38.27240826956278,-109.355917
12231,0,11,9,15,10,4,49,38.27240826956278,-109.3556475
12232,10,20,10,10,14,1,65,38.27240826956278,-109.355378
12233,4,29,6,3,6,7,55,38.27240826956278,-109.3551086
12234,2,31,6,4,7,4,54,38.27240826956278,-109.3548391
12235,3,17,6,5,6,7,44,38.27240826956278,-109.3545696
12236,12,15,10,5,5,9,56,38.27240826956278,-109.3543001
12237,9,26,12,3,2,17,69,38.27240826956278,-109.3540306
12238,4,31,15,1,4,22,77,38.27240826956278,-109.3537611
12239,2,25,16,1,4,27,75,38.27240826956278,-109.3534916
12240,3,25,17,4,8,28,85,38.27240826956278,-109.3532221
12241,7,20,16,5,10,21,79,38.27240826956278,-109.3529526
12242,4,23,13,5,10,13,68,38.27240826956278,-109.3526831
12243,1,15,11,3,11,9,50,38.27240826956278,-109.3524136
12244,4,17,13,6,14,10,64,38.27240826956278,-109.3521441
12245,4,23,16,2,12,17,74,38.27240826956278,-109.3518746
12246,2,26,17,0,10,21,76,38.27240826956278,-109.3516051
12247,1,26,14,2,10,16,69,38.27240826956278,-109.3513356
12248,2,25,15,2,7,20,71,38.27240826956278,-109.3510661
12249,2,20,16,1,3,26,68,38.27240826956278,-109.3507966
12250,2,18,15,0,2,26,63,38.27240826956278,-109.3505271
12251,3,16,15,0,1,26,61,38.27240826956278,-109.3502577
12252,3,15,14,2,2,24,60,38.27240826956278,-109.3499882
12253,4,17,14,2,2,22,61,38.27240826956278,-109.3497187
12254,3,17,13,1,2,21,57,38.27240826956278,-109.3494492
12255,1,17,11,1,2,19,51,38.27240826956278,-109.3491797
12256,1,16,11,3,4,17,52,38.27240826956278,-109.3489102
12257,3,15,14,0,2,24,58,38.27240826956278,-109.3486407
12258,1,14,15,0,1,28,59,38.27240826956278,-109.3483712
12259,1,14,16,0,2,29,62,38.27240826956278,-109.3481017
12260,2,15,17,2,2,29,67,38.27240826956278,-109.3478322
12261,0,14,16,2,2,29,63,38.27240826956278,-109.3475627
12262,1,14,17,1,1,29,63,38.27240826956278,-109.3472932
12263,1,16,18,0,2,28,65,38.27240826956278,-109.3470237
12264,1,19,17,0,3,27,67,38.27240826956278,-109.3467542
12265,2,21,18,2,5,26,74,38.27240826956278,-109.3464847
12266,1,21,19,2,5,30,78,38.27240826956278,-109.3462152
12267,1,20,20,0,5,34,80,38.27240826956278,-109.3459457
12268,0,22,20,0,3,36,81,38.27240826956278,-109.3456762
12269,0,25,18,0,3,32,78,38.27240826956278,-109.3454068
12270,0,27,18,1,5,26,77,38.27240826956278,-109.3451373
12271,0,23,13,0,4,21,61,38.27240826956278,-109.3448678
12272,0,18,13,4,6,17,58,38.27240826956278,-109.3445983
12273,1,19,12,8,9,13,62,38.27240826956278,-109.3443288
12274,3,19,13,14,8,12,69,38.27240826956278,-109.3440593
12275,5,20,15,17,4,16,77,38.27240826956278,-109.3437898
12276,11,26,16,18,3,13,87,38.27240826956278,-109.3435203
12277,14,29,18,18,3,9,91,38.27240826956278,-109.3432508
12278,12,27,17,14,7,12,89,38.27240826956278,-109.3429813
12279,7,28,14,13,11,9,82,38.27240826956278,-109.3427118
12280,6,31,14,10,11,9,81,38.27240826956278,-109.3424423
12281,5,30,14,9,11,10,79,38.27240826956278,-109.3421728
12282,4,27,14,9,9,13,76,38.27240826956278,-109.3419033
12283,4,26,14,9,8,14,75,38.27240826956278,-109.3416338
12284,7,28,14,15,9,6,79,38.27240826956278,-109.3413643
12285,7,30,14,17,10,5,83,38.27240826956278,-109.3410948
12286,9,31,15,20,10,4,89,38.27240826956278,-109.3408253
12287,11,31,15,21,9,4,91,38.27240826956278,-109.3405558
12288,9,32,15,16,10,5,87,38.27240826956278,-109.3402864
12289,8,32,15,16,13,5,89,38.27240826956278,-109.3400169
12290,2,51,12,3,17,4,89,38.27213877497754,-109.4364959
12291,2,48,11,2,14,7,84,38.27213877497754,-109.4362264
12292,2,44,10,0,12,11,79,38.27213877497754,-109.4359569
12293,2,42,10,0,12,10,76,38.27213877497754,-109.4356874
12294,2,46,10,1,13,6,78,38.27213877497754,-109.4354179
12295,2,51,10,2,14,4,83,38.27213877497754,-109.4351484
12296,2,50,10,1,13,6,82,38.27213877497754,-109.434879
12297,2,42,10,0,12,9,75,38.27213877497754,-109.4346095
12298,2,38,10,0,8,11,69,38.27213877497754,-109.43434
12299,2,36,8,2,7,8,63,38.27213877497754,-109.4340705
12300,2,34,8,2,8,7,61,38.27213877497754,-109.433801
12301,2,31,7,3,9,6,58,38.27213877497754,-109.4335315
12302,3,26,8,6,10,6,59,38.27213877497754,-109.433262
12303,5,35,13,19,16,1,89,38.27213877497754,-109.4329925
12304,8,20,12,19,32,1,92,38.27213877497754,-109.432723
12305,1,15,10,25,31,6,88,38.27213877497754,-109.4324535
12306,2,18,13,21,26,8,88,38.27213877497754,-109.432184
12307,1,25,15,21,16,9,87,38.27213877497754,-109.4319145
12308,2,28,15,17,19,6,87,38.27213877497754,-109.431645
12309,2,30,14,9,18,10,83,38.27213877497754,-109.4313755
12310,0,32,13,3,14,17,79,38.27213877497754,-109.431106
12311,0,35,14,2,17,13,81,38.27213877497754,-109.4308365
12312,0,35,12,0,14,15,76,38.27213877497754,-109.430567
12313,0,34,13,0,12,19,78,38.27213877497754,-109.4302975
12314,0,32,13,0,11,21,77,38.27213877497754,-109.430028
12315,0,34,13,0,11,20,78,38.27213877497754,-109.4297586
12316,0,34,14,0,10,21,79,38.27213877497754,-109.4294891
12317,0,31,13,0,10,21,75,38.27213877497754,-109.4292196
12318,0,35,12,0,12,17,76,38.27213877497754,-109.4289501
12319,0,39,12,0,15,14,80,38.27213877497754,-109.4286806
12320,0,39,12,0,16,12,79,38.27213877497754,-109.4284111
12321,1,40,12,0,16,11,80,38.27213877497754,-109.4281416
12322,2,39,12,0,16,11,80,38.27213877497754,-109.4278721
12323,1,36,12,0,13,15,77,38.27213877497754,-109.4276026
12324,0,33,12,0,10,19,74,38.27213877497754,-109.4273331
12325,1,35,11,0,9,17,73,38.27213877497754,-109.4270636
12326,1,37,11,0,12,14,75,38.27213877497754,-109.4267941
12327,1,33,11,0,10,14,69,38.27213877497754,-109.4265246
12328,1,30,10,1,11,11,64,38.27213877497754,-109.4262551
12329,3,34,10,5,12,6,70,38.27213877497754,-109.4259856
12330,2,41,10,0,14,7,74,38.27213877497754,-109.4257161
12331,2,46,10,1,16,5,80,38.27213877497754,-109.4254466
12332,2,43,10,1,14,7,77,38.27213877497754,-109.4251771
12333,2,41,10,0,14,9,76,38.27213877497754,-109.4249077
12334,3,42,10,0,14,9,78,38.27213877497754,-109.4246382
12335,3,48,11,2,14,6,84,38.27213877497754,-109.4243687
12336,3,47,10,2,13,8,83,38.27213877497754,-109.4240992
12337,3,47,11,2,13,8,84,38.27213877497754,-109.4238297
12338,4,49,11,2,14,6,86,38.27213877497754,-109.4235602
12339,4,50,12,5,15,3,89,38.27213877497754,-109.4232907
12340,5,51,13,5,17,2,93,38.27213877497754,-109.4230212
12341,4,51,13,5,17,2,92,38.27213877497754,-109.4227517
12342,4,51,13,5,17,2,92,38.27213877497754,-109.4224822
12343,4,51,13,5,17,2,92,38.27213877497754,-109.4222127
12344,4,50,12,4,18,2,90,38.27213877497754,-109.4219432
12345,4,48,12,4,18,3,89,38.27213877497754,-109.4216737
12346,4,47,12,4,18,3,88,38.27213877497754,-109.4214042
12347,4,46,12,4,18,3,87,38.27213877497754,-109.4211347
12348,4,45,13,4,18,4,88,38.27213877497754,-109.4208652
12349,3,40,11,1,15,8,78,38.27213877497754,-109.4205957
12350,3,40,11,1,15,10,80,38.27213877497754,-109.4203262
12351,2,38,11,0,14,12,77,38.27213877497754,-109.4200568
12352,3,32,11,1,12,11,70,38.27213877497754,-109.4197873
12353,4,26,10,3,10,10,63,38.27213877497754,-109.4195178
12354,3,33,10,5,14,5,70,38.27213877497754,-109.4192483
12355,5,38,10,7,14,2,76,38.27213877497754,-109.4189788
12356,7,39,11,10,13,1,81,38.27213877497754,-109.4187093
12357,8,39,11,10,13,1,82,38.27213877497754,-109.4184398
12358,6,41,11,8,13,1,80,38.27213877497754,-109.4181703
12359,6,41,11,8,13,2,81,38.27213877497754,-109.4179008
12360,5,40,10,8,12,2,77,38.27213877497754,-109.4176313
12361,5,41,11,9,13,2,81,38.27213877497754,-109.4173618
12362,4,44,12,8,14,2,84,38.27213877497754,-109.4170923
12363,3,46,12,7,14,2,84,38.27213877497754,-109.4168228
12364,5,43,13,9,11,2,83,38.27213877497754,-109.4165533
12365,9,36,14,12,11,2,84,38.27213877497754,-109.4162838
12366,16,32,15,13,11,2,89,38.27213877497754,-109.4160143
12367,19,30,15,12,10,1,87,38.27213877497754,-109.4157448
12368,15,32,14,11,10,1,83,38.27213877497754,-109.4154753
12369,13,33,14,12,11,1,84,38.27213877497754,-109.4152058
12370,11,36,13,12,12,1,85,38.27213877497754,-109.4149364
12371,7,41,12,12,13,1,86,38.27213877497754,-109.4146669
12372,6,44,13,10,14,1,88,38.27213877497754,-109.4143974
12373,8,46,14,10,14,1,93,38.27213877497754,-109.4141279
12374,9,47,14,9,16,1,96,38.27213877497754,-109.4138584
12375,10,44,13,8,16,1,92,38.27213877497754,-109.4135889
12376,12,40,13,10,15,1,91,38.27213877497754,-109.4133194
12377,9,43,13,9,16,1,91,38.27213877497754,-109.4130499
12378,11,42,14,9,15,1,92,38.27213877497754,-109.4127804
12379,14,40,13,8,14,1,90,38.27213877497754,-109.4125109
12380,14,40,13,8,14,1,90,38.27213877497754,-109.4122414
12381,11,44,13,8,15,1,92,38.27213877497754,-109.4119719
12382,6,49,13,7,16,1,92,38.27213877497754,-109.4117024
12383,5,51,12,7,16,1,92,38.27213877497754,-109.4114329
12384,5,52,13,6,17,1,94,38.27213877497754,-109.4111634
12385,5,52,12,5,18,1,93,38.27213877497754,-109.4108939
12386,4,55,11,4,17,1,92,38.27213877497754,-109.4106244
12387,4,56,10,4,15,1,90,38.27213877497754,-109.4103549
12388,4,53,11,5,16,1,90,38.27213877497754,-109.4100855
12389,5,49,12,5,17,2,90,38.27213877497754,-109.409816
12390,5,51,12,5,17,1,91,38.27213877497754,-109.4095465
12391,6,50,12,6,18,0,92,38.27213877497754,-109.409277
12392,7,48,13,6,18,0,92,38.27213877497754,-109.4090075
12393,6,47,13,6,18,1,91,38.27213877497754,-109.408738
12394,5,47,13,6,18,1,90,38.27213877497754,-109.4084685
12395,6,47,13,6,18,0,90,38.27213877497754,-109.408199
12396,5,46,12,6,18,2,89,38.27213877497754,-109.4079295
12397,6,46,12,6,18,1,89,38.27213877497754,-109.40766
12398,7,45,12,7,18,1,90,38.27213877497754,-109.4073905
12399,7,45,13,7,18,1,91,38.27213877497754,-109.407121
12400,8,43,13,9,17,0,90,38.27213877497754,-109.4068515
12401,2,44,11,0,12,8,77,38.27213877497754,-109.3879869
12402,2,30,13,0,7,18,70,38.27213877497754,-109.3877174
12403,1,25,14,1,5,21,67,38.27213877497754,-109.3874479
12404,2,30,12,0,6,18,68,38.27213877497754,-109.3871784
12405,1,37,11,0,10,15,74,38.27213877497754,-109.3869089
12406,2,42,11,0,11,13,79,38.27213877497754,-109.3866394
12407,2,39,10,0,10,12,73,38.27213877497754,-109.3863699
12408,2,35,11,0,9,14,71,38.27213877497754,-109.3861004
12409,2,30,11,0,7,17,67,38.27213877497754,-109.3858309
12410,1,25,12,0,6,20,64,38.27213877497754,-109.3855614
12411,0,24,14,0,5,25,68,38.27213877497754,-109.3852919
12412,0,23,15,0,5,27,70,38.27213877497754,-109.3850225
12413,0,24,14,0,4,26,68,38.27213877497754,-109.384753
12414,1,27,13,0,5,23,69,38.27213877497754,-109.3844835
12415,3,35,12,0,9,16,75,38.27213877497754,-109.384214
12416,5,37,13,4,11,10,80,38.27213877497754,-109.3839445
12417,10,40,15,10,12,2,89,38.27213877497754,-109.383675
12418,12,38,15,14,10,1,90,38.27213877497754,-109.3834055
12419,10,40,14,10,10,2,86,38.27213877497754,-109.383136
12420,5,44,11,5,10,5,80,38.27213877497754,-109.3828665
12421,2,43,10,1,11,8,75,38.27213877497754,-109.382597
12422,4,32,10,5,8,9,68,38.27213877497754,-109.3823275
12423,5,31,11,9,8,5,69,38.27213877497754,-109.382058
12424,14,33,12,8,9,2,78,38.27213877497754,-109.3817885
12425,16,28,15,12,9,3,83,38.27213877497754,-109.381519
12426,17,29,16,15,11,1,89,38.27213877497754,-109.3812495
12427,14,32,15,11,13,3,88,38.27213877497754,-109.38098
12428,10,32,15,9,13,6,85,38.27213877497754,-109.3807105
12429,9,32,15,8,12,9,85,38.27213877497754,-109.380441
12430,8,35,15,6,12,9,85,38.27213877497754,-109.3801716
12431,7,35,14,6,12,9,83,38.27213877497754,-109.3799021
12432,6,35,14,5,11,10,81,38.27213877497754,-109.3796326
12433,6,35,14,4,10,10,79,38.27213877497754,-109.3793631
12434,5,31,13,3,8,14,74,38.27213877497754,-109.3790936
12435,3,26,14,3,7,18,71,38.27213877497754,-109.3788241
12436,2,26,15,1,6,22,72,38.27213877497754,-109.3785546
12437,1,27,15,1,6,24,74,38.27213877497754,-109.3782851
12438,1,24,16,2,5,26,74,38.27213877497754,-109.3780156
12439,2,22,16,2,3,26,71,38.27213877497754,-109.3777461
12440,2,20,16,2,3,27,70,38.27213877497754,-109.3774766
12441,2,24,14,3,4,23,70,38.27213877497754,-109.3772071
12442,2,38,11,1,10,14,76,38.27213877497754,-109.3769376
12443,1,44,9,1,11,11,77,38.27213877497754,-109.3766681
12444,2,36,9,1,9,11,68,38.27213877497754,-109.3763986
12445,1,25,10,2,4,16,58,38.27213877497754,-109.3761291
12446,1,15,10,4,5,14,49,38.27213877497754,-109.3758596
12447,1,23,11,7,6,9,57,38.27213877497754,-109.3755901
12448,2,26,9,4,10,7,58,38.27213877497754,-109.3753206
12449,2,42,10,3,15,5,77,38.27213877497754,-109.3750512
12450,2,41,10,4,15,5,77,38.27213877497754,-109.3747817
12451,4,30,11,8,13,6,72,38.27213877497754,-109.3745122
12452,4,24,12,6,8,13,67,38.27213877497754,-109.3742427
12453,1,27,11,0,8,17,64,38.27213877497754,-109.3739732
12454,2,26,12,7,13,10,70,38.27213877497754,-109.3737037
12455,1,29,10,6,18,7,71,38.27213877497754,-109.3734342
12456,1,31,9,6,18,4,69,38.27213877497754,-109.3731647
12457,3,38,12,3,15,9,80,38.27213877497754,-109.3728952
12458,2,38,12,5,11,6,74,38.27213877497754,-109.3726257
12459,3,47,10,8,10,1,79,38.27213877497754,-109.3723562
12460,0,48,9,3,11,3,74,38.27213877497754,-109.3720867
12461,2,45,8,5,11,3,74,38.27213877497754,-109.3718172
12462,4,37,8,6,10,4,69,38.27213877497754,-109.3715477
12463,4,39,8,6,10,5,72,38.27213877497754,-109.3712782
12464,3,43,8,5,11,5,75,38.27213877497754,-109.3710087
12465,4,42,8,7,11,3,75,38.27213877497754,-109.3707392
12466,2,46,8,5,10,4,75,38.27213877497754,-109.3704697
12467,3,42,8,6,10,4,73,38.27213877497754,-109.3702003
12468,4,32,9,6,10,6,67,38.27213877497754,-109.3699308
12469,4,33,10,6,10,7,70,38.27213877497754,-109.3696613
12470,2,36,9,4,9,6,66,38.27213877497754,-109.3693918
12471,2,40,9,3,10,8,72,38.27213877497754,-109.3691223
12472,3,34,11,3,11,10,72,38.27213877497754,-109.3688528
12473,3,27,14,2,8,19,73,38.27213877497754,-109.3685833
12474,1,26,15,2,5,26,75,38.27213877497754,-109.3683138
12475,3,24,16,1,10,24,78,38.27213877497754,-109.3680443
12476,4,19,14,2,5,23,67,38.27213877497754,-109.3677748
12477,3,19,14,4,7,23,70,38.27213877497754,-109.3675053
12478,3,25,15,9,13,14,79,38.27213877497754,-109.3672358
12479,5,23,13,13,18,5,77,38.27213877497754,-109.3669663
12480,6,17,13,13,19,6,74,38.27213877497754,-109.3666968
12481,3,12,10,10,14,5,54,38.27213877497754,-109.3664273
12482,5,20,11,15,18,4,73,38.27213877497754,-109.3661578
12483,1,18,9,14,12,4,58,38.27213877497754,-109.3658883
12484,0,27,10,5,12,12,66,38.27213877497754,-109.3656188
12485,2,24,15,1,4,25,71,38.27213877497754,-109.3653493
12486,1,22,19,0,3,30,75,38.27213877497754,-109.3650799
12487,1,25,19,0,6,29,80,38.27213877497754,-109.3648104
12488,1,25,18,1,5,29,79,38.27213877497754,-109.3645409
12489,1,27,19,0,5,32,84,38.27213877497754,-109.3642714
12490,0,26,19,0,5,32,82,38.27213877497754,-109.3640019
12491,0,23,17,0,3,34,77,38.27213877497754,-109.3637324
12492,2,23,17,0,2,31,75,38.27213877497754,-109.3634629
12493,2,21,17,0,1,29,70,38.27213877497754,-109.3631934
12494,1,21,15,0,1,28,66,38.27213877497754,-109.3629239
12495,1,23,13,0,2,24,63,38.27213877497754,-109.3626544
12496,1,25,12,0,3,21,62,38.27213877497754,-109.3623849
12497,0,21,12,1,2,21,57,38.27213877497754,-109.3621154
12498,1,16,12,3,4,18,54,38.27213877497754,-109.3618459
12499,2,15,9,4,6,11,47,38.27213877497754,-109.3615764
12500,2,20,8,5,7,7,49,38.27213877497754,-109.3613069
12501,2,22,7,3,7,6,47,38.27213877497754,-109.3610374
12502,2,18,7,2,7,6,42,38.27213877497754,-109.3607679
12503,2,12,8,4,7,8,41,38.27213877497754,-109.3604984
12504,3,15,10,6,6,9,49,38.27213877497754,-109.360229
12505,3,15,12,6,5,13,54,38.27213877497754,-109.3599595
12506,2,14,15,3,3,21,58,38.27213877497754,-109.35969
12507,3,18,16,2,3,24,66,38.27213877497754,-109.3594205
12508,3,29,14,3,8,16,73,38.27213877497754,-109.359151
12509,2,30,13,2,11,13,71,38.27213877497754,-109.3588815
12510,1,21,14,2,6,21,65,38.27213877497754,-109.358612
12511,1,20,16,1,5,28,71,38.27213877497754,-109.3583425
12512,1,23,19,1,6,31,81,38.27213877497754,-109.358073
12513,2,25,17,1,7,29,81,38.27213877497754,-109.3578035
12514,3,27,17,3,12,23,85,38.27213877497754,-109.357534
12515,3,26,16,7,16,19,87,38.27213877497754,-109.3572645
12516,2,21,16,12,15,17,83,38.27213877497754,-109.356995
12517,3,18,15,14,13,16,79,38.27213877497754,-109.3567255
12518,4,18,14,10,13,18,77,38.27213877497754,-109.356456
12519,4,13,12,13,15,11,68,38.27213877497754,-109.3561865
12520,1,11,10,13,14,5,54,38.27213877497754,-109.355917
12521,4,16,11,13,13,2,59,38.27213877497754,-109.3556475
12522,8,39,8,3,9,3,70,38.27213877497754,-109.355378
12523,3,24,8,3,9,6,53,38.27213877497754,-109.3551086
12524,3,23,8,4,9,8,55,38.27213877497754,-109.3548391
12525,5,21,9,5,7,8,55,38.27213877497754,-109.3545696
12526,8,21,11,5,6,12,63,38.27213877497754,-109.3543001
12527,4,20,15,1,4,22,66,38.27213877497754,-109.3540306
12528,2,24,18,1,4,34,83,38.27213877497754,-109.3537611
12529,3,22,18,2,9,28,82,38.27213877497754,-109.3534916
12530,4,18,15,10,10,24,81,38.27213877497754,-109.3532221
12531,1,23,17,2,12,22,77,38.27213877497754,-109.3529526
12532,5,18,12,5,11,7,58,38.27213877497754,-109.3526831
12533,0,14,13,5,13,11,56,38.27213877497754,-109.3524136
12534,1,19,14,6,13,12,65,38.27213877497754,-109.3521441
12535,1,23,17,2,7,23,73,38.27213877497754,-109.3518746
12536,1,25,16,0,5,26,73,38.27213877497754,-109.3516051
12537,2,19,12,1,3,19,56,38.27213877497754,-109.3513356
12538,3,16,12,3,4,18,56,38.27213877497754,-109.3510661
12539,3,15,13,3,4,19,57,38.27213877497754,-109.3507966
12540,2,15,14,2,3,22,58,38.27213877497754,-109.3505271
12541,2,16,14,1,2,23,58,38.27213877497754,-109.3502577
12542,4,18,14,3,3,21,63,38.27213877497754,-109.3499882
12543,5,18,14,2,2,21,62,38.27213877497754,-109.3497187
12544,4,18,13,1,2,21,59,38.27213877497754,-109.3494492
12545,1,17,12,0,2,21,53,38.27213877497754,-109.3491797
12546,3,18,12,1,3,19,56,38.27213877497754,-109.3489102
12547,3,17,14,2,3,21,60,38.27213877497754,-109.3486407
12548,2,15,14,3,4,24,62,38.27213877497754,-109.3483712
12549,2,14,15,2,3,27,63,38.27213877497754,-109.3481017
12550,2,15,16,1,2,27,63,38.27213877497754,-109.3478322
12551,1,14,16,1,1,27,60,38.27213877497754,-109.3475627
12552,2,14,17,1,1,27,62,38.27213877497754,-109.3472932
12553,1,15,16,0,1,27,60,38.27213877497754,-109.3470237
12554,1,18,16,0,1,27,63,38.27213877497754,-109.3467542
12555,2,21,17,1,3,27,71,38.27213877497754,-109.3464847
12556,1,20,18,1,4,31,75,38.27213877497754,-109.3462152
12557,1,18,21,1,7,35,83,38.27213877497754,-109.3459457
12558,0,17,22,1,6,36,82,38.27213877497754,-109.3456762
12559,1,17,21,1,6,35,81,38.27213877497754,-109.3454068
12560,1,15,19,0,2,35,72,38.27213877497754,-109.3451373
12561,3,15,15,4,5,18,60,38.27213877497754,-109.3448678
12562,3,23,10,5,7,9,57,38.27213877497754,-109.3445983
12563,3,27,9,6,9,5,59,38.27213877497754,-109.3443288
12564,4,27,11,9,11,5,67,38.27213877497754,-109.3440593
12565,3,19,13,9,4,17,65,38.27213877497754,-109.3437898
12566,8,31,14,13,4,10,80,38.27213877497754,-109.3435203
12567,11,34,16,15,3,7,86,38.27213877497754,-109.3432508
12568,11,33,15,14,3,9,85,38.27213877497754,-109.3429813
12569,7,29,14,12,8,10,80,38.27213877497754,-109.3427118
12570,6,30,14,12,8,9,79,38.27213877497754,-109.3424423
12571,7,31,14,11,10,8,81,38.27213877497754,-109.3421728
12572,5,29,13,11,9,8,75,38.27213877497754,-109.3419033
12573,5,28,13,11,8,9,74,38.27213877497754,-109.3416338
12574,7,29,14,14,9,7,80,38.27213877497754,-109.3413643
12575,6,29,13,14,10,7,79,38.27213877497754,-109.3410948
12576,7,29,13,15,9,6,79,38.27213877497754,-109.3408253
12577,7,30,14,14,10,6,81,38.27213877497754,-109.3405558
12578,7,33,14,12,12,6,84,38.27213877497754,-109.3402864
12579,5,33,14,11,13,6,82,38.27213877497754,-109.3400169
12580,6,34,14,11,12,6,83,38.27213877497754,-109.3397474
12581,2,51,11,3,16,4,87,38.27186928039231,-109.4367654
12582,2,48,11,1,15,7,84,38.27186928039231,-109.4364959
12583,1,42,10,0,12,12,77,38.27186928039231,-109.4362264
12584,1,38,10,0,9,12,70,38.27186928039231,-109.4359569
12585,2,39,9,0,10,11,71,38.27186928039231,-109.4356874
12586,1,42,9,0,11,9,72,38.27186928039231,-109.4354179
12587,2,48,9,0,12,7,78,38.27186928039231,-109.4351484
12588,2,47,9,0,12,7,77,38.27186928039231,-109.434879
12589,1,40,10,0,11,8,70,38.27186928039231,-109.4346095
12590,2,38,11,3,10,6,70,38.27186928039231,-109.43434
12591,1,35,7,2,8,6,59,38.27186928039231,-109.4340705
12592,2,30,7,2,8,6,55,38.27186928039231,-109.433801
12593,3,25,8,4,9,6,55,38.27186928039231,-109.4335315
12594,8,33,13,12,13,4,83,38.27186928039231,-109.433262
12595,6,25,12,16,26,6,91,38.27186928039231,-109.4329925
12596,2,21,13,19,28,5,88,38.27186928039231,-109.432723
12597,1,22,12,21,24,3,83,38.27186928039231,-109.4324535
12598,0,32,12,11,22,7,84,38.27186928039231,-109.432184
12599,0,34,13,8,21,9,85,38.27186928039231,-109.4319145
12600,0,36,13,6,19,11,85,38.27186928039231,-109.431645
12601,0,36,12,4,16,14,82,38.27186928039231,-109.4313755
12602,0,34,12,1,13,15,75,38.27186928039231,-109.431106
12603,1,35,13,0,14,14,77,38.27186928039231,-109.4308365
12604,1,36,11,0,13,13,74,38.27186928039231,-109.430567
12605,1,41,11,0,17,9,79,38.27186928039231,-109.4302975
12606,0,38,12,0,15,12,77,38.27186928039231,-109.430028
12607,1,38,12,0,13,14,78,38.27186928039231,-109.4297586
12608,1,37,12,0,10,18,78,38.27186928039231,-109.4294891
12609,0,33,12,0,10,19,74,38.27186928039231,-109.4292196
12610,1,38,11,0,13,14,77,38.27186928039231,-109.4289501
12611,2,42,11,0,15,11,81,38.27186928039231,-109.4286806
12612,1,41,11,0,15,11,79,38.27186928039231,-109.4284111
12613,2,42,12,0,17,10,83,38.27186928039231,-109.4281416
12614,2,40,12,0,16,11,81,38.27186928039231,-109.4278721
12615,2,39,12,0,16,10,79,38.27186928039231,-109.4276026
12616,3,40,12,0,14,11,80,38.27186928039231,-109.4273331
12617,2,41,11,0,13,12,79,38.27186928039231,-109.4270636
12618,2,39,12,0,12,13,78,38.27186928039231,-109.4267941
12619,0,32,11,0,9,16,68,38.27186928039231,-109.4265246
12620,1,30,11,2,12,11,67,38.27186928039231,-109.4262551
12621,1,37,10,3,12,7,70,38.27186928039231,-109.4259856
12622,1,39,9,0,11,8,68,38.27186928039231,-109.4257161
12623,2,43,8,3,10,4,70,38.27186928039231,-109.4254466
12624,2,43,9,2,11,5,72,38.27186928039231,-109.4251771
12625,1,41,10,0,14,7,73,38.27186928039231,-109.4249077
12626,2,44,11,1,14,7,79,38.27186928039231,-109.4246382
12627,3,50,11,3,13,6,86,38.27186928039231,-109.4243687
12628,3,50,10,3,13,6,85,38.27186928039231,-109.4240992
12629,3,51,11,3,14,5,87,38.27186928039231,-109.4238297
12630,4,51,12,3,16,3,89,38.27186928039231,-109.4235602
12631,4,51,13,5,17,2,92,38.27186928039231,-109.4232907
12632,5,50,13,6,18,1,93,38.27186928039231,-109.4230212
12633,4,50,13,6,17,2,92,38.27186928039231,-109.4227517
12634,4,51,13,5,16,2,91,38.27186928039231,-109.4224822
12635,4,51,13,5,17,2,92,38.27186928039231,-109.4222127
12636,4,50,13,5,18,2,92,38.27186928039231,-109.4219432
12637,4,49,13,4,19,2,91,38.27186928039231,-109.4216737
12638,4,47,12,4,19,2,88,38.27186928039231,-109.4214042
12639,5,45,12,4,19,3,88,38.27186928039231,-109.4211347
12640,5,44,12,4,18,3,86,38.27186928039231,-109.4208652
12641,3,41,12,2,17,6,81,38.27186928039231,-109.4205957
12642,3,40,12,1,15,9,80,38.27186928039231,-109.4203262
12643,2,38,12,0,14,11,77,38.27186928039231,-109.4200568
12644,1,31,11,1,11,14,69,38.27186928039231,-109.4197873
12645,2,24,11,3,11,11,62,38.27186928039231,-109.4195178
12646,6,32,10,6,12,4,70,38.27186928039231,-109.4192483
12647,5,35,9,5,12,4,70,38.27186928039231,-109.4189788
12648,4,38,9,5,12,4,72,38.27186928039231,-109.4187093
12649,4,40,10,5,12,4,75,38.27186928039231,-109.4184398
12650,4,40,11,6,13,4,78,38.27186928039231,-109.4181703
12651,3,45,11,4,15,4,82,38.27186928039231,-109.4179008
12652,4,48,12,4,15,3,86,38.27186928039231,-109.4176313
12653,4,49,12,5,15,2,87,38.27186928039231,-109.4173618
12654,5,48,13,7,15,2,90,38.27186928039231,-109.4170923
12655,6,46,13,9,15,2,91,38.27186928039231,-109.4168228
12656,9,43,15,11,12,2,92,38.27186928039231,-109.4165533
12657,13,37,16,12,11,2,91,38.27186928039231,-109.4162838
12658,14,35,16,13,11,1,90,38.27186928039231,-109.4160143
12659,10,40,14,11,12,1,88,38.27186928039231,-109.4157448
12660,15,37,14,14,11,0,91,38.27186928039231,-109.4154753
12661,14,36,14,14,12,0,90,38.27186928039231,-109.4152058
12662,11,37,13,12,13,1,87,38.27186928039231,-109.4149364
12663,8,40,13,11,14,1,87,38.27186928039231,-109.4146669
12664,11,44,14,9,14,0,92,38.27186928039231,-109.4143974
12665,13,41,14,10,13,1,92,38.27186928039231,-109.4141279
12666,13,41,14,10,14,1,93,38.27186928039231,-109.4138584
12667,15,39,13,10,14,0,91,38.27186928039231,-109.4135889
12668,22,35,13,8,12,0,90,38.27186928039231,-109.4133194
12669,18,37,13,9,13,0,90,38.27186928039231,-109.4130499
12670,17,37,13,8,14,0,89,38.27186928039231,-109.4127804
12671,17,37,13,8,15,0,90,38.27186928039231,-109.4125109
12672,16,39,13,8,14,0,90,38.27186928039231,-109.4122414
12673,16,41,13,8,13,0,91,38.27186928039231,-109.4119719
12674,12,45,12,9,13,0,91,38.27186928039231,-109.4117024
12675,7,49,12,7,16,0,91,38.27186928039231,-109.4114329
12676,5,52,12,5,17,1,92,38.27186928039231,-109.4111634
12677,4,54,11,4,17,1,91,38.27186928039231,-109.4108939
12678,4,58,10,4,15,1,92,38.27186928039231,-109.4106244
12679,3,57,11,3,16,2,92,38.27186928039231,-109.4103549
12680,4,53,12,5,18,1,93,38.27186928039231,-109.4100855
12681,5,50,13,6,18,1,93,38.27186928039231,-109.409816
12682,7,48,13,6,17,1,92,38.27186928039231,-109.4095465
12683,8,46,13,7,17,0,91,38.27186928039231,-109.409277
12684,9,46,13,7,17,0,92,38.27186928039231,-109.4090075
12685,7,46,13,6,17,1,90,38.27186928039231,-109.408738
12686,7,48,13,6,17,1,92,38.27186928039231,-109.4084685
12687,7,49,13,6,17,1,93,38.27186928039231,-109.408199
12688,7,48,12,5,17,1,90,38.27186928039231,-109.4079295
12689,7,48,12,5,16,1,89,38.27186928039231,-109.40766
12690,7,48,12,5,17,1,90,38.27186928039231,-109.4073905
12691,7,46,12,5,17,2,89,38.27186928039231,-109.407121
12692,9,43,13,9,16,1,91,38.27186928039231,-109.4068515
12693,3,28,13,4,9,14,71,38.27186928039231,-109.3879869
12694,1,17,17,1,4,28,68,38.27186928039231,-109.3877174
12695,1,19,18,0,4,29,71,38.27186928039231,-109.3874479
12696,1,21,15,0,3,26,66,38.27186928039231,-109.3871784
12697,2,31,12,0,6,19,70,38.27186928039231,-109.3869089
12698,2,40,11,0,10,14,77,38.27186928039231,-109.3866394
12699,2,43,10,0,11,10,76,38.27186928039231,-109.3863699
12700,2,38,10,0,11,11,72,38.27186928039231,-109.3861004
12701,2,30,11,0,8,16,67,38.27186928039231,-109.3858309
12702,2,27,13,0,5,21,68,38.27186928039231,-109.3855614
12703,1,24,14,0,5,25,69,38.27186928039231,-109.3852919
12704,1,24,14,0,4,24,67,38.27186928039231,-109.3850225
12705,2,27,13,0,5,22,69,38.27186928039231,-109.384753
12706,2,32,12,0,9,17,72,38.27186928039231,-109.3844835
12707,5,37,13,3,12,11,81,38.27186928039231,-109.384214
12708,7,38,14,6,12,7,84,38.27186928039231,-109.3839445
12709,10,41,15,9,13,2,90,38.27186928039231,-109.383675
12710,12,39,15,13,12,1,92,38.27186928039231,-109.3834055
12711,12,39,14,12,11,1,89,38.27186928039231,-109.383136
12712,6,41,12,7,10,4,80,38.27186928039231,-109.3828665
12713,3,40,10,2,11,8,74,38.27186928039231,-109.382597
12714,3,36,11,5,9,9,73,38.27186928039231,-109.3823275
12715,1,36,9,5,9,8,68,38.27186928039231,-109.382058
12716,10,39,12,6,8,4,79,38.27186928039231,-109.3817885
12717,11,32,16,15,12,3,89,38.27186928039231,-109.381519
12718,10,31,15,12,15,4,87,38.27186928039231,-109.3812495
12719,10,34,15,11,15,4,89,38.27186928039231,-109.38098
12720,7,34,15,10,16,6,88,38.27186928039231,-109.3807105
12721,8,35,15,8,14,7,87,38.27186928039231,-109.380441
12722,9,36,14,7,13,6,85,38.27186928039231,-109.3801716
12723,10,37,14,7,13,5,86,38.27186928039231,-109.3799021
12724,9,38,14,7,13,6,87,38.27186928039231,-109.3796326
12725,8,39,14,6,13,6,86,38.27186928039231,-109.3793631
12726,6,39,13,5,13,8,84,38.27186928039231,-109.3790936
12727,5,36,13,5,13,9,81,38.27186928039231,-109.3788241
12728,4,32,13,3,11,14,77,38.27186928039231,-109.3785546
12729,3,30,13,3,8,17,74,38.27186928039231,-109.3782851
12730,2,30,13,3,7,19,74,38.27186928039231,-109.3780156
12731,2,24,14,3,4,22,69,38.27186928039231,-109.3777461
12732,3,25,14,3,4,22,71,38.27186928039231,-109.3774766
12733,3,32,12,2,7,17,73,38.27186928039231,-109.3772071
12734,2,39,11,1,11,11,75,38.27186928039231,-109.3769376
12735,2,37,9,3,9,8,68,38.27186928039231,-109.3766681
12736,2,28,10,3,9,11,63,38.27186928039231,-109.3763986
12737,0,21,11,3,5,17,57,38.27186928039231,-109.3761291
12738,0,21,11,2,5,17,56,38.27186928039231,-109.3758596
12739,0,26,9,4,8,9,56,38.27186928039231,-109.3755901
12740,1,40,9,4,11,5,70,38.27186928039231,-109.3753206
12741,2,39,10,5,14,6,76,38.27186928039231,-109.3750512
12742,2,34,10,4,13,8,71,38.27186928039231,-109.3747817
12743,2,31,11,4,11,10,69,38.27186928039231,-109.3745122
12744,2,30,10,1,9,12,64,38.27186928039231,-109.3742427
12745,2,26,10,1,5,15,59,38.27186928039231,-109.3739732
12746,1,22,11,5,9,12,60,38.27186928039231,-109.3737037
12747,2,22,9,9,18,4,64,38.27186928039231,-109.3734342
12748,2,31,10,6,20,1,70,38.27186928039231,-109.3731647
12749,5,42,11,3,13,0,74,38.27186928039231,-109.3728952
12750,1,41,10,4,11,4,71,38.27186928039231,-109.3726257
12751,2,38,8,5,10,6,69,38.27186928039231,-109.3723562
12752,4,36,9,7,9,6,71,38.27186928039231,-109.3720867
12753,4,39,9,7,10,6,75,38.27186928039231,-109.3718172
12754,3,38,9,5,9,8,72,38.27186928039231,-109.3715477
12755,1,39,9,4,10,10,73,38.27186928039231,-109.3712782
12756,1,42,9,4,10,8,74,38.27186928039231,-109.3710087
12757,2,42,9,5,11,6,75,38.27186928039231,-109.3707392
12758,0,39,9,3,11,8,70,38.27186928039231,-109.3704697
12759,1,41,10,3,13,6,74,38.27186928039231,-109.3702003
12760,2,34,12,5,9,9,71,38.27186928039231,-109.3699308
12761,2,28,13,2,9,15,69,38.27186928039231,-109.3696613
12762,4,29,16,5,5,18,77,38.27186928039231,-109.3693918
12763,4,30,15,5,6,18,78,38.27186928039231,-109.3691223
12764,4,26,14,3,8,17,72,38.27186928039231,-109.3688528
12765,3,25,13,0,9,21,71,38.27186928039231,-109.3685833
12766,2,25,16,0,8,24,75,38.27186928039231,-109.3683138
12767,1,23,16,0,9,24,73,38.27186928039231,-109.3680443
12768,1,25,18,0,10,26,80,38.27186928039231,-109.3677748
12769,2,20,17,2,10,25,76,38.27186928039231,-109.3675053
12770,4,17,15,8,12,18,74,38.27186928039231,-109.3672358
12771,1,13,15,13,15,14,71,38.27186928039231,-109.3669663
12772,2,7,11,10,11,16,57,38.27186928039231,-109.3666968
12773,1,10,13,20,12,9,65,38.27186928039231,-109.3664273
12774,5,19,12,17,14,7,74,38.27186928039231,-109.3661578
12775,3,25,13,11,8,14,74,38.27186928039231,-109.3658883
12776,0,23,14,2,6,25,70,38.27186928039231,-109.3656188
12777,0,24,19,0,5,29,77,38.27186928039231,-109.3653493
12778,0,26,20,0,6,28,80,38.27186928039231,-109.3650799
12779,1,25,19,0,6,29,80,38.27186928039231,-109.3648104
12780,1,25,19,0,5,31,81,38.27186928039231,-109.3645409
12781,1,23,19,0,3,34,80,38.27186928039231,-109.3642714
12782,0,20,18,0,2,35,75,38.27186928039231,-109.3640019
12783,0,21,17,0,2,34,74,38.27186928039231,-109.3637324
12784,1,22,18,0,2,32,75,38.27186928039231,-109.3634629
12785,1,22,18,0,2,32,75,38.27186928039231,-109.3631934
12786,0,22,17,0,1,30,70,38.27186928039231,-109.3629239
12787,0,20,14,0,1,26,61,38.27186928039231,-109.3626544
12788,1,24,12,0,3,20,60,38.27186928039231,-109.3623849
12789,0,21,10,2,4,18,55,38.27186928039231,-109.3621154
12790,2,22,9,3,7,10,53,38.27186928039231,-109.3618459
12791,3,25,7,3,7,6,51,38.27186928039231,-109.3615764
12792,1,22,7,2,8,6,46,38.27186928039231,-109.3613069
12793,2,19,6,1,8,7,43,38.27186928039231,-109.3610374
12794,3,16,7,2,8,7,43,38.27186928039231,-109.3607679
12795,3,14,9,5,8,8,47,38.27186928039231,-109.3604984
12796,3,16,10,5,6,10,50,38.27186928039231,-109.360229
12797,1,17,12,4,4,17,55,38.27186928039231,-109.3599595
12798,2,20,15,2,4,21,64,38.27186928039231,-109.35969
12799,2,20,17,2,3,25,69,38.27186928039231,-109.3594205
12800,2,21,16,1,4,25,69,38.27186928039231,-109.359151
12801,2,23,15,1,4,24,69,38.27186928039231,-109.3588815
12802,1,20,16,1,5,26,69,38.27186928039231,-109.358612
12803,2,21,18,1,5,29,76,38.27186928039231,-109.3583425
12804,2,25,18,1,8,27,81,38.27186928039231,-109.358073
12805,3,26,17,2,9,23,80,38.27186928039231,-109.3578035
12806,2,24,18,3,12,24,83,38.27186928039231,-109.357534
12807,2,25,17,5,13,20,82,38.27186928039231,-109.3572645
12808,2,25,15,11,17,12,82,38.27186928039231,-109.356995
12809,5,23,13,15,20,6,82,38.27186928039231,-109.3567255
12810,5,19,13,12,15,12,76,38.27186928039231,-109.356456
12811,2,22,11,11,20,6,72,38.27186928039231,-109.3561865
12812,1,13,11,12,11,6,54,38.27186928039231,-109.355917
12813,2,27,8,4,7,6,54,38.27186928039231,-109.3556475
12814,3,27,8,2,8,5,53,38.27186928039231,-109.355378
12815,2,24,9,4,8,7,54,38.27186928039231,-109.3551086
12816,2,31,10,3,7,11,64,38.27186928039231,-109.3548391
12817,2,28,12,0,6,17,65,38.27186928039231,-109.3545696
12818,3,23,15,0,4,23,68,38.27186928039231,-109.3543001
12819,4,24,17,0,5,29,79,38.27186928039231,-109.3540306
12820,3,24,18,2,6,32,85,38.27186928039231,-109.3537611
12821,4,23,16,6,9,23,81,38.27186928039231,-109.3534916
12822,5,21,15,8,10,17,76,38.27186928039231,-109.3532221
12823,4,20,14,6,13,14,71,38.27186928039231,-109.3529526
12824,4,15,12,9,13,4,57,38.27186928039231,-109.3526831
12825,0,16,11,10,14,8,59,38.27186928039231,-109.3524136
12826,2,22,12,4,7,14,61,38.27186928039231,-109.3521441
12827,3,22,14,0,4,21,64,38.27186928039231,-109.3518746
12828,2,23,14,0,3,22,64,38.27186928039231,-109.3516051
12829,3,22,14,0,3,22,64,38.27186928039231,-109.3513356
12830,3,19,12,2,4,17,57,38.27186928039231,-109.3510661
12831,2,17,11,4,6,16,56,38.27186928039231,-109.3507966
12832,2,16,12,4,5,17,56,38.27186928039231,-109.3505271
12833,2,17,12,3,4,17,55,38.27186928039231,-109.3502577
12834,2,17,12,3,4,18,56,38.27186928039231,-109.3499882
12835,3,16,13,2,3,20,57,38.27186928039231,-109.3497187
12836,2,16,14,1,2,23,58,38.27186928039231,-109.3494492
12837,1,17,14,0,2,24,58,38.27186928039231,-109.3491797
12838,2,18,14,0,2,23,59,38.27186928039231,-109.3489102
12839,2,18,14,1,3,22,60,38.27186928039231,-109.3486407
12840,2,17,14,2,4,25,64,38.27186928039231,-109.3483712
12841,2,16,15,1,3,26,63,38.27186928039231,-109.3481017
12842,1,16,14,2,3,24,60,38.27186928039231,-109.3478322
12843,1,16,15,2,3,24,61,38.27186928039231,-109.3475627
12844,2,16,16,1,2,27,64,38.27186928039231,-109.3472932
12845,2,17,17,0,1,28,65,38.27186928039231,-109.3470237
12846,2,18,17,0,1,29,67,38.27186928039231,-109.3467542
12847,2,20,18,0,3,30,73,38.27186928039231,-109.3464847
12848,1,21,18,1,5,30,76,38.27186928039231,-109.3462152
12849,1,21,19,0,5,31,77,38.27186928039231,-109.3459457
12850,0,17,18,0,4,32,71,38.27186928039231,-109.3456762
12851,1,11,16,2,3,26,59,38.27186928039231,-109.3454068
12852,4,12,14,4,4,19,57,38.27186928039231,-109.3451373
12853,4,15,11,6,7,11,54,38.27186928039231,-109.3448678
12854,4,17,10,8,9,8,56,38.27186928039231,-109.3445983
12855,5,20,11,12,9,6,63,38.27186928039231,-109.3443288
12856,8,23,15,14,6,8,74,38.27186928039231,-109.3440593
12857,6,19,17,9,4,19,74,38.27186928039231,-109.3437898
12858,12,31,17,14,3,9,86,38.27186928039231,-109.3435203
12859,12,34,16,17,3,6,88,38.27186928039231,-109.3432508
12860,12,33,15,16,3,7,86,38.27186928039231,-109.3429813
12861,11,32,14,16,5,8,86,38.27186928039231,-109.3427118
12862,8,31,14,15,7,9,84,38.27186928039231,-109.3424423
12863,7,30,14,13,9,8,81,38.27186928039231,-109.3421728
12864,7,30,13,12,9,7,78,38.27186928039231,-109.3419033
12865,7,30,13,12,9,7,78,38.27186928039231,-109.3416338
12866,8,30,14,14,9,7,82,38.27186928039231,-109.3413643
12867,6,31,13,13,10,7,80,38.27186928039231,-109.3410948
12868,5,31,13,12,10,7,78,38.27186928039231,-109.3408253
12869,4,32,13,11,10,7,77,38.27186928039231,-109.3405558
12870,5,34,13,10,12,6,80,38.27186928039231,-109.3402864
12871,5,34,13,10,12,6,80,38.27186928039231,-109.3400169
12872,6,34,14,12,10,6,82,38.27186928039231,-109.3397474
12873,1,43,11,0,12,12,79,38.27159978580707,-109.4370349
12874,2,49,11,3,15,7,87,38.27159978580707,-109.4367654
12875,2,45,10,1,13,11,82,38.27159978580707,-109.4364959
12876,1,41,10,0,11,13,76,38.27159978580707,-109.4362264
12877,1,42,10,0,10,12,75,38.27159978580707,-109.4359569
12878,1,39,9,0,10,12,71,38.27159978580707,-109.4356874
12879,1,39,9,0,10,12,71,38.27159978580707,-109.4354179
12880,1,42,10,0,11,9,73,38.27159978580707,-109.4351484
12881,1,41,9,0,10,8,69,38.27159978580707,-109.434879
12882,1,38,9,1,8,8,65,38.27159978580707,-109.4346095
12883,2,38,10,1,8,7,66,38.27159978580707,-109.43434
12884,2,34,10,2,9,6,63,38.27159978580707,-109.4340705
12885,3,29,12,8,11,6,69,38.27159978580707,-109.433801
12886,9,26,13,17,20,4,89,38.27159978580707,-109.4335315
12887,2,16,12,25,26,9,90,38.27159978580707,-109.433262
12888,2,23,11,18,21,7,82,38.27159978580707,-109.4329925
12889,0,32,11,13,23,6,85,38.27159978580707,-109.432723
12890,1,36,12,6,19,6,80,38.27159978580707,-109.4324535
12891,2,37,12,4,15,8,78,38.27159978580707,-109.432184
12892,1,36,11,3,13,10,74,38.27159978580707,-109.4319145
12893,2,37,12,1,13,10,75,38.27159978580707,-109.431645
12894,1,35,12,0,12,12,72,38.27159978580707,-109.4313755
12895,1,34,11,0,11,15,72,38.27159978580707,-109.431106
12896,1,33,11,0,11,15,71,38.27159978580707,-109.4308365
12897,1,33,12,2,13,12,73,38.27159978580707,-109.430567
12898,1,32,12,5,14,10,74,38.27159978580707,-109.4302975
12899,0,33,11,1,14,11,70,38.27159978580707,-109.430028
12900,2,38,11,0,14,11,76,38.27159978580707,-109.4297586
12901,3,42,11,1,14,10,81,38.27159978580707,-109.4294891
12902,2,43,11,0,14,10,80,38.27159978580707,-109.4292196
12903,3,48,11,2,15,6,85,38.27159978580707,-109.4289501
12904,3,47,11,1,16,6,84,38.27159978580707,-109.4286806
12905,2,43,12,1,18,7,83,38.27159978580707,-109.4284111
12906,3,45,13,3,18,6,88,38.27159978580707,-109.4281416
12907,3,44,13,3,18,6,87,38.27159978580707,-109.4278721
12908,3,45,13,4,18,5,88,38.27159978580707,-109.4276026
12909,4,46,13,5,18,3,89,38.27159978580707,-109.4273331
12910,3,46,12,4,17,4,86,38.27159978580707,-109.4270636
12911,3,43,12,2,16,8,84,38.27159978580707,-109.4267941
12912,1,38,12,0,14,12,77,38.27159978580707,-109.4265246
12913,1,32,12,1,13,13,72,38.27159978580707,-109.4262551
12914,2,29,11,2,12,11,67,38.27159978580707,-109.4259856
12915,2,31,10,1,9,11,64,38.27159978580707,-109.4257161
12916,2,33,9,4,10,6,64,38.27159978580707,-109.4254466
12917,2,35,8,3,9,6,63,38.27159978580707,-109.4251771
12918,1,37,8,2,11,7,66,38.27159978580707,-109.4249077
12919,2,39,9,2,14,5,71,38.27159978580707,-109.4246382
12920,2,47,10,2,14,5,80,38.27159978580707,-109.4243687
12921,2,50,10,2,13,7,84,38.27159978580707,-109.4240992
12922,3,50,11,3,14,6,87,38.27159978580707,-109.4238297
12923,3,51,12,3,17,4,90,38.27159978580707,-109.4235602
12924,3,51,12,4,17,2,89,38.27159978580707,-109.4232907
12925,4,50,13,5,18,2,92,38.27159978580707,-109.4230212
12926,4,49,13,6,17,2,91,38.27159978580707,-109.4227517
12927,4,50,13,7,18,1,93,38.27159978580707,-109.4224822
12928,4,50,14,7,18,1,94,38.27159978580707,-109.4222127
12929,4,49,13,5,19,1,91,38.27159978580707,-109.4219432
12930,4,48,13,6,19,1,91,38.27159978580707,-109.4216737
12931,4,46,13,5,19,2,89,38.27159978580707,-109.4214042
12932,4,44,13,5,19,3,88,38.27159978580707,-109.4211347
12933,5,42,13,4,18,4,86,38.27159978580707,-109.4208652
12934,3,39,11,1,16,9,79,38.27159978580707,-109.4205957
12935,3,38,12,1,16,10,80,38.27159978580707,-109.4203262
12936,2,36,12,1,15,11,77,38.27159978580707,-109.4200568
12937,1,33,12,0,13,13,72,38.27159978580707,-109.4197873
12938,1,30,12,0,9,16,68,38.27159978580707,-109.4195178
12939,2,34,11,1,14,10,72,38.27159978580707,-109.4192483
12940,3,40,11,1,14,8,77,38.27159978580707,-109.4189788
12941,3,43,11,2,16,6,81,38.27159978580707,-109.4187093
12942,4,43,12,3,17,4,83,38.27159978580707,-109.4184398
12943,5,44,13,6,18,3,89,38.27159978580707,-109.4181703
12944,5,45,13,6,18,2,89,38.27159978580707,-109.4179008
12945,5,47,13,6,18,1,90,38.27159978580707,-109.4176313
12946,5,47,13,7,17,1,90,38.27159978580707,-109.4173618
12947,6,47,13,8,16,1,91,38.27159978580707,-109.4170923
12948,11,41,14,11,14,1,92,38.27159978580707,-109.4168228
12949,13,41,14,11,12,1,92,38.27159978580707,-109.4165533
12950,12,41,15,12,12,1,93,38.27159978580707,-109.4162838
12951,10,41,15,12,12,1,91,38.27159978580707,-109.4160143
12952,9,44,14,11,13,1,92,38.27159978580707,-109.4157448
12953,12,40,14,13,13,1,93,38.27159978580707,-109.4154753
12954,12,41,14,11,14,1,93,38.27159978580707,-109.4152058
12955,11,41,14,9,16,1,92,38.27159978580707,-109.4149364
12956,11,41,14,9,16,1,92,38.27159978580707,-109.4146669
12957,14,39,14,11,15,0,93,38.27159978580707,-109.4143974
12958,20,36,13,10,12,0,91,38.27159978580707,-109.4141279
12959,19,36,13,9,11,0,88,38.27159978580707,-109.4138584
12960,18,36,13,8,11,0,86,38.27159978580707,-109.4135889
12961,18,37,13,7,11,0,86,38.27159978580707,-109.4133194
12962,14,40,13,9,13,1,90,38.27159978580707,-109.4130499
12963,18,36,13,9,12,1,89,38.27159978580707,-109.4127804
12964,24,33,12,7,11,0,87,38.27159978580707,-109.4125109
12965,26,33,12,6,10,1,88,38.27159978580707,-109.4122414
12966,16,40,13,8,13,0,90,38.27159978580707,-109.4119719
12967,9,47,13,7,16,0,92,38.27159978580707,-109.4117024
12968,6,50,13,5,17,1,92,38.27159978580707,-109.4114329
12969,4,55,12,4,16,2,93,38.27159978580707,-109.4111634
12970,3,58,10,3,16,2,92,38.27159978580707,-109.4108939
12971,3,58,10,4,16,1,92,38.27159978580707,-109.4106244
12972,4,57,11,4,16,1,93,38.27159978580707,-109.4103549
12973,5,55,12,5,17,1,95,38.27159978580707,-109.4100855
12974,5,52,13,6,17,1,94,38.27159978580707,-109.409816
12975,6,48,13,7,17,1,92,38.27159978580707,-109.4095465
12976,8,46,13,7,17,0,91,38.27159978580707,-109.409277
12977,8,45,13,7,17,0,90,38.27159978580707,-109.4090075
12978,8,46,13,7,17,0,91,38.27159978580707,-109.408738
12979,7,48,13,6,17,1,92,38.27159978580707,-109.4084685
12980,6,49,13,6,17,1,92,38.27159978580707,-109.408199
12981,7,50,13,5,17,1,93,38.27159978580707,-109.4079295
12982,7,49,12,5,17,1,91,38.27159978580707,-109.40766
12983,7,49,13,5,17,1,92,38.27159978580707,-109.4073905
12984,8,46,12,6,16,1,89,38.27159978580707,-109.407121
12985,10,42,13,10,15,1,91,38.27159978580707,-109.4068515
12986,1,24,16,1,4,25,71,38.27159978580707,-109.3879869
12987,1,23,18,0,4,31,77,38.27159978580707,-109.3877174
12988,2,23,18,0,5,32,80,38.27159978580707,-109.3874479
12989,2,20,17,0,3,30,72,38.27159978580707,-109.3871784
12990,1,22,14,1,2,24,64,38.27159978580707,-109.3869089
12991,1,35,11,0,7,17,71,38.27159978580707,-109.3866394
12992,2,40,10,0,10,12,74,38.27159978580707,-109.3863699
12993,1,30,10,0,10,13,64,38.27159978580707,-109.3861004
12994,1,27,11,0,7,17,63,38.27159978580707,-109.3858309
12995,2,26,13,0,5,23,69,38.27159978580707,-109.3855614
12996,2,23,14,0,4,25,68,38.27159978580707,-109.3852919
12997,2,25,12,0,4,22,65,38.27159978580707,-109.3850225
12998,2,34,12,0,8,16,72,38.27159978580707,-109.384753
12999,3,35,12,1,12,13,76,38.27159978580707,-109.3844835
13000,6,36,14,5,12,9,82,38.27159978580707,-109.384214
13001,7,36,14,7,12,8,84,38.27159978580707,-109.3839445
13002,8,38,14,8,13,4,85,38.27159978580707,-109.383675
13003,11,37,15,13,13,1,90,38.27159978580707,-109.3834055
13004,13,37,15,14,11,0,90,38.27159978580707,-109.383136
13005,6,41,13,8,13,2,83,38.27159978580707,-109.3828665
13006,4,37,11,4,13,7,76,38.27159978580707,-109.382597
13007,2,34,11,4,12,9,72,38.27159978580707,-109.3823275
13008,2,44,8,3,9,8,74,38.27159978580707,-109.382058
13009,8,39,11,6,9,7,80,38.27159978580707,-109.3817885
13010,6,33,14,9,15,8,85,38.27159978580707,-109.381519
13011,7,31,14,8,15,9,84,38.27159978580707,-109.3812495
13012,8,32,14,9,16,7,86,38.27159978580707,-109.38098
13013,7,33,14,10,16,6,86,38.27159978580707,-109.3807105
13014,7,37,14,9,15,6,88,38.27159978580707,-109.380441
13015,8,37,13,8,14,5,85,38.27159978580707,-109.3801716
13016,8,38,13,7,14,6,86,38.27159978580707,-109.3799021
13017,9,38,14,6,14,6,87,38.27159978580707,-109.3796326
13018,8,39,13,6,15,6,87,38.27159978580707,-109.3793631
13019,6,37,13,6,14,7,83,38.27159978580707,-109.3790936
13020,5,38,13,5,15,7,83,38.27159978580707,-109.3788241
13021,3,40,13,1,12,12,81,38.27159978580707,-109.3785546
13022,2,41,13,1,10,15,82,38.27159978580707,-109.3782851
13023,1,42,12,0,11,14,80,38.27159978580707,-109.3780156
13024,2,36,12,1,12,13,76,38.27159978580707,-109.3777461
13025,2,29,12,2,10,14,69,38.27159978580707,-109.3774766
13026,2,28,10,2,7,14,63,38.27159978580707,-109.3772071
13027,1,29,10,2,9,12,63,38.27159978580707,-109.3769376
13028,1,26,11,3,10,13,64,38.27159978580707,-109.3766681
13029,1,23,12,2,6,18,62,38.27159978580707,-109.3763986
13030,1,25,12,0,5,19,62,38.27159978580707,-109.3761291
13031,2,28,10,1,6,15,62,38.27159978580707,-109.3758596
13032,3,28,10,6,10,7,64,38.27159978580707,-109.3755901
13033,4,21,11,8,12,8,64,38.27159978580707,-109.3753206
13034,6,21,13,7,9,14,70,38.27159978580707,-109.3750512
13035,7,20,16,5,7,19,74,38.27159978580707,-109.3747817
13036,7,20,15,7,7,19,75,38.27159978580707,-109.3745122
13037,7,23,13,8,9,13,73,38.27159978580707,-109.3742427
13038,4,21,12,8,8,14,67,38.27159978580707,-109.3739732
13039,6,19,11,17,13,7,73,38.27159978580707,-109.3737037
13040,13,18,13,12,5,6,67,38.27159978580707,-109.3734342
13041,5,21,10,8,9,3,56,38.27159978580707,-109.3731647
13042,0,47,8,1,11,7,74,38.27159978580707,-109.3728952
13043,0,34,9,2,9,11,65,38.27159978580707,-109.3726257
13044,3,33,12,4,7,10,69,38.27159978580707,-109.3723562
13045,3,32,14,3,6,11,69,38.27159978580707,-109.3720867
13046,2,31,11,2,7,15,68,38.27159978580707,-109.3718172
13047,2,26,12,3,6,16,65,38.27159978580707,-109.3715477
13048,0,21,10,2,4,17,54,38.27159978580707,-109.3712782
13049,0,25,10,2,5,15,57,38.27159978580707,-109.3710087
13050,2,27,13,2,8,15,67,38.27159978580707,-109.3707392
13051,2,24,13,2,7,18,66,38.27159978580707,-109.3704697
13052,5,30,14,3,7,16,75,38.27159978580707,-109.3702003
13053,4,31,16,9,4,18,82,38.27159978580707,-109.3699308
13054,5,28,16,5,5,22,81,38.27159978580707,-109.3696613
13055,6,20,14,5,3,22,70,38.27159978580707,-109.3693918
13056,6,21,13,7,5,20,72,38.27159978580707,-109.3691223
13057,4,27,15,3,8,20,77,38.27159978580707,-109.3688528
13058,3,26,14,0,9,21,73,38.27159978580707,-109.3685833
13059,2,28,15,0,7,22,74,38.27159978580707,-109.3683138
13060,1,27,15,1,6,23,73,38.27159978580707,-109.3680443
13061,3,29,16,2,4,24,78,38.27159978580707,-109.3677748
13062,2,27,18,1,10,22,80,38.27159978580707,-109.3675053
13063,3,19,17,5,13,17,74,38.27159978580707,-109.3672358
13064,1,9,13,16,14,14,67,38.27159978580707,-109.3669663
13065,5,10,11,26,20,2,74,38.27159978580707,-109.3666968
13066,3,19,13,22,17,3,77,38.27159978580707,-109.3664273
13067,2,20,12,7,15,11,67,38.27159978580707,-109.3661578
13068,1,27,15,3,7,23,76,38.27159978580707,-109.3658883
13069,0,24,17,0,5,29,75,38.27159978580707,-109.3656188
13070,0,27,19,0,6,28,80,38.27159978580707,-109.3653493
13071,1,27,20,1,7,27,83,38.27159978580707,-109.3650799
13072,0,27,19,0,6,30,82,38.27159978580707,-109.3648104
13073,0,25,19,0,4,33,81,38.27159978580707,-109.3645409
13074,0,20,18,0,2,35,75,38.27159978580707,-109.3642714
13075,0,18,18,0,2,34,72,38.27159978580707,-109.3640019
13076,0,19,17,0,1,32,69,38.27159978580707,-109.3637324
13077,0,19,18,0,2,33,72,38.27159978580707,-109.3634629
13078,0,20,18,0,3,34,75,38.27159978580707,-109.3631934
13079,0,19,17,0,2,31,69,38.27159978580707,-109.3629239
13080,0,17,15,0,1,27,60,38.27159978580707,-109.3626544
13081,1,21,12,1,3,20,58,38.27159978580707,-109.3623849
13082,1,21,9,2,5,14,52,38.27159978580707,-109.3621154
13083,1,20,8,3,8,8,48,38.27159978580707,-109.3618459
13084,3,26,8,3,7,5,52,38.27159978580707,-109.3615764
13085,2,18,8,2,8,8,46,38.27159978580707,-109.3613069
13086,2,18,8,3,7,9,47,38.27159978580707,-109.3610374
13087,2,18,9,4,6,9,48,38.27159978580707,-109.3607679
13088,2,17,10,5,7,10,51,38.27159978580707,-109.3604984
13089,2,21,11,4,6,12,56,38.27159978580707,-109.360229
13090,2,28,12,3,7,13,65,38.27159978580707,-109.3599595
13091,3,28,12,2,8,15,68,38.27159978580707,-109.35969
13092,3,25,14,2,5,20,69,38.27159978580707,-109.3594205
13093,3,23,16,1,4,24,71,38.27159978580707,-109.359151
13094,2,25,16,1,5,25,74,38.27159978580707,-109.3588815
13095,2,24,16,0,4,25,71,38.27159978580707,-109.358612
13096,2,25,16,0,5,25,73,38.27159978580707,-109.3583425
13097,2,26,15,0,7,24,74,38.27159978580707,-109.358073
13098,3,28,16,0,8,22,77,38.27159978580707,-109.3578035
13099,0,25,16,0,9,24,74,38.27159978580707,-109.357534
13100,2,29,16,7,16,10,80,38.27159978580707,-109.3572645
13101,0,26,12,9,22,5,74,38.27159978580707,-109.356995
13102,0,27,10,7,22,3,69,38.27159978580707,-109.3567255
13103,3,26,12,11,13,4,69,38.27159978580707,-109.356456
13104,1,33,8,3,10,6,61,38.27159978580707,-109.3561865
13105,1,30,8,2,9,7,57,38.27159978580707,-109.355917
13106,1,25,8,3,7,8,52,38.27159978580707,-109.3556475
13107,2,25,9,4,9,8,57,38.27159978580707,-109.355378
13108,2,30,11,5,8,8,64,38.27159978580707,-109.3551086
13109,2,29,12,2,9,14,68,38.27159978580707,-109.3548391
13110,3,26,15,0,6,22,72,38.27159978580707,-109.3545696
13111,2,25,14,0,5,23,69,38.27159978580707,-109.3543001
13112,2,25,14,0,8,21,70,38.27159978580707,-109.3540306
13113,2,27,13,0,7,21,70,38.27159978580707,-109.3537611
13114,2,27,13,0,8,19,69,38.27159978580707,-109.3534916
13115,2,25,11,2,12,10,62,38.27159978580707,-109.3532221
13116,2,26,10,5,11,7,61,38.27159978580707,-109.3529526
13117,2,34,10,6,12,3,67,38.27159978580707,-109.3526831
13118,2,33,10,7,11,4,67,38.27159978580707,-109.3524136
13119,3,26,10,6,12,7,64,38.27159978580707,-109.3521441
13120,3,25,10,4,10,9,61,38.27159978580707,-109.3518746
13121,4,23,13,5,6,12,63,38.27159978580707,-109.3516051
13122,5,22,12,7,8,10,64,38.27159978580707,-109.3513356
13123,3,21,12,8,10,11,65,38.27159978580707,-109.3510661
13124,1,16,12,7,6,17,59,38.27159978580707,-109.3507966
13125,1,14,13,3,4,21,56,38.27159978580707,-109.3505271
13126,3,19,14,1,3,21,61,38.27159978580707,-109.3502577
13127,2,18,13,0,3,20,56,38.27159978580707,-109.3499882
13128,1,16,13,0,3,21,54,38.27159978580707,-109.3497187
13129,2,15,14,1,3,22,57,38.27159978580707,-109.3494492
13130,2,17,14,0,3,24,60,38.27159978580707,-109.3491797
13131,1,20,15,0,2,26,64,38.27159978580707,-109.3489102
13132,1,19,14,0,3,27,64,38.27159978580707,-109.3486407
13133,1,20,15,0,3,27,66,38.27159978580707,-109.3483712
13134,1,19,15,0,3,28,66,38.27159978580707,-109.3481017
13135,2,18,15,1,3,26,65,38.27159978580707,-109.3478322
13136,2,19,15,1,4,24,65,38.27159978580707,-109.3475627
13137,1,19,16,1,3,26,66,38.27159978580707,-109.3472932
13138,2,19,17,1,3,27,69,38.27159978580707,-109.3470237
13139,2,20,17,1,3,28,71,38.27159978580707,-109.3467542
13140,1,22,19,1,5,30,78,38.27159978580707,-109.3464847
13141,1,21,19,0,5,31,77,38.27159978580707,-109.3462152
13142,1,20,17,0,3,28,69,38.27159978580707,-109.3459457
13143,1,15,14,2,3,22,57,38.27159978580707,-109.3456762
13144,3,14,12,5,7,15,56,38.27159978580707,-109.3454068
13145,4,20,10,3,6,11,54,38.27159978580707,-109.3451373
13146,8,18,13,10,9,8,66,38.27159978580707,-109.3448678
13147,13,15,17,13,10,10,78,38.27159978580707,-109.3445983
13148,20,14,18,23,8,8,91,38.27159978580707,-109.3443288
13149,18,17,17,19,10,7,88,38.27159978580707,-109.3440593
13150,15,20,17,17,8,11,88,38.27159978580707,-109.3437898
13151,16,28,17,23,2,7,93,38.27159978580707,-109.3435203
13152,12,33,15,21,4,5,90,38.27159978580707,-109.3432508
13153,9,33,14,17,7,7,87,38.27159978580707,-109.3429813
13154,9,34,15,13,8,9,88,38.27159978580707,-109.3427118
13155,7,33,14,11,10,9,84,38.27159978580707,-109.3424423
13156,6,34,14,11,11,8,84,38.27159978580707,-109.3421728
13157,7,34,14,11,11,7,84,38.27159978580707,-109.3419033
13158,8,33,14,13,9,6,83,38.27159978580707,-109.3416338
13159,9,33,14,15,9,5,85,38.27159978580707,-109.3413643
13160,7,36,14,12,11,5,85,38.27159978580707,-109.3410948
13161,6,35,13,11,10,6,81,38.27159978580707,-109.3408253
13162,5,35,12,9,9,7,77,38.27159978580707,-109.3405558
13163,4,33,12,9,10,7,75,38.27159978580707,-109.3402864
13164,6,32,13,12,10,7,80,38.27159978580707,-109.3400169
13165,10,35,14,15,11,5,90,38.27159978580707,-109.3397474
13166,10,36,14,14,10,5,89,38.27159978580707,-109.3394779
13167,1,38,11,0,11,13,74,38.27133029122184,-109.4373044
13168,1,35,12,0,10,16,74,38.27133029122184,-109.4370349
13169,2,50,10,0,13,10,85,38.27133029122184,-109.4367654
13170,1,50,10,0,13,9,83,38.27133029122184,-109.4364959
13171,1,48,10,0,12,10,81,38.27133029122184,-109.4362264
13172,1,43,10,0,10,12,76,38.27133029122184,-109.4359569
13173,1,38,10,0,9,14,72,38.27133029122184,-109.4356874
13174,1,38,10,0,10,12,71,38.27133029122184,-109.4354179
13175,1,39,9,0,10,11,70,38.27133029122184,-109.4351484
13176,1,37,9,1,9,9,66,38.27133029122184,-109.434879
13177,2,32,7,3,7,8,59,38.27133029122184,-109.4346095
13178,1,33,7,3,8,6,58,38.27133029122184,-109.43434
13179,3,33,8,8,8,5,65,38.27133029122184,-109.4340705
13180,4,26,12,18,18,2,80,38.27133029122184,-109.433801
13181,10,16,12,13,34,6,91,38.27133029122184,-109.4335315
13182,1,17,11,22,24,10,85,38.27133029122184,-109.433262
13183,0,27,11,21,22,3,84,38.27133029122184,-109.4329925
13184,0,36,12,6,19,9,82,38.27133029122184,-109.432723
13185,1,39,11,0,15,11,77,38.27133029122184,-109.4324535
13186,1,40,11,1,15,10,78,38.27133029122184,-109.432184
13187,1,32,12,5,13,11,74,38.27133029122184,-109.4319145
13188,2,37,11,0,12,14,76,38.27133029122184,-109.431645
13189,1,37,12,0,13,14,77,38.27133029122184,-109.4313755
13190,1,35,12,0,13,16,77,38.27133029122184,-109.431106
13191,1,33,12,0,10,18,74,38.27133029122184,-109.4308365
13192,2,31,11,0,10,13,67,38.27133029122184,-109.430567
13193,1,35,10,1,14,9,70,38.27133029122184,-109.4302975
13194,1,34,11,1,14,11,72,38.27133029122184,-109.430028
13195,0,34,11,0,11,15,71,38.27133029122184,-109.4297586
13196,3,42,11,0,14,10,80,38.27133029122184,-109.4294891
13197,3,47,12,3,17,4,86,38.27133029122184,-109.4292196
13198,3,48,12,3,17,5,88,38.27133029122184,-109.4289501
13199,3,48,12,3,18,3,87,38.27133029122184,-109.4286806
13200,4,49,13,3,19,3,91,38.27133029122184,-109.4284111
13201,3,49,13,4,19,3,91,38.27133029122184,-109.4281416
13202,4,47,13,5,19,2,90,38.27133029122184,-109.4278721
13203,5,47,13,8,19,1,93,38.27133029122184,-109.4276026
13204,4,47,13,9,18,1,92,38.27133029122184,-109.4273331
13205,4,46,13,6,18,2,89,38.27133029122184,-109.4270636
13206,5,46,12,5,17,3,88,38.27133029122184,-109.4267941
13207,4,43,12,3,17,6,85,38.27133029122184,-109.4265246
13208,1,38,12,1,14,13,79,38.27133029122184,-109.4262551
13209,1,29,13,0,8,21,72,38.27133029122184,-109.4259856
13210,1,23,14,1,4,23,66,38.27133029122184,-109.4257161
13211,1,26,12,3,10,15,67,38.27133029122184,-109.4254466
13212,1,27,11,2,10,13,64,38.27133029122184,-109.4251771
13213,1,33,10,0,11,10,65,38.27133029122184,-109.4249077
13214,1,38,9,0,13,8,69,38.27133029122184,-109.4246382
13215,1,42,9,0,13,8,73,38.27133029122184,-109.4243687
13216,2,44,11,0,13,10,80,38.27133029122184,-109.4240992
13217,2,48,12,1,15,7,85,38.27133029122184,-109.4238297
13218,3,50,12,2,17,5,89,38.27133029122184,-109.4235602
13219,3,51,12,3,17,4,90,38.27133029122184,-109.4232907
13220,3,51,12,3,17,3,89,38.27133029122184,-109.4230212
13221,4,49,13,5,18,2,91,38.27133029122184,-109.4227517
13222,5,48,13,6,19,1,92,38.27133029122184,-109.4224822
13223,5,46,13,6,19,1,90,38.27133029122184,-109.4222127
13224,5,45,13,6,19,1,89,38.27133029122184,-109.4219432
13225,6,45,13,8,19,1,92,38.27133029122184,-109.4216737
13226,5,45,13,6,19,1,89,38.27133029122184,-109.4214042
13227,5,43,13,5,18,3,87,38.27133029122184,-109.4211347
13228,5,42,13,3,18,6,87,38.27133029122184,-109.4208652
13229,2,39,12,1,15,10,79,38.27133029122184,-109.4205957
13230,3,36,12,2,15,9,77,38.27133029122184,-109.4203262
13231,2,35,12,2,15,10,76,38.27133029122184,-109.4200568
13232,1,34,12,0,14,12,73,38.27133029122184,-109.4197873
13233,1,35,11,0,13,13,73,38.27133029122184,-109.4195178
13234,2,40,12,2,15,8,79,38.27133029122184,-109.4192483
13235,5,43,13,6,18,3,88,38.27133029122184,-109.4189788
13236,5,44,13,7,19,1,89,38.27133029122184,-109.4187093
13237,5,45,13,7,19,0,89,38.27133029122184,-109.4184398
13238,6,44,13,8,18,0,89,38.27133029122184,-109.4181703
13239,7,42,14,10,17,0,90,38.27133029122184,-109.4179008
13240,6,43,13,10,16,1,89,38.27133029122184,-109.4176313
13241,7,43,13,11,16,0,90,38.27133029122184,-109.4173618
13242,11,42,13,11,14,0,91,38.27133029122184,-109.4170923
13243,20,35,14,12,10,1,92,38.27133029122184,-109.4168228
13244,16,39,14,11,11,1,92,38.27133029122184,-109.4165533
13245,12,42,14,11,12,0,91,38.27133029122184,-109.4162838
13246,12,42,14,12,12,0,92,38.27133029122184,-109.4160143
13247,14,40,14,13,12,0,93,38.27133029122184,-109.4157448
13248,12,41,14,14,12,0,93,38.27133029122184,-109.4154753
13249,10,43,14,11,14,1,93,38.27133029122184,-109.4152058
13250,10,43,13,9,16,1,92,38.27133029122184,-109.4149364
13251,12,42,13,9,15,1,92,38.27133029122184,-109.4146669
13252,14,42,13,9,14,1,93,38.27133029122184,-109.4143974
13253,12,43,13,8,15,1,92,38.27133029122184,-109.4141279
13254,11,42,14,9,14,1,91,38.27133029122184,-109.4138584
13255,11,43,14,9,14,1,92,38.27133029122184,-109.4135889
13256,10,45,14,8,15,1,93,38.27133029122184,-109.4133194
13257,10,45,13,8,14,1,91,38.27133029122184,-109.4130499
13258,13,42,13,7,15,0,90,38.27133029122184,-109.4127804
13259,14,40,13,8,14,1,90,38.27133029122184,-109.4125109
13260,11,43,14,8,14,1,91,38.27133029122184,-109.4122414
13261,8,47,13,8,15,1,92,38.27133029122184,-109.4119719
13262,6,49,13,6,17,1,92,38.27133029122184,-109.4117024
13263,4,53,12,5,17,2,93,38.27133029122184,-109.4114329
13264,3,56,11,4,15,2,91,38.27133029122184,-109.4111634
13265,3,59,10,4,15,2,93,38.27133029122184,-109.4108939
13266,3,56,10,4,16,1,90,38.27133029122184,-109.4106244
13267,4,55,11,5,17,0,92,38.27133029122184,-109.4103549
13268,4,55,12,4,17,1,93,38.27133029122184,-109.4100855
13269,4,55,12,4,17,2,94,38.27133029122184,-109.409816
13270,5,52,13,5,17,1,93,38.27133029122184,-109.4095465
13271,5,51,13,5,17,1,92,38.27133029122184,-109.409277
13272,6,49,13,6,18,1,93,38.27133029122184,-109.4090075
13273,6,49,13,6,18,1,93,38.27133029122184,-109.408738
13274,6,50,13,5,17,1,92,38.27133029122184,-109.4084685
13275,6,51,13,5,17,0,92,38.27133029122184,-109.408199
13276,6,51,12,5,16,1,91,38.27133029122184,-109.4079295
13277,7,50,13,5,17,1,93,38.27133029122184,-109.40766
13278,7,48,13,6,17,1,92,38.27133029122184,-109.4073905
13279,10,44,13,8,16,0,91,38.27133029122184,-109.407121
13280,13,40,13,11,14,0,91,38.27133029122184,-109.4068515
13281,2,38,12,0,9,15,76,38.27133029122184,-109.3879869
13282,3,34,12,1,9,15,74,38.27133029122184,-109.3877174
13283,3,35,13,2,11,13,77,38.27133029122184,-109.3874479
13284,3,35,12,2,11,14,77,38.27133029122184,-109.3871784
13285,2,34,11,0,8,16,71,38.27133029122184,-109.3869089
13286,1,33,10,0,8,15,67,38.27133029122184,-109.3866394
13287,1,31,10,0,9,13,64,38.27133029122184,-109.3863699
13288,2,25,11,0,6,17,61,38.27133029122184,-109.3861004
13289,1,23,12,0,5,22,63,38.27133029122184,-109.3858309
13290,1,24,14,0,5,25,69,38.27133029122184,-109.3855614
13291,2,24,13,0,4,22,65,38.27133029122184,-109.3852919
13292,2,29,12,0,5,19,67,38.27133029122184,-109.3850225
13293,4,36,12,0,10,15,77,38.27133029122184,-109.384753
13294,5,37,13,2,12,10,79,38.27133029122184,-109.3844835
13295,7,36,14,6,12,8,83,38.27133029122184,-109.384214
13296,6,35,14,7,12,7,81,38.27133029122184,-109.3839445
13297,7,36,14,8,12,5,82,38.27133029122184,-109.383675
13298,10,36,14,12,14,1,87,38.27133029122184,-109.3834055
13299,11,36,14,13,13,1,88,38.27133029122184,-109.383136
13300,6,37,13,4,12,6,78,38.27133029122184,-109.3828665
13301,3,33,12,1,11,12,72,38.27133029122184,-109.382597
13302,2,33,12,2,11,12,72,38.27133029122184,-109.3823275
13303,3,35,12,2,11,11,74,38.27133029122184,-109.382058
13304,7,31,14,5,12,10,79,38.27133029122184,-109.3817885
13305,5,32,15,5,14,14,85,38.27133029122184,-109.381519
13306,7,33,14,8,17,8,87,38.27133029122184,-109.3812495
13307,8,34,14,11,16,5,88,38.27133029122184,-109.38098
13308,9,35,13,11,15,3,86,38.27133029122184,-109.3807105
13309,9,37,13,12,16,2,89,38.27133029122184,-109.380441
13310,8,38,14,10,16,3,89,38.27133029122184,-109.3801716
13311,8,40,14,8,16,3,89,38.27133029122184,-109.3799021
13312,8,40,14,7,16,3,88,38.27133029122184,-109.3796326
13313,7,41,13,8,16,3,88,38.27133029122184,-109.3793631
13314,5,42,13,7,16,3,86,38.27133029122184,-109.3790936
13315,5,42,13,5,16,4,85,38.27133029122184,-109.3788241
13316,3,38,12,2,14,10,79,38.27133029122184,-109.3785546
13317,2,31,13,2,8,17,73,38.27133029122184,-109.3782851
13318,2,29,13,2,5,20,71,38.27133029122184,-109.3780156
13319,2,39,11,0,12,12,76,38.27133029122184,-109.3777461
13320,2,34,11,2,12,8,69,38.27133029122184,-109.3774766
13321,3,30,10,3,9,10,65,38.27133029122184,-109.3772071
13322,3,25,12,2,9,14,65,38.27133029122184,-109.3769376
13323,2,24,15,0,5,25,71,38.27133029122184,-109.3766681
13324,2,23,16,1,6,23,71,38.27133029122184,-109.3763986
13325,4,22,16,3,6,21,72,38.27133029122184,-109.3761291
13326,3,22,15,3,8,19,70,38.27133029122184,-109.3758596
13327,3,24,13,4,11,14,69,38.27133029122184,-109.3755901
13328,7,29,13,12,15,5,81,38.27133029122184,-109.3753206
13329,7,27,15,8,11,14,82,38.27133029122184,-109.3750512
13330,8,28,17,5,10,20,88,38.27133029122184,-109.3747817
13331,5,27,17,4,11,23,87,38.27133029122184,-109.3745122
13332,2,27,15,5,12,21,82,38.27133029122184,-109.3742427
13333,2,19,13,13,8,14,69,38.27133029122184,-109.3739732
13334,7,13,11,18,11,10,70,38.27133029122184,-109.3737037
13335,18,16,14,12,4,8,72,38.27133029122184,-109.3734342
13336,4,29,9,8,8,8,66,38.27133029122184,-109.3731647
13337,1,30,9,5,8,10,63,38.27133029122184,-109.3728952
13338,0,18,12,5,3,19,57,38.27133029122184,-109.3726257
13339,3,18,16,4,5,24,70,38.27133029122184,-109.3723562
13340,4,23,17,1,7,26,78,38.27133029122184,-109.3720867
13341,3,24,18,0,7,30,82,38.27133029122184,-109.3718172
13342,1,25,19,0,8,31,84,38.27133029122184,-109.3715477
13343,1,25,18,0,8,29,81,38.27133029122184,-109.3712782
13344,3,27,16,2,4,26,78,38.27133029122184,-109.3710087
13345,4,27,15,6,2,24,78,38.27133029122184,-109.3707392
13346,6,29,16,9,4,19,83,38.27133029122184,-109.3704697
13347,4,26,14,0,7,21,72,38.27133029122184,-109.3702003
13348,5,26,15,8,4,20,78,38.27133029122184,-109.3699308
13349,5,25,14,8,4,21,77,38.27133029122184,-109.3696613
13350,6,25,14,4,4,23,76,38.27133029122184,-109.3693918
13351,5,21,14,4,4,23,71,38.27133029122184,-109.3691223
13352,6,21,14,4,3,21,69,38.27133029122184,-109.3688528
13353,3,25,15,0,8,25,76,38.27133029122184,-109.3685833
13354,2,28,16,1,6,27,80,38.27133029122184,-109.3683138
13355,2,28,15,0,12,24,81,38.27133029122184,-109.3680443
13356,7,28,14,4,9,14,76,38.27133029122184,-109.3677748
13357,8,33,14,12,10,6,83,38.27133029122184,-109.3675053
13358,4,22,12,10,17,4,69,38.27133029122184,-109.3672358
13359,3,15,12,15,17,4,66,38.27133029122184,-109.3669663
13360,4,21,12,19,14,5,75,38.27133029122184,-109.3666968
13361,6,27,14,13,10,6,76,38.27133029122184,-109.3664273
13362,0,24,14,0,10,18,66,38.27133029122184,-109.3661578
13363,1,23,19,2,7,27,79,38.27133029122184,-109.3658883
13364,2,27,17,0,8,23,77,38.27133029122184,-109.3656188
13365,0,27,17,0,8,26,78,38.27133029122184,-109.3653493
13366,0,27,18,0,6,30,81,38.27133029122184,-109.3650799
13367,0,24,18,0,3,32,77,38.27133029122184,-109.3648104
13368,0,23,18,0,2,33,76,38.27133029122184,-109.3645409
13369,0,20,18,0,1,34,73,38.27133029122184,-109.3642714
13370,0,19,18,0,1,33,71,38.27133029122184,-109.3640019
13371,0,20,18,0,2,34,74,38.27133029122184,-109.3637324
13372,0,19,19,0,2,34,74,38.27133029122184,-109.3634629
13373,0,18,18,0,2,32,70,38.27133029122184,-109.3631934
13374,1,17,16,0,1,28,63,38.27133029122184,-109.3629239
13375,2,14,14,1,2,23,56,38.27133029122184,-109.3626544
13376,2,19,12,2,3,19,57,38.27133029122184,-109.3623849
13377,2,19,9,3,4,13,50,38.27133029122184,-109.3621154
13378,1,20,9,5,6,9,50,38.27133029122184,-109.3618459
13379,4,29,6,4,7,7,57,38.27133029122184,-109.3615764
13380,3,21,8,3,6,10,51,38.27133029122184,-109.3613069
13381,3,20,8,3,6,11,51,38.27133029122184,-109.3610374
13382,1,19,10,4,6,13,53,38.27133029122184,-109.3607679
13383,1,19,11,4,5,16,56,38.27133029122184,-109.3604984
13384,1,19,11,3,4,17,55,38.27133029122184,-109.360229
13385,3,26,11,3,6,15,64,38.27133029122184,-109.3599595
13386,3,25,13,3,7,17,68,38.27133029122184,-109.35969
13387,3,23,15,2,6,20,69,38.27133029122184,-109.3594205
13388,3,24,16,0,4,24,71,38.27133029122184,-109.359151
13389,2,23,17,0,5,28,75,38.27133029122184,-109.3588815
13390,1,22,17,0,4,29,73,38.27133029122184,-109.358612
13391,0,23,15,0,4,25,67,38.27133029122184,-109.3583425
13392,1,25,12,0,5,20,63,38.27133029122184,-109.358073
13393,2,24,11,0,5,18,60,38.27133029122184,-109.3578035
13394,1,19,10,0,5,18,53,38.27133029122184,-109.357534
13395,3,16,9,5,8,7,48,38.27133029122184,-109.3572645
13396,1,22,9,6,10,6,54,38.27133029122184,-109.356995
13397,2,26,8,4,8,7,55,38.27133029122184,-109.3567255
13398,1,30,7,2,7,9,56,38.27133029122184,-109.356456
13399,1,29,8,2,7,10,57,38.27133029122184,-109.3561865
13400,2,28,10,4,8,11,63,38.27133029122184,-109.355917
13401,2,28,12,4,8,12,66,38.27133029122184,-109.3556475
13402,2,28,11,2,9,14,66,38.27133029122184,-109.355378
13403,4,26,15,3,7,18,73,38.27133029122184,-109.3551086
13404,2,26,14,1,8,20,71,38.27133029122184,-109.3548391
13405,1,27,13,1,10,17,69,38.27133029122184,-109.3545696
13406,0,27,12,2,11,15,67,38.27133029122184,-109.3543001
13407,0,29,11,1,12,13,66,38.27133029122184,-109.3540306
13408,1,31,12,1,12,13,70,38.27133029122184,-109.3537611
13409,4,32,11,4,13,9,73,38.27133029122184,-109.3534916
13410,4,37,10,10,11,4,76,38.27133029122184,-109.3532221
13411,3,40,10,11,11,2,77,38.27133029122184,-109.3529526
13412,4,43,9,7,10,4,77,38.27133029122184,-109.3526831
13413,8,35,11,14,12,2,82,38.27133029122184,-109.3524136
13414,6,26,11,17,13,2,75,38.27133029122184,-109.3521441
13415,0,24,10,14,19,3,70,38.27133029122184,-109.3518746
13416,1,21,9,9,18,3,61,38.27133029122184,-109.3516051
13417,1,16,10,12,13,4,56,38.27133029122184,-109.3513356
13418,3,16,11,9,10,8,57,38.27133029122184,-109.3510661
13419,2,14,12,6,6,14,54,38.27133029122184,-109.3507966
13420,3,15,13,2,4,19,56,38.27133029122184,-109.3505271
13421,3,14,13,2,4,21,57,38.27133029122184,-109.3502577
13422,2,16,14,1,4,23,60,38.27133029122184,-109.3499882
13423,2,17,15,2,4,25,65,38.27133029122184,-109.3497187
13424,2,17,15,2,4,26,66,38.27133029122184,-109.3494492
13425,2,17,16,1,3,28,67,38.27133029122184,-109.3491797
13426,2,21,16,0,3,29,71,38.27133029122184,-109.3489102
13427,1,20,15,0,3,28,67,38.27133029122184,-109.3486407
13428,1,21,16,0,4,29,71,38.27133029122184,-109.3483712
13429,1,20,17,0,4,30,72,38.27133029122184,-109.3481017
13430,1,20,17,0,3,30,71,38.27133029122184,-109.3478322
13431,2,19,16,0,1,27,65,38.27133029122184,-109.3475627
13432,1,20,16,0,1,28,66,38.27133029122184,-109.3472932
13433,1,20,15,0,3,26,65,38.27133029122184,-109.3470237
13434,2,21,16,1,4,26,70,38.27133029122184,-109.3467542
13435,1,23,18,0,5,29,76,38.27133029122184,-109.3464847
13436,0,21,18,0,4,32,75,38.27133029122184,-109.3462152
13437,2,19,17,0,2,26,66,38.27133029122184,-109.3459457
13438,2,12,13,4,4,18,53,38.27133029122184,-109.3456762
13439,3,17,11,5,7,12,55,38.27133029122184,-109.3454068
13440,5,19,13,4,4,15,60,38.27133029122184,-109.3451373
13441,8,18,17,9,8,17,77,38.27133029122184,-109.3448678
13442,12,20,18,12,10,18,90,38.27133029122184,-109.3445983
13443,18,20,17,10,11,14,90,38.27133029122184,-109.3443288
13444,19,17,16,12,10,10,84,38.27133029122184,-109.3440593
13445,16,22,17,16,8,11,90,38.27133029122184,-109.3437898
13446,14,28,15,17,7,9,90,38.27133029122184,-109.3435203
13447,10,32,14,16,9,7,88,38.27133029122184,-109.3432508
13448,8,35,15,12,10,9,89,38.27133029122184,-109.3429813
13449,7,35,15,11,9,9,86,38.27133029122184,-109.3427118
13450,6,36,15,10,11,8,86,38.27133029122184,-109.3424423
13451,6,36,14,10,12,8,86,38.27133029122184,-109.3421728
13452,6,35,14,11,12,7,85,38.27133029122184,-109.3419033
13453,7,34,14,12,10,7,84,38.27133029122184,-109.3416338
13454,7,35,14,13,9,6,84,38.27133029122184,-109.3413643
13455,7,37,14,12,11,5,86,38.27133029122184,-109.3410948
13456,7,35,13,11,10,7,83,38.27133029122184,-109.3408253
13457,7,34,13,11,10,7,82,38.27133029122184,-109.3405558
13458,10,34,13,12,11,6,86,38.27133029122184,-109.3402864
13459,15,33,13,14,12,4,91,38.27133029122184,-109.3400169
13460,24,27,11,13,9,3,87,38.27133029122184,-109.3397474
13461,18,31,12,14,11,4,90,38.27133029122184,-109.3394779
13462,8,36,13,14,11,5,87,38.27133029122184,-109.3392084
13463,2,42,11,0,13,13,81,38.271060796636604,-109.4375739
13464,1,40,10,0,13,12,76,38.271060796636604,-109.4373044
13465,1,36,11,0,13,11,72,38.271060796636604,-109.4370349
13466,1,41,9,0,12,10,73,38.271060796636604,-109.4367654
13467,1,44,9,0,12,8,74,38.271060796636604,-109.4364959
13468,1,43,10,0,11,9,74,38.271060796636604,-109.4362264
13469,2,39,10,0,9,12,72,38.271060796636604,-109.4359569
13470,2,40,11,1,10,11,75,38.271060796636604,-109.4356874
13471,2,38,10,1,10,9,70,38.271060796636604,-109.4354179
13472,2,37,9,3,9,7,67,38.271060796636604,-109.4351484
13473,0,36,8,2,10,7,63,38.271060796636604,-109.434879
13474,1,41,7,3,9,5,66,38.271060796636604,-109.4346095
13475,2,36,7,2,8,6,61,38.271060796636604,-109.43434
13476,3,27,9,8,7,7,61,38.271060796636604,-109.4340705
13477,10,24,12,19,22,2,89,38.271060796636604,-109.433801
13478,4,15,11,21,32,8,91,38.271060796636604,-109.4335315
13479,1,19,13,21,23,9,86,38.271060796636604,-109.433262
13480,1,31,12,9,19,10,82,38.271060796636604,-109.4329925
13481,0,38,12,6,20,8,84,38.271060796636604,-109.432723
13482,1,39,11,0,17,10,78,38.271060796636604,-109.4324535
13483,1,39,11,0,14,12,77,38.271060796636604,-109.432184
13484,1,35,12,1,13,12,74,38.271060796636604,-109.4319145
13485,2,40,11,0,14,10,77,38.271060796636604,-109.431645
13486,2,39,11,0,14,12,78,38.271060796636604,-109.4313755
13487,2,41,12,0,14,11,80,38.271060796636604,-109.431106
13488,3,42,12,2,16,8,83,38.271060796636604,-109.4308365
13489,1,32,11,3,14,9,70,38.271060796636604,-109.430567
13490,2,37,9,0,11,9,68,38.271060796636604,-109.4302975
13491,1,34,9,0,10,12,66,38.271060796636604,-109.430028
13492,2,35,10,0,10,13,70,38.271060796636604,-109.4297586
13493,4,47,10,0,13,8,82,38.271060796636604,-109.4294891
13494,3,49,11,5,15,2,85,38.271060796636604,-109.4292196
13495,3,50,11,5,17,2,88,38.271060796636604,-109.4289501
13496,3,48,12,3,18,4,88,38.271060796636604,-109.4286806
13497,3,48,12,3,18,4,88,38.271060796636604,-109.4284111
13498,3,51,13,4,18,3,92,38.271060796636604,-109.4281416
13499,4,49,13,5,19,2,92,38.271060796636604,-109.4278721
13500,4,48,13,8,18,1,92,38.271060796636604,-109.4276026
13501,4,47,13,8,17,1,90,38.271060796636604,-109.4273331
13502,4,48,13,7,17,1,90,38.271060796636604,-109.4270636
13503,4,49,12,5,17,1,88,38.271060796636604,-109.4267941
13504,4,47,12,4,17,3,87,38.271060796636604,-109.4265246
13505,3,43,12,3,16,7,84,38.271060796636604,-109.4262551
13506,3,38,12,2,14,11,80,38.271060796636604,-109.4259856
13507,2,34,12,1,10,16,75,38.271060796636604,-109.4257161
13508,2,36,13,0,11,17,79,38.271060796636604,-109.4254466
13509,1,37,12,0,13,14,77,38.271060796636604,-109.4251771
13510,1,37,11,0,14,12,75,38.271060796636604,-109.4249077
13511,1,36,11,0,12,13,73,38.271060796636604,-109.4246382
13512,1,37,10,0,10,14,72,38.271060796636604,-109.4243687
13513,2,41,10,0,11,12,76,38.271060796636604,-109.4240992
13514,3,46,11,1,13,9,83,38.271060796636604,-109.4238297
13515,3,48,12,2,16,6,87,38.271060796636604,-109.4235602
13516,3,47,12,3,18,4,87,38.271060796636604,-109.4232907
13517,3,46,13,4,18,3,87,38.271060796636604,-109.4230212
13518,4,46,13,4,18,3,88,38.271060796636604,-109.4227517
13519,4,46,13,4,18,4,89,38.271060796636604,-109.4224822
13520,4,44,13,3,18,5,87,38.271060796636604,-109.4222127
13521,5,43,13,4,19,4,88,38.271060796636604,-109.4219432
13522,5,43,13,5,18,4,88,38.271060796636604,-109.4216737
13523,5,43,13,5,18,4,88,38.271060796636604,-109.4214042
13524,5,43,13,4,17,5,87,38.271060796636604,-109.4211347
13525,4,41,12,2,16,8,83,38.271060796636604,-109.4208652
13526,2,38,11,2,15,9,77,38.271060796636604,-109.4205957
13527,3,38,12,2,17,8,80,38.271060796636604,-109.4203262
13528,4,39,12,3,17,6,81,38.271060796636604,-109.4200568
13529,4,41,12,3,17,5,82,38.271060796636604,-109.4197873
13530,5,44,12,3,18,4,86,38.271060796636604,-109.4195178
13531,3,44,13,4,18,4,86,38.271060796636604,-109.4192483
13532,4,45,13,7,19,1,89,38.271060796636604,-109.4189788
13533,5,46,13,9,18,0,91,38.271060796636604,-109.4187093
13534,6,45,13,10,18,0,92,38.271060796636604,-109.4184398
13535,6,44,13,10,17,0,90,38.271060796636604,-109.4181703
13536,7,39,14,12,16,0,88,38.271060796636604,-109.4179008
13537,8,41,14,12,16,0,91,38.271060796636604,-109.4176313
13538,10,42,14,11,15,0,92,38.271060796636604,-109.4173618
13539,14,41,14,10,13,0,92,38.271060796636604,-109.4170923
13540,18,37,14,11,12,0,92,38.271060796636604,-109.4168228
13541,12,41,13,10,15,0,91,38.271060796636604,-109.4165533
13542,11,42,13,10,14,0,90,38.271060796636604,-109.4162838
13543,12,41,13,12,13,0,91,38.271060796636604,-109.4160143
13544,13,39,13,14,13,0,92,38.271060796636604,-109.4157448
13545,13,39,13,15,12,0,92,38.271060796636604,-109.4154753
13546,12,41,14,12,14,0,93,38.271060796636604,-109.4152058
13547,11,43,13,9,15,0,91,38.271060796636604,-109.4149364
13548,10,44,13,8,14,1,90,38.271060796636604,-109.4146669
13549,12,43,13,9,14,1,92,38.271060796636604,-109.4143974
13550,9,45,14,8,16,1,93,38.271060796636604,-109.4141279
13551,8,46,14,9,15,1,93,38.271060796636604,-109.4138584
13552,8,46,14,9,16,1,94,38.271060796636604,-109.4135889
13553,7,48,13,8,16,1,93,38.271060796636604,-109.4133194
13554,6,51,12,6,16,1,92,38.271060796636604,-109.4130499
13555,8,50,12,7,16,0,93,38.271060796636604,-109.4127804
13556,8,49,13,7,16,0,93,38.271060796636604,-109.4125109
13557,7,49,13,7,16,1,93,38.271060796636604,-109.4122414
13558,6,51,13,6,16,2,94,38.271060796636604,-109.4119719
13559,5,53,12,5,17,1,93,38.271060796636604,-109.4117024
13560,3,57,11,4,16,2,93,38.271060796636604,-109.4114329
13561,3,58,10,4,15,1,91,38.271060796636604,-109.4111634
13562,3,57,10,4,15,1,90,38.271060796636604,-109.4108939
13563,4,56,11,3,17,1,92,38.271060796636604,-109.4106244
13564,4,56,12,4,17,1,94,38.271060796636604,-109.4103549
13565,4,56,12,4,16,1,93,38.271060796636604,-109.4100855
13566,4,55,12,4,16,2,93,38.271060796636604,-109.409816
13567,5,53,13,5,17,1,94,38.271060796636604,-109.4095465
13568,5,50,13,5,17,2,92,38.271060796636604,-109.409277
13569,5,50,13,6,17,1,92,38.271060796636604,-109.4090075
13570,5,51,12,5,17,1,91,38.271060796636604,-109.408738
13571,5,52,12,5,17,1,92,38.271060796636604,-109.4084685
13572,5,52,12,5,17,1,92,38.271060796636604,-109.408199
13573,5,53,12,4,16,2,92,38.271060796636604,-109.4079295
13574,5,52,12,4,16,1,90,38.271060796636604,-109.40766
13575,7,50,13,6,17,1,94,38.271060796636604,-109.4073905
13576,9,46,13,8,16,0,92,38.271060796636604,-109.407121
13577,12,44,13,9,14,0,92,38.271060796636604,-109.4068515
13578,2,40,11,0,10,13,76,38.271060796636604,-109.3879869
13579,2,46,11,0,14,9,82,38.271060796636604,-109.3877174
13580,2,48,11,1,15,7,84,38.271060796636604,-109.3874479
13581,2,47,11,1,15,7,83,38.271060796636604,-109.3871784
13582,2,43,11,0,14,10,80,38.271060796636604,-109.3869089
13583,2,28,12,1,8,16,67,38.271060796636604,-109.3866394
13584,1,23,11,0,5,19,59,38.271060796636604,-109.3863699
13585,1,21,12,0,4,21,59,38.271060796636604,-109.3861004
13586,1,21,14,0,4,23,63,38.271060796636604,-109.3858309
13587,2,23,15,0,4,23,67,38.271060796636604,-109.3855614
13588,2,26,12,0,4,20,64,38.271060796636604,-109.3852919
13589,3,33,12,0,8,16,72,38.271060796636604,-109.3850225
13590,5,38,13,2,11,11,80,38.271060796636604,-109.384753
13591,6,38,13,4,12,8,81,38.271060796636604,-109.3844835
13592,6,35,13,6,12,7,79,38.271060796636604,-109.384214
13593,6,36,13,6,13,6,80,38.271060796636604,-109.3839445
13594,7,36,14,8,13,4,82,38.271060796636604,-109.383675
13595,8,36,14,11,14,2,85,38.271060796636604,-109.3834055
13596,7,36,13,9,13,4,82,38.271060796636604,-109.383136
13597,5,35,12,3,10,10,75,38.271060796636604,-109.3828665
13598,3,26,12,1,7,17,66,38.271060796636604,-109.382597
13599,2,30,11,1,8,16,68,38.271060796636604,-109.3823275
13600,3,35,11,1,11,12,73,38.271060796636604,-109.382058
13601,5,32,12,3,12,10,74,38.271060796636604,-109.3817885
13602,6,36,14,4,14,11,85,38.271060796636604,-109.381519
13603,6,36,14,7,16,7,86,38.271060796636604,-109.3812495
13604,7,37,13,10,17,4,88,38.271060796636604,-109.38098
13605,8,36,13,11,17,3,88,38.271060796636604,-109.3807105
13606,9,34,14,11,17,3,88,38.271060796636604,-109.380441
13607,8,39,14,12,16,1,90,38.271060796636604,-109.3801716
13608,7,41,14,11,16,1,90,38.271060796636604,-109.3799021
13609,7,43,14,9,16,1,90,38.271060796636604,-109.3796326
13610,7,44,13,8,16,1,89,38.271060796636604,-109.3793631
13611,6,42,13,8,17,2,88,38.271060796636604,-109.3790936
13612,5,38,12,7,15,4,81,38.271060796636604,-109.3788241
13613,5,40,12,3,14,7,81,38.271060796636604,-109.3785546
13614,4,38,12,1,12,10,77,38.271060796636604,-109.3782851
13615,3,35,12,0,9,15,74,38.271060796636604,-109.3780156
13616,3,40,10,0,10,13,76,38.271060796636604,-109.3777461
13617,1,30,11,2,10,12,66,38.271060796636604,-109.3774766
13618,1,25,12,1,7,18,64,38.271060796636604,-109.3772071
13619,1,27,14,0,7,23,72,38.271060796636604,-109.3769376
13620,2,28,15,0,7,23,75,38.271060796636604,-109.3766681
13621,4,34,14,3,12,15,82,38.271060796636604,-109.3763986
13622,6,34,15,4,12,14,85,38.271060796636604,-109.3761291
13623,4,34,14,6,16,11,85,38.271060796636604,-109.3758596
13624,5,33,14,12,16,4,84,38.271060796636604,-109.3755901
13625,11,31,13,15,15,1,86,38.271060796636604,-109.3753206
13626,10,26,14,13,14,6,83,38.271060796636604,-109.3750512
13627,10,26,14,14,13,8,85,38.271060796636604,-109.3747817
13628,8,27,15,10,13,12,85,38.271060796636604,-109.3745122
13629,7,27,14,9,12,14,83,38.271060796636604,-109.3742427
13630,7,18,12,15,14,5,71,38.271060796636604,-109.3739732
13631,8,14,11,16,10,10,69,38.271060796636604,-109.3737037
13632,14,13,13,14,10,8,72,38.271060796636604,-109.3734342
13633,10,17,11,12,9,10,69,38.271060796636604,-109.3731647
13634,1,16,13,5,5,21,61,38.271060796636604,-109.3728952
13635,3,18,20,2,5,33,81,38.271060796636604,-109.3726257
13636,4,17,19,6,5,27,78,38.271060796636604,-109.3723562
13637,4,21,18,7,7,24,81,38.271060796636604,-109.3720867
13638,1,23,19,2,8,29,82,38.271060796636604,-109.3718172
13639,2,22,20,2,7,33,86,38.271060796636604,-109.3715477
13640,1,24,21,0,6,34,86,38.271060796636604,-109.3712782
13641,2,29,17,3,6,27,84,38.271060796636604,-109.3710087
13642,3,35,15,7,3,23,86,38.271060796636604,-109.3707392
13643,6,32,15,9,3,20,85,38.271060796636604,-109.3704697
13644,9,26,12,12,6,16,81,38.271060796636604,-109.3702003
13645,7,25,13,12,7,15,79,38.271060796636604,-109.3699308
13646,7,26,12,11,7,16,79,38.271060796636604,-109.3696613
13647,6,28,13,9,5,18,79,38.271060796636604,-109.3693918
13648,4,28,14,3,4,22,75,38.271060796636604,-109.3691223
13649,3,26,15,7,3,24,78,38.271060796636604,-109.3688528
13650,4,25,16,6,6,24,81,38.271060796636604,-109.3685833
13651,3,27,17,4,13,21,85,38.271060796636604,-109.3683138
13652,6,28,16,7,16,13,86,38.271060796636604,-109.3680443
13653,9,28,13,15,13,4,82,38.271060796636604,-109.3677748
13654,15,28,10,15,13,1,82,38.271060796636604,-109.3675053
13655,7,25,11,11,16,2,72,38.271060796636604,-109.3672358
13656,9,16,10,17,17,5,74,38.271060796636604,-109.3669663
13657,3,15,9,17,11,2,57,38.271060796636604,-109.3666968
13658,3,17,9,12,11,4,56,38.271060796636604,-109.3664273
13659,2,14,11,6,10,12,55,38.271060796636604,-109.3661578
13660,1,18,12,4,7,19,61,38.271060796636604,-109.3658883
13661,0,23,14,1,7,22,67,38.271060796636604,-109.3656188
13662,0,22,14,0,4,25,65,38.271060796636604,-109.3653493
13663,0,22,16,0,1,31,70,38.271060796636604,-109.3650799
13664,0,21,17,0,2,32,72,38.271060796636604,-109.3648104
13665,0,20,18,0,1,33,72,38.271060796636604,-109.3645409
13666,0,19,18,0,1,33,71,38.271060796636604,-109.3642714
13667,0,19,18,0,2,32,71,38.271060796636604,-109.3640019
13668,0,21,19,0,2,34,76,38.271060796636604,-109.3637324
13669,0,18,18,0,1,32,69,38.271060796636604,-109.3634629
13670,0,18,16,0,1,28,63,38.271060796636604,-109.3631934
13671,1,19,13,0,2,23,58,38.271060796636604,-109.3629239
13672,4,16,13,2,3,19,57,38.271060796636604,-109.3626544
13673,2,21,13,1,4,18,59,38.271060796636604,-109.3623849
13674,2,21,11,1,4,15,54,38.271060796636604,-109.3621154
13675,6,29,7,2,3,11,58,38.271060796636604,-109.3618459
13676,3,25,7,4,5,9,53,38.271060796636604,-109.3615764
13677,4,16,7,3,4,11,45,38.271060796636604,-109.3613069
13678,4,16,8,3,6,10,47,38.271060796636604,-109.3610374
13679,2,21,11,3,6,13,56,38.271060796636604,-109.3607679
13680,2,23,12,3,6,17,63,38.271060796636604,-109.3604984
13681,2,19,15,3,4,22,65,38.271060796636604,-109.360229
13682,2,21,15,2,4,22,66,38.271060796636604,-109.3599595
13683,2,21,15,2,3,23,66,38.271060796636604,-109.35969
13684,2,21,15,2,3,24,67,38.271060796636604,-109.3594205
13685,2,22,17,1,3,27,72,38.271060796636604,-109.359151
13686,1,22,18,0,3,30,74,38.271060796636604,-109.3588815
13687,2,24,16,0,2,26,70,38.271060796636604,-109.358612
13688,2,26,14,0,3,22,67,38.271060796636604,-109.3583425
13689,2,26,12,0,5,18,63,38.271060796636604,-109.358073
13690,2,27,12,0,6,15,62,38.271060796636604,-109.3578035
13691,1,25,10,0,6,15,57,38.271060796636604,-109.357534
13692,2,32,10,3,10,10,67,38.271060796636604,-109.3572645
13693,2,27,11,5,8,12,65,38.271060796636604,-109.356995
13694,2,21,11,5,6,16,61,38.271060796636604,-109.3567255
13695,2,26,13,4,7,15,67,38.271060796636604,-109.356456
13696,2,30,11,1,8,14,66,38.271060796636604,-109.3561865
13697,1,28,11,3,9,15,67,38.271060796636604,-109.355917
13698,1,22,12,2,6,19,62,38.271060796636604,-109.3556475
13699,1,18,14,1,2,24,60,38.271060796636604,-109.355378
13700,1,18,15,0,3,26,63,38.271060796636604,-109.3551086
13701,1,22,14,0,7,22,66,38.271060796636604,-109.3548391
13702,1,27,13,1,11,17,70,38.271060796636604,-109.3545696
13703,1,30,12,2,12,13,70,38.271060796636604,-109.3543001
13704,1,35,11,1,14,9,71,38.271060796636604,-109.3540306
13705,1,39,11,0,15,8,74,38.271060796636604,-109.3537611
13706,2,37,11,4,15,6,75,38.271060796636604,-109.3534916
13707,3,38,12,9,13,4,79,38.271060796636604,-109.3532221
13708,5,33,12,12,13,3,78,38.271060796636604,-109.3529526
13709,8,32,12,14,15,1,82,38.271060796636604,-109.3526831
13710,3,34,12,12,22,3,86,38.271060796636604,-109.3524136
13711,0,25,12,11,28,3,79,38.271060796636604,-109.3521441
13712,2,14,9,11,19,3,58,38.271060796636604,-109.3518746
13713,0,9,5,1,16,0,31,38.271060796636604,-109.3516051
13714,0,15,7,15,10,3,50,38.271060796636604,-109.3513356
13715,2,21,11,6,11,8,59,38.271060796636604,-109.3510661
13716,1,21,12,1,5,18,58,38.271060796636604,-109.3507966
13717,0,20,15,0,4,26,65,38.271060796636604,-109.3505271
13718,0,18,17,0,4,30,69,38.271060796636604,-109.3502577
13719,2,18,19,1,6,30,76,38.271060796636604,-109.3499882
13720,1,21,19,1,6,29,77,38.271060796636604,-109.3497187
13721,1,20,18,0,5,30,74,38.271060796636604,-109.3494492
13722,1,20,17,0,4,30,72,38.271060796636604,-109.3491797
13723,1,23,16,0,4,28,72,38.271060796636604,-109.3489102
13724,1,22,17,0,3,29,72,38.271060796636604,-109.3486407
13725,1,20,17,1,4,31,74,38.271060796636604,-109.3483712
13726,1,21,18,2,5,31,78,38.271060796636604,-109.3481017
13727,1,19,18,0,4,32,74,38.271060796636604,-109.3478322
13728,3,22,17,1,1,26,70,38.271060796636604,-109.3475627
13729,1,20,16,0,1,28,66,38.271060796636604,-109.3472932
13730,1,21,16,0,2,27,67,38.271060796636604,-109.3470237
13731,1,21,17,0,4,27,70,38.271060796636604,-109.3467542
13732,1,21,18,0,4,31,75,38.271060796636604,-109.3464847
13733,1,20,17,0,2,29,69,38.271060796636604,-109.3462152
13734,1,16,16,0,2,25,60,38.271060796636604,-109.3459457
13735,1,12,13,1,2,22,51,38.271060796636604,-109.3456762
13736,2,15,14,2,3,21,57,38.271060796636604,-109.3454068
13737,5,22,19,2,2,27,77,38.271060796636604,-109.3451373
13738,2,19,18,2,4,28,73,38.271060796636604,-109.3448678
13739,6,28,16,6,9,19,84,38.271060796636604,-109.3445983
13740,12,31,15,9,11,10,88,38.271060796636604,-109.3443288
13741,14,32,15,11,11,8,91,38.271060796636604,-109.3440593
13742,12,31,15,12,9,9,88,38.271060796636604,-109.3437898
13743,11,35,15,10,12,6,89,38.271060796636604,-109.3435203
13744,7,37,14,10,13,6,87,38.271060796636604,-109.3432508
13745,6,36,14,9,11,8,84,38.271060796636604,-109.3429813
13746,6,36,14,9,10,9,84,38.271060796636604,-109.3427118
13747,6,36,14,10,10,9,85,38.271060796636604,-109.3424423
13748,6,34,14,11,11,9,85,38.271060796636604,-109.3421728
13749,6,33,14,10,11,9,83,38.271060796636604,-109.3419033
13750,6,32,14,10,10,10,82,38.271060796636604,-109.3416338
13751,6,33,14,11,9,9,82,38.271060796636604,-109.3413643
13752,10,34,14,13,10,6,87,38.271060796636604,-109.3410948
13753,12,35,14,14,10,4,89,38.271060796636604,-109.3408253
13754,15,33,13,14,11,4,90,38.271060796636604,-109.3405558
13755,17,32,13,14,11,4,91,38.271060796636604,-109.3402864
13756,17,30,12,13,12,5,89,38.271060796636604,-109.3400169
13757,21,29,11,12,12,3,88,38.271060796636604,-109.3397474
13758,16,33,12,13,13,4,91,38.271060796636604,-109.3394779
13759,7,37,13,10,14,5,86,38.271060796636604,-109.3392084
13760,5,39,13,8,13,6,84,38.271060796636604,-109.3389389
13761,2,42,11,0,13,13,81,38.270791302051364,-109.4375739
13762,1,42,11,1,14,11,80,38.270791302051364,-109.4373044
13763,1,37,11,1,13,11,74,38.270791302051364,-109.4370349
13764,1,41,10,1,12,7,72,38.270791302051364,-109.4367654
13765,2,40,10,3,10,6,71,38.270791302051364,-109.4364959
13766,2,39,9,2,9,7,68,38.270791302051364,-109.4362264
13767,2,39,9,1,9,8,68,38.270791302051364,-109.4359569
13768,2,43,10,2,10,7,74,38.270791302051364,-109.4356874
13769,1,40,9,1,8,8,67,38.270791302051364,-109.4354179
13770,2,38,9,2,9,7,67,38.270791302051364,-109.4351484
13771,1,38,7,3,9,6,64,38.270791302051364,-109.434879
13772,1,38,7,3,9,5,63,38.270791302051364,-109.4346095
13773,3,36,9,8,11,3,70,38.270791302051364,-109.43434
13774,9,28,10,19,15,1,82,38.270791302051364,-109.4340705
13775,7,22,9,30,21,5,94,38.270791302051364,-109.433801
13776,3,20,12,20,28,9,92,38.270791302051364,-109.4335315
13777,1,28,11,8,22,7,77,38.270791302051364,-109.433262
13778,0,37,12,2,17,12,80,38.270791302051364,-109.4329925
13779,1,39,12,3,15,10,80,38.270791302051364,-109.432723
13780,3,41,13,3,16,7,83,38.270791302051364,-109.4324535
13781,3,44,12,3,17,5,84,38.270791302051364,-109.432184
13782,2,52,11,1,18,5,89,38.270791302051364,-109.4319145
13783,2,51,10,0,15,6,84,38.270791302051364,-109.431645
13784,1,43,10,0,15,8,77,38.270791302051364,-109.4313755
13785,2,41,11,1,14,9,78,38.270791302051364,-109.431106
13786,2,40,12,0,15,10,79,38.270791302051364,-109.4308365
13787,1,37,12,0,10,16,76,38.270791302051364,-109.430567
13788,0,29,11,2,11,12,65,38.270791302051364,-109.4302975
13789,1,39,10,3,10,7,70,38.270791302051364,-109.430028
13790,1,44,8,2,9,6,70,38.270791302051364,-109.4297586
13791,2,46,8,1,11,6,74,38.270791302051364,-109.4294891
13792,2,51,9,0,13,6,81,38.270791302051364,-109.4292196
13793,2,48,10,0,14,8,82,38.270791302051364,-109.4289501
13794,2,44,11,0,14,9,80,38.270791302051364,-109.4286806
13795,2,43,11,0,14,9,79,38.270791302051364,-109.4284111
13796,3,52,12,1,16,5,89,38.270791302051364,-109.4281416
13797,4,51,13,5,17,3,93,38.270791302051364,-109.4278721
13798,4,50,13,5,17,3,92,38.270791302051364,-109.4276026
13799,4,48,12,4,17,3,88,38.270791302051364,-109.4273331
13800,4,46,12,5,17,3,87,38.270791302051364,-109.4270636
13801,4,46,12,4,17,4,87,38.270791302051364,-109.4267941
13802,4,47,12,5,18,3,89,38.270791302051364,-109.4265246
13803,4,46,13,4,17,5,89,38.270791302051364,-109.4262551
13804,3,44,12,2,15,8,84,38.270791302051364,-109.4259856
13805,3,43,12,0,11,13,82,38.270791302051364,-109.4257161
13806,2,36,13,0,10,15,76,38.270791302051364,-109.4254466
13807,1,36,12,0,11,15,75,38.270791302051364,-109.4251771
13808,1,37,12,0,12,14,76,38.270791302051364,-109.4249077
13809,2,38,11,0,13,13,77,38.270791302051364,-109.4246382
13810,2,40,11,0,12,14,79,38.270791302051364,-109.4243687
13811,3,44,11,0,13,9,80,38.270791302051364,-109.4240992
13812,3,45,11,1,15,7,82,38.270791302051364,-109.4238297
13813,3,46,12,2,17,6,86,38.270791302051364,-109.4235602
13814,4,46,12,4,18,3,87,38.270791302051364,-109.4232907
13815,4,46,13,6,19,2,90,38.270791302051364,-109.4230212
13816,6,45,13,7,18,1,90,38.270791302051364,-109.4227517
13817,5,44,13,6,19,3,90,38.270791302051364,-109.4224822
13818,3,42,13,3,17,7,85,38.270791302051364,-109.4222127
13819,3,39,12,1,15,10,80,38.270791302051364,-109.4219432
13820,4,43,13,2,16,8,86,38.270791302051364,-109.4216737
13821,3,42,12,2,15,8,82,38.270791302051364,-109.4214042
13822,3,40,12,2,15,9,81,38.270791302051364,-109.4211347
13823,3,39,12,2,15,8,79,38.270791302051364,-109.4208652
13824,5,42,12,5,18,3,85,38.270791302051364,-109.4205957
13825,6,43,12,6,19,1,87,38.270791302051364,-109.4203262
13826,7,44,13,7,19,0,90,38.270791302051364,-109.4200568
13827,7,45,13,7,19,0,91,38.270791302051364,-109.4197873
13828,6,46,13,6,19,0,90,38.270791302051364,-109.4195178
13829,5,46,13,7,19,1,91,38.270791302051364,-109.4192483
13830,5,45,13,8,18,0,89,38.270791302051364,-109.4189788
13831,5,46,13,9,17,0,90,38.270791302051364,-109.4187093
13832,5,47,13,9,18,0,92,38.270791302051364,-109.4184398
13833,5,46,13,8,17,1,90,38.270791302051364,-109.4181703
13834,8,41,14,12,16,0,91,38.270791302051364,-109.4179008
13835,9,40,14,12,15,0,90,38.270791302051364,-109.4176313
13836,10,41,14,11,15,0,91,38.270791302051364,-109.4173618
13837,12,40,13,11,15,0,91,38.270791302051364,-109.4170923
13838,14,37,13,12,14,0,90,38.270791302051364,-109.4168228
13839,8,42,13,11,16,0,90,38.270791302051364,-109.4165533
13840,9,42,13,11,16,0,91,38.270791302051364,-109.4162838
13841,10,42,13,11,16,0,92,38.270791302051364,-109.4160143
13842,10,43,13,11,15,0,92,38.270791302051364,-109.4157448
13843,11,41,13,10,16,0,91,38.270791302051364,-109.4154753
13844,13,39,13,12,14,0,91,38.270791302051364,-109.4152058
13845,13,40,13,11,14,0,91,38.270791302051364,-109.4149364
13846,13,41,13,9,14,0,90,38.270791302051364,-109.4146669
13847,11,43,13,8,14,0,89,38.270791302051364,-109.4143974
13848,11,43,14,9,14,1,92,38.270791302051364,-109.4141279
13849,9,43,14,10,15,1,92,38.270791302051364,-109.4138584
13850,9,44,13,9,16,1,92,38.270791302051364,-109.4135889
13851,8,48,13,8,16,1,94,38.270791302051364,-109.4133194
13852,5,52,12,6,16,1,92,38.270791302051364,-109.4130499
13853,6,52,12,7,16,0,93,38.270791302051364,-109.4127804
13854,7,50,12,7,16,0,92,38.270791302051364,-109.4125109
13855,6,49,12,7,16,1,91,38.270791302051364,-109.4122414
13856,5,52,12,6,15,2,92,38.270791302051364,-109.4119719
13857,5,57,11,4,15,1,93,38.270791302051364,-109.4117024
13858,4,58,9,4,15,0,90,38.270791302051364,-109.4114329
13859,4,58,10,4,15,1,92,38.270791302051364,-109.4111634
13860,4,56,11,4,16,1,92,38.270791302051364,-109.4108939
13861,4,56,12,4,17,1,94,38.270791302051364,-109.4106244
13862,4,55,12,4,17,1,93,38.270791302051364,-109.4103549
13863,4,55,12,4,17,1,93,38.270791302051364,-109.4100855
13864,4,55,12,4,17,1,93,38.270791302051364,-109.409816
13865,5,53,12,5,17,1,93,38.270791302051364,-109.4095465
13866,5,50,13,5,16,2,91,38.270791302051364,-109.409277
13867,6,49,13,6,16,1,91,38.270791302051364,-109.4090075
13868,6,52,13,5,16,1,93,38.270791302051364,-109.408738
13869,5,53,12,4,17,1,92,38.270791302051364,-109.4084685
13870,5,52,12,4,17,1,91,38.270791302051364,-109.408199
13871,6,51,12,4,16,2,91,38.270791302051364,-109.4079295
13872,5,51,12,5,16,2,91,38.270791302051364,-109.40766
13873,6,51,13,6,16,1,93,38.270791302051364,-109.4073905
13874,7,49,13,7,16,1,93,38.270791302051364,-109.407121
13875,8,47,13,8,15,1,92,38.270791302051364,-109.4068515
13876,2,28,14,1,6,20,71,38.270791302051364,-109.3879869
13877,2,41,11,0,12,11,77,38.270791302051364,-109.3877174
13878,2,48,11,0,14,7,82,38.270791302051364,-109.3874479
13879,2,46,11,1,15,8,83,38.270791302051364,-109.3871784
13880,2,37,12,1,12,12,76,38.270791302051364,-109.3869089
13881,2,26,13,0,5,22,68,38.270791302051364,-109.3866394
13882,1,22,12,0,3,23,61,38.270791302051364,-109.3863699
13883,1,21,13,0,3,24,62,38.270791302051364,-109.3861004
13884,1,22,13,0,4,24,64,38.270791302051364,-109.3858309
13885,2,25,13,0,4,23,67,38.270791302051364,-109.3855614
13886,3,29,12,0,5,19,68,38.270791302051364,-109.3852919
13887,4,34,12,2,10,13,75,38.270791302051364,-109.3850225
13888,6,37,13,5,12,8,81,38.270791302051364,-109.384753
13889,7,37,14,6,13,6,83,38.270791302051364,-109.3844835
13890,7,37,14,7,13,5,83,38.270791302051364,-109.384214
13891,7,37,13,7,14,5,83,38.270791302051364,-109.3839445
13892,7,38,13,8,15,4,85,38.270791302051364,-109.383675
13893,8,38,14,9,14,3,86,38.270791302051364,-109.3834055
13894,8,36,13,8,13,4,82,38.270791302051364,-109.383136
13895,6,35,12,4,12,8,77,38.270791302051364,-109.3828665
13896,5,32,12,1,9,13,72,38.270791302051364,-109.382597
13897,3,27,13,1,6,18,68,38.270791302051364,-109.3823275
13898,3,27,12,1,7,17,67,38.270791302051364,-109.382058
13899,3,30,12,2,10,14,71,38.270791302051364,-109.3817885
13900,6,38,13,5,14,7,83,38.270791302051364,-109.381519
13901,7,39,14,7,16,5,88,38.270791302051364,-109.3812495
13902,7,38,13,7,16,4,85,38.270791302051364,-109.38098
13903,8,37,13,6,16,4,84,38.270791302051364,-109.3807105
13904,9,37,14,7,15,4,86,38.270791302051364,-109.380441
13905,6,38,13,7,14,4,82,38.270791302051364,-109.3801716
13906,6,43,12,5,15,3,84,38.270791302051364,-109.3799021
13907,5,42,12,5,15,3,82,38.270791302051364,-109.3796326
13908,7,40,12,7,15,2,83,38.270791302051364,-109.3793631
13909,7,38,12,7,15,2,81,38.270791302051364,-109.3790936
13910,4,38,11,5,16,4,78,38.270791302051364,-109.3788241
13911,4,41,11,4,16,4,80,38.270791302051364,-109.3785546
13912,4,40,12,3,14,7,80,38.270791302051364,-109.3782851
13913,4,38,11,1,12,10,76,38.270791302051364,-109.3780156
13914,3,34,11,0,8,14,70,38.270791302051364,-109.3777461
13915,2,28,14,0,6,21,71,38.270791302051364,-109.3774766
13916,2,31,14,0,8,21,76,38.270791302051364,-109.3772071
13917,4,35,14,1,12,16,82,38.270791302051364,-109.3769376
13918,6,36,14,6,15,9,86,38.270791302051364,-109.3766681
13919,8,35,14,8,13,7,85,38.270791302051364,-109.3763986
13920,8,33,14,7,16,8,86,38.270791302051364,-109.3761291
13921,7,33,14,9,17,7,87,38.270791302051364,-109.3758596
13922,8,29,13,11,14,5,80,38.270791302051364,-109.3755901
13923,15,27,13,13,12,3,83,38.270791302051364,-109.3753206
13924,11,29,14,15,14,3,86,38.270791302051364,-109.3750512
13925,9,29,14,15,15,5,87,38.270791302051364,-109.3747817
13926,8,27,14,12,14,9,84,38.270791302051364,-109.3745122
13927,8,22,11,15,13,6,75,38.270791302051364,-109.3742427
13928,8,16,10,17,16,3,70,38.270791302051364,-109.3739732
13929,10,16,13,14,10,10,73,38.270791302051364,-109.3737037
13930,5,18,15,11,9,22,80,38.270791302051364,-109.3734342
13931,2,20,19,4,8,31,84,38.270791302051364,-109.3731647
13932,4,23,20,4,5,29,85,38.270791302051364,-109.3728952
13933,3,19,19,4,2,34,81,38.270791302051364,-109.3726257
13934,13,19,14,15,7,12,80,38.270791302051364,-109.3723562
13935,14,19,16,14,7,11,81,38.270791302051364,-109.3720867
13936,2,21,16,1,5,27,72,38.270791302051364,-109.3718172
13937,5,21,19,3,4,30,82,38.270791302051364,-109.3715477
13938,5,20,19,3,4,28,79,38.270791302051364,-109.3712782
13939,3,22,18,3,6,28,80,38.270791302051364,-109.3710087
13940,3,25,17,1,9,25,80,38.270791302051364,-109.3707392
13941,4,26,17,3,4,28,82,38.270791302051364,-109.3704697
13942,4,28,12,9,5,19,77,38.270791302051364,-109.3702003
13943,9,21,11,10,9,15,75,38.270791302051364,-109.3699308
13944,7,24,12,11,8,15,77,38.270791302051364,-109.3696613
13945,6,25,11,12,6,15,75,38.270791302051364,-109.3693918
13946,5,29,14,8,6,16,78,38.270791302051364,-109.3691223
13947,3,31,16,7,8,20,85,38.270791302051364,-109.3688528
13948,4,29,15,10,8,16,82,38.270791302051364,-109.3685833
13949,5,25,17,12,12,14,85,38.270791302051364,-109.3683138
13950,8,26,15,13,17,10,89,38.270791302051364,-109.3680443
13951,4,25,15,14,13,10,81,38.270791302051364,-109.3677748
13952,10,29,10,14,15,1,79,38.270791302051364,-109.3675053
13953,6,25,10,17,15,1,74,38.270791302051364,-109.3672358
13954,5,15,10,14,19,1,64,38.270791302051364,-109.3669663
13955,6,19,8,16,12,3,64,38.270791302051364,-109.3666968
13956,5,25,10,10,9,10,69,38.270791302051364,-109.3664273
13957,3,19,10,8,14,9,63,38.270791302051364,-109.3661578
13958,1,24,12,2,12,15,66,38.270791302051364,-109.3658883
13959,1,26,15,0,8,23,73,38.270791302051364,-109.3656188
13960,2,23,17,0,3,28,73,38.270791302051364,-109.3653493
13961,1,22,18,0,1,31,73,38.270791302051364,-109.3650799
13962,1,19,18,0,1,32,71,38.270791302051364,-109.3648104
13963,0,19,18,0,1,32,70,38.270791302051364,-109.3645409
13964,0,18,18,0,1,33,70,38.270791302051364,-109.3642714
13965,0,19,17,0,2,30,68,38.270791302051364,-109.3640019
13966,0,20,17,0,2,31,70,38.270791302051364,-109.3637324
13967,0,18,16,0,1,27,62,38.270791302051364,-109.3634629
13968,1,21,13,0,2,23,60,38.270791302051364,-109.3631934
13969,2,21,12,1,3,19,58,38.270791302051364,-109.3629239
13970,2,22,14,2,4,19,63,38.270791302051364,-109.3626544
13971,1,17,12,0,2,22,54,38.270791302051364,-109.3623849
13972,2,21,9,3,5,11,51,38.270791302051364,-109.3621154
13973,5,31,5,3,6,5,55,38.270791302051364,-109.3618459
13974,3,23,5,4,7,6,48,38.270791302051364,-109.3615764
13975,5,16,7,3,6,9,46,38.270791302051364,-109.3613069
13976,4,18,8,3,5,11,49,38.270791302051364,-109.3610374
13977,3,22,10,3,6,11,55,38.270791302051364,-109.3607679
13978,2,27,10,3,7,14,63,38.270791302051364,-109.3604984
13979,2,29,11,2,7,15,66,38.270791302051364,-109.360229
13980,2,30,11,1,7,15,66,38.270791302051364,-109.3599595
13981,2,26,12,1,5,18,64,38.270791302051364,-109.35969
13982,2,21,15,1,2,24,65,38.270791302051364,-109.3594205
13983,2,22,17,0,2,29,72,38.270791302051364,-109.359151
13984,1,24,17,0,2,29,73,38.270791302051364,-109.3588815
13985,2,26,16,0,4,27,75,38.270791302051364,-109.358612
13986,1,26,17,0,4,29,77,38.270791302051364,-109.3583425
13987,1,23,17,0,4,29,74,38.270791302051364,-109.358073
13988,2,21,15,0,4,25,67,38.270791302051364,-109.3578035
13989,2,20,16,0,3,26,67,38.270791302051364,-109.357534
13990,2,18,16,0,2,27,65,38.270791302051364,-109.3572645
13991,2,17,16,0,1,28,64,38.270791302051364,-109.356995
13992,1,17,15,1,1,27,62,38.270791302051364,-109.3567255
13993,7,22,13,6,5,19,72,38.270791302051364,-109.356456
13994,6,25,14,8,6,19,78,38.270791302051364,-109.3561865
13995,3,25,15,6,3,25,77,38.270791302051364,-109.355917
13996,3,21,16,1,3,28,72,38.270791302051364,-109.3556475
13997,3,21,15,1,1,26,67,38.270791302051364,-109.355378
13998,1,20,14,0,3,25,63,38.270791302051364,-109.3551086
13999,1,27,12,0,8,18,66,38.270791302051364,-109.3548391
14000,1,27,12,2,11,15,68,38.270791302051364,-109.3545696
14001,1,30,12,3,14,12,72,38.270791302051364,-109.3543001
14002,1,32,12,1,14,12,72,38.270791302051364,-109.3540306
14003,1,35,11,0,16,10,73,38.270791302051364,-109.3537611
14004,4,31,13,9,15,7,79,38.270791302051364,-109.3534916
14005,7,32,13,16,14,5,87,38.270791302051364,-109.3532221
14006,0,28,13,9,15,10,75,38.270791302051364,-109.3529526
14007,2,20,10,10,13,9,64,38.270791302051364,-109.3526831
14008,3,15,11,9,14,10,62,38.270791302051364,-109.3524136
14009,3,9,8,6,12,10,48,38.270791302051364,-109.3521441
14010,1,4,5,0,7,10,27,38.270791302051364,-109.3518746
14011,0,6,9,0,6,12,33,38.270791302051364,-109.3516051
14012,2,19,12,8,12,10,63,38.270791302051364,-109.3513356
14013,1,23,15,4,6,23,72,38.270791302051364,-109.3510661
14014,1,23,19,1,5,30,79,38.270791302051364,-109.3507966
14015,1,23,20,0,5,32,81,38.270791302051364,-109.3505271
14016,1,20,21,1,5,32,80,38.270791302051364,-109.3502577
14017,1,19,21,2,6,30,79,38.270791302051364,-109.3499882
14018,2,23,20,2,7,26,80,38.270791302051364,-109.3497187
14019,1,24,19,0,6,29,79,38.270791302051364,-109.3494492
14020,0,24,19,0,6,29,78,38.270791302051364,-109.3491797
14021,2,25,18,1,7,26,79,38.270791302051364,-109.3489102
14022,2,23,20,2,6,28,81,38.270791302051364,-109.3486407
14023,1,21,19,3,6,30,80,38.270791302051364,-109.3483712
14024,1,21,19,3,6,32,82,38.270791302051364,-109.3481017
14025,1,21,19,2,6,32,81,38.270791302051364,-109.3478322
14026,4,23,19,4,3,26,79,38.270791302051364,-109.3475627
14027,2,20,18,1,2,27,70,38.270791302051364,-109.3472932
14028,2,22,18,1,3,28,74,38.270791302051364,-109.3470237
14029,2,22,19,1,5,29,78,38.270791302051364,-109.3467542
14030,1,21,19,0,4,31,76,38.270791302051364,-109.3464847
14031,2,20,17,0,2,28,69,38.270791302051364,-109.3462152
14032,1,15,16,0,2,24,58,38.270791302051364,-109.3459457
14033,1,15,16,0,2,26,60,38.270791302051364,-109.3456762
14034,2,19,18,0,3,29,71,38.270791302051364,-109.3454068
14035,1,21,18,0,3,30,73,38.270791302051364,-109.3451373
14036,2,25,16,2,5,24,74,38.270791302051364,-109.3448678
14037,5,34,14,4,11,14,82,38.270791302051364,-109.3445983
14038,7,39,14,7,14,6,87,38.270791302051364,-109.3443288
14039,7,40,15,9,14,4,89,38.270791302051364,-109.3440593
14040,8,40,14,9,14,4,89,38.270791302051364,-109.3437898
14041,8,41,14,10,14,4,91,38.270791302051364,-109.3435203
14042,7,41,14,10,13,4,89,38.270791302051364,-109.3432508
14043,6,41,14,10,12,6,89,38.270791302051364,-109.3429813
14044,6,39,14,9,12,7,87,38.270791302051364,-109.3427118
14045,6,37,14,9,11,8,85,38.270791302051364,-109.3424423
14046,6,37,14,9,11,9,86,38.270791302051364,-109.3421728
14047,6,35,14,8,11,9,83,38.270791302051364,-109.3419033
14048,5,34,13,8,10,9,79,38.270791302051364,-109.3416338
14049,6,34,13,10,9,9,81,38.270791302051364,-109.3413643
14050,12,34,14,14,9,6,89,38.270791302051364,-109.3410948
14051,13,33,13,15,9,5,88,38.270791302051364,-109.3408253
14052,11,34,13,14,10,5,87,38.270791302051364,-109.3405558
14053,11,34,13,13,12,5,88,38.270791302051364,-109.3402864
14054,11,34,13,11,14,5,88,38.270791302051364,-109.3400169
14055,12,34,12,12,13,5,88,38.270791302051364,-109.3397474
14056,12,34,13,11,13,5,88,38.270791302051364,-109.3394779
14057,9,36,13,10,14,5,87,38.270791302051364,-109.3392084
14058,6,40,13,8,14,5,86,38.270791302051364,-109.3389389
14059,2,45,11,1,14,11,84,38.270521807466125,-109.4378434
14060,2,49,11,1,14,10,87,38.270521807466125,-109.4375739
14061,2,52,11,1,14,9,89,38.270521807466125,-109.4373044
14062,2,46,11,1,13,9,82,38.270521807466125,-109.4370349
14063,2,42,10,1,13,7,75,38.270521807466125,-109.4367654
14064,2,39,10,4,11,5,71,38.270521807466125,-109.4364959
14065,2,40,9,2,9,6,68,38.270521807466125,-109.4362264
14066,3,43,9,2,8,6,71,38.270521807466125,-109.4359569
14067,2,40,9,2,9,6,68,38.270521807466125,-109.4356874
14068,2,39,9,2,8,6,66,38.270521807466125,-109.4354179
14069,2,33,10,4,9,6,64,38.270521807466125,-109.4351484
14070,4,31,10,7,12,4,68,38.270521807466125,-109.434879
14071,6,31,13,14,17,2,83,38.270521807466125,-109.4346095
14072,10,24,12,24,20,2,92,38.270521807466125,-109.43434
14073,1,20,11,26,26,8,92,38.270521807466125,-109.4340705
14074,3,17,12,25,25,10,92,38.270521807466125,-109.433801
14075,2,23,12,18,19,10,84,38.270521807466125,-109.4335315
14076,0,34,12,4,20,11,81,38.270521807466125,-109.433262
14077,1,37,11,0,15,13,77,38.270521807466125,-109.4329925
14078,3,45,11,1,16,7,83,38.270521807466125,-109.432723
14079,4,50,12,5,18,2,91,38.270521807466125,-109.4324535
14080,4,51,12,7,17,1,92,38.270521807466125,-109.432184
14081,3,51,11,6,17,1,89,38.270521807466125,-109.4319145
14082,2,50,10,0,14,6,82,38.270521807466125,-109.431645
14083,2,40,10,0,13,8,73,38.270521807466125,-109.4313755
14084,2,35,11,2,13,10,73,38.270521807466125,-109.431106
14085,1,35,12,0,13,13,74,38.270521807466125,-109.4308365
14086,0,31,13,0,8,21,73,38.270521807466125,-109.430567
14087,1,28,13,1,9,18,70,38.270521807466125,-109.4302975
14088,2,25,12,5,10,13,67,38.270521807466125,-109.430028
14089,2,30,10,5,10,9,66,38.270521807466125,-109.4297586
14090,3,38,9,7,10,4,71,38.270521807466125,-109.4294891
14091,1,41,9,0,12,9,72,38.270521807466125,-109.4292196
14092,1,38,10,0,12,12,73,38.270521807466125,-109.4289501
14093,1,37,11,0,11,13,73,38.270521807466125,-109.4286806
14094,2,40,10,0,12,12,76,38.270521807466125,-109.4284111
14095,2,50,10,0,14,8,84,38.270521807466125,-109.4281416
14096,3,48,11,3,15,5,85,38.270521807466125,-109.4278721
14097,3,46,12,3,15,6,85,38.270521807466125,-109.4276026
14098,3,44,12,2,15,7,83,38.270521807466125,-109.4273331
14099,3,42,11,1,14,9,80,38.270521807466125,-109.4270636
14100,4,44,11,2,14,7,82,38.270521807466125,-109.4267941
14101,4,46,12,2,15,6,85,38.270521807466125,-109.4265246
14102,3,43,12,2,15,8,83,38.270521807466125,-109.4262551
14103,3,39,12,1,13,11,79,38.270521807466125,-109.4259856
14104,2,37,12,0,10,15,76,38.270521807466125,-109.4257161
14105,1,32,12,0,8,18,71,38.270521807466125,-109.4254466
14106,1,32,12,0,7,19,71,38.270521807466125,-109.4251771
14107,1,34,12,0,8,18,73,38.270521807466125,-109.4249077
14108,1,37,11,0,11,16,76,38.270521807466125,-109.4246382
14109,2,43,12,0,13,12,82,38.270521807466125,-109.4243687
14110,3,45,12,1,15,8,84,38.270521807466125,-109.4240992
14111,3,45,12,3,17,6,86,38.270521807466125,-109.4238297
14112,4,45,13,4,17,4,87,38.270521807466125,-109.4235602
14113,4,46,13,4,18,4,89,38.270521807466125,-109.4232907
14114,4,45,13,5,18,3,88,38.270521807466125,-109.4230212
14115,5,44,13,5,18,3,88,38.270521807466125,-109.4227517
14116,4,43,13,4,18,5,87,38.270521807466125,-109.4224822
14117,2,40,12,3,17,8,82,38.270521807466125,-109.4222127
14118,2,38,11,0,13,12,76,38.270521807466125,-109.4219432
14119,2,39,11,1,14,10,77,38.270521807466125,-109.4216737
14120,3,39,11,1,14,10,78,38.270521807466125,-109.4214042
14121,3,38,11,2,15,9,78,38.270521807466125,-109.4211347
14122,5,38,12,5,17,4,81,38.270521807466125,-109.4208652
14123,7,43,13,9,18,0,90,38.270521807466125,-109.4205957
14124,6,45,13,8,19,0,91,38.270521807466125,-109.4203262
14125,7,46,13,8,19,0,93,38.270521807466125,-109.4200568
14126,7,46,13,7,18,0,91,38.270521807466125,-109.4197873
14127,7,47,13,7,18,0,92,38.270521807466125,-109.4195178
14128,8,44,13,10,17,0,92,38.270521807466125,-109.4192483
14129,8,43,13,11,17,0,92,38.270521807466125,-109.4189788
14130,6,45,13,10,17,0,91,38.270521807466125,-109.4187093
14131,6,46,13,9,17,0,91,38.270521807466125,-109.4184398
14132,7,45,13,9,17,0,91,38.270521807466125,-109.4181703
14133,8,40,13,11,16,0,88,38.270521807466125,-109.4179008
14134,13,38,14,12,14,0,91,38.270521807466125,-109.4176313
14135,17,35,14,13,13,0,92,38.270521807466125,-109.4173618
14136,19,35,14,13,12,0,93,38.270521807466125,-109.4170923
14137,14,38,14,13,14,0,93,38.270521807466125,-109.4168228
14138,9,42,13,10,16,0,90,38.270521807466125,-109.4165533
14139,9,42,13,10,16,0,90,38.270521807466125,-109.4162838
14140,10,42,13,10,16,0,91,38.270521807466125,-109.4160143
14141,10,41,13,11,16,0,91,38.270521807466125,-109.4157448
14142,9,42,12,9,16,0,88,38.270521807466125,-109.4154753
14143,9,40,13,12,16,0,90,38.270521807466125,-109.4152058
14144,11,39,13,12,15,0,90,38.270521807466125,-109.4149364
14145,12,39,14,12,15,0,92,38.270521807466125,-109.4146669
14146,13,39,15,13,13,0,93,38.270521807466125,-109.4143974
14147,13,40,14,12,12,0,91,38.270521807466125,-109.4141279
14148,12,40,14,12,13,0,91,38.270521807466125,-109.4138584
14149,11,42,14,11,15,0,93,38.270521807466125,-109.4135889
14150,10,45,13,9,16,0,93,38.270521807466125,-109.4133194
14151,8,46,14,9,17,0,94,38.270521807466125,-109.4130499
14152,8,47,13,9,16,1,94,38.270521807466125,-109.4127804
14153,8,47,13,8,16,0,92,38.270521807466125,-109.4125109
14154,8,49,12,8,16,0,93,38.270521807466125,-109.4122414
14155,7,53,11,7,15,0,93,38.270521807466125,-109.4119719
14156,5,56,9,5,14,0,89,38.270521807466125,-109.4117024
14157,4,56,10,5,15,1,91,38.270521807466125,-109.4114329
14158,4,56,11,5,16,1,93,38.270521807466125,-109.4111634
14159,4,55,11,5,16,1,92,38.270521807466125,-109.4108939
14160,4,55,12,4,17,1,93,38.270521807466125,-109.4106244
14161,4,55,12,4,17,2,94,38.270521807466125,-109.4103549
14162,4,55,12,4,16,1,92,38.270521807466125,-109.4100855
14163,5,54,12,5,16,1,93,38.270521807466125,-109.409816
14164,5,51,12,5,17,1,91,38.270521807466125,-109.4095465
14165,6,49,13,6,16,2,92,38.270521807466125,-109.409277
14166,6,48,13,6,16,1,90,38.270521807466125,-109.4090075
14167,7,50,13,6,16,1,93,38.270521807466125,-109.408738
14168,6,51,12,5,16,1,91,38.270521807466125,-109.4084685
14169,5,50,12,5,16,1,89,38.270521807466125,-109.408199
14170,6,50,12,5,15,2,90,38.270521807466125,-109.4079295
14171,5,51,12,5,15,2,90,38.270521807466125,-109.40766
14172,5,52,12,5,16,2,92,38.270521807466125,-109.4073905
14173,6,51,13,6,16,1,93,38.270521807466125,-109.407121
14174,6,49,13,7,15,1,91,38.270521807466125,-109.4068515
14175,2,27,14,2,6,19,70,38.270521807466125,-109.3879869
14176,2,31,13,1,8,16,71,38.270521807466125,-109.3877174
14177,2,42,11,0,13,11,79,38.270521807466125,-109.3874479
14178,2,40,11,0,12,11,76,38.270521807466125,-109.3871784
14179,2,31,12,1,8,17,71,38.270521807466125,-109.3869089
14180,2,29,13,0,6,20,70,38.270521807466125,-109.3866394
14181,2,27,12,0,6,18,65,38.270521807466125,-109.3863699
14182,1,25,12,0,5,22,65,38.270521807466125,-109.3861004
14183,1,27,13,0,5,22,68,38.270521807466125,-109.3858309
14184,2,30,12,0,5,20,69,38.270521807466125,-109.3855614
14185,4,34,12,2,10,14,76,38.270521807466125,-109.3852919
14186,6,38,13,6,13,7,83,38.270521807466125,-109.3850225
14187,8,40,14,7,14,6,89,38.270521807466125,-109.384753
14188,9,39,13,7,14,5,87,38.270521807466125,-109.3844835
14189,9,38,14,8,15,5,89,38.270521807466125,-109.384214
14190,8,40,14,7,15,5,89,38.270521807466125,-109.3839445
14191,8,41,14,7,15,5,90,38.270521807466125,-109.383675
14192,9,40,14,8,14,4,89,38.270521807466125,-109.3834055
14193,9,39,13,8,14,3,86,38.270521807466125,-109.383136
14194,7,38,13,6,13,5,82,38.270521807466125,-109.3828665
14195,5,36,12,3,12,9,77,38.270521807466125,-109.382597
14196,4,31,12,2,8,15,72,38.270521807466125,-109.3823275
14197,3,28,13,1,6,19,70,38.270521807466125,-109.382058
14198,3,27,14,1,7,19,71,38.270521807466125,-109.3817885
14199,4,32,13,3,12,12,76,38.270521807466125,-109.381519
14200,5,36,13,5,14,7,80,38.270521807466125,-109.3812495
14201,6,39,13,6,14,6,84,38.270521807466125,-109.38098
14202,6,39,13,6,14,6,84,38.270521807466125,-109.3807105
14203,6,36,12,7,14,6,81,38.270521807466125,-109.380441
14204,6,35,12,8,14,4,79,38.270521807466125,-109.3801716
14205,4,39,11,4,15,4,77,38.270521807466125,-109.3799021
14206,3,41,11,3,14,6,78,38.270521807466125,-109.3796326
14207,3,40,10,2,14,7,76,38.270521807466125,-109.3793631
14208,3,42,10,2,14,6,77,38.270521807466125,-109.3790936
14209,3,38,10,3,14,6,74,38.270521807466125,-109.3788241
14210,2,41,10,3,14,6,76,38.270521807466125,-109.3785546
14211,2,42,10,2,13,8,77,38.270521807466125,-109.3782851
14212,2,39,10,0,11,12,74,38.270521807466125,-109.3780156
14213,2,32,12,2,10,13,71,38.270521807466125,-109.3777461
14214,2,28,13,0,5,21,69,38.270521807466125,-109.3774766
14215,3,32,13,0,8,17,73,38.270521807466125,-109.3772071
14216,5,36,12,4,12,8,77,38.270521807466125,-109.3769376
14217,8,35,12,9,15,3,82,38.270521807466125,-109.3766681
14218,8,34,13,9,14,4,82,38.270521807466125,-109.3763986
14219,7,32,14,10,15,8,86,38.270521807466125,-109.3761291
14220,7,31,14,11,16,9,88,38.270521807466125,-109.3758596
14221,9,29,14,10,15,8,85,38.270521807466125,-109.3755901
14222,14,28,14,8,13,8,85,38.270521807466125,-109.3753206
14223,13,29,14,10,14,6,86,38.270521807466125,-109.3750512
14224,11,30,13,14,16,3,87,38.270521807466125,-109.3747817
14225,11,26,11,19,14,3,84,38.270521807466125,-109.3745122
14226,10,20,10,18,14,2,74,38.270521807466125,-109.3742427
14227,9,17,10,22,14,1,73,38.270521807466125,-109.3739732
14228,11,27,14,12,10,7,81,38.270521807466125,-109.3737037
14229,7,29,16,7,9,16,84,38.270521807466125,-109.3734342
14230,4,30,16,2,6,21,79,38.270521807466125,-109.3731647
14231,3,30,15,0,4,24,76,38.270521807466125,-109.3728952
14232,5,24,16,4,2,27,78,38.270521807466125,-109.3726257
14233,13,19,15,10,7,16,80,38.270521807466125,-109.3723562
14234,11,19,16,9,6,14,75,38.270521807466125,-109.3720867
14235,6,24,16,0,7,21,74,38.270521807466125,-109.3718172
14236,7,25,17,5,8,19,81,38.270521807466125,-109.3715477
14237,6,22,18,6,3,25,80,38.270521807466125,-109.3712782
14238,3,22,18,3,2,28,76,38.270521807466125,-109.3710087
14239,2,24,17,0,6,29,78,38.270521807466125,-109.3707392
14240,2,27,18,1,3,31,82,38.270521807466125,-109.3704697
14241,5,30,15,4,9,19,82,38.270521807466125,-109.3702003
14242,4,33,15,7,6,18,83,38.270521807466125,-109.3699308
14243,5,30,13,3,9,16,76,38.270521807466125,-109.3696613
14244,6,28,13,1,9,16,73,38.270521807466125,-109.3693918
14245,3,30,16,2,10,17,78,38.270521807466125,-109.3691223
14246,7,25,15,14,12,11,84,38.270521807466125,-109.3688528
14247,5,26,16,15,10,13,85,38.270521807466125,-109.3685833
14248,6,25,15,15,14,11,86,38.270521807466125,-109.3683138
14249,5,23,14,16,17,9,84,38.270521807466125,-109.3680443
14250,6,16,13,18,15,9,77,38.270521807466125,-109.3677748
14251,10,20,11,17,21,0,79,38.270521807466125,-109.3675053
14252,6,9,9,19,19,4,66,38.270521807466125,-109.3672358
14253,4,12,9,22,16,2,65,38.270521807466125,-109.3669663
14254,3,17,9,19,12,4,64,38.270521807466125,-109.3666968
14255,8,25,10,13,12,6,74,38.270521807466125,-109.3664273
14256,4,26,11,13,11,10,75,38.270521807466125,-109.3661578
14257,2,27,15,3,11,19,77,38.270521807466125,-109.3658883
14258,1,26,17,0,7,26,77,38.270521807466125,-109.3656188
14259,2,23,18,0,2,32,77,38.270521807466125,-109.3653493
14260,1,19,17,0,0,32,69,38.270521807466125,-109.3650799
14261,1,18,18,0,0,31,68,38.270521807466125,-109.3648104
14262,1,18,17,0,0,32,68,38.270521807466125,-109.3645409
14263,0,17,18,0,1,32,68,38.270521807466125,-109.3642714
14264,0,19,17,0,2,30,68,38.270521807466125,-109.3640019
14265,1,19,15,0,1,27,63,38.270521807466125,-109.3637324
14266,1,20,13,0,2,22,58,38.270521807466125,-109.3634629
14267,1,24,11,1,3,18,58,38.270521807466125,-109.3631934
14268,2,24,11,1,4,17,59,38.270521807466125,-109.3629239
14269,2,24,14,2,4,18,64,38.270521807466125,-109.3626544
14270,2,18,10,1,2,18,51,38.270521807466125,-109.3623849
14271,6,27,5,3,5,7,53,38.270521807466125,-109.3621154
14272,2,26,4,4,7,4,47,38.270521807466125,-109.3618459
14273,5,24,5,4,8,5,51,38.270521807466125,-109.3615764
14274,3,20,7,4,6,9,49,38.270521807466125,-109.3613069
14275,2,24,8,2,7,10,53,38.270521807466125,-109.3610374
14276,2,29,10,2,7,13,63,38.270521807466125,-109.3607679
14277,2,29,11,2,6,15,65,38.270521807466125,-109.3604984
14278,2,30,11,2,6,16,67,38.270521807466125,-109.360229
14279,2,26,12,1,6,17,64,38.270521807466125,-109.3599595
14280,2,21,14,0,3,23,63,38.270521807466125,-109.35969
14281,2,22,16,0,2,27,69,38.270521807466125,-109.3594205
14282,2,24,17,0,4,29,76,38.270521807466125,-109.359151
14283,2,25,18,0,4,29,78,38.270521807466125,-109.3588815
14284,1,26,18,0,5,30,80,38.270521807466125,-109.358612
14285,1,28,20,0,5,30,84,38.270521807466125,-109.3583425
14286,1,28,20,0,6,30,85,38.270521807466125,-109.358073
14287,0,27,19,0,6,30,82,38.270521807466125,-109.3578035
14288,1,24,21,0,6,32,84,38.270521807466125,-109.357534
14289,1,24,21,0,5,34,85,38.270521807466125,-109.3572645
14290,1,23,21,0,4,35,84,38.270521807466125,-109.356995
14291,4,17,16,2,4,30,73,38.270521807466125,-109.3567255
14292,6,18,16,7,3,28,78,38.270521807466125,-109.356456
14293,6,19,15,5,4,28,77,38.270521807466125,-109.3561865
14294,1,26,18,0,7,28,80,38.270521807466125,-109.355917
14295,1,25,17,0,7,28,78,38.270521807466125,-109.3556475
14296,2,23,16,0,6,25,72,38.270521807466125,-109.355378
14297,3,23,15,5,3,22,71,38.270521807466125,-109.3551086
14298,7,26,15,8,5,17,78,38.270521807466125,-109.3548391
14299,4,26,15,5,13,16,79,38.270521807466125,-109.3545696
14300,5,28,16,7,10,18,84,38.270521807466125,-109.3543001
14301,3,27,17,6,12,19,84,38.270521807466125,-109.3540306
14302,3,25,19,2,11,23,83,38.270521807466125,-109.3537611
14303,4,26,18,5,15,17,85,38.270521807466125,-109.3534916
14304,2,23,14,10,16,15,80,38.270521807466125,-109.3532221
14305,3,18,10,8,11,12,62,38.270521807466125,-109.3529526
14306,1,15,9,2,7,14,48,38.270521807466125,-109.3526831
14307,1,8,7,3,5,7,31,38.270521807466125,-109.3524136
14308,0,4,6,0,5,6,21,38.270521807466125,-109.3521441
14309,1,8,11,3,6,17,46,38.270521807466125,-109.3518746
14310,1,13,13,7,8,18,60,38.270521807466125,-109.3516051
14311,2,20,19,5,7,23,76,38.270521807466125,-109.3513356
14312,1,21,22,2,8,29,83,38.270521807466125,-109.3510661
14313,2,19,22,3,6,32,84,38.270521807466125,-109.3507966
14314,1,19,22,2,6,32,82,38.270521807466125,-109.3505271
14315,1,19,22,2,6,32,82,38.270521807466125,-109.3502577
14316,1,19,22,2,6,30,80,38.270521807466125,-109.3499882
14317,1,21,21,2,6,30,81,38.270521807466125,-109.3497187
14318,1,23,20,1,7,29,81,38.270521807466125,-109.3494492
14319,1,23,19,1,8,28,80,38.270521807466125,-109.3491797
14320,2,24,19,2,8,28,83,38.270521807466125,-109.3489102
14321,2,23,19,3,8,28,83,38.270521807466125,-109.3486407
14322,1,21,19,2,6,30,79,38.270521807466125,-109.3483712
14323,2,20,20,3,5,31,81,38.270521807466125,-109.3481017
14324,2,19,20,4,4,31,80,38.270521807466125,-109.3478322
14325,4,21,18,7,4,26,80,38.270521807466125,-109.3475627
14326,3,21,19,4,2,27,76,38.270521807466125,-109.3472932
14327,3,21,19,4,3,27,77,38.270521807466125,-109.3470237
14328,2,22,20,2,4,30,80,38.270521807466125,-109.3467542
14329,1,21,19,0,4,31,76,38.270521807466125,-109.3464847
14330,1,21,17,0,2,29,70,38.270521807466125,-109.3462152
14331,1,15,16,0,1,26,59,38.270521807466125,-109.3459457
14332,1,18,17,0,2,27,65,38.270521807466125,-109.3456762
14333,1,23,18,1,5,29,77,38.270521807466125,-109.3454068
14334,2,23,18,2,5,29,79,38.270521807466125,-109.3451373
14335,2,26,16,2,6,23,75,38.270521807466125,-109.3448678
14336,4,29,14,4,8,18,77,38.270521807466125,-109.3445983
14337,7,34,14,5,12,12,84,38.270521807466125,-109.3443288
14338,8,37,14,8,14,7,88,38.270521807466125,-109.3440593
14339,10,39,14,9,12,6,90,38.270521807466125,-109.3437898
14340,13,40,14,10,11,4,92,38.270521807466125,-109.3435203
14341,15,39,13,11,10,3,91,38.270521807466125,-109.3432508
14342,14,40,13,12,10,3,92,38.270521807466125,-109.3429813
14343,9,41,13,10,12,3,88,38.270521807466125,-109.3427118
14344,6,39,14,8,12,7,86,38.270521807466125,-109.3424423
14345,6,38,14,8,11,8,85,38.270521807466125,-109.3421728
14346,6,38,13,8,10,8,83,38.270521807466125,-109.3419033
14347,6,38,13,9,10,7,83,38.270521807466125,-109.3416338
14348,8,38,14,12,10,6,88,38.270521807466125,-109.3413643
14349,11,36,13,14,9,5,88,38.270521807466125,-109.3410948
14350,10,36,13,13,12,4,88,38.270521807466125,-109.3408253
14351,9,35,13,13,12,4,86,38.270521807466125,-109.3405558
14352,9,35,13,13,12,4,86,38.270521807466125,-109.3402864
14353,10,35,13,12,13,4,87,38.270521807466125,-109.3400169
14354,12,33,12,12,12,5,86,38.270521807466125,-109.3397474
14355,15,33,12,13,11,4,88,38.270521807466125,-109.3394779
14356,14,34,12,13,12,4,89,38.270521807466125,-109.3392084
14357,10,36,13,12,13,5,89,38.270521807466125,-109.3389389
14358,8,38,13,11,12,6,88,38.270521807466125,-109.3386694
14359,2,48,11,0,14,10,85,38.27025231288089,-109.4381129
14360,2,50,12,1,16,8,89,38.27025231288089,-109.4378434
14361,2,53,11,1,15,8,90,38.27025231288089,-109.4375739
14362,1,53,10,1,14,8,87,38.27025231288089,-109.4373044
14363,2,50,11,1,13,8,85,38.27025231288089,-109.4370349
14364,2,41,9,2,10,7,71,38.27025231288089,-109.4367654
14365,2,40,10,3,10,6,71,38.27025231288089,-109.4364959
14366,3,40,10,4,10,6,73,38.27025231288089,-109.4362264
14367,3,38,10,3,8,7,69,38.27025231288089,-109.4359569
14368,2,34,10,3,8,6,63,38.27025231288089,-109.4356874
14369,4,37,10,3,9,5,68,38.27025231288089,-109.4354179
14370,3,30,10,6,10,6,65,38.27025231288089,-109.4351484
14371,6,28,11,16,15,4,80,38.27025231288089,-109.434879
14372,18,20,10,18,20,2,88,38.27025231288089,-109.4346095
14373,6,21,11,30,22,4,94,38.27025231288089,-109.43434
14374,3,19,13,17,29,6,87,38.27025231288089,-109.4340705
14375,2,23,11,21,22,4,83,38.27025231288089,-109.433801
14376,0,34,11,12,23,5,85,38.27025231288089,-109.4335315
14377,1,36,11,3,15,9,75,38.27025231288089,-109.433262
14378,3,56,9,0,15,5,88,38.27025231288089,-109.4329925
14379,3,50,10,4,16,3,86,38.27025231288089,-109.432723
14380,3,48,11,6,16,1,85,38.27025231288089,-109.4324535
14381,4,48,12,6,18,1,89,38.27025231288089,-109.432184
14382,4,47,13,7,18,1,90,38.27025231288089,-109.4319145
14383,3,43,12,4,17,4,83,38.27025231288089,-109.431645
14384,1,38,11,2,15,9,76,38.27025231288089,-109.4313755
14385,1,37,11,0,13,12,74,38.27025231288089,-109.431106
14386,2,39,11,0,14,11,77,38.27025231288089,-109.4308365
14387,1,36,10,0,12,13,72,38.27025231288089,-109.430567
14388,1,35,11,0,11,16,74,38.27025231288089,-109.4302975
14389,1,31,12,0,10,18,72,38.27025231288089,-109.430028
14390,2,28,12,3,11,14,70,38.27025231288089,-109.4297586
14391,3,33,10,4,12,7,69,38.27025231288089,-109.4294891
14392,1,37,10,0,12,11,71,38.27025231288089,-109.4292196
14393,1,39,10,0,12,12,74,38.27025231288089,-109.4289501
14394,2,38,11,1,14,10,76,38.27025231288089,-109.4286806
14395,3,37,11,2,14,9,76,38.27025231288089,-109.4284111
14396,3,39,10,2,12,10,76,38.27025231288089,-109.4281416
14397,3,40,10,1,13,9,76,38.27025231288089,-109.4278721
14398,2,41,11,2,15,7,78,38.27025231288089,-109.4276026
14399,2,41,12,2,15,8,80,38.27025231288089,-109.4273331
14400,2,41,10,0,13,11,77,38.27025231288089,-109.4270636
14401,2,43,10,0,11,11,77,38.27025231288089,-109.4267941
14402,2,42,10,1,13,8,76,38.27025231288089,-109.4265246
14403,2,39,11,1,13,9,75,38.27025231288089,-109.4262551
14404,2,34,11,0,11,13,71,38.27025231288089,-109.4259856
14405,1,35,11,0,12,14,73,38.27025231288089,-109.4257161
14406,0,34,12,0,10,18,74,38.27025231288089,-109.4254466
14407,0,31,12,0,10,18,71,38.27025231288089,-109.4251771
14408,0,32,12,0,9,19,72,38.27025231288089,-109.4249077
14409,1,36,11,0,9,17,74,38.27025231288089,-109.4246382
14410,2,40,12,1,12,13,80,38.27025231288089,-109.4243687
14411,3,44,11,1,13,10,82,38.27025231288089,-109.4240992
14412,3,46,12,4,15,5,85,38.27025231288089,-109.4238297
14413,4,46,13,6,16,3,88,38.27025231288089,-109.4235602
14414,4,46,13,4,17,4,88,38.27025231288089,-109.4232907
14415,3,44,13,3,18,5,86,38.27025231288089,-109.4230212
14416,3,43,12,3,16,7,84,38.27025231288089,-109.4227517
14417,3,41,12,2,16,8,82,38.27025231288089,-109.4224822
14418,2,39,12,1,16,9,79,38.27025231288089,-109.4222127
14419,2,38,11,2,15,9,77,38.27025231288089,-109.4219432
14420,4,38,12,5,17,5,81,38.27025231288089,-109.4216737
14421,4,39,11,4,17,5,80,38.27025231288089,-109.4214042
14422,5,40,12,6,18,2,83,38.27025231288089,-109.4211347
14423,7,42,13,10,19,0,91,38.27025231288089,-109.4208652
14424,8,44,13,9,19,0,93,38.27025231288089,-109.4205957
14425,7,45,13,9,19,0,93,38.27025231288089,-109.4203262
14426,6,46,13,9,19,0,93,38.27025231288089,-109.4200568
14427,6,47,13,8,18,0,92,38.27025231288089,-109.4197873
14428,7,47,13,9,17,0,93,38.27025231288089,-109.4195178
14429,9,41,14,13,15,0,92,38.27025231288089,-109.4192483
14430,10,41,14,12,15,0,92,38.27025231288089,-109.4189788
14431,8,43,13,11,16,0,91,38.27025231288089,-109.4187093
14432,6,45,13,10,16,0,90,38.27025231288089,-109.4184398
14433,7,46,13,9,17,0,92,38.27025231288089,-109.4181703
14434,8,43,13,11,16,0,91,38.27025231288089,-109.4179008
14435,17,36,14,13,12,0,92,38.27025231288089,-109.4176313
14436,22,34,15,13,11,0,95,38.27025231288089,-109.4173618
14437,18,37,14,12,12,0,93,38.27025231288089,-109.4170923
14438,10,43,13,11,15,0,92,38.27025231288089,-109.4168228
14439,8,44,13,10,15,0,90,38.27025231288089,-109.4165533
14440,10,42,13,10,15,0,90,38.27025231288089,-109.4162838
14441,11,40,12,9,16,0,88,38.27025231288089,-109.4160143
14442,10,41,12,9,16,0,88,38.27025231288089,-109.4157448
14443,10,42,13,12,15,0,92,38.27025231288089,-109.4154753
14444,10,41,14,12,16,0,93,38.27025231288089,-109.4152058
14445,8,43,14,11,16,0,92,38.27025231288089,-109.4149364
14446,7,42,13,12,14,0,88,38.27025231288089,-109.4146669
14447,9,41,13,11,12,1,87,38.27025231288089,-109.4143974
14448,5,47,12,8,13,1,86,38.27025231288089,-109.4141279
14449,7,48,13,8,15,1,92,38.27025231288089,-109.4138584
14450,8,46,13,8,16,1,92,38.27025231288089,-109.4135889
14451,9,46,14,9,16,1,95,38.27025231288089,-109.4133194
14452,8,46,14,9,17,0,94,38.27025231288089,-109.4130499
14453,8,48,13,8,17,0,94,38.27025231288089,-109.4127804
14454,8,49,13,7,16,0,93,38.27025231288089,-109.4125109
14455,8,50,12,8,15,0,93,38.27025231288089,-109.4122414
14456,7,51,10,8,14,0,90,38.27025231288089,-109.4119719
14457,3,56,9,5,13,0,86,38.27025231288089,-109.4117024
14458,4,57,10,3,16,1,91,38.27025231288089,-109.4114329
14459,4,54,12,3,17,2,92,38.27025231288089,-109.4111634
14460,5,52,13,4,17,2,93,38.27025231288089,-109.4108939
14461,4,52,13,5,18,1,93,38.27025231288089,-109.4106244
14462,5,51,13,5,18,1,93,38.27025231288089,-109.4103549
14463,5,51,13,5,17,1,92,38.27025231288089,-109.4100855
14464,5,52,13,5,17,1,93,38.27025231288089,-109.409816
14465,6,50,13,6,17,1,93,38.27025231288089,-109.4095465
14466,6,49,13,5,17,1,91,38.27025231288089,-109.409277
14467,6,47,12,6,17,1,89,38.27025231288089,-109.4090075
14468,7,48,12,5,17,1,90,38.27025231288089,-109.408738
14469,6,49,12,5,17,1,90,38.27025231288089,-109.4084685
14470,6,50,12,5,16,1,90,38.27025231288089,-109.408199
14471,6,51,13,6,15,2,93,38.27025231288089,-109.4079295
14472,5,51,12,6,16,2,92,38.27025231288089,-109.40766
14473,5,51,13,6,16,1,92,38.27025231288089,-109.4073905
14474,6,50,13,6,16,1,92,38.27025231288089,-109.407121
14475,6,48,13,6,17,1,91,38.27025231288089,-109.4068515
14476,2,27,14,3,8,18,72,38.27025231288089,-109.3879869
14477,1,23,16,0,5,25,70,38.27025231288089,-109.3877174
14478,1,25,15,1,5,23,70,38.27025231288089,-109.3874479
14479,1,27,14,1,6,21,70,38.27025231288089,-109.3871784
14480,2,28,12,1,6,20,69,38.27025231288089,-109.3869089
14481,1,29,12,0,7,18,67,38.27025231288089,-109.3866394
14482,2,27,11,0,9,15,64,38.27025231288089,-109.3863699
14483,2,27,12,0,7,19,67,38.27025231288089,-109.3861004
14484,2,30,12,0,7,18,69,38.27025231288089,-109.3858309
14485,3,34,11,1,10,13,72,38.27025231288089,-109.3855614
14486,5,38,12,6,13,7,81,38.27025231288089,-109.3852919
14487,8,37,13,10,15,4,87,38.27025231288089,-109.3850225
14488,10,35,13,11,15,3,87,38.27025231288089,-109.384753
14489,11,35,13,9,14,4,86,38.27025231288089,-109.3844835
14490,11,36,13,8,15,5,88,38.27025231288089,-109.384214
14491,10,40,13,7,15,4,89,38.27025231288089,-109.3839445
14492,9,41,13,6,15,4,88,38.27025231288089,-109.383675
14493,9,41,13,7,15,4,89,38.27025231288089,-109.3834055
14494,8,41,13,7,15,4,88,38.27025231288089,-109.383136
14495,7,39,13,5,14,6,84,38.27025231288089,-109.3828665
14496,5,37,12,4,12,8,78,38.27025231288089,-109.382597
14497,5,34,12,3,11,11,76,38.27025231288089,-109.3823275
14498,4,30,13,3,8,16,74,38.27025231288089,-109.382058
14499,3,27,15,2,7,20,74,38.27025231288089,-109.3817885
14500,2,25,14,2,6,20,69,38.27025231288089,-109.381519
14501,3,35,12,1,11,12,74,38.27025231288089,-109.3812495
14502,3,36,12,2,13,10,76,38.27025231288089,-109.38098
14503,4,33,12,3,13,10,75,38.27025231288089,-109.3807105
14504,5,31,12,5,13,9,75,38.27025231288089,-109.380441
14505,8,34,13,5,12,6,78,38.27025231288089,-109.3801716
14506,3,37,11,4,15,5,75,38.27025231288089,-109.3799021
14507,2,39,11,2,15,7,76,38.27025231288089,-109.3796326
14508,3,36,11,2,12,10,74,38.27025231288089,-109.3793631
14509,3,28,12,3,9,14,69,38.27025231288089,-109.3790936
14510,3,32,12,1,10,13,71,38.27025231288089,-109.3788241
14511,2,45,11,0,13,10,81,38.27025231288089,-109.3785546
14512,2,45,10,0,12,10,79,38.27025231288089,-109.3782851
14513,3,39,10,0,11,11,74,38.27025231288089,-109.3780156
14514,3,38,11,0,13,10,75,38.27025231288089,-109.3777461
14515,2,29,13,1,8,16,69,38.27025231288089,-109.3774766
14516,3,26,12,0,6,18,65,38.27025231288089,-109.3772071
14517,4,28,12,1,8,15,68,38.27025231288089,-109.3769376
14518,5,35,13,2,11,11,77,38.27025231288089,-109.3766681
14519,3,33,14,9,16,8,83,38.27025231288089,-109.3763986
14520,5,31,14,10,16,10,86,38.27025231288089,-109.3761291
14521,6,29,14,11,16,9,85,38.27025231288089,-109.3758596
14522,7,28,14,12,16,8,85,38.27025231288089,-109.3755901
14523,10,28,14,11,15,8,86,38.27025231288089,-109.3753206
14524,9,30,14,12,15,7,87,38.27025231288089,-109.3750512
14525,11,27,13,15,14,3,83,38.27025231288089,-109.3747817
14526,16,22,11,15,13,2,79,38.27025231288089,-109.3745122
14527,15,18,11,15,14,1,74,38.27025231288089,-109.3742427
14528,15,20,12,22,11,1,81,38.27025231288089,-109.3739732
14529,16,28,13,13,10,4,84,38.27025231288089,-109.3737037
14530,15,28,13,11,10,5,82,38.27025231288089,-109.3734342
14531,13,29,13,10,10,7,82,38.27025231288089,-109.3731647
14532,10,31,15,7,6,14,83,38.27025231288089,-109.3728952
14533,5,26,17,1,5,25,79,38.27025231288089,-109.3726257
14534,3,20,19,1,1,30,74,38.27025231288089,-109.3723562
14535,2,21,15,0,4,27,69,38.27025231288089,-109.3720867
14536,3,24,14,0,6,21,68,38.27025231288089,-109.3718172
14537,5,32,16,2,8,17,80,38.27025231288089,-109.3715477
14538,4,33,17,4,6,18,82,38.27025231288089,-109.3712782
14539,2,31,16,6,4,19,78,38.27025231288089,-109.3710087
14540,3,27,15,0,7,24,76,38.27025231288089,-109.3707392
14541,2,27,15,0,9,26,79,38.27025231288089,-109.3704697
14542,4,30,15,0,8,21,78,38.27025231288089,-109.3702003
14543,3,27,14,0,9,22,75,38.27025231288089,-109.3699308
14544,2,29,15,0,8,23,77,38.27025231288089,-109.3696613
14545,2,32,14,3,7,20,78,38.27025231288089,-109.3693918
14546,4,29,13,10,10,11,77,38.27025231288089,-109.3691223
14547,4,27,14,10,9,14,78,38.27025231288089,-109.3688528
14548,9,29,12,11,19,7,87,38.27025231288089,-109.3685833
14549,5,26,13,15,21,5,85,38.27025231288089,-109.3683138
14550,4,21,11,15,20,6,77,38.27025231288089,-109.3680443
14551,7,14,10,16,13,7,67,38.27025231288089,-109.3677748
14552,5,7,6,10,7,8,43,38.27025231288089,-109.3675053
14553,7,9,13,22,16,7,74,38.27025231288089,-109.3672358
14554,4,17,10,26,14,6,77,38.27025231288089,-109.3669663
14555,2,20,10,19,13,5,69,38.27025231288089,-109.3666968
14556,7,26,9,13,14,5,74,38.27025231288089,-109.3664273
14557,2,27,13,11,11,14,78,38.27025231288089,-109.3661578
14558,2,23,15,7,4,27,78,38.27025231288089,-109.3658883
14559,1,24,16,0,3,31,75,38.27025231288089,-109.3656188
14560,2,20,16,0,0,29,67,38.27025231288089,-109.3653493
14561,1,19,14,0,0,28,62,38.27025231288089,-109.3650799
14562,2,19,16,0,0,29,66,38.27025231288089,-109.3648104
14563,1,18,16,0,0,30,65,38.27025231288089,-109.3645409
14564,0,17,16,0,0,31,64,38.27025231288089,-109.3642714
14565,0,16,16,0,0,29,61,38.27025231288089,-109.3640019
14566,1,18,14,1,1,24,59,38.27025231288089,-109.3637324
14567,1,21,12,1,2,22,59,38.27025231288089,-109.3634629
14568,1,19,12,1,3,20,56,38.27025231288089,-109.3631934
14569,2,19,13,1,4,20,59,38.27025231288089,-109.3629239
14570,4,22,14,3,3,18,64,38.27025231288089,-109.3626544
14571,1,22,9,3,5,9,49,38.27025231288089,-109.3623849
14572,6,29,5,4,6,4,54,38.27025231288089,-109.3621154
14573,4,22,5,4,6,5,46,38.27025231288089,-109.3618459
14574,7,25,7,5,9,5,58,38.27025231288089,-109.3615764
14575,6,25,9,5,8,7,60,38.27025231288089,-109.3613069
14576,2,26,10,4,8,10,60,38.27025231288089,-109.3610374
14577,2,30,10,3,8,12,65,38.27025231288089,-109.3607679
14578,2,30,11,2,8,14,67,38.27025231288089,-109.3604984
14579,3,29,12,1,6,17,68,38.27025231288089,-109.360229
14580,2,22,14,0,4,22,64,38.27025231288089,-109.3599595
14581,2,25,16,0,4,24,71,38.27025231288089,-109.35969
14582,2,28,16,0,6,24,76,38.27025231288089,-109.3594205
14583,2,27,15,0,5,24,73,38.27025231288089,-109.359151
14584,1,25,16,0,3,27,72,38.27025231288089,-109.3588815
14585,1,23,17,0,4,30,75,38.27025231288089,-109.358612
14586,1,25,17,0,4,31,78,38.27025231288089,-109.3583425
14587,1,25,18,0,4,31,79,38.27025231288089,-109.358073
14588,1,26,18,0,5,30,80,38.27025231288089,-109.3578035
14589,1,26,19,0,4,32,82,38.27025231288089,-109.357534
14590,0,25,19,0,4,32,80,38.27025231288089,-109.3572645
14591,0,26,17,0,3,31,77,38.27025231288089,-109.356995
14592,4,24,16,4,4,29,81,38.27025231288089,-109.3567255
14593,5,25,16,8,3,24,81,38.27025231288089,-109.356456
14594,1,35,16,7,6,19,84,38.27025231288089,-109.3561865
14595,1,30,17,0,12,22,82,38.27025231288089,-109.355917
14596,1,27,17,0,12,22,79,38.27025231288089,-109.3556475
14597,2,27,16,4,11,19,79,38.27025231288089,-109.355378
14598,3,31,17,6,10,19,86,38.27025231288089,-109.3551086
14599,2,26,17,9,10,19,83,38.27025231288089,-109.3548391
14600,2,24,18,6,10,24,84,38.27025231288089,-109.3545696
14601,2,21,18,3,12,25,81,38.27025231288089,-109.3543001
14602,1,20,18,3,12,26,80,38.27025231288089,-109.3540306
14603,3,17,14,15,11,23,83,38.27025231288089,-109.3537611
14604,1,16,15,13,16,17,78,38.27025231288089,-109.3534916
14605,1,13,15,8,19,16,72,38.27025231288089,-109.3532221
14606,0,4,9,0,9,17,39,38.27025231288089,-109.3529526
14607,0,1,7,0,4,15,27,38.27025231288089,-109.3526831
14608,0,6,7,2,4,9,28,38.27025231288089,-109.3524136
14609,1,16,14,7,11,15,64,38.27025231288089,-109.3521441
14610,2,16,18,7,8,21,72,38.27025231288089,-109.3518746
14611,1,19,21,2,7,28,78,38.27025231288089,-109.3516051
14612,1,24,20,0,8,29,82,38.27025231288089,-109.3513356
14613,1,24,21,2,10,28,86,38.27025231288089,-109.3510661
14614,1,20,22,2,8,31,84,38.27025231288089,-109.3507966
14615,1,19,22,3,6,31,82,38.27025231288089,-109.3505271
14616,1,19,21,4,7,30,82,38.27025231288089,-109.3502577
14617,2,17,20,4,8,27,78,38.27025231288089,-109.3499882
14618,2,19,20,3,7,29,80,38.27025231288089,-109.3497187
14619,2,22,20,2,6,29,81,38.27025231288089,-109.3494492
14620,2,24,20,1,6,28,81,38.27025231288089,-109.3491797
14621,1,23,20,2,6,29,81,38.27025231288089,-109.3489102
14622,1,22,20,2,6,29,80,38.27025231288089,-109.3486407
14623,1,21,19,2,5,29,77,38.27025231288089,-109.3483712
14624,2,21,19,3,5,29,79,38.27025231288089,-109.3481017
14625,3,20,19,6,5,27,80,38.27025231288089,-109.3478322
14626,3,20,18,5,4,26,76,38.27025231288089,-109.3475627
14627,4,19,19,5,2,27,76,38.27025231288089,-109.3472932
14628,4,20,19,5,3,26,77,38.27025231288089,-109.3470237
14629,3,20,19,3,3,28,76,38.27025231288089,-109.3467542
14630,1,20,19,0,3,32,75,38.27025231288089,-109.3464847
14631,1,19,18,0,1,29,68,38.27025231288089,-109.3462152
14632,1,17,15,0,2,24,59,38.27025231288089,-109.3459457
14633,1,19,16,0,2,25,63,38.27025231288089,-109.3456762
14634,1,23,18,1,4,28,75,38.27025231288089,-109.3454068
14635,2,24,19,3,6,29,83,38.27025231288089,-109.3451373
14636,1,27,17,1,6,26,78,38.27025231288089,-109.3448678
14637,4,30,16,3,7,22,82,38.27025231288089,-109.3445983
14638,8,31,14,6,9,15,83,38.27025231288089,-109.3443288
14639,10,33,13,8,11,11,86,38.27025231288089,-109.3440593
14640,12,35,14,9,9,9,88,38.27025231288089,-109.3437898
14641,15,37,13,11,9,5,90,38.27025231288089,-109.3435203
14642,16,38,13,11,10,3,91,38.27025231288089,-109.3432508
14643,15,39,13,11,10,3,91,38.27025231288089,-109.3429813
14644,12,40,13,11,11,3,90,38.27025231288089,-109.3427118
14645,7,41,13,9,12,5,87,38.27025231288089,-109.3424423
14646,8,40,14,10,11,6,89,38.27025231288089,-109.3421728
14647,9,40,14,11,11,5,90,38.27025231288089,-109.3419033
14648,9,40,14,11,11,4,89,38.27025231288089,-109.3416338
14649,9,40,14,12,11,3,89,38.27025231288089,-109.3413643
14650,10,39,13,12,11,3,88,38.27025231288089,-109.3410948
14651,10,38,13,12,13,3,89,38.27025231288089,-109.3408253
14652,12,37,12,12,11,4,88,38.27025231288089,-109.3405558
14653,17,34,12,12,10,4,89,38.27025231288089,-109.3402864
14654,21,32,11,12,11,3,90,38.27025231288089,-109.3400169
14655,19,32,12,12,11,3,89,38.27025231288089,-109.3397474
14656,20,31,12,12,11,3,89,38.27025231288089,-109.3394779
14657,19,31,12,13,10,3,88,38.27025231288089,-109.3392084
14658,17,32,12,13,10,4,88,38.27025231288089,-109.3389389
14659,14,35,12,12,11,4,88,38.27025231288089,-109.3386694
14660,15,36,12,11,10,5,89,38.27025231288089,-109.3383999
14661,2,42,10,0,13,10,77,38.26998281829566,-109.4381129
14662,2,40,11,2,15,8,78,38.26998281829566,-109.4378434
14663,1,43,11,1,15,8,79,38.26998281829566,-109.4375739
14664,1,47,11,0,15,9,83,38.26998281829566,-109.4373044
14665,1,46,11,0,13,9,80,38.26998281829566,-109.4370349
14666,2,42,10,1,10,8,73,38.26998281829566,-109.4367654
14667,3,40,12,4,10,7,76,38.26998281829566,-109.4364959
14668,3,35,12,4,9,7,70,38.26998281829566,-109.4362264
14669,3,30,11,3,7,9,63,38.26998281829566,-109.4359569
14670,2,27,11,6,10,7,63,38.26998281829566,-109.4356874
14671,6,28,11,11,15,5,76,38.26998281829566,-109.4354179
14672,8,27,12,18,20,3,88,38.26998281829566,-109.4351484
14673,1,23,11,22,28,3,88,38.26998281829566,-109.434879
14674,3,20,11,23,27,3,87,38.26998281829566,-109.4346095
14675,3,22,13,17,26,4,85,38.26998281829566,-109.43434
14676,2,28,13,10,21,9,83,38.26998281829566,-109.4340705
14677,0,31,13,7,15,12,78,38.26998281829566,-109.433801
14678,0,28,11,3,12,12,66,38.26998281829566,-109.4335315
14679,3,41,10,0,13,10,77,38.26998281829566,-109.433262
14680,1,40,10,1,13,9,74,38.26998281829566,-109.4329925
14681,2,46,11,0,17,5,81,38.26998281829566,-109.432723
14682,3,47,12,4,19,3,88,38.26998281829566,-109.4324535
14683,3,45,12,8,20,1,89,38.26998281829566,-109.432184
14684,3,44,13,9,19,1,89,38.26998281829566,-109.4319145
14685,2,44,13,9,19,2,89,38.26998281829566,-109.431645
14686,2,39,12,6,17,7,83,38.26998281829566,-109.4313755
14687,1,35,11,2,14,11,74,38.26998281829566,-109.431106
14688,1,37,11,0,13,11,73,38.26998281829566,-109.4308365
14689,1,39,11,1,15,9,76,38.26998281829566,-109.430567
14690,1,32,12,1,11,16,73,38.26998281829566,-109.4302975
14691,1,30,13,0,10,20,74,38.26998281829566,-109.430028
14692,0,28,12,2,11,17,70,38.26998281829566,-109.4297586
14693,1,29,10,6,10,11,67,38.26998281829566,-109.4294891
14694,1,31,10,4,11,10,67,38.26998281829566,-109.4292196
14695,1,36,10,2,12,10,71,38.26998281829566,-109.4289501
14696,2,40,11,2,15,7,77,38.26998281829566,-109.4286806
14697,2,42,11,3,17,5,80,38.26998281829566,-109.4284111
14698,3,44,11,1,14,7,80,38.26998281829566,-109.4281416
14699,3,41,12,2,17,7,82,38.26998281829566,-109.4278721
14700,4,41,12,4,17,5,83,38.26998281829566,-109.4276026
14701,4,41,12,4,17,5,83,38.26998281829566,-109.4273331
14702,2,41,12,2,16,7,80,38.26998281829566,-109.4270636
14703,2,39,11,1,14,9,76,38.26998281829566,-109.4267941
14704,2,39,10,1,12,9,73,38.26998281829566,-109.4265246
14705,1,34,10,2,11,9,67,38.26998281829566,-109.4262551
14706,1,29,10,4,11,10,65,38.26998281829566,-109.4259856
14707,1,30,11,4,13,9,68,38.26998281829566,-109.4257161
14708,0,31,11,0,11,14,67,38.26998281829566,-109.4254466
14709,0,32,13,2,14,13,74,38.26998281829566,-109.4251771
14710,0,35,12,0,13,15,75,38.26998281829566,-109.4249077
14711,0,34,11,0,10,16,71,38.26998281829566,-109.4246382
14712,1,38,11,0,11,14,75,38.26998281829566,-109.4243687
14713,2,41,11,0,12,11,77,38.26998281829566,-109.4240992
14714,2,43,11,2,13,8,79,38.26998281829566,-109.4238297
14715,3,43,12,3,14,7,82,38.26998281829566,-109.4235602
14716,4,42,12,2,16,7,83,38.26998281829566,-109.4232907
14717,3,40,12,1,15,9,80,38.26998281829566,-109.4230212
14718,3,39,11,1,15,9,78,38.26998281829566,-109.4227517
14719,3,41,12,1,16,8,81,38.26998281829566,-109.4224822
14720,4,41,12,3,17,5,82,38.26998281829566,-109.4222127
14721,5,39,12,6,17,3,82,38.26998281829566,-109.4219432
14722,5,42,12,9,18,1,87,38.26998281829566,-109.4216737
14723,6,43,12,7,19,1,88,38.26998281829566,-109.4214042
14724,6,44,13,7,19,1,90,38.26998281829566,-109.4211347
14725,6,45,13,8,20,0,92,38.26998281829566,-109.4208652
14726,7,45,13,9,19,0,93,38.26998281829566,-109.4205957
14727,5,47,13,6,19,1,91,38.26998281829566,-109.4203262
14728,5,48,12,5,18,2,90,38.26998281829566,-109.4200568
14729,5,48,12,6,18,1,90,38.26998281829566,-109.4197873
14730,7,47,13,8,17,0,92,38.26998281829566,-109.4195178
14731,10,41,14,13,15,0,93,38.26998281829566,-109.4192483
14732,11,40,14,13,15,0,93,38.26998281829566,-109.4189788
14733,10,40,14,13,15,0,92,38.26998281829566,-109.4187093
14734,7,43,14,11,17,0,92,38.26998281829566,-109.4184398
14735,6,46,13,8,18,0,91,38.26998281829566,-109.4181703
14736,6,45,14,11,17,0,93,38.26998281829566,-109.4179008
14737,10,43,14,12,14,0,93,38.26998281829566,-109.4176313
14738,10,43,14,13,14,0,94,38.26998281829566,-109.4173618
14739,8,44,14,12,15,0,93,38.26998281829566,-109.4170923
14740,7,45,13,9,16,0,90,38.26998281829566,-109.4168228
14741,8,45,13,8,14,1,89,38.26998281829566,-109.4165533
14742,7,45,11,7,14,1,85,38.26998281829566,-109.4162838
14743,8,43,11,7,13,1,83,38.26998281829566,-109.4160143
14744,11,40,12,8,13,1,85,38.26998281829566,-109.4157448
14745,10,40,13,10,14,0,87,38.26998281829566,-109.4154753
14746,7,43,13,10,14,1,88,38.26998281829566,-109.4152058
14747,6,43,12,9,13,1,84,38.26998281829566,-109.4149364
14748,5,43,12,9,11,1,81,38.26998281829566,-109.4146669
14749,7,42,12,9,11,1,82,38.26998281829566,-109.4143974
14750,7,44,14,12,13,1,91,38.26998281829566,-109.4141279
14751,9,46,14,9,15,1,94,38.26998281829566,-109.4138584
14752,9,46,14,9,15,1,94,38.26998281829566,-109.4135889
14753,9,45,14,10,16,0,94,38.26998281829566,-109.4133194
14754,8,45,13,9,17,0,92,38.26998281829566,-109.4130499
14755,7,49,12,8,17,0,93,38.26998281829566,-109.4127804
14756,9,49,11,9,13,0,91,38.26998281829566,-109.4125109
14757,9,51,11,9,12,0,92,38.26998281829566,-109.4122414
14758,6,54,10,7,13,0,90,38.26998281829566,-109.4119719
14759,4,53,10,4,16,0,87,38.26998281829566,-109.4117024
14760,4,55,11,4,18,0,92,38.26998281829566,-109.4114329
14761,5,52,13,4,18,1,93,38.26998281829566,-109.4111634
14762,6,50,13,5,17,1,92,38.26998281829566,-109.4108939
14763,6,49,13,6,17,1,92,38.26998281829566,-109.4106244
14764,8,50,13,7,16,0,94,38.26998281829566,-109.4103549
14765,6,50,13,5,16,1,91,38.26998281829566,-109.4100855
14766,6,50,13,5,17,1,92,38.26998281829566,-109.409816
14767,6,49,13,5,18,1,92,38.26998281829566,-109.4095465
14768,7,49,12,5,17,1,91,38.26998281829566,-109.409277
14769,8,46,13,6,17,1,91,38.26998281829566,-109.4090075
14770,7,46,13,6,17,1,90,38.26998281829566,-109.408738
14771,6,48,13,6,16,1,90,38.26998281829566,-109.4084685
14772,6,50,13,5,17,1,92,38.26998281829566,-109.408199
14773,5,51,13,6,16,1,92,38.26998281829566,-109.4079295
14774,5,51,13,6,16,1,92,38.26998281829566,-109.40766
14775,6,49,13,7,17,1,93,38.26998281829566,-109.4073905
14776,6,48,13,7,17,1,92,38.26998281829566,-109.407121
14777,6,48,13,6,17,1,91,38.26998281829566,-109.4068515
14778,3,37,13,3,14,11,81,38.26998281829566,-109.3879869
14779,1,28,14,0,7,21,71,38.26998281829566,-109.3877174
14780,1,26,14,0,5,23,69,38.26998281829566,-109.3874479
14781,1,30,13,0,7,20,71,38.26998281829566,-109.3871784
14782,2,33,13,0,9,17,74,38.26998281829566,-109.3869089
14783,1,29,12,0,6,20,68,38.26998281829566,-109.3866394
14784,3,25,13,0,6,19,66,38.26998281829566,-109.3863699
14785,3,25,13,0,6,20,67,38.26998281829566,-109.3861004
14786,2,26,13,0,7,19,67,38.26998281829566,-109.3858309
14787,3,30,13,2,9,15,72,38.26998281829566,-109.3855614
14788,5,37,13,5,13,8,81,38.26998281829566,-109.3852919
14789,7,35,14,11,16,3,86,38.26998281829566,-109.3850225
14790,8,33,14,14,15,2,86,38.26998281829566,-109.384753
14791,9,36,13,12,15,3,88,38.26998281829566,-109.3844835
14792,10,38,13,7,15,5,88,38.26998281829566,-109.384214
14793,12,38,14,8,15,3,90,38.26998281829566,-109.3839445
14794,11,39,13,7,16,3,89,38.26998281829566,-109.383675
14795,8,41,13,6,16,4,88,38.26998281829566,-109.3834055
14796,7,41,13,5,15,6,87,38.26998281829566,-109.383136
14797,7,40,13,5,14,6,85,38.26998281829566,-109.3828665
14798,6,38,13,4,13,7,81,38.26998281829566,-109.382597
14799,5,35,13,5,13,8,79,38.26998281829566,-109.3823275
14800,5,32,14,4,11,11,77,38.26998281829566,-109.382058
14801,4,30,14,3,9,16,76,38.26998281829566,-109.3817885
14802,2,28,14,2,7,20,73,38.26998281829566,-109.381519
14803,3,38,12,0,11,13,77,38.26998281829566,-109.3812495
14804,3,33,13,1,10,16,76,38.26998281829566,-109.38098
14805,2,25,13,2,7,20,69,38.26998281829566,-109.3807105
14806,2,26,13,1,7,19,68,38.26998281829566,-109.380441
14807,3,38,11,1,13,9,75,38.26998281829566,-109.3801716
14808,2,37,11,2,13,9,74,38.26998281829566,-109.3799021
14809,2,37,11,2,14,9,75,38.26998281829566,-109.3796326
14810,3,34,11,2,12,10,72,38.26998281829566,-109.3793631
14811,3,28,12,3,8,15,69,38.26998281829566,-109.3790936
14812,4,30,12,1,8,15,70,38.26998281829566,-109.3788241
14813,3,32,11,1,9,13,69,38.26998281829566,-109.3785546
14814,3,31,11,2,9,11,67,38.26998281829566,-109.3782851
14815,2,31,12,3,10,13,71,38.26998281829566,-109.3780156
14816,3,32,13,1,10,18,77,38.26998281829566,-109.3777461
14817,2,27,14,2,9,20,74,38.26998281829566,-109.3774766
14818,2,26,14,0,8,22,72,38.26998281829566,-109.3772071
14819,3,29,14,0,8,22,76,38.26998281829566,-109.3769376
14820,3,32,15,0,12,19,81,38.26998281829566,-109.3766681
14821,3,32,14,5,17,12,83,38.26998281829566,-109.3763986
14822,6,32,13,8,16,8,83,38.26998281829566,-109.3761291
14823,7,31,14,9,16,8,85,38.26998281829566,-109.3758596
14824,7,30,15,10,15,10,87,38.26998281829566,-109.3755901
14825,8,29,15,11,14,9,86,38.26998281829566,-109.3753206
14826,9,29,14,14,15,5,86,38.26998281829566,-109.3750512
14827,13,24,12,15,12,4,80,38.26998281829566,-109.3747817
14828,18,21,11,12,12,1,75,38.26998281829566,-109.3745122
14829,17,21,11,13,13,0,75,38.26998281829566,-109.3742427
14830,14,24,13,17,13,1,82,38.26998281829566,-109.3739732
14831,16,25,13,16,12,2,84,38.26998281829566,-109.3737037
14832,15,25,12,17,12,2,83,38.26998281829566,-109.3734342
14833,14,26,13,15,13,3,84,38.26998281829566,-109.3731647
14834,10,30,14,10,11,8,83,38.26998281829566,-109.3728952
14835,5,30,16,2,9,21,83,38.26998281829566,-109.3726257
14836,3,25,17,0,7,26,78,38.26998281829566,-109.3723562
14837,6,23,17,1,8,23,78,38.26998281829566,-109.3720867
14838,3,26,16,2,5,24,76,38.26998281829566,-109.3718172
14839,3,29,15,3,4,23,77,38.26998281829566,-109.3715477
14840,4,30,16,5,5,19,79,38.26998281829566,-109.3712782
14841,3,28,15,1,8,20,75,38.26998281829566,-109.3710087
14842,2,23,16,0,7,25,73,38.26998281829566,-109.3707392
14843,3,26,16,0,11,23,79,38.26998281829566,-109.3704697
14844,1,26,16,0,9,25,77,38.26998281829566,-109.3702003
14845,3,26,15,3,8,23,78,38.26998281829566,-109.3699308
14846,3,27,16,3,11,20,80,38.26998281829566,-109.3696613
14847,3,29,17,4,13,18,84,38.26998281829566,-109.3693918
14848,3,24,14,13,13,12,79,38.26998281829566,-109.3691223
14849,2,27,16,11,19,9,84,38.26998281829566,-109.3688528
14850,2,23,13,11,25,4,78,38.26998281829566,-109.3685833
14851,6,27,10,19,22,1,85,38.26998281829566,-109.3683138
14852,5,20,9,15,20,1,70,38.26998281829566,-109.3680443
14853,3,16,14,16,21,4,74,38.26998281829566,-109.3677748
14854,3,17,14,11,18,8,71,38.26998281829566,-109.3675053
14855,4,18,12,19,17,6,76,38.26998281829566,-109.3672358
14856,4,19,12,19,16,3,73,38.26998281829566,-109.3669663
14857,4,26,10,8,17,5,70,38.26998281829566,-109.3666968
14858,4,28,13,9,12,11,77,38.26998281829566,-109.3664273
14859,1,25,14,4,7,23,74,38.26998281829566,-109.3661578
14860,0,23,15,0,3,31,72,38.26998281829566,-109.3658883
14861,1,19,15,0,1,29,65,38.26998281829566,-109.3656188
14862,2,22,14,0,0,26,64,38.26998281829566,-109.3653493
14863,1,20,13,0,1,26,61,38.26998281829566,-109.3650799
14864,2,18,15,0,1,28,64,38.26998281829566,-109.3648104
14865,1,18,15,0,0,28,62,38.26998281829566,-109.3645409
14866,1,19,14,0,0,25,59,38.26998281829566,-109.3642714
14867,1,20,13,1,1,23,59,38.26998281829566,-109.3640019
14868,1,22,12,1,2,21,59,38.26998281829566,-109.3637324
14869,1,22,12,1,2,21,59,38.26998281829566,-109.3634629
14870,1,17,14,1,3,22,58,38.26998281829566,-109.3631934
14871,1,15,14,1,3,22,56,38.26998281829566,-109.3629239
14872,4,23,13,4,4,17,65,38.26998281829566,-109.3626544
14873,1,24,9,6,7,6,53,38.26998281829566,-109.3623849
14874,4,23,5,4,6,5,47,38.26998281829566,-109.3621154
14875,6,20,6,4,6,6,48,38.26998281829566,-109.3618459
14876,5,23,9,4,6,11,58,38.26998281829566,-109.3615764
14877,5,23,10,2,5,14,59,38.26998281829566,-109.3613069
14878,2,26,11,5,8,13,65,38.26998281829566,-109.3610374
14879,2,29,11,3,7,15,67,38.26998281829566,-109.3607679
14880,2,28,12,1,7,16,66,38.26998281829566,-109.3604984
14881,2,22,13,1,6,18,62,38.26998281829566,-109.360229
14882,2,21,14,1,5,21,64,38.26998281829566,-109.3599595
14883,2,23,16,0,4,25,70,38.26998281829566,-109.35969
14884,1,25,15,0,5,25,71,38.26998281829566,-109.3594205
14885,1,26,14,0,5,23,69,38.26998281829566,-109.359151
14886,2,26,15,0,5,24,72,38.26998281829566,-109.3588815
14887,1,25,15,0,4,27,72,38.26998281829566,-109.358612
14888,0,22,17,0,6,29,74,38.26998281829566,-109.3583425
14889,0,23,18,0,7,29,77,38.26998281829566,-109.358073
14890,1,22,18,0,5,30,76,38.26998281829566,-109.3578035
14891,2,23,17,0,3,28,73,38.26998281829566,-109.357534
14892,2,22,15,1,3,25,68,38.26998281829566,-109.3572645
14893,1,27,13,0,3,23,67,38.26998281829566,-109.356995
14894,3,24,15,2,4,20,68,38.26998281829566,-109.3567255
14895,5,29,15,8,5,16,78,38.26998281829566,-109.356456
14896,1,29,13,0,8,20,71,38.26998281829566,-109.3561865
14897,1,28,14,1,13,17,74,38.26998281829566,-109.355917
14898,1,29,15,2,10,18,75,38.26998281829566,-109.3556475
14899,2,31,16,1,4,24,78,38.26998281829566,-109.355378
14900,2,30,16,1,4,24,77,38.26998281829566,-109.3551086
14901,2,29,18,1,4,28,82,38.26998281829566,-109.3548391
14902,2,25,19,3,8,26,83,38.26998281829566,-109.3545696
14903,1,29,17,2,7,25,81,38.26998281829566,-109.3543001
14904,1,30,14,2,11,20,78,38.26998281829566,-109.3540306
14905,2,28,15,4,9,20,78,38.26998281829566,-109.3537611
14906,0,20,14,5,14,15,68,38.26998281829566,-109.3534916
14907,0,13,14,8,15,16,66,38.26998281829566,-109.3532221
14908,0,6,13,13,15,17,64,38.26998281829566,-109.3529526
14909,1,13,17,5,13,15,64,38.26998281829566,-109.3526831
14910,3,24,18,3,11,16,75,38.26998281829566,-109.3524136
14911,0,23,18,1,7,24,73,38.26998281829566,-109.3521441
14912,0,24,19,0,7,26,76,38.26998281829566,-109.3518746
14913,0,24,19,0,7,28,78,38.26998281829566,-109.3516051
14914,0,24,21,0,7,29,81,38.26998281829566,-109.3513356
14915,1,24,22,1,7,31,86,38.26998281829566,-109.3510661
14916,1,22,22,1,7,31,84,38.26998281829566,-109.3507966
14917,0,21,22,1,7,32,83,38.26998281829566,-109.3505271
14918,1,20,21,3,7,29,81,38.26998281829566,-109.3502577
14919,2,18,19,5,7,28,79,38.26998281829566,-109.3499882
14920,3,18,19,6,5,27,78,38.26998281829566,-109.3497187
14921,3,21,19,4,5,27,79,38.26998281829566,-109.3494492
14922,2,24,19,1,5,28,79,38.26998281829566,-109.3491797
14923,1,24,20,0,6,28,79,38.26998281829566,-109.3489102
14924,1,23,20,2,5,29,80,38.26998281829566,-109.3486407
14925,2,22,20,2,5,29,80,38.26998281829566,-109.3483712
14926,2,22,20,3,5,29,81,38.26998281829566,-109.3481017
14927,2,22,19,3,4,28,78,38.26998281829566,-109.3478322
14928,2,20,20,3,4,31,80,38.26998281829566,-109.3475627
14929,2,17,19,1,2,31,72,38.26998281829566,-109.3472932
14930,3,18,20,2,2,30,75,38.26998281829566,-109.3470237
14931,3,19,20,2,2,31,77,38.26998281829566,-109.3467542
14932,2,17,19,0,2,32,72,38.26998281829566,-109.3464847
14933,1,17,17,0,1,27,63,38.26998281829566,-109.3462152
14934,2,20,14,0,3,19,58,38.26998281829566,-109.3459457
14935,1,20,14,1,3,21,60,38.26998281829566,-109.3456762
14936,0,23,18,0,4,28,73,38.26998281829566,-109.3454068
14937,1,24,20,1,7,32,85,38.26998281829566,-109.3451373
14938,1,25,19,0,7,31,83,38.26998281829566,-109.3448678
14939,3,30,17,2,8,25,85,38.26998281829566,-109.3445983
14940,7,33,15,6,11,14,86,38.26998281829566,-109.3443288
14941,9,35,14,10,13,7,88,38.26998281829566,-109.3440593
14942,11,35,14,10,12,6,88,38.26998281829566,-109.3437898
14943,10,38,14,11,12,4,89,38.26998281829566,-109.3435203
14944,8,40,13,9,12,4,86,38.26998281829566,-109.3432508
14945,9,40,13,10,12,4,88,38.26998281829566,-109.3429813
14946,12,39,13,13,10,3,90,38.26998281829566,-109.3427118
14947,12,38,13,11,11,4,89,38.26998281829566,-109.3424423
14948,11,38,13,13,10,4,89,38.26998281829566,-109.3421728
14949,11,38,13,12,10,4,88,38.26998281829566,-109.3419033
14950,11,37,13,12,10,4,87,38.26998281829566,-109.3416338
14951,10,38,13,12,10,4,87,38.26998281829566,-109.3413643
14952,9,39,13,13,10,3,87,38.26998281829566,-109.3410948
14953,10,38,13,13,11,4,89,38.26998281829566,-109.3408253
14954,15,36,13,12,10,4,90,38.26998281829566,-109.3405558
14955,21,32,12,12,9,3,89,38.26998281829566,-109.3402864
14956,26,29,11,10,9,4,89,38.26998281829566,-109.3400169
14957,26,28,11,11,9,4,89,38.26998281829566,-109.3397474
14958,24,29,12,12,9,4,90,38.26998281829566,-109.3394779
14959,21,31,12,12,9,4,89,38.26998281829566,-109.3392084
14960,20,33,11,12,10,3,89,38.26998281829566,-109.3389389
14961,19,35,11,10,10,4,89,38.26998281829566,-109.3386694
14962,18,36,12,10,9,5,90,38.26998281829566,-109.3383999
14963,2,39,10,4,13,6,74,38.26971332371042,-109.4383824
14964,3,46,9,2,10,5,75,38.26971332371042,-109.4381129
14965,2,44,10,1,12,6,75,38.26971332371042,-109.4378434
14966,1,43,10,1,12,7,74,38.26971332371042,-109.4375739
14967,1,44,10,0,13,8,76,38.26971332371042,-109.4373044
14968,2,43,10,2,13,6,76,38.26971332371042,-109.4370349
14969,3,45,11,6,11,3,79,38.26971332371042,-109.4367654
14970,2,35,11,5,10,6,69,38.26971332371042,-109.4364959
14971,3,28,11,5,9,7,63,38.26971332371042,-109.4362264
14972,3,25,11,9,11,6,65,38.26971332371042,-109.4359569
14973,5,27,11,22,14,3,82,38.26971332371042,-109.4356874
14974,4,21,9,31,23,1,89,38.26971332371042,-109.4354179
14975,2,28,11,14,23,7,85,38.26971332371042,-109.4351484
14976,1,35,13,7,19,12,87,38.26971332371042,-109.434879
14977,1,35,12,8,18,10,84,38.26971332371042,-109.4346095
14978,0,36,12,7,19,8,82,38.26971332371042,-109.43434
14979,0,36,13,7,21,6,83,38.26971332371042,-109.4340705
14980,0,35,12,7,19,8,81,38.26971332371042,-109.433801
14981,0,36,11,6,17,8,78,38.26971332371042,-109.4335315
14982,2,40,12,1,17,8,80,38.26971332371042,-109.433262
14983,1,42,11,0,16,10,80,38.26971332371042,-109.4329925
14984,4,48,11,2,18,3,86,38.26971332371042,-109.432723
14985,4,48,12,3,20,2,89,38.26971332371042,-109.4324535
14986,3,46,12,6,21,1,89,38.26971332371042,-109.432184
14987,3,46,12,4,21,2,88,38.26971332371042,-109.4319145
14988,3,45,12,4,21,3,88,38.26971332371042,-109.431645
14989,2,40,12,1,16,10,81,38.26971332371042,-109.4313755
14990,1,32,11,1,12,14,71,38.26971332371042,-109.431106
14991,1,30,11,3,13,11,69,38.26971332371042,-109.4308365
14992,3,44,10,0,12,11,80,38.26971332371042,-109.430567
14993,2,40,12,1,14,9,78,38.26971332371042,-109.4302975
14994,1,37,11,0,13,13,75,38.26971332371042,-109.430028
14995,1,37,11,0,13,13,75,38.26971332371042,-109.4297586
14996,0,34,11,2,14,11,72,38.26971332371042,-109.4294891
14997,1,32,10,6,13,8,70,38.26971332371042,-109.4292196
14998,1,36,10,1,12,9,69,38.26971332371042,-109.4289501
14999,1,42,9,0,12,8,72,38.26971332371042,-109.4286806
15000,2,42,10,1,14,6,75,38.26971332371042,-109.4284111
15001,2,44,10,0,13,7,76,38.26971332371042,-109.4281416
15002,3,44,12,5,17,3,84,38.26971332371042,-109.4278721
15003,4,45,13,7,19,1,89,38.26971332371042,-109.4276026
15004,4,45,13,7,19,2,90,38.26971332371042,-109.4273331
15005,4,43,12,4,18,5,86,38.26971332371042,-109.4270636
15006,3,39,12,2,16,8,80,38.26971332371042,-109.4267941
15007,2,36,11,0,11,13,73,38.26971332371042,-109.4265246
15008,1,31,10,0,8,14,64,38.26971332371042,-109.4262551
15009,1,29,9,1,9,12,61,38.26971332371042,-109.4259856
15010,1,34,9,3,9,8,64,38.26971332371042,-109.4257161
15011,1,31,9,5,11,7,64,38.26971332371042,-109.4254466
15012,2,30,10,5,13,7,67,38.26971332371042,-109.4251771
15013,2,32,11,5,14,7,71,38.26971332371042,-109.4249077
15014,2,34,12,5,13,7,73,38.26971332371042,-109.4246382
15015,2,36,10,2,11,9,70,38.26971332371042,-109.4243687
15016,2,36,10,3,9,9,69,38.26971332371042,-109.4240992
15017,1,37,10,1,11,11,71,38.26971332371042,-109.4238297
15018,2,35,11,0,12,10,70,38.26971332371042,-109.4235602
15019,3,38,11,1,14,9,76,38.26971332371042,-109.4232907
15020,4,39,12,4,16,6,81,38.26971332371042,-109.4230212
15021,4,41,12,3,17,6,83,38.26971332371042,-109.4227517
15022,5,42,12,5,18,2,84,38.26971332371042,-109.4224822
15023,7,42,13,10,19,0,91,38.26971332371042,-109.4222127
15024,7,41,14,13,17,0,92,38.26971332371042,-109.4219432
15025,5,41,14,13,17,0,90,38.26971332371042,-109.4216737
15026,6,43,13,11,18,0,91,38.26971332371042,-109.4214042
15027,6,45,13,9,18,0,91,38.26971332371042,-109.4211347
15028,6,46,13,9,18,0,92,38.26971332371042,-109.4208652
15029,6,45,13,9,18,0,91,38.26971332371042,-109.4205957
15030,4,48,13,7,19,0,91,38.26971332371042,-109.4203262
15031,5,49,12,5,18,1,90,38.26971332371042,-109.4200568
15032,5,48,12,6,18,1,90,38.26971332371042,-109.4197873
15033,7,45,13,8,16,1,90,38.26971332371042,-109.4195178
15034,10,40,14,12,15,0,91,38.26971332371042,-109.4192483
15035,10,40,14,12,15,0,91,38.26971332371042,-109.4189788
15036,9,41,14,11,16,0,91,38.26971332371042,-109.4187093
15037,7,44,13,10,17,0,91,38.26971332371042,-109.4184398
15038,5,47,13,7,18,1,91,38.26971332371042,-109.4181703
15039,6,47,13,9,18,0,93,38.26971332371042,-109.4179008
15040,6,46,13,9,16,1,91,38.26971332371042,-109.4176313
15041,6,46,13,8,16,2,91,38.26971332371042,-109.4173618
15042,5,46,13,7,16,2,89,38.26971332371042,-109.4170923
15043,6,47,13,10,16,1,93,38.26971332371042,-109.4168228
15044,7,47,14,10,14,0,92,38.26971332371042,-109.4165533
15045,6,45,13,9,14,1,88,38.26971332371042,-109.4162838
15046,7,41,12,7,12,2,81,38.26971332371042,-109.4160143
15047,8,38,13,8,11,2,80,38.26971332371042,-109.4157448
15048,7,40,13,9,11,2,82,38.26971332371042,-109.4154753
15049,5,41,12,10,11,1,80,38.26971332371042,-109.4152058
15050,5,41,13,11,11,1,82,38.26971332371042,-109.4149364
15051,7,42,13,12,12,1,87,38.26971332371042,-109.4146669
15052,8,43,14,12,12,1,90,38.26971332371042,-109.4143974
15053,10,42,15,13,13,1,94,38.26971332371042,-109.4141279
15054,10,45,14,10,14,1,94,38.26971332371042,-109.4138584
15055,10,45,13,9,13,1,91,38.26971332371042,-109.4135889
15056,11,44,13,9,14,1,92,38.26971332371042,-109.4133194
15057,9,47,12,8,16,0,92,38.26971332371042,-109.4130499
15058,7,51,11,6,17,0,92,38.26971332371042,-109.4127804
15059,7,53,11,8,14,0,93,38.26971332371042,-109.4125109
15060,6,54,10,8,14,0,92,38.26971332371042,-109.4122414
15061,5,53,11,5,17,0,91,38.26971332371042,-109.4119719
15062,5,49,11,4,19,0,88,38.26971332371042,-109.4117024
15063,6,52,12,5,18,0,93,38.26971332371042,-109.4114329
15064,5,52,13,5,18,1,94,38.26971332371042,-109.4111634
15065,5,51,13,5,18,1,93,38.26971332371042,-109.4108939
15066,6,50,13,7,17,1,94,38.26971332371042,-109.4106244
15067,6,51,13,7,16,1,94,38.26971332371042,-109.4103549
15068,5,51,13,6,16,1,92,38.26971332371042,-109.4100855
15069,5,50,13,5,17,1,91,38.26971332371042,-109.409816
15070,5,50,12,5,18,1,91,38.26971332371042,-109.4095465
15071,6,49,12,4,17,1,89,38.26971332371042,-109.409277
15072,7,47,13,6,17,1,91,38.26971332371042,-109.4090075
15073,7,48,13,7,17,1,93,38.26971332371042,-109.408738
15074,6,49,13,6,17,1,92,38.26971332371042,-109.4084685
15075,5,51,13,5,17,1,92,38.26971332371042,-109.408199
15076,5,52,12,5,17,1,92,38.26971332371042,-109.4079295
15077,5,50,13,6,18,0,92,38.26971332371042,-109.40766
15078,8,47,13,8,17,0,93,38.26971332371042,-109.4073905
15079,8,46,13,8,17,0,92,38.26971332371042,-109.407121
15080,7,46,13,7,17,0,90,38.26971332371042,-109.4068515
15081,3,46,13,3,15,7,87,38.26971332371042,-109.3879869
15082,2,41,12,0,14,12,81,38.26971332371042,-109.3877174
15083,1,34,12,0,9,18,74,38.26971332371042,-109.3874479
15084,2,34,12,0,10,16,74,38.26971332371042,-109.3871784
15085,2,36,12,0,12,14,76,38.26971332371042,-109.3869089
15086,2,30,12,0,7,19,70,38.26971332371042,-109.3866394
15087,1,23,14,0,4,23,65,38.26971332371042,-109.3863699
15088,1,25,13,0,5,21,65,38.26971332371042,-109.3861004
15089,2,25,13,0,6,20,66,38.26971332371042,-109.3858309
15090,2,27,13,0,7,19,68,38.26971332371042,-109.3855614
15091,4,36,13,2,12,12,79,38.26971332371042,-109.3852919
15092,4,38,13,8,17,5,85,38.26971332371042,-109.3850225
15093,5,39,13,8,18,4,87,38.26971332371042,-109.384753
15094,6,39,13,7,17,5,87,38.26971332371042,-109.3844835
15095,7,39,13,7,17,4,87,38.26971332371042,-109.384214
15096,8,39,13,6,17,4,87,38.26971332371042,-109.3839445
15097,8,38,13,6,17,4,86,38.26971332371042,-109.383675
15098,8,40,13,5,16,5,87,38.26971332371042,-109.3834055
15099,7,41,13,4,15,6,86,38.26971332371042,-109.383136
15100,6,39,13,5,14,7,84,38.26971332371042,-109.3828665
15101,5,38,13,4,14,8,82,38.26971332371042,-109.382597
15102,5,38,13,3,13,8,80,38.26971332371042,-109.3823275
15103,5,36,13,4,13,9,80,38.26971332371042,-109.382058
15104,5,33,13,4,11,10,76,38.26971332371042,-109.3817885
15105,4,34,12,3,12,11,76,38.26971332371042,-109.381519
15106,4,38,13,2,14,10,81,38.26971332371042,-109.3812495
15107,3,32,13,2,10,16,76,38.26971332371042,-109.38098
15108,2,24,14,2,4,23,69,38.26971332371042,-109.3807105
15109,1,24,13,1,4,23,66,38.26971332371042,-109.380441
15110,3,41,11,0,13,10,78,38.26971332371042,-109.3801716
15111,2,42,11,1,15,9,80,38.26971332371042,-109.3799021
15112,2,39,11,1,14,9,76,38.26971332371042,-109.3796326
15113,3,36,11,2,13,9,74,38.26971332371042,-109.3793631
15114,3,33,11,3,11,11,72,38.26971332371042,-109.3790936
15115,3,29,12,3,9,14,70,38.26971332371042,-109.3788241
15116,3,29,13,2,9,16,72,38.26971332371042,-109.3785546
15117,2,28,13,3,10,17,73,38.26971332371042,-109.3782851
15118,1,29,14,2,10,19,75,38.26971332371042,-109.3780156
15119,2,31,16,2,9,21,81,38.26971332371042,-109.3777461
15120,2,28,17,1,8,24,80,38.26971332371042,-109.3774766
15121,4,28,16,1,8,21,78,38.26971332371042,-109.3772071
15122,4,30,15,1,9,20,79,38.26971332371042,-109.3769376
15123,3,32,15,1,11,18,80,38.26971332371042,-109.3766681
15124,3,35,14,4,18,11,85,38.26971332371042,-109.3763986
15125,4,36,14,5,17,10,86,38.26971332371042,-109.3761291
15126,5,34,14,4,15,12,84,38.26971332371042,-109.3758596
15127,6,34,15,3,13,14,85,38.26971332371042,-109.3755901
15128,7,33,15,6,14,12,87,38.26971332371042,-109.3753206
15129,13,30,14,10,13,6,86,38.26971332371042,-109.3750512
15130,18,23,12,12,11,2,78,38.26971332371042,-109.3747817
15131,13,23,11,11,12,1,71,38.26971332371042,-109.3745122
15132,11,26,11,11,12,0,71,38.26971332371042,-109.3742427
15133,11,28,13,16,13,2,83,38.26971332371042,-109.3739732
15134,15,24,13,21,11,2,86,38.26971332371042,-109.3737037
15135,17,22,12,19,12,2,84,38.26971332371042,-109.3734342
15136,16,23,12,18,12,3,84,38.26971332371042,-109.3731647
15137,16,23,16,11,10,9,85,38.26971332371042,-109.3728952
15138,13,21,17,6,10,15,82,38.26971332371042,-109.3726257
15139,5,21,18,2,7,22,75,38.26971332371042,-109.3723562
15140,3,26,17,2,4,27,79,38.26971332371042,-109.3720867
15141,2,27,16,2,4,27,78,38.26971332371042,-109.3718172
15142,3,26,17,0,8,26,80,38.26971332371042,-109.3715477
15143,7,26,17,0,8,26,84,38.26971332371042,-109.3712782
15144,2,25,17,0,7,26,77,38.26971332371042,-109.3710087
15145,2,25,17,0,7,26,77,38.26971332371042,-109.3707392
15146,3,27,17,1,9,24,81,38.26971332371042,-109.3704697
15147,1,25,18,2,10,26,82,38.26971332371042,-109.3702003
15148,5,27,15,5,13,17,82,38.26971332371042,-109.3699308
15149,9,25,15,10,15,9,83,38.26971332371042,-109.3696613
15150,3,29,14,10,19,7,82,38.26971332371042,-109.3693918
15151,4,26,13,13,12,8,76,38.26971332371042,-109.3691223
15152,3,19,11,14,18,7,72,38.26971332371042,-109.3688528
15153,4,7,8,11,11,10,51,38.26971332371042,-109.3685833
15154,7,8,8,16,12,6,57,38.26971332371042,-109.3683138
15155,7,14,12,24,19,5,81,38.26971332371042,-109.3680443
15156,3,19,10,25,15,5,77,38.26971332371042,-109.3677748
15157,3,21,12,21,13,5,75,38.26971332371042,-109.3675053
15158,1,26,10,12,15,5,69,38.26971332371042,-109.3672358
15159,4,29,11,6,16,5,71,38.26971332371042,-109.3669663
15160,2,32,14,4,11,15,78,38.26971332371042,-109.3666968
15161,3,28,16,2,7,23,79,38.26971332371042,-109.3664273
15162,0,23,14,0,4,28,69,38.26971332371042,-109.3661578
15163,0,20,15,0,1,28,64,38.26971332371042,-109.3658883
15164,1,22,14,0,0,26,63,38.26971332371042,-109.3656188
15165,1,24,13,0,2,24,64,38.26971332371042,-109.3653493
15166,2,22,15,0,3,22,64,38.26971332371042,-109.3650799
15167,3,18,15,0,2,25,63,38.26971332371042,-109.3648104
15168,2,18,15,1,2,23,61,38.26971332371042,-109.3645409
15169,1,22,12,1,3,20,59,38.26971332371042,-109.3642714
15170,1,22,12,1,2,21,59,38.26971332371042,-109.3640019
15171,1,23,11,0,3,21,59,38.26971332371042,-109.3637324
15172,0,20,13,1,3,22,59,38.26971332371042,-109.3634629
15173,1,17,15,0,2,24,59,38.26971332371042,-109.3631934
15174,0,15,14,0,2,24,55,38.26971332371042,-109.3629239
15175,3,24,13,2,4,16,62,38.26971332371042,-109.3626544
15176,1,27,8,4,7,6,53,38.26971332371042,-109.3623849
15177,2,22,5,4,6,6,45,38.26971332371042,-109.3621154
15178,4,17,6,4,6,8,45,38.26971332371042,-109.3618459
15179,3,21,8,3,7,11,53,38.26971332371042,-109.3615764
15180,3,22,9,4,7,13,58,38.26971332371042,-109.3613069
15181,2,28,12,5,8,13,68,38.26971332371042,-109.3610374
15182,3,28,12,3,7,16,69,38.26971332371042,-109.3607679
15183,2,24,12,2,5,18,63,38.26971332371042,-109.3604984
15184,2,19,13,5,6,17,62,38.26971332371042,-109.360229
15185,4,22,13,5,7,17,68,38.26971332371042,-109.3599595
15186,2,22,16,1,5,26,72,38.26971332371042,-109.35969
15187,1,24,15,0,6,25,71,38.26971332371042,-109.3594205
15188,1,28,12,0,7,20,68,38.26971332371042,-109.359151
15189,0,25,14,0,7,25,71,38.26971332371042,-109.3588815
15190,0,23,15,0,4,27,69,38.26971332371042,-109.358612
15191,0,20,15,0,4,26,65,38.26971332371042,-109.3583425
15192,1,21,16,0,4,26,68,38.26971332371042,-109.358073
15193,2,26,17,0,3,25,73,38.26971332371042,-109.3578035
15194,2,32,15,2,3,19,73,38.26971332371042,-109.357534
15195,2,34,15,4,5,17,77,38.26971332371042,-109.3572645
15196,1,30,12,1,8,16,68,38.26971332371042,-109.356995
15197,6,26,10,11,10,12,75,38.26971332371042,-109.3567255
15198,8,25,11,12,9,11,76,38.26971332371042,-109.356456
15199,9,27,13,11,7,13,80,38.26971332371042,-109.3561865
15200,4,33,14,8,6,15,80,38.26971332371042,-109.355917
15201,2,28,14,4,9,14,71,38.26971332371042,-109.3556475
15202,3,32,14,4,7,17,77,38.26971332371042,-109.355378
15203,3,31,15,1,6,21,77,38.26971332371042,-109.3551086
15204,2,29,16,0,5,27,79,38.26971332371042,-109.3548391
15205,1,25,15,1,9,22,73,38.26971332371042,-109.3545696
15206,0,32,14,0,12,15,73,38.26971332371042,-109.3543001
15207,4,34,12,4,15,7,76,38.26971332371042,-109.3540306
15208,6,31,11,9,13,4,74,38.26971332371042,-109.3537611
15209,4,31,13,8,10,8,74,38.26971332371042,-109.3534916
15210,2,28,11,6,20,2,69,38.26971332371042,-109.3532221
15211,6,30,11,9,12,5,73,38.26971332371042,-109.3529526
15212,5,12,10,9,10,7,53,38.26971332371042,-109.3526831
15213,6,14,12,12,12,7,63,38.26971332371042,-109.3524136
15214,2,14,14,5,5,20,60,38.26971332371042,-109.3521441
15215,0,18,16,0,3,27,64,38.26971332371042,-109.3518746
15216,0,21,16,0,4,29,70,38.26971332371042,-109.3516051
15217,0,22,18,0,4,30,74,38.26971332371042,-109.3513356
15218,0,22,19,0,5,30,76,38.26971332371042,-109.3510661
15219,0,23,19,0,4,31,77,38.26971332371042,-109.3507966
15220,0,25,19,0,4,30,78,38.26971332371042,-109.3505271
15221,1,25,20,1,5,28,80,38.26971332371042,-109.3502577
15222,1,23,20,2,6,29,81,38.26971332371042,-109.3499882
15223,1,24,20,1,6,30,82,38.26971332371042,-109.3497187
15224,2,24,19,3,6,27,81,38.26971332371042,-109.3494492
15225,2,24,18,3,6,27,80,38.26971332371042,-109.3491797
15226,1,26,20,0,6,28,81,38.26971332371042,-109.3489102
15227,2,24,20,1,5,30,82,38.26971332371042,-109.3486407
15228,2,23,20,2,5,29,81,38.26971332371042,-109.3483712
15229,2,22,20,3,4,29,80,38.26971332371042,-109.3481017
15230,2,20,19,1,2,31,75,38.26971332371042,-109.3478322
15231,2,19,19,1,3,32,76,38.26971332371042,-109.3475627
15232,1,17,19,0,3,33,73,38.26971332371042,-109.3472932
15233,3,17,20,1,2,32,75,38.26971332371042,-109.3470237
15234,3,17,20,1,2,31,74,38.26971332371042,-109.3467542
15235,2,17,18,0,1,30,68,38.26971332371042,-109.3464847
15236,1,17,15,0,2,26,61,38.26971332371042,-109.3462152
15237,1,22,14,1,4,19,61,38.26971332371042,-109.3459457
15238,1,21,15,1,3,23,64,38.26971332371042,-109.3456762
15239,1,23,18,0,4,31,77,38.26971332371042,-109.3454068
15240,1,21,21,0,6,36,85,38.26971332371042,-109.3451373
15241,1,23,20,1,8,33,86,38.26971332371042,-109.3448678
15242,3,28,18,2,8,26,85,38.26971332371042,-109.3445983
15243,7,32,15,7,10,15,86,38.26971332371042,-109.3443288
15244,9,35,14,12,11,6,87,38.26971332371042,-109.3440593
15245,10,36,14,13,10,5,88,38.26971332371042,-109.3437898
15246,8,39,14,11,13,5,90,38.26971332371042,-109.3435203
15247,7,41,14,9,13,5,89,38.26971332371042,-109.3432508
15248,9,41,14,11,11,4,90,38.26971332371042,-109.3429813
15249,15,39,13,13,9,2,91,38.26971332371042,-109.3427118
15250,18,34,11,10,8,2,83,38.26971332371042,-109.3424423
15251,15,37,13,13,9,3,90,38.26971332371042,-109.3421728
15252,13,37,13,14,9,3,89,38.26971332371042,-109.3419033
15253,12,36,13,14,9,4,88,38.26971332371042,-109.3416338
15254,11,36,13,13,10,4,87,38.26971332371042,-109.3413643
15255,7,38,13,13,13,3,87,38.26971332371042,-109.3410948
15256,7,40,14,12,13,3,89,38.26971332371042,-109.3408253
15257,8,38,14,13,12,4,89,38.26971332371042,-109.3405558
15258,10,36,13,14,10,4,87,38.26971332371042,-109.3402864
15259,15,34,13,14,9,4,89,38.26971332371042,-109.3400169
15260,21,30,12,14,8,3,88,38.26971332371042,-109.3397474
15261,23,30,12,13,8,4,90,38.26971332371042,-109.3394779
15262,23,30,12,11,8,5,89,38.26971332371042,-109.3392084
15263,21,31,11,11,9,4,87,38.26971332371042,-109.3389389
15264,14,37,12,11,9,4,87,38.26971332371042,-109.3386694
15265,12,38,13,10,11,5,89,38.26971332371042,-109.3383999
15266,13,37,13,11,11,5,90,38.26971332371042,-109.3381304
15267,6,19,11,16,21,6,79,38.26944382912519,-109.4386519
15268,2,34,10,6,10,7,69,38.26944382912519,-109.4383824
15269,4,45,10,4,11,4,78,38.26944382912519,-109.4381129
15270,1,38,10,2,13,7,71,38.26944382912519,-109.4378434
15271,1,39,10,1,12,8,71,38.26944382912519,-109.4375739
15272,2,40,9,2,12,7,72,38.26944382912519,-109.4373044
15273,3,37,9,3,10,6,68,38.26944382912519,-109.4370349
15274,5,38,9,3,9,3,67,38.26944382912519,-109.4367654
15275,3,30,10,3,7,7,60,38.26944382912519,-109.4364959
15276,4,25,12,9,10,7,67,38.26944382912519,-109.4362264
15277,12,22,13,28,4,7,86,38.26944382912519,-109.4359569
15278,9,19,11,30,10,7,86,38.26944382912519,-109.4356874
15279,7,17,13,17,11,15,80,38.26944382912519,-109.4354179
15280,0,36,13,1,17,17,84,38.26944382912519,-109.4351484
15281,0,38,13,1,15,16,83,38.26944382912519,-109.434879
15282,0,37,13,6,19,10,85,38.26944382912519,-109.4346095
15283,0,38,13,2,19,12,84,38.26944382912519,-109.43434
15284,3,40,11,0,16,10,80,38.26944382912519,-109.4340705
15285,3,40,11,0,15,11,80,38.26944382912519,-109.433801
15286,2,39,11,0,15,10,77,38.26944382912519,-109.4335315
15287,3,43,11,0,17,7,81,38.26944382912519,-109.433262
15288,4,47,12,1,20,3,87,38.26944382912519,-109.4329925
15289,4,48,11,2,19,3,87,38.26944382912519,-109.432723
15290,4,48,11,2,19,2,86,38.26944382912519,-109.4324535
15291,4,48,12,2,19,2,87,38.26944382912519,-109.432184
15292,4,48,12,3,19,2,88,38.26944382912519,-109.4319145
15293,3,44,13,4,20,4,88,38.26944382912519,-109.431645
15294,2,39,14,2,16,13,86,38.26944382912519,-109.4313755
15295,1,34,13,1,12,18,79,38.26944382912519,-109.431106
15296,1,33,12,3,12,13,74,38.26944382912519,-109.4308365
15297,2,45,10,0,14,9,80,38.26944382912519,-109.430567
15298,3,51,13,5,18,1,91,38.26944382912519,-109.4302975
15299,3,47,13,5,18,2,88,38.26944382912519,-109.430028
15300,2,43,11,1,17,6,80,38.26944382912519,-109.4297586
15301,2,42,11,0,16,8,79,38.26944382912519,-109.4294891
15302,3,43,10,1,16,6,79,38.26944382912519,-109.4292196
15303,2,38,11,1,15,8,75,38.26944382912519,-109.4289501
15304,3,39,11,3,16,6,78,38.26944382912519,-109.4286806
15305,3,41,11,4,16,4,79,38.26944382912519,-109.4284111
15306,3,41,11,2,17,6,80,38.26944382912519,-109.4281416
15307,3,43,12,2,17,6,83,38.26944382912519,-109.4278721
15308,3,44,13,5,18,3,86,38.26944382912519,-109.4276026
15309,4,45,13,7,19,2,90,38.26944382912519,-109.4273331
15310,5,45,13,6,20,2,91,38.26944382912519,-109.4270636
15311,4,43,13,4,20,4,88,38.26944382912519,-109.4267941
15312,2,39,11,0,14,12,78,38.26944382912519,-109.4265246
15313,1,35,11,0,10,15,72,38.26944382912519,-109.4262551
15314,1,32,10,0,8,14,65,38.26944382912519,-109.4259856
15315,0,35,9,1,9,10,64,38.26944382912519,-109.4257161
15316,3,38,8,3,9,5,66,38.26944382912519,-109.4254466
15317,2,35,8,4,10,5,64,38.26944382912519,-109.4251771
15318,4,31,9,5,8,8,65,38.26944382912519,-109.4249077
15319,3,28,9,5,9,8,62,38.26944382912519,-109.4246382
15320,3,28,9,4,9,9,62,38.26944382912519,-109.4243687
15321,2,36,9,3,9,6,65,38.26944382912519,-109.4240992
15322,1,33,10,1,12,10,67,38.26944382912519,-109.4238297
15323,2,35,11,1,13,10,72,38.26944382912519,-109.4235602
15324,4,40,11,2,16,5,78,38.26944382912519,-109.4232907
15325,5,45,12,6,17,2,87,38.26944382912519,-109.4230212
15326,4,42,11,3,17,5,82,38.26944382912519,-109.4227517
15327,5,42,12,7,17,1,84,38.26944382912519,-109.4224822
15328,6,41,13,12,16,0,88,38.26944382912519,-109.4222127
15329,6,40,13,13,16,0,88,38.26944382912519,-109.4219432
15330,5,39,13,13,15,1,86,38.26944382912519,-109.4216737
15331,5,39,13,13,15,1,86,38.26944382912519,-109.4214042
15332,5,41,12,11,15,1,85,38.26944382912519,-109.4211347
15333,4,42,12,10,15,1,84,38.26944382912519,-109.4208652
15334,4,43,12,10,15,1,85,38.26944382912519,-109.4205957
15335,7,46,13,10,16,0,92,38.26944382912519,-109.4203262
15336,7,46,13,9,18,0,93,38.26944382912519,-109.4200568
15337,7,45,13,9,18,0,92,38.26944382912519,-109.4197873
15338,10,40,14,12,16,0,92,38.26944382912519,-109.4195178
15339,10,38,14,13,15,0,90,38.26944382912519,-109.4192483
15340,8,43,14,10,16,0,91,38.26944382912519,-109.4189788
15341,6,47,13,7,17,1,91,38.26944382912519,-109.4187093
15342,5,49,13,6,18,1,92,38.26944382912519,-109.4184398
15343,4,48,13,6,17,2,90,38.26944382912519,-109.4181703
15344,5,47,13,8,16,1,90,38.26944382912519,-109.4179008
15345,6,46,13,9,15,1,90,38.26944382912519,-109.4176313
15346,5,47,13,8,15,2,90,38.26944382912519,-109.4173618
15347,5,48,13,9,14,1,90,38.26944382912519,-109.4170923
15348,7,45,14,13,13,1,93,38.26944382912519,-109.4168228
15349,8,43,14,13,12,1,91,38.26944382912519,-109.4165533
15350,10,41,15,13,12,1,92,38.26944382912519,-109.4162838
15351,11,39,15,13,12,1,91,38.26944382912519,-109.4160143
15352,11,37,15,13,11,1,88,38.26944382912519,-109.4157448
15353,10,37,15,13,11,1,87,38.26944382912519,-109.4154753
15354,9,38,14,12,11,2,86,38.26944382912519,-109.4152058
15355,7,43,14,10,11,2,87,38.26944382912519,-109.4149364
15356,7,45,13,9,12,3,89,38.26944382912519,-109.4146669
15357,9,45,14,10,14,1,93,38.26944382912519,-109.4143974
15358,10,43,14,12,13,1,93,38.26944382912519,-109.4141279
15359,9,44,14,10,15,1,93,38.26944382912519,-109.4138584
15360,9,46,13,8,15,1,92,38.26944382912519,-109.4135889
15361,9,48,12,6,16,1,92,38.26944382912519,-109.4133194
15362,7,50,12,6,16,1,92,38.26944382912519,-109.4130499
15363,5,51,11,5,16,3,91,38.26944382912519,-109.4127804
15364,5,54,11,7,15,1,93,38.26944382912519,-109.4125109
15365,5,52,11,7,16,0,91,38.26944382912519,-109.4122414
15366,6,51,12,7,18,0,94,38.26944382912519,-109.4119719
15367,7,49,12,8,17,0,93,38.26944382912519,-109.4117024
15368,6,52,13,6,18,0,95,38.26944382912519,-109.4114329
15369,5,52,13,5,17,1,93,38.26944382912519,-109.4111634
15370,4,53,12,4,17,2,92,38.26944382912519,-109.4108939
15371,5,52,13,5,16,2,93,38.26944382912519,-109.4106244
15372,4,51,13,5,16,3,92,38.26944382912519,-109.4103549
15373,4,51,13,5,17,2,92,38.26944382912519,-109.4100855
15374,4,51,13,5,18,1,92,38.26944382912519,-109.409816
15375,4,51,13,4,18,1,91,38.26944382912519,-109.4095465
15376,5,50,12,4,17,1,89,38.26944382912519,-109.409277
15377,5,50,13,6,18,0,92,38.26944382912519,-109.4090075
15378,5,51,13,6,18,0,93,38.26944382912519,-109.408738
15379,5,51,12,6,17,0,91,38.26944382912519,-109.4084685
15380,5,50,12,5,18,1,91,38.26944382912519,-109.408199
15381,5,49,13,6,18,1,92,38.26944382912519,-109.4079295
15382,6,48,13,6,18,0,91,38.26944382912519,-109.40766
15383,8,45,13,8,17,0,91,38.26944382912519,-109.4073905
15384,9,45,13,8,16,0,91,38.26944382912519,-109.407121
15385,8,46,13,6,16,1,90,38.26944382912519,-109.4068515
15386,5,49,13,5,14,5,91,38.26944382912519,-109.3879869
15387,3,47,12,1,15,9,87,38.26944382912519,-109.3877174
15388,2,44,11,0,14,12,83,38.26944382912519,-109.3874479
15389,2,44,11,0,14,11,82,38.26944382912519,-109.3871784
15390,2,43,11,0,14,11,81,38.26944382912519,-109.3869089
15391,3,40,12,1,12,13,81,38.26944382912519,-109.3866394
15392,1,27,13,0,5,21,67,38.26944382912519,-109.3863699
15393,1,28,13,0,6,21,69,38.26944382912519,-109.3861004
15394,2,26,13,0,6,22,69,38.26944382912519,-109.3858309
15395,2,26,13,0,6,21,68,38.26944382912519,-109.3855614
15396,4,36,12,0,12,12,76,38.26944382912519,-109.3852919
15397,5,42,12,4,18,5,86,38.26944382912519,-109.3850225
15398,5,42,12,5,19,4,87,38.26944382912519,-109.384753
15399,5,40,12,5,19,5,86,38.26944382912519,-109.3844835
15400,6,39,13,6,18,5,87,38.26944382912519,-109.384214
15401,6,40,13,4,18,6,87,38.26944382912519,-109.3839445
15402,6,41,13,4,17,7,88,38.26944382912519,-109.383675
15403,6,41,13,3,16,6,85,38.26944382912519,-109.3834055
15404,5,40,13,4,15,6,83,38.26944382912519,-109.383136
15405,5,40,13,4,14,6,82,38.26944382912519,-109.3828665
15406,4,41,12,2,14,8,81,38.26944382912519,-109.382597
15407,3,41,11,2,15,8,80,38.26944382912519,-109.3823275
15408,3,40,12,2,14,9,80,38.26944382912519,-109.382058
15409,3,39,12,2,14,9,79,38.26944382912519,-109.3817885
15410,3,41,12,2,16,7,81,38.26944382912519,-109.381519
15411,3,41,13,2,15,9,83,38.26944382912519,-109.3812495
15412,3,39,12,1,12,13,80,38.26944382912519,-109.38098
15413,2,36,12,1,10,15,76,38.26944382912519,-109.3807105
15414,2,33,12,1,8,16,72,38.26944382912519,-109.380441
15415,1,34,10,0,9,14,68,38.26944382912519,-109.3801716
15416,2,37,11,0,11,11,72,38.26944382912519,-109.3799021
15417,2,29,12,1,9,15,68,38.26944382912519,-109.3796326
15418,2,28,12,3,8,16,69,38.26944382912519,-109.3793631
15419,3,34,11,2,11,11,72,38.26944382912519,-109.3790936
15420,2,32,13,0,9,17,73,38.26944382912519,-109.3788241
15421,2,30,15,1,9,21,78,38.26944382912519,-109.3785546
15422,1,30,17,1,10,23,82,38.26944382912519,-109.3782851
15423,1,29,17,2,9,22,80,38.26944382912519,-109.3780156
15424,0,28,19,1,9,27,84,38.26944382912519,-109.3777461
15425,2,27,18,0,9,26,82,38.26944382912519,-109.3774766
15426,2,26,16,0,7,27,78,38.26944382912519,-109.3772071
15427,1,27,15,0,9,24,76,38.26944382912519,-109.3769376
15428,2,33,14,1,14,17,81,38.26944382912519,-109.3766681
15429,3,36,13,5,18,10,85,38.26944382912519,-109.3763986
15430,5,37,13,3,16,9,83,38.26944382912519,-109.3761291
15431,7,36,13,5,14,10,85,38.26944382912519,-109.3758596
15432,8,34,14,6,13,11,86,38.26944382912519,-109.3755901
15433,8,32,14,7,13,11,85,38.26944382912519,-109.3753206
15434,13,27,13,10,11,7,81,38.26944382912519,-109.3750512
15435,12,21,11,11,13,3,71,38.26944382912519,-109.3747817
15436,10,21,10,11,12,1,65,38.26944382912519,-109.3745122
15437,13,26,11,10,11,1,72,38.26944382912519,-109.3742427
15438,13,27,13,16,13,3,85,38.26944382912519,-109.3739732
15439,16,23,13,19,12,3,86,38.26944382912519,-109.3737037
15440,17,23,13,14,12,3,82,38.26944382912519,-109.3734342
15441,19,21,13,13,12,4,82,38.26944382912519,-109.3731647
15442,23,19,15,6,9,10,82,38.26944382912519,-109.3728952
15443,23,19,16,5,7,12,82,38.26944382912519,-109.3726257
15444,14,23,16,15,9,7,84,38.26944382912519,-109.3723562
15445,7,29,17,7,8,14,82,38.26944382912519,-109.3720867
15446,3,28,17,3,5,25,81,38.26944382912519,-109.3718172
15447,7,27,16,0,9,21,80,38.26944382912519,-109.3715477
15448,3,27,14,0,7,21,72,38.26944382912519,-109.3712782
15449,2,27,13,0,10,19,71,38.26944382912519,-109.3710087
15450,4,28,15,6,11,15,79,38.26944382912519,-109.3707392
15451,3,25,15,10,8,17,78,38.26944382912519,-109.3704697
15452,3,27,16,4,10,22,82,38.26944382912519,-109.3702003
15453,4,29,15,5,13,16,82,38.26944382912519,-109.3699308
15454,5,28,14,13,12,9,81,38.26944382912519,-109.3696613
15455,3,27,13,13,16,7,79,38.26944382912519,-109.3693918
15456,1,24,13,10,21,1,70,38.26944382912519,-109.3691223
15457,0,10,9,9,18,3,49,38.26944382912519,-109.3688528
15458,2,10,10,16,17,5,60,38.26944382912519,-109.3685833
15459,5,15,10,16,20,3,69,38.26944382912519,-109.3683138
15460,4,20,11,20,17,4,76,38.26944382912519,-109.3680443
15461,6,25,12,14,17,2,76,38.26944382912519,-109.3677748
15462,6,27,12,12,10,9,76,38.26944382912519,-109.3675053
15463,2,30,13,4,12,12,73,38.26944382912519,-109.3672358
15464,2,29,15,0,9,21,76,38.26944382912519,-109.3669663
15465,1,24,15,0,6,26,72,38.26944382912519,-109.3666968
15466,3,24,15,0,4,24,70,38.26944382912519,-109.3664273
15467,1,21,12,0,2,22,58,38.26944382912519,-109.3661578
15468,0,22,12,0,2,22,58,38.26944382912519,-109.3658883
15469,1,24,12,0,2,21,60,38.26944382912519,-109.3656188
15470,2,24,12,0,3,20,61,38.26944382912519,-109.3653493
15471,1,20,13,1,3,19,57,38.26944382912519,-109.3650799
15472,2,17,13,1,3,20,56,38.26944382912519,-109.3648104
15473,1,20,12,2,4,18,57,38.26944382912519,-109.3645409
15474,1,21,12,2,4,18,58,38.26944382912519,-109.3642714
15475,0,20,13,0,2,22,57,38.26944382912519,-109.3640019
15476,0,23,11,0,3,21,58,38.26944382912519,-109.3637324
15477,0,21,13,0,2,23,59,38.26944382912519,-109.3634629
15478,0,18,15,0,1,27,61,38.26944382912519,-109.3631934
15479,0,17,14,0,2,25,58,38.26944382912519,-109.3629239
15480,3,21,12,3,6,14,59,38.26944382912519,-109.3626544
15481,2,27,8,2,7,5,51,38.26944382912519,-109.3623849
15482,3,23,5,3,7,5,46,38.26944382912519,-109.3621154
15483,3,19,6,3,8,7,46,38.26944382912519,-109.3618459
15484,2,21,8,5,7,11,54,38.26944382912519,-109.3615764
15485,4,22,9,4,7,13,59,38.26944382912519,-109.3613069
15486,2,24,14,4,6,19,69,38.26944382912519,-109.3610374
15487,2,25,14,2,6,19,68,38.26944382912519,-109.3607679
15488,2,21,13,2,5,19,62,38.26944382912519,-109.3604984
15489,4,22,13,6,7,13,65,38.26944382912519,-109.360229
15490,6,23,13,7,9,13,71,38.26944382912519,-109.3599595
15491,1,21,15,1,5,26,69,38.26944382912519,-109.35969
15492,1,31,13,0,5,22,72,38.26944382912519,-109.3594205
15493,0,32,10,1,6,15,64,38.26944382912519,-109.359151
15494,0,27,11,0,7,16,61,38.26944382912519,-109.3588815
15495,0,27,11,0,7,18,63,38.26944382912519,-109.358612
15496,3,38,12,3,7,14,77,38.26944382912519,-109.3583425
15497,4,42,14,5,7,11,83,38.26944382912519,-109.358073
15498,5,38,15,10,6,12,86,38.26944382912519,-109.3578035
15499,5,37,14,9,7,12,84,38.26944382912519,-109.357534
15500,5,33,13,10,8,12,81,38.26944382912519,-109.3572645
15501,3,34,12,2,10,12,73,38.26944382912519,-109.356995
15502,0,34,11,0,12,11,68,38.26944382912519,-109.3567255
15503,3,37,12,11,5,10,78,38.26944382912519,-109.356456
15504,6,28,10,12,10,10,76,38.26944382912519,-109.3561865
15505,7,27,10,12,11,8,75,38.26944382912519,-109.355917
15506,2,24,11,5,5,10,57,38.26944382912519,-109.3556475
15507,2,31,13,2,6,20,74,38.26944382912519,-109.355378
15508,2,25,15,3,8,18,71,38.26944382912519,-109.3551086
15509,2,24,14,3,7,19,69,38.26944382912519,-109.3548391
15510,4,25,14,9,11,11,74,38.26944382912519,-109.3545696
15511,10,33,10,20,11,0,84,38.26944382912519,-109.3543001
15512,11,32,9,21,11,0,84,38.26944382912519,-109.3540306
15513,10,38,8,22,6,0,84,38.26944382912519,-109.3537611
15514,16,44,10,10,7,1,88,38.26944382912519,-109.3534916
15515,10,41,11,13,11,1,87,38.26944382912519,-109.3532221
15516,0,26,10,9,18,2,65,38.26944382912519,-109.3529526
15517,4,21,9,8,12,4,58,38.26944382912519,-109.3526831
15518,9,28,10,12,10,3,72,38.26944382912519,-109.3524136
15519,2,12,12,5,6,16,53,38.26944382912519,-109.3521441
15520,1,15,15,0,2,26,59,38.26944382912519,-109.3518746
15521,1,20,16,0,3,28,68,38.26944382912519,-109.3516051
15522,0,21,18,0,4,30,73,38.26944382912519,-109.3513356
15523,0,20,18,0,4,30,72,38.26944382912519,-109.3510661
15524,0,21,18,0,3,31,73,38.26944382912519,-109.3507966
15525,2,23,17,0,4,27,73,38.26944382912519,-109.3505271
15526,3,26,17,2,5,23,76,38.26944382912519,-109.3502577
15527,2,25,19,2,6,27,81,38.26944382912519,-109.3499882
15528,0,25,19,1,5,31,81,38.26944382912519,-109.3497187
15529,0,26,19,1,7,29,82,38.26944382912519,-109.3494492
15530,1,24,20,2,8,28,83,38.26944382912519,-109.3491797
15531,2,21,21,3,6,30,83,38.26944382912519,-109.3489102
15532,2,22,20,2,4,30,80,38.26944382912519,-109.3486407
15533,3,22,19,2,3,28,77,38.26944382912519,-109.3483712
15534,2,21,19,0,2,30,74,38.26944382912519,-109.3481017
15535,2,18,18,0,1,31,70,38.26944382912519,-109.3478322
15536,2,18,18,0,0,30,68,38.26944382912519,-109.3475627
15537,1,16,18,0,0,32,67,38.26944382912519,-109.3472932
15538,1,15,18,0,1,30,65,38.26944382912519,-109.3470237
15539,2,15,17,0,1,29,64,38.26944382912519,-109.3467542
15540,1,16,17,0,1,28,63,38.26944382912519,-109.3464847
15541,1,18,16,0,2,26,63,38.26944382912519,-109.3462152
15542,1,20,15,0,3,23,62,38.26944382912519,-109.3459457
15543,1,21,17,0,2,27,68,38.26944382912519,-109.3456762
15544,1,23,20,1,3,32,80,38.26944382912519,-109.3454068
15545,2,23,19,1,6,32,83,38.26944382912519,-109.3451373
15546,3,27,18,3,6,27,84,38.26944382912519,-109.3448678
15547,4,31,16,4,8,21,84,38.26944382912519,-109.3445983
15548,6,35,14,6,9,14,84,38.26944382912519,-109.3443288
15549,7,37,14,8,10,10,86,38.26944382912519,-109.3440593
15550,8,38,14,8,11,8,87,38.26944382912519,-109.3437898
15551,7,38,14,7,14,8,88,38.26944382912519,-109.3435203
15552,7,40,14,8,13,6,88,38.26944382912519,-109.3432508
15553,10,40,14,11,10,4,89,38.26944382912519,-109.3429813
15554,14,39,14,13,9,3,92,38.26944382912519,-109.3427118
15555,15,38,13,13,9,3,91,38.26944382912519,-109.3424423
15556,12,38,14,14,9,3,90,38.26944382912519,-109.3421728
15557,10,38,13,14,11,3,89,38.26944382912519,-109.3419033
15558,8,39,13,13,12,3,88,38.26944382912519,-109.3416338
15559,7,41,13,12,12,3,88,38.26944382912519,-109.3413643
15560,6,40,14,12,12,3,87,38.26944382912519,-109.3410948
15561,7,39,14,12,11,4,87,38.26944382912519,-109.3408253
15562,7,39,14,12,11,4,87,38.26944382912519,-109.3405558
15563,7,39,14,12,11,4,87,38.26944382912519,-109.3402864
15564,8,39,14,12,10,4,87,38.26944382912519,-109.3400169
15565,14,35,14,13,8,4,88,38.26944382912519,-109.3397474
15566,16,36,13,12,9,4,90,38.26944382912519,-109.3394779
15567,15,38,13,11,10,4,91,38.26944382912519,-109.3392084
15568,13,39,13,11,11,4,91,38.26944382912519,-109.3389389
15569,9,41,13,10,12,4,89,38.26944382912519,-109.3386694
15570,7,42,14,9,13,4,89,38.26944382912519,-109.3383999
15571,7,42,14,8,13,5,89,38.26944382912519,-109.3381304
15572,7,42,14,8,12,5,88,38.26944382912519,-109.3378609
15573,6,20,9,23,22,5,85,38.26917433453995,-109.4386519
15574,5,22,10,13,15,6,71,38.26917433453995,-109.4383824
15575,5,28,12,7,10,8,70,38.26917433453995,-109.4381129
15576,3,28,10,6,13,6,66,38.26917433453995,-109.4378434
15577,6,28,11,8,10,6,69,38.26917433453995,-109.4375739
15578,6,29,11,7,9,6,68,38.26917433453995,-109.4373044
15579,5,30,10,7,10,5,67,38.26917433453995,-109.4370349
15580,4,30,9,3,9,4,59,38.26917433453995,-109.4367654
15581,4,24,11,8,12,6,65,38.26917433453995,-109.4364959
15582,7,32,12,14,19,3,87,38.26917433453995,-109.4362264
15583,16,20,11,27,9,5,88,38.26917433453995,-109.4359569
15584,6,21,11,21,12,9,80,38.26917433453995,-109.4356874
15585,6,21,13,15,10,13,78,38.26917433453995,-109.4354179
15586,1,36,13,3,17,15,85,38.26917433453995,-109.4351484
15587,1,36,14,2,13,17,83,38.26917433453995,-109.434879
15588,2,35,13,2,16,15,83,38.26917433453995,-109.4346095
15589,2,38,13,2,18,10,83,38.26917433453995,-109.43434
15590,2,43,12,0,19,6,82,38.26917433453995,-109.4340705
15591,2,43,11,0,17,8,81,38.26917433453995,-109.433801
15592,2,41,11,0,15,10,79,38.26917433453995,-109.4335315
15593,2,41,11,0,15,9,78,38.26917433453995,-109.433262
15594,4,44,12,1,17,6,84,38.26917433453995,-109.4329925
15595,3,47,12,4,20,3,89,38.26917433453995,-109.432723
15596,3,47,12,4,20,1,87,38.26917433453995,-109.4324535
15597,4,46,12,4,21,1,88,38.26917433453995,-109.432184
15598,3,46,13,3,21,2,88,38.26917433453995,-109.4319145
15599,3,43,12,2,18,7,85,38.26917433453995,-109.431645
15600,1,40,12,0,16,12,81,38.26917433453995,-109.4313755
15601,0,38,12,0,14,14,78,38.26917433453995,-109.431106
15602,1,38,11,1,14,11,76,38.26917433453995,-109.4308365
15603,3,45,11,0,14,8,81,38.26917433453995,-109.430567
15604,4,49,12,4,20,0,89,38.26917433453995,-109.4302975
15605,4,48,12,5,20,0,89,38.26917433453995,-109.430028
15606,4,47,11,3,19,2,86,38.26917433453995,-109.4297586
15607,5,48,12,3,19,3,90,38.26917433453995,-109.4294891
15608,5,48,11,1,17,4,86,38.26917433453995,-109.4292196
15609,2,40,11,0,14,12,79,38.26917433453995,-109.4289501
15610,2,40,11,0,15,10,78,38.26917433453995,-109.4286806
15611,4,43,12,0,17,8,84,38.26917433453995,-109.4284111
15612,3,43,12,2,18,6,84,38.26917433453995,-109.4281416
15613,3,43,12,0,17,9,84,38.26917433453995,-109.4278721
15614,2,40,12,1,16,8,79,38.26917433453995,-109.4276026
15615,3,40,13,4,17,6,83,38.26917433453995,-109.4273331
15616,5,42,13,6,19,3,88,38.26917433453995,-109.4270636
15617,5,45,13,7,21,1,92,38.26917433453995,-109.4267941
15618,3,40,12,2,17,8,82,38.26917433453995,-109.4265246
15619,2,39,12,0,14,13,80,38.26917433453995,-109.4262551
15620,1,35,12,0,11,16,75,38.26917433453995,-109.4259856
15621,0,29,11,0,8,16,64,38.26917433453995,-109.4257161
15622,2,33,10,1,11,10,67,38.26917433453995,-109.4254466
15623,1,35,8,1,7,10,62,38.26917433453995,-109.4251771
15624,4,30,8,4,6,10,62,38.26917433453995,-109.4249077
15625,3,30,9,4,8,10,64,38.26917433453995,-109.4246382
15626,2,31,10,4,9,10,66,38.26917433453995,-109.4243687
15627,2,38,10,2,13,8,73,38.26917433453995,-109.4240992
15628,1,32,11,3,11,10,68,38.26917433453995,-109.4238297
15629,2,36,11,3,15,6,73,38.26917433453995,-109.4235602
15630,4,43,11,4,17,2,81,38.26917433453995,-109.4232907
15631,4,46,12,6,17,2,87,38.26917433453995,-109.4230212
15632,3,38,11,4,14,5,75,38.26917433453995,-109.4227517
15633,3,39,11,6,15,3,77,38.26917433453995,-109.4224822
15634,5,40,11,10,14,1,81,38.26917433453995,-109.4222127
15635,6,40,12,11,13,1,83,38.26917433453995,-109.4219432
15636,5,37,11,10,13,1,77,38.26917433453995,-109.4216737
15637,5,36,11,10,13,2,77,38.26917433453995,-109.4214042
15638,4,38,11,9,13,2,77,38.26917433453995,-109.4211347
15639,3,39,11,9,13,2,77,38.26917433453995,-109.4208652
15640,3,39,11,7,15,2,77,38.26917433453995,-109.4205957
15641,7,41,13,12,15,0,88,38.26917433453995,-109.4203262
15642,8,43,13,11,17,0,92,38.26917433453995,-109.4200568
15643,9,44,14,11,17,0,95,38.26917433453995,-109.4197873
15644,10,43,14,12,15,0,94,38.26917433453995,-109.4195178
15645,8,44,13,11,16,0,92,38.26917433453995,-109.4192483
15646,6,47,13,8,17,0,91,38.26917433453995,-109.4189788
15647,5,49,13,6,18,1,92,38.26917433453995,-109.4187093
15648,4,50,13,5,17,1,90,38.26917433453995,-109.4184398
15649,5,50,13,7,16,1,92,38.26917433453995,-109.4181703
15650,7,47,13,8,15,1,91,38.26917433453995,-109.4179008
15651,6,46,13,8,16,1,90,38.26917433453995,-109.4176313
15652,6,48,13,8,16,1,92,38.26917433453995,-109.4173618
15653,6,48,13,9,15,1,92,38.26917433453995,-109.4170923
15654,8,44,14,13,13,1,93,38.26917433453995,-109.4168228
15655,8,42,14,12,13,1,90,38.26917433453995,-109.4165533
15656,10,41,15,12,12,1,91,38.26917433453995,-109.4162838
15657,13,38,15,13,12,0,91,38.26917433453995,-109.4160143
15658,15,35,15,14,12,0,91,38.26917433453995,-109.4157448
15659,13,35,16,15,12,1,92,38.26917433453995,-109.4154753
15660,11,37,15,15,12,1,91,38.26917433453995,-109.4152058
15661,10,41,15,13,12,1,92,38.26917433453995,-109.4149364
15662,10,44,14,11,13,1,93,38.26917433453995,-109.4146669
15663,12,42,14,11,13,1,93,38.26917433453995,-109.4143974
15664,15,40,14,12,13,1,95,38.26917433453995,-109.4141279
15665,15,40,14,11,13,1,94,38.26917433453995,-109.4138584
15666,12,44,13,9,15,1,94,38.26917433453995,-109.4135889
15667,8,47,13,7,16,1,92,38.26917433453995,-109.4133194
15668,6,50,13,6,17,1,93,38.26917433453995,-109.4130499
15669,3,55,10,4,15,2,89,38.26917433453995,-109.4127804
15670,4,55,11,5,16,1,92,38.26917433453995,-109.4125109
15671,6,52,12,7,17,0,94,38.26917433453995,-109.4122414
15672,7,48,12,8,18,0,93,38.26917433453995,-109.4119719
15673,8,47,13,8,17,0,93,38.26917433453995,-109.4117024
15674,8,48,13,8,17,0,94,38.26917433453995,-109.4114329
15675,5,51,12,5,17,1,91,38.26917433453995,-109.4111634
15676,5,53,12,4,16,2,92,38.26917433453995,-109.4108939
15677,5,53,12,4,15,2,91,38.26917433453995,-109.4106244
15678,4,51,12,4,16,3,90,38.26917433453995,-109.4103549
15679,4,52,13,5,17,1,92,38.26917433453995,-109.4100855
15680,5,50,13,7,18,1,94,38.26917433453995,-109.409816
15681,5,49,13,8,17,1,93,38.26917433453995,-109.4095465
15682,5,50,13,8,16,1,93,38.26917433453995,-109.409277
15683,5,53,13,6,16,1,94,38.26917433453995,-109.4090075
15684,5,52,13,5,16,2,93,38.26917433453995,-109.408738
15685,5,50,13,6,17,1,92,38.26917433453995,-109.4084685
15686,5,48,13,7,18,0,91,38.26917433453995,-109.408199
15687,7,46,13,7,18,1,92,38.26917433453995,-109.4079295
15688,8,44,13,9,17,0,91,38.26917433453995,-109.40766
15689,10,43,13,9,16,0,91,38.26917433453995,-109.4073905
15690,10,45,13,8,16,0,92,38.26917433453995,-109.407121
15691,7,47,13,7,16,1,91,38.26917433453995,-109.4068515
15692,4,47,13,2,15,7,88,38.26917433453995,-109.3879869
15693,3,48,12,1,15,8,87,38.26917433453995,-109.3877174
15694,2,46,11,0,14,10,83,38.26917433453995,-109.3874479
15695,2,45,11,0,13,11,82,38.26917433453995,-109.3871784
15696,2,44,11,0,13,11,81,38.26917433453995,-109.3869089
15697,2,42,11,0,12,12,79,38.26917433453995,-109.3866394
15698,1,31,12,0,7,19,70,38.26917433453995,-109.3863699
15699,1,27,13,0,7,22,70,38.26917433453995,-109.3861004
15700,2,26,14,0,7,22,71,38.26917433453995,-109.3858309
15701,2,27,13,0,7,20,69,38.26917433453995,-109.3855614
15702,4,35,12,1,12,12,76,38.26917433453995,-109.3852919
15703,5,42,12,4,17,5,85,38.26917433453995,-109.3850225
15704,5,42,12,5,19,4,87,38.26917433453995,-109.384753
15705,5,41,12,5,19,4,86,38.26917433453995,-109.3844835
15706,5,40,12,5,18,6,86,38.26917433453995,-109.384214
15707,6,41,13,4,16,6,86,38.26917433453995,-109.3839445
15708,6,42,13,3,16,6,86,38.26917433453995,-109.383675
15709,5,42,13,4,16,5,85,38.26917433453995,-109.3834055
15710,5,43,13,4,16,5,86,38.26917433453995,-109.383136
15711,5,43,13,4,16,4,85,38.26917433453995,-109.3828665
15712,3,44,11,2,15,6,81,38.26917433453995,-109.382597
15713,2,40,11,1,14,9,77,38.26917433453995,-109.3823275
15714,2,39,11,1,14,9,76,38.26917433453995,-109.382058
15715,2,41,11,1,15,8,78,38.26917433453995,-109.3817885
15716,2,45,11,1,16,7,82,38.26917433453995,-109.381519
15717,3,40,12,2,15,9,81,38.26917433453995,-109.3812495
15718,2,39,11,1,12,13,78,38.26917433453995,-109.38098
15719,2,38,11,1,11,14,77,38.26917433453995,-109.3807105
15720,2,34,11,1,10,14,72,38.26917433453995,-109.380441
15721,2,29,11,2,8,14,66,38.26917433453995,-109.3801716
15722,2,30,12,4,12,11,71,38.26917433453995,-109.3799021
15723,2,28,13,3,9,16,71,38.26917433453995,-109.3796326
15724,1,27,14,1,6,21,70,38.26917433453995,-109.3793631
15725,2,33,13,0,8,18,74,38.26917433453995,-109.3790936
15726,2,30,13,0,9,19,73,38.26917433453995,-109.3788241
15727,2,26,14,2,9,20,73,38.26917433453995,-109.3785546
15728,2,22,15,4,6,22,71,38.26917433453995,-109.3782851
15729,2,20,16,2,4,25,69,38.26917433453995,-109.3780156
15730,3,26,16,1,7,25,78,38.26917433453995,-109.3777461
15731,4,26,16,2,6,24,78,38.26917433453995,-109.3774766
15732,3,26,17,1,7,27,81,38.26917433453995,-109.3772071
15733,3,29,15,0,10,24,81,38.26917433453995,-109.3769376
15734,3,35,14,3,16,13,84,38.26917433453995,-109.3766681
15735,4,35,13,3,15,12,82,38.26917433453995,-109.3763986
15736,6,36,13,5,15,9,84,38.26917433453995,-109.3761291
15737,7,34,13,7,14,9,84,38.26917433453995,-109.3758596
15738,7,34,14,8,14,9,86,38.26917433453995,-109.3755901
15739,7,33,14,8,14,9,85,38.26917433453995,-109.3753206
15740,10,25,12,14,12,5,78,38.26917433453995,-109.3750512
15741,9,20,10,14,14,3,70,38.26917433453995,-109.3747817
15742,11,21,12,13,13,3,73,38.26917433453995,-109.3745122
15743,11,27,13,11,12,5,79,38.26917433453995,-109.3742427
15744,8,30,14,12,13,8,85,38.26917433453995,-109.3739732
15745,15,25,14,13,12,5,84,38.26917433453995,-109.3737037
15746,16,24,14,14,11,4,83,38.26917433453995,-109.3734342
15747,15,23,13,14,11,5,81,38.26917433453995,-109.3731647
15748,17,21,13,8,8,11,78,38.26917433453995,-109.3728952
15749,12,23,12,10,6,13,76,38.26917433453995,-109.3726257
15750,11,17,13,14,7,17,79,38.26917433453995,-109.3723562
15751,7,24,19,7,7,16,80,38.26917433453995,-109.3720867
15752,4,25,17,0,9,23,78,38.26917433453995,-109.3718172
15753,2,29,16,2,9,24,82,38.26917433453995,-109.3715477
15754,7,26,13,7,7,12,72,38.26917433453995,-109.3712782
15755,13,26,11,18,11,2,81,38.26917433453995,-109.3710087
15756,8,22,12,18,11,6,77,38.26917433453995,-109.3707392
15757,9,20,15,19,13,8,84,38.26917433453995,-109.3704697
15758,4,21,15,15,13,12,80,38.26917433453995,-109.3702003
15759,2,24,14,14,24,7,85,38.26917433453995,-109.3699308
15760,4,19,13,14,19,11,80,38.26917433453995,-109.3696613
15761,3,17,14,11,10,14,69,38.26917433453995,-109.3693918
15762,1,13,11,12,19,4,60,38.26917433453995,-109.3691223
15763,8,15,10,15,17,2,67,38.26917433453995,-109.3688528
15764,4,22,11,17,18,1,73,38.26917433453995,-109.3685833
15765,2,25,11,14,17,2,71,38.26917433453995,-109.3683138
15766,0,27,10,10,15,6,68,38.26917433453995,-109.3680443
15767,6,33,12,4,9,13,77,38.26917433453995,-109.3677748
15768,4,24,16,5,4,23,76,38.26917433453995,-109.3675053
15769,0,22,16,0,3,30,71,38.26917433453995,-109.3672358
15770,0,20,15,0,3,27,65,38.26917433453995,-109.3669663
15771,1,21,13,0,3,22,60,38.26917433453995,-109.3666968
15772,2,24,12,0,4,17,59,38.26917433453995,-109.3664273
15773,1,28,10,0,6,13,58,38.26917433453995,-109.3661578
15774,1,26,10,0,5,14,56,38.26917433453995,-109.3658883
15775,2,21,11,0,4,16,54,38.26917433453995,-109.3656188
15776,3,18,12,1,5,15,54,38.26917433453995,-109.3653493
15777,2,22,11,1,5,15,56,38.26917433453995,-109.3650799
15778,2,19,12,1,4,17,55,38.26917433453995,-109.3648104
15779,1,18,12,1,3,18,53,38.26917433453995,-109.3645409
15780,1,18,13,0,3,21,56,38.26917433453995,-109.3642714
15781,0,20,14,0,2,26,62,38.26917433453995,-109.3640019
15782,0,22,13,0,3,25,63,38.26917433453995,-109.3637324
15783,0,21,13,0,3,24,61,38.26917433453995,-109.3634629
15784,0,20,13,0,2,24,59,38.26917433453995,-109.3631934
15785,0,17,13,0,2,23,55,38.26917433453995,-109.3629239
15786,1,20,11,3,6,14,55,38.26917433453995,-109.3626544
15787,3,28,8,4,7,5,55,38.26917433453995,-109.3623849
15788,4,31,6,5,8,5,59,38.26917433453995,-109.3621154
15789,4,25,8,5,7,9,58,38.26917433453995,-109.3618459
15790,3,24,13,4,7,16,67,38.26917433453995,-109.3615764
15791,3,18,18,3,4,26,72,38.26917433453995,-109.3613069
15792,2,18,18,0,2,30,70,38.26917433453995,-109.3610374
15793,2,20,15,0,2,26,65,38.26917433453995,-109.3607679
15794,1,20,13,0,3,23,60,38.26917433453995,-109.3604984
15795,2,18,13,3,5,17,58,38.26917433453995,-109.360229
15796,6,18,13,8,9,11,65,38.26917433453995,-109.3599595
15797,2,16,14,1,4,23,60,38.26917433453995,-109.35969
15798,2,33,15,0,5,23,78,38.26917433453995,-109.3594205
15799,2,37,12,2,6,17,76,38.26917433453995,-109.359151
15800,0,33,11,0,12,12,68,38.26917433453995,-109.3588815
15801,1,42,9,0,5,15,72,38.26917433453995,-109.358612
15802,4,39,10,4,8,11,76,38.26917433453995,-109.3583425
15803,3,41,10,4,8,11,77,38.26917433453995,-109.358073
15804,4,36,15,13,7,11,86,38.26917433453995,-109.3578035
15805,5,32,14,11,6,15,83,38.26917433453995,-109.357534
15806,6,24,13,10,7,17,77,38.26917433453995,-109.3572645
15807,5,25,12,9,7,17,75,38.26917433453995,-109.356995
15808,2,32,11,1,6,21,73,38.26917433453995,-109.3567255
15809,3,34,12,4,8,14,75,38.26917433453995,-109.356456
15810,3,31,12,7,8,12,73,38.26917433453995,-109.3561865
15811,3,27,14,11,9,11,75,38.26917433453995,-109.355917
15812,4,27,13,12,11,9,76,38.26917433453995,-109.3556475
15813,7,26,11,10,9,9,72,38.26917433453995,-109.355378
15814,10,26,13,15,17,7,88,38.26917433453995,-109.3551086
15815,7,24,15,16,13,8,83,38.26917433453995,-109.3548391
15816,12,27,10,20,10,4,83,38.26917433453995,-109.3545696
15817,7,28,11,19,13,4,82,38.26917433453995,-109.3543001
15818,5,30,14,11,17,6,83,38.26917433453995,-109.3540306
15819,5,35,10,19,14,1,84,38.26917433453995,-109.3537611
15820,8,22,10,21,12,5,78,38.26917433453995,-109.3534916
15821,8,19,10,22,15,5,79,38.26917433453995,-109.3532221
15822,1,14,14,9,15,6,59,38.26917433453995,-109.3529526
15823,0,12,12,14,14,4,56,38.26917433453995,-109.3526831
15824,1,19,10,15,10,6,61,38.26917433453995,-109.3524136
15825,0,19,12,5,6,19,61,38.26917433453995,-109.3521441
15826,1,20,16,0,4,27,68,38.26917433453995,-109.3518746
15827,1,23,19,1,6,29,79,38.26917433453995,-109.3516051
15828,0,19,21,2,5,31,78,38.26917433453995,-109.3513356
15829,0,20,21,1,6,31,79,38.26917433453995,-109.3510661
15830,1,22,20,0,6,32,81,38.26917433453995,-109.3507966
15831,1,23,19,0,5,30,78,38.26917433453995,-109.3505271
15832,1,26,18,0,5,27,77,38.26917433453995,-109.3502577
15833,0,25,19,1,6,30,81,38.26917433453995,-109.3499882
15834,1,23,20,2,6,32,84,38.26917433453995,-109.3497187
15835,1,21,20,2,7,31,82,38.26917433453995,-109.3494492
15836,2,19,21,3,8,29,82,38.26917433453995,-109.3491797
15837,2,18,21,4,6,30,81,38.26917433453995,-109.3489102
15838,1,20,22,3,4,31,81,38.26917433453995,-109.3486407
15839,3,23,21,3,4,28,82,38.26917433453995,-109.3483712
15840,3,22,19,1,2,28,75,38.26917433453995,-109.3481017
15841,3,19,18,0,1,29,70,38.26917433453995,-109.3478322
15842,2,18,18,0,0,30,68,38.26917433453995,-109.3475627
15843,1,15,18,0,0,29,63,38.26917433453995,-109.3472932
15844,2,14,17,0,0,27,60,38.26917433453995,-109.3470237
15845,1,15,17,1,1,25,60,38.26917433453995,-109.3467542
15846,0,15,16,0,1,26,58,38.26917433453995,-109.3464847
15847,0,17,17,0,1,28,63,38.26917433453995,-109.3462152
15848,0,17,16,0,2,26,61,38.26917433453995,-109.3459457
15849,1,20,19,0,2,30,72,38.26917433453995,-109.3456762
15850,2,24,20,2,4,31,83,38.26917433453995,-109.3454068
15851,2,26,19,2,4,29,82,38.26917433453995,-109.3451373
15852,4,33,16,3,7,20,83,38.26917433453995,-109.3448678
15853,5,36,14,4,9,15,83,38.26917433453995,-109.3445983
15854,4,37,14,5,9,14,83,38.26917433453995,-109.3443288
15855,5,36,13,5,10,14,83,38.26917433453995,-109.3440593
15856,4,34,13,5,11,13,80,38.26917433453995,-109.3437898
15857,6,37,14,7,14,9,87,38.26917433453995,-109.3435203
15858,8,40,14,9,14,6,91,38.26917433453995,-109.3432508
15859,8,42,14,10,14,3,91,38.26917433453995,-109.3429813
15860,8,42,14,11,14,3,92,38.26917433453995,-109.3427118
15861,8,42,14,9,14,4,91,38.26917433453995,-109.3424423
15862,9,40,13,11,14,3,90,38.26917433453995,-109.3421728
15863,9,39,13,11,13,3,88,38.26917433453995,-109.3419033
15864,9,39,13,11,13,4,89,38.26917433453995,-109.3416338
15865,9,39,13,11,12,4,88,38.26917433453995,-109.3413643
15866,8,40,13,12,12,4,89,38.26917433453995,-109.3410948
15867,7,40,14,11,11,4,87,38.26917433453995,-109.3408253
15868,8,40,14,12,11,4,89,38.26917433453995,-109.3405558
15869,8,40,14,12,12,3,89,38.26917433453995,-109.3402864
15870,9,40,14,10,11,4,88,38.26917433453995,-109.3400169
15871,11,39,14,11,10,5,90,38.26917433453995,-109.3397474
15872,10,39,14,10,12,4,89,38.26917433453995,-109.3394779
15873,10,40,14,10,13,3,90,38.26917433453995,-109.3392084
15874,9,42,14,10,13,3,91,38.26917433453995,-109.3389389
15875,8,42,13,10,12,3,88,38.26917433453995,-109.3386694
15876,8,41,13,9,13,5,89,38.26917433453995,-109.3383999
15877,9,40,13,9,11,6,88,38.26917433453995,-109.3381304
15878,10,40,13,9,11,6,89,38.26917433453995,-109.3378609
15879,8,41,13,8,12,5,87,38.26917433453995,-109.3375914
15880,0,11,6,16,28,8,69,38.268904839954715,-109.4389214
15881,0,13,7,14,30,10,74,38.268904839954715,-109.4386519
15882,5,17,8,10,30,8,78,38.268904839954715,-109.4383824
15883,14,19,10,7,26,2,78,38.268904839954715,-109.4381129
15884,8,30,12,12,22,3,87,38.268904839954715,-109.4378434
15885,14,27,12,17,16,1,87,38.268904839954715,-109.4375739
15886,13,23,12,20,14,2,84,38.268904839954715,-109.4373044
15887,9,23,12,16,13,5,78,38.268904839954715,-109.4370349
15888,4,19,11,11,14,5,64,38.268904839954715,-109.4367654
15889,7,28,10,18,22,3,88,38.268904839954715,-109.4364959
15890,4,17,9,12,25,10,77,38.268904839954715,-109.4362264
15891,1,20,12,17,24,12,86,38.268904839954715,-109.4359569
15892,0,29,13,7,17,13,79,38.268904839954715,-109.4356874
15893,2,36,11,5,22,6,82,38.268904839954715,-109.4354179
15894,1,37,13,3,18,11,83,38.268904839954715,-109.4351484
15895,0,36,14,1,15,16,82,38.268904839954715,-109.434879
15896,1,38,13,0,16,14,82,38.268904839954715,-109.4346095
15897,2,39,11,0,14,12,78,38.268904839954715,-109.43434
15898,3,43,12,0,17,8,83,38.268904839954715,-109.4340705
15899,4,45,11,1,19,5,85,38.268904839954715,-109.433801
15900,3,43,11,1,19,6,83,38.268904839954715,-109.4335315
15901,1,39,12,0,18,10,80,38.268904839954715,-109.433262
15902,1,37,12,0,13,14,77,38.268904839954715,-109.4329925
15903,2,38,12,0,15,12,79,38.268904839954715,-109.432723
15904,2,41,12,1,19,7,82,38.268904839954715,-109.4324535
15905,3,43,12,5,21,2,86,38.268904839954715,-109.432184
15906,3,44,13,4,20,3,87,38.268904839954715,-109.4319145
15907,2,39,13,1,16,11,82,38.268904839954715,-109.431645
15908,2,37,12,0,15,13,79,38.268904839954715,-109.4313755
15909,2,39,11,0,16,11,79,38.268904839954715,-109.431106
15910,3,42,11,1,17,7,81,38.268904839954715,-109.4308365
15911,3,46,11,0,15,8,83,38.268904839954715,-109.430567
15912,5,47,11,2,16,4,85,38.268904839954715,-109.4302975
15913,5,48,11,2,18,3,87,38.268904839954715,-109.430028
15914,5,49,11,3,19,2,89,38.268904839954715,-109.4297586
15915,5,48,11,3,19,2,88,38.268904839954715,-109.4294891
15916,3,45,11,1,17,5,82,38.268904839954715,-109.4292196
15917,3,42,11,0,14,9,79,38.268904839954715,-109.4289501
15918,3,40,11,0,14,10,78,38.268904839954715,-109.4286806
15919,3,41,11,0,16,9,80,38.268904839954715,-109.4284111
15920,3,44,11,0,17,8,83,38.268904839954715,-109.4281416
15921,3,42,11,0,15,10,81,38.268904839954715,-109.4278721
15922,2,40,11,0,14,12,79,38.268904839954715,-109.4276026
15923,1,37,12,1,15,11,77,38.268904839954715,-109.4273331
15924,2,38,13,6,18,6,83,38.268904839954715,-109.4270636
15925,4,43,13,6,20,3,89,38.268904839954715,-109.4267941
15926,2,40,13,2,17,7,81,38.268904839954715,-109.4265246
15927,1,39,13,1,16,11,81,38.268904839954715,-109.4262551
15928,1,35,13,0,13,16,78,38.268904839954715,-109.4259856
15929,0,30,13,0,10,18,71,38.268904839954715,-109.4257161
15930,1,32,12,0,10,18,73,38.268904839954715,-109.4254466
15931,0,31,11,0,9,17,68,38.268904839954715,-109.4251771
15932,0,31,11,0,10,15,67,38.268904839954715,-109.4249077
15933,1,33,11,0,13,12,70,38.268904839954715,-109.4246382
15934,1,33,11,6,16,7,74,38.268904839954715,-109.4243687
15935,2,32,12,4,14,10,74,38.268904839954715,-109.4240992
15936,2,31,12,6,12,10,73,38.268904839954715,-109.4238297
15937,2,31,12,5,13,9,72,38.268904839954715,-109.4235602
15938,2,36,10,4,14,6,72,38.268904839954715,-109.4232907
15939,4,40,11,5,15,4,79,38.268904839954715,-109.4230212
15940,3,36,10,4,11,7,71,38.268904839954715,-109.4227517
15941,3,34,10,5,12,5,69,38.268904839954715,-109.4224822
15942,4,34,10,7,13,4,72,38.268904839954715,-109.4222127
15943,5,34,10,8,13,4,74,38.268904839954715,-109.4219432
15944,5,33,10,8,14,3,73,38.268904839954715,-109.4216737
15945,4,34,11,8,13,4,74,38.268904839954715,-109.4214042
15946,3,32,10,8,12,5,70,38.268904839954715,-109.4211347
15947,3,30,11,7,12,7,70,38.268904839954715,-109.4208652
15948,4,31,11,5,13,7,71,38.268904839954715,-109.4205957
15949,6,37,11,10,15,1,80,38.268904839954715,-109.4203262
15950,7,40,12,11,15,0,85,38.268904839954715,-109.4200568
15951,7,44,13,10,16,0,90,38.268904839954715,-109.4197873
15952,7,46,13,11,16,0,93,38.268904839954715,-109.4195178
15953,6,48,13,9,17,0,93,38.268904839954715,-109.4192483
15954,5,50,13,7,17,1,93,38.268904839954715,-109.4189788
15955,5,50,13,7,17,1,93,38.268904839954715,-109.4187093
15956,5,50,13,8,16,1,93,38.268904839954715,-109.4184398
15957,5,50,13,8,14,1,91,38.268904839954715,-109.4181703
15958,7,48,13,8,16,1,93,38.268904839954715,-109.4179008
15959,8,46,13,9,16,0,92,38.268904839954715,-109.4176313
15960,9,45,14,10,16,0,94,38.268904839954715,-109.4173618
15961,10,44,14,11,14,0,93,38.268904839954715,-109.4170923
15962,12,42,14,13,13,0,94,38.268904839954715,-109.4168228
15963,13,40,14,14,12,0,93,38.268904839954715,-109.4165533
15964,12,39,15,15,12,0,93,38.268904839954715,-109.4162838
15965,13,39,15,15,12,0,94,38.268904839954715,-109.4160143
15966,14,39,16,14,12,0,95,38.268904839954715,-109.4157448
15967,14,38,16,15,13,0,96,38.268904839954715,-109.4154753
15968,12,39,15,14,13,0,93,38.268904839954715,-109.4152058
15969,12,40,15,13,13,0,93,38.268904839954715,-109.4149364
15970,12,40,15,12,13,0,92,38.268904839954715,-109.4146669
15971,12,42,14,11,13,0,92,38.268904839954715,-109.4143974
15972,13,41,13,11,14,1,93,38.268904839954715,-109.4141279
15973,13,42,14,10,14,1,94,38.268904839954715,-109.4138584
15974,9,47,13,8,16,0,93,38.268904839954715,-109.4135889
15975,5,51,12,6,18,1,93,38.268904839954715,-109.4133194
15976,4,54,12,7,17,0,94,38.268904839954715,-109.4130499
15977,3,54,11,7,14,1,90,38.268904839954715,-109.4127804
15978,5,52,12,7,17,0,93,38.268904839954715,-109.4125109
15979,7,49,13,7,17,0,93,38.268904839954715,-109.4122414
15980,8,47,13,7,17,0,92,38.268904839954715,-109.4119719
15981,9,47,13,8,17,0,94,38.268904839954715,-109.4117024
15982,9,48,12,6,16,0,91,38.268904839954715,-109.4114329
15983,8,50,12,6,16,0,92,38.268904839954715,-109.4111634
15984,6,52,13,5,17,1,94,38.268904839954715,-109.4108939
15985,5,52,13,5,17,1,93,38.268904839954715,-109.4106244
15986,6,51,13,5,17,1,93,38.268904839954715,-109.4103549
15987,5,51,13,6,17,1,93,38.268904839954715,-109.4100855
15988,6,50,13,7,16,1,93,38.268904839954715,-109.409816
15989,6,50,14,8,15,1,94,38.268904839954715,-109.4095465
15990,5,51,13,7,14,2,92,38.268904839954715,-109.409277
15991,5,53,13,6,14,2,93,38.268904839954715,-109.4090075
15992,5,52,12,5,15,2,91,38.268904839954715,-109.408738
15993,6,50,12,6,15,2,91,38.268904839954715,-109.4084685
15994,9,46,13,8,15,1,92,38.268904839954715,-109.408199
15995,12,43,13,9,15,0,92,38.268904839954715,-109.4079295
15996,13,42,14,11,15,0,95,38.268904839954715,-109.40766
15997,13,42,14,9,16,0,94,38.268904839954715,-109.4073905
15998,11,44,14,9,16,0,94,38.268904839954715,-109.407121
15999,9,46,14,9,16,0,94,38.268904839954715,-109.4068515
16000,3,44,13,0,12,12,84,38.268904839954715,-109.3879869
16001,2,48,12,1,12,10,85,38.268904839954715,-109.3877174
16002,1,44,11,0,11,13,80,38.268904839954715,-109.3874479
16003,1,42,10,0,10,14,77,38.268904839954715,-109.3871784
16004,1,39,11,0,9,14,74,38.268904839954715,-109.3869089
16005,2,35,12,0,8,17,74,38.268904839954715,-109.3866394
16006,1,30,12,0,5,21,69,38.268904839954715,-109.3863699
16007,2,29,14,0,7,22,74,38.268904839954715,-109.3861004
16008,2,27,14,0,8,21,72,38.268904839954715,-109.3858309
16009,3,29,13,0,9,17,71,38.268904839954715,-109.3855614
16010,4,37,12,1,14,11,79,38.268904839954715,-109.3852919
16011,5,41,12,3,17,5,83,38.268904839954715,-109.3850225
16012,5,42,12,5,18,3,85,38.268904839954715,-109.384753
16013,5,42,12,5,18,4,86,38.268904839954715,-109.3844835
16014,5,40,13,4,17,7,86,38.268904839954715,-109.384214
16015,6,39,13,5,16,7,86,38.268904839954715,-109.3839445
16016,6,42,13,5,16,6,88,38.268904839954715,-109.383675
16017,5,42,13,5,16,4,85,38.268904839954715,-109.3834055
16018,5,43,13,5,17,4,87,38.268904839954715,-109.383136
16019,5,44,13,4,17,4,87,38.268904839954715,-109.3828665
16020,4,41,12,2,16,6,81,38.268904839954715,-109.382597
16021,3,39,11,2,15,7,77,38.268904839954715,-109.3823275
16022,3,40,11,2,15,7,78,38.268904839954715,-109.382058
16023,2,41,11,2,15,7,78,38.268904839954715,-109.3817885
16024,2,43,12,2,15,9,83,38.268904839954715,-109.381519
16025,2,40,12,1,13,12,80,38.268904839954715,-109.3812495
16026,2,40,11,0,11,13,77,38.268904839954715,-109.38098
16027,1,39,10,0,11,13,74,38.268904839954715,-109.3807105
16028,2,35,11,1,11,12,72,38.268904839954715,-109.380441
16029,2,36,11,4,13,8,74,38.268904839954715,-109.3801716
16030,2,36,11,3,13,9,74,38.268904839954715,-109.3799021
16031,2,35,11,1,10,14,73,38.268904839954715,-109.3796326
16032,2,32,12,1,8,17,72,38.268904839954715,-109.3793631
16033,2,27,14,0,5,22,70,38.268904839954715,-109.3790936
16034,0,25,13,0,7,23,68,38.268904839954715,-109.3788241
16035,2,24,14,0,5,24,69,38.268904839954715,-109.3785546
16036,2,19,15,2,2,28,68,38.268904839954715,-109.3782851
16037,1,17,15,2,2,30,67,38.268904839954715,-109.3780156
16038,2,22,15,1,3,28,71,38.268904839954715,-109.3777461
16039,1,22,14,0,4,27,68,38.268904839954715,-109.3774766
16040,1,27,15,0,8,24,75,38.268904839954715,-109.3772071
16041,2,33,14,1,14,17,81,38.268904839954715,-109.3769376
16042,4,36,13,5,17,9,84,38.268904839954715,-109.3766681
16043,8,34,13,9,17,4,85,38.268904839954715,-109.3763986
16044,11,34,13,8,14,5,85,38.268904839954715,-109.3761291
16045,13,33,13,10,14,4,87,38.268904839954715,-109.3758596
16046,12,30,13,14,14,2,85,38.268904839954715,-109.3755901
16047,13,29,13,14,13,2,84,38.268904839954715,-109.3753206
16048,12,23,11,14,13,2,75,38.268904839954715,-109.3750512
16049,9,21,11,13,14,2,70,38.268904839954715,-109.3747817
16050,9,25,12,9,12,5,72,38.268904839954715,-109.3745122
16051,8,32,14,5,12,11,82,38.268904839954715,-109.3742427
16052,7,27,15,7,11,16,83,38.268904839954715,-109.3739732
16053,12,25,15,12,9,12,85,38.268904839954715,-109.3737037
16054,16,24,14,11,9,8,82,38.268904839954715,-109.3734342
16055,14,23,13,11,9,7,77,38.268904839954715,-109.3731647
16056,8,23,11,9,12,7,70,38.268904839954715,-109.3728952
16057,6,30,12,6,7,16,77,38.268904839954715,-109.3726257
16058,8,21,17,3,6,19,74,38.268904839954715,-109.3723562
16059,5,22,16,0,8,25,76,38.268904839954715,-109.3720867
16060,6,17,14,7,4,23,71,38.268904839954715,-109.3718172
16061,5,20,12,12,7,15,71,38.268904839954715,-109.3715477
16062,14,26,11,13,10,3,77,38.268904839954715,-109.3712782
16063,6,22,12,13,7,13,73,38.268904839954715,-109.3710087
16064,4,20,13,15,7,12,71,38.268904839954715,-109.3707392
16065,5,20,13,22,17,4,81,38.268904839954715,-109.3704697
16066,1,20,14,16,21,10,82,38.268904839954715,-109.3702003
16067,3,17,13,18,21,11,83,38.268904839954715,-109.3699308
16068,3,12,12,12,12,16,67,38.268904839954715,-109.3696613
16069,4,11,12,12,17,9,65,38.268904839954715,-109.3693918
16070,1,14,11,25,14,5,70,38.268904839954715,-109.3691223
16071,2,18,10,16,17,4,67,38.268904839954715,-109.3688528
16072,2,26,10,12,18,2,70,38.268904839954715,-109.3685833
16073,1,26,10,13,15,3,68,38.268904839954715,-109.3683138
16074,1,28,10,5,12,11,67,38.268904839954715,-109.3680443
16075,2,28,15,1,5,26,77,38.268904839954715,-109.3677748
16076,0,22,17,0,1,33,73,38.268904839954715,-109.3675053
16077,0,20,15,0,1,28,64,38.268904839954715,-109.3672358
16078,1,20,13,0,2,22,58,38.268904839954715,-109.3669663
16079,1,22,12,0,5,16,56,38.268904839954715,-109.3666968
16080,2,24,11,1,7,12,57,38.268904839954715,-109.3664273
16081,2,28,11,1,7,11,60,38.268904839954715,-109.3661578
16082,2,21,12,2,5,15,57,38.268904839954715,-109.3658883
16083,3,16,12,2,4,15,52,38.268904839954715,-109.3656188
16084,4,16,11,4,5,13,53,38.268904839954715,-109.3653493
16085,2,19,11,4,5,14,55,38.268904839954715,-109.3650799
16086,2,16,14,0,3,21,56,38.268904839954715,-109.3648104
16087,0,18,15,0,3,27,63,38.268904839954715,-109.3645409
16088,0,20,16,0,3,30,69,38.268904839954715,-109.3642714
16089,0,21,16,0,2,30,69,38.268904839954715,-109.3640019
16090,0,22,16,0,2,30,70,38.268904839954715,-109.3637324
16091,0,21,15,0,2,26,64,38.268904839954715,-109.3634629
16092,0,20,14,0,2,25,61,38.268904839954715,-109.3631934
16093,0,18,14,0,1,24,57,38.268904839954715,-109.3629239
16094,0,20,11,2,3,17,53,38.268904839954715,-109.3626544
16095,1,24,8,4,6,6,49,38.268904839954715,-109.3623849
16096,4,30,6,6,8,4,58,38.268904839954715,-109.3621154
16097,8,23,9,7,6,8,61,38.268904839954715,-109.3618459
16098,2,15,17,3,3,24,64,38.268904839954715,-109.3615764
16099,2,16,18,0,2,29,67,38.268904839954715,-109.3613069
16100,2,17,16,0,2,27,64,38.268904839954715,-109.3610374
16101,2,21,14,0,3,24,64,38.268904839954715,-109.3607679
16102,1,21,13,1,3,22,61,38.268904839954715,-109.3604984
16103,1,21,13,3,5,17,60,38.268904839954715,-109.360229
16104,11,14,13,7,7,10,62,38.268904839954715,-109.3599595
16105,4,14,12,4,5,17,56,38.268904839954715,-109.35969
16106,4,25,15,5,3,18,70,38.268904839954715,-109.3594205
16107,4,28,15,6,4,17,74,38.268904839954715,-109.359151
16108,4,36,13,2,6,18,79,38.268904839954715,-109.3588815
16109,3,35,13,0,5,19,75,38.268904839954715,-109.358612
16110,0,31,13,0,8,19,71,38.268904839954715,-109.3583425
16111,3,28,14,5,7,17,74,38.268904839954715,-109.358073
16112,2,32,14,8,3,19,78,38.268904839954715,-109.3578035
16113,1,29,13,0,9,20,72,38.268904839954715,-109.357534
16114,3,28,14,8,6,18,77,38.268904839954715,-109.3572645
16115,6,32,14,5,13,14,84,38.268904839954715,-109.356995
16116,12,27,16,6,15,14,90,38.268904839954715,-109.3567255
16117,7,23,16,15,10,12,83,38.268904839954715,-109.356456
16118,10,29,14,12,13,7,85,38.268904839954715,-109.3561865
16119,7,29,14,14,13,6,83,38.268904839954715,-109.355917
16120,8,23,17,13,15,14,90,38.268904839954715,-109.3556475
16121,10,25,12,17,12,6,82,38.268904839954715,-109.355378
16122,8,23,10,23,11,5,80,38.268904839954715,-109.3551086
16123,7,28,12,25,13,6,91,38.268904839954715,-109.3548391
16124,6,20,11,23,17,9,86,38.268904839954715,-109.3545696
16125,6,16,11,22,16,11,82,38.268904839954715,-109.3543001
16126,6,12,12,20,17,14,81,38.268904839954715,-109.3540306
16127,6,11,12,19,14,14,76,38.268904839954715,-109.3537611
16128,2,9,12,11,11,13,58,38.268904839954715,-109.3534916
16129,0,1,7,0,1,18,27,38.268904839954715,-109.3532221
16130,0,3,9,3,2,17,34,38.268904839954715,-109.3529526
16131,3,10,15,12,8,22,70,38.268904839954715,-109.3526831
16132,5,20,15,11,6,21,78,38.268904839954715,-109.3524136
16133,0,21,18,1,5,29,74,38.268904839954715,-109.3521441
16134,0,24,20,0,6,31,81,38.268904839954715,-109.3518746
16135,0,23,21,1,7,32,84,38.268904839954715,-109.3516051
16136,0,22,21,0,5,31,79,38.268904839954715,-109.3513356
16137,0,21,19,0,5,30,75,38.268904839954715,-109.3510661
16138,1,23,20,2,6,29,81,38.268904839954715,-109.3507966
16139,1,23,20,1,7,29,81,38.268904839954715,-109.3505271
16140,0,23,20,1,7,30,81,38.268904839954715,-109.3502577
16141,1,20,20,4,6,31,82,38.268904839954715,-109.3499882
16142,1,18,21,3,4,34,81,38.268904839954715,-109.3497187
16143,1,17,21,3,5,33,80,38.268904839954715,-109.3494492
16144,1,18,20,4,8,30,81,38.268904839954715,-109.3491797
16145,2,19,20,5,8,27,81,38.268904839954715,-109.3489102
16146,2,21,21,4,7,29,84,38.268904839954715,-109.3486407
16147,2,21,21,3,4,30,81,38.268904839954715,-109.3483712
16148,3,23,20,2,4,28,80,38.268904839954715,-109.3481017
16149,3,21,18,1,2,27,72,38.268904839954715,-109.3478322
16150,0,16,17,0,1,29,63,38.268904839954715,-109.3475627
16151,1,16,16,0,1,26,60,38.268904839954715,-109.3472932
16152,1,16,16,0,1,26,60,38.268904839954715,-109.3470237
16153,1,16,15,0,1,24,57,38.268904839954715,-109.3467542
16154,1,17,16,0,1,24,59,38.268904839954715,-109.3464847
16155,1,17,18,0,1,27,64,38.268904839954715,-109.3462152
16156,1,18,17,0,2,26,64,38.268904839954715,-109.3459457
16157,1,21,19,0,2,29,72,38.268904839954715,-109.3456762
16158,2,24,19,1,4,29,79,38.268904839954715,-109.3454068
16159,3,25,19,4,4,26,81,38.268904839954715,-109.3451373
16160,5,34,15,5,9,15,83,38.268904839954715,-109.3448678
16161,5,37,13,5,11,11,82,38.268904839954715,-109.3445983
16162,5,36,13,6,11,11,82,38.268904839954715,-109.3443288
16163,5,36,13,7,12,10,83,38.268904839954715,-109.3440593
16164,6,38,13,7,13,8,85,38.268904839954715,-109.3437898
16165,8,41,14,11,14,4,92,38.268904839954715,-109.3435203
16166,7,42,14,11,14,3,91,38.268904839954715,-109.3432508
16167,7,43,14,9,14,4,91,38.268904839954715,-109.3429813
16168,7,43,13,7,14,5,89,38.268904839954715,-109.3427118
16169,8,42,13,8,14,5,90,38.268904839954715,-109.3424423
16170,11,37,13,11,12,4,88,38.268904839954715,-109.3421728
16171,14,36,13,12,10,5,90,38.268904839954715,-109.3419033
16172,16,35,13,12,8,4,88,38.268904839954715,-109.3416338
16173,15,35,13,13,9,4,89,38.268904839954715,-109.3413643
16174,13,37,14,13,10,3,90,38.268904839954715,-109.3410948
16175,12,38,14,12,11,4,91,38.268904839954715,-109.3408253
16176,10,39,14,12,11,4,90,38.268904839954715,-109.3405558
16177,9,40,14,12,12,4,91,38.268904839954715,-109.3402864
16178,8,41,14,11,12,4,90,38.268904839954715,-109.3400169
16179,7,42,14,9,13,4,89,38.268904839954715,-109.3397474
16180,7,42,14,8,14,4,89,38.268904839954715,-109.3394779
16181,6,43,14,9,14,4,90,38.268904839954715,-109.3392084
16182,6,43,14,10,14,4,91,38.268904839954715,-109.3389389
16183,7,42,14,9,13,4,89,38.268904839954715,-109.3386694
16184,8,40,13,10,13,4,88,38.268904839954715,-109.3383999
16185,7,41,13,9,14,4,88,38.268904839954715,-109.3381304
16186,7,41,13,8,14,4,87,38.268904839954715,-109.3378609
16187,7,42,13,9,14,3,88,38.268904839954715,-109.3375914
16188,7,16,11,29,15,9,87,38.268635345369475,-109.4391909
16189,4,23,11,26,20,3,87,38.268635345369475,-109.4389214
16190,4,22,11,23,23,3,86,38.268635345369475,-109.4386519
16191,1,14,7,15,29,3,69,38.268635345369475,-109.4383824
16192,0,4,4,10,27,7,52,38.268635345369475,-109.4381129
16193,0,2,3,13,25,9,52,38.268635345369475,-109.4378434
16194,0,6,4,12,29,10,61,38.268635345369475,-109.4375739
16195,0,14,8,17,32,12,83,38.268635345369475,-109.4373044
16196,4,20,12,12,35,10,93,38.268635345369475,-109.4370349
16197,6,20,11,12,34,10,93,38.268635345369475,-109.4367654
16198,0,4,3,0,23,10,40,38.268635345369475,-109.4364959
16199,0,9,7,7,27,13,63,38.268635345369475,-109.4362264
16200,1,20,12,18,23,10,84,38.268635345369475,-109.4359569
16201,3,28,12,12,15,7,77,38.268635345369475,-109.4356874
16202,2,35,12,7,17,8,81,38.268635345369475,-109.4354179
16203,1,37,13,1,19,12,83,38.268635345369475,-109.4351484
16204,1,39,12,0,16,12,80,38.268635345369475,-109.434879
16205,2,42,11,0,17,9,81,38.268635345369475,-109.4346095
16206,3,42,12,3,19,6,85,38.268635345369475,-109.43434
16207,1,39,12,0,17,11,80,38.268635345369475,-109.4340705
16208,1,39,12,0,17,11,80,38.268635345369475,-109.433801
16209,2,39,12,0,18,10,81,38.268635345369475,-109.4335315
16210,1,39,12,0,18,10,80,38.268635345369475,-109.433262
16211,1,38,12,0,14,13,78,38.268635345369475,-109.4329925
16212,1,34,12,0,13,16,76,38.268635345369475,-109.432723
16213,1,38,12,0,17,11,79,38.268635345369475,-109.4324535
16214,2,41,12,1,19,7,82,38.268635345369475,-109.432184
16215,2,40,12,1,19,8,82,38.268635345369475,-109.4319145
16216,1,36,12,0,14,14,77,38.268635345369475,-109.431645
16217,2,38,12,0,13,14,79,38.268635345369475,-109.4313755
16218,3,42,12,0,15,10,82,38.268635345369475,-109.431106
16219,3,44,12,0,18,6,83,38.268635345369475,-109.4308365
16220,3,43,11,0,17,8,82,38.268635345369475,-109.430567
16221,2,38,11,1,16,8,76,38.268635345369475,-109.4302975
16222,4,41,11,1,16,7,80,38.268635345369475,-109.430028
16223,5,45,11,1,17,4,83,38.268635345369475,-109.4297586
16224,4,45,11,3,19,2,84,38.268635345369475,-109.4294891
16225,3,43,11,3,19,3,82,38.268635345369475,-109.4292196
16226,4,43,11,0,16,5,79,38.268635345369475,-109.4289501
16227,3,40,11,0,16,7,77,38.268635345369475,-109.4286806
16228,2,39,11,0,14,10,76,38.268635345369475,-109.4284111
16229,1,37,11,0,14,10,73,38.268635345369475,-109.4281416
16230,2,38,10,2,17,6,75,38.268635345369475,-109.4278721
16231,1,37,11,0,14,12,75,38.268635345369475,-109.4276026
16232,1,36,12,0,14,13,76,38.268635345369475,-109.4273331
16233,1,35,13,1,14,13,77,38.268635345369475,-109.4270636
16234,1,34,13,0,13,15,76,38.268635345369475,-109.4267941
16235,1,35,13,0,14,13,76,38.268635345369475,-109.4265246
16236,1,33,13,2,14,13,76,38.268635345369475,-109.4262551
16237,0,33,13,2,14,13,75,38.268635345369475,-109.4259856
16238,0,34,13,1,14,14,76,38.268635345369475,-109.4257161
16239,1,37,14,0,13,17,82,38.268635345369475,-109.4254466
16240,1,36,14,0,12,18,81,38.268635345369475,-109.4251771
16241,0,33,12,0,11,17,73,38.268635345369475,-109.4249077
16242,1,34,11,0,13,15,74,38.268635345369475,-109.4246382
16243,3,37,11,3,16,7,77,38.268635345369475,-109.4243687
16244,2,33,11,6,16,6,74,38.268635345369475,-109.4240992
16245,2,34,11,5,16,8,76,38.268635345369475,-109.4238297
16246,1,32,12,2,13,12,72,38.268635345369475,-109.4235602
16247,1,29,11,2,11,13,67,38.268635345369475,-109.4232907
16248,2,31,11,3,12,9,68,38.268635345369475,-109.4230212
16249,3,33,10,4,12,8,70,38.268635345369475,-109.4227517
16250,3,31,10,4,11,8,67,38.268635345369475,-109.4224822
16251,3,28,10,5,11,10,67,38.268635345369475,-109.4222127
16252,2,27,12,5,11,11,68,38.268635345369475,-109.4219432
16253,2,28,11,5,12,11,69,38.268635345369475,-109.4216737
16254,3,30,11,7,14,8,73,38.268635345369475,-109.4214042
16255,3,29,12,7,13,10,74,38.268635345369475,-109.4211347
16256,2,29,12,5,12,12,72,38.268635345369475,-109.4208652
16257,2,27,12,6,12,10,69,38.268635345369475,-109.4205957
16258,4,31,11,8,14,5,73,38.268635345369475,-109.4203262
16259,5,36,10,9,14,2,76,38.268635345369475,-109.4200568
16260,5,39,12,11,14,1,82,38.268635345369475,-109.4197873
16261,6,42,12,13,14,1,88,38.268635345369475,-109.4195178
16262,7,46,13,12,15,0,93,38.268635345369475,-109.4192483
16263,5,50,13,8,17,0,93,38.268635345369475,-109.4189788
16264,5,51,13,8,16,0,93,38.268635345369475,-109.4187093
16265,6,50,13,9,16,1,95,38.268635345369475,-109.4184398
16266,5,51,13,7,16,1,93,38.268635345369475,-109.4181703
16267,7,48,13,9,16,0,93,38.268635345369475,-109.4179008
16268,10,44,13,10,15,0,92,38.268635345369475,-109.4176313
16269,10,45,13,10,15,0,93,38.268635345369475,-109.4173618
16270,9,46,13,10,15,0,93,38.268635345369475,-109.4170923
16271,9,44,14,12,14,0,93,38.268635345369475,-109.4168228
16272,9,42,14,14,13,1,93,38.268635345369475,-109.4165533
16273,10,41,15,16,12,1,95,38.268635345369475,-109.4162838
16274,11,40,15,16,11,1,94,38.268635345369475,-109.4160143
16275,11,40,15,16,11,0,93,38.268635345369475,-109.4157448
16276,11,39,14,15,12,1,92,38.268635345369475,-109.4154753
16277,15,37,15,13,12,0,92,38.268635345369475,-109.4152058
16278,15,37,14,13,12,0,91,38.268635345369475,-109.4149364
16279,12,41,14,11,13,0,91,38.268635345369475,-109.4146669
16280,11,44,13,9,15,0,92,38.268635345369475,-109.4143974
16281,8,49,12,8,16,0,93,38.268635345369475,-109.4141279
16282,9,48,12,8,14,0,91,38.268635345369475,-109.4138584
16283,6,52,12,7,15,0,92,38.268635345369475,-109.4135889
16284,5,54,11,6,16,0,92,38.268635345369475,-109.4133194
16285,5,55,11,7,15,0,93,38.268635345369475,-109.4130499
16286,4,55,11,6,16,0,92,38.268635345369475,-109.4127804
16287,5,51,13,7,17,0,93,38.268635345369475,-109.4125109
16288,7,48,13,8,17,0,93,38.268635345369475,-109.4122414
16289,9,47,13,7,17,0,93,38.268635345369475,-109.4119719
16290,9,45,12,7,17,0,90,38.268635345369475,-109.4117024
16291,8,47,12,6,16,0,89,38.268635345369475,-109.4114329
16292,6,50,12,5,16,1,90,38.268635345369475,-109.4111634
16293,5,52,12,5,17,1,92,38.268635345369475,-109.4108939
16294,4,52,12,4,17,1,90,38.268635345369475,-109.4106244
16295,6,51,13,6,17,0,93,38.268635345369475,-109.4103549
16296,6,50,14,8,17,0,95,38.268635345369475,-109.4100855
16297,5,51,13,8,16,1,94,38.268635345369475,-109.409816
16298,5,53,13,6,15,2,94,38.268635345369475,-109.4095465
16299,5,53,12,5,15,2,92,38.268635345369475,-109.409277
16300,5,53,13,5,15,2,93,38.268635345369475,-109.4090075
16301,5,51,12,5,17,1,91,38.268635345369475,-109.408738
16302,7,48,13,7,16,1,92,38.268635345369475,-109.4084685
16303,12,43,13,10,15,0,93,38.268635345369475,-109.408199
16304,14,40,14,10,15,0,93,38.268635345369475,-109.4079295
16305,15,40,15,11,14,0,95,38.268635345369475,-109.40766
16306,15,41,15,11,14,0,96,38.268635345369475,-109.4073905
16307,14,41,14,10,15,0,94,38.268635345369475,-109.407121
16308,11,43,14,9,16,0,93,38.268635345369475,-109.4068515
16309,2,34,13,2,7,17,75,38.268635345369475,-109.3879869
16310,2,44,11,0,12,11,80,38.268635345369475,-109.3877174
16311,1,38,10,0,8,15,72,38.268635345369475,-109.3874479
16312,1,33,11,0,6,17,68,38.268635345369475,-109.3871784
16313,2,30,12,0,6,18,68,38.268635345369475,-109.3869089
16314,2,34,13,0,8,20,77,38.268635345369475,-109.3866394
16315,2,30,12,0,7,19,70,38.268635345369475,-109.3863699
16316,4,30,13,0,9,18,74,38.268635345369475,-109.3861004
16317,5,30,13,0,8,17,73,38.268635345369475,-109.3858309
16318,4,32,12,1,8,15,72,38.268635345369475,-109.3855614
16319,3,38,12,0,13,12,78,38.268635345369475,-109.3852919
16320,4,43,12,1,17,6,83,38.268635345369475,-109.3850225
16321,5,43,12,3,18,4,85,38.268635345369475,-109.384753
16322,5,41,12,5,17,5,85,38.268635345369475,-109.3844835
16323,6,38,13,5,16,7,85,38.268635345369475,-109.384214
16324,6,39,13,5,15,6,84,38.268635345369475,-109.3839445
16325,6,41,13,6,15,4,85,38.268635345369475,-109.383675
16326,5,42,13,5,16,4,85,38.268635345369475,-109.3834055
16327,4,43,13,5,17,4,86,38.268635345369475,-109.383136
16328,5,43,13,5,17,4,87,38.268635345369475,-109.3828665
16329,5,38,12,5,16,4,80,38.268635345369475,-109.382597
16330,6,36,12,6,16,4,80,38.268635345369475,-109.3823275
16331,4,38,11,4,15,5,77,38.268635345369475,-109.382058
16332,3,38,11,4,14,7,77,38.268635345369475,-109.3817885
16333,3,38,11,3,14,9,78,38.268635345369475,-109.381519
16334,2,38,12,1,11,14,78,38.268635345369475,-109.3812495
16335,1,39,10,0,10,14,74,38.268635345369475,-109.38098
16336,1,38,10,0,10,13,72,38.268635345369475,-109.3807105
16337,1,36,10,1,12,11,71,38.268635345369475,-109.380441
16338,2,34,11,4,14,8,73,38.268635345369475,-109.3801716
16339,2,38,11,3,13,9,76,38.268635345369475,-109.3799021
16340,2,39,12,2,13,11,79,38.268635345369475,-109.3796326
16341,2,33,12,1,11,15,74,38.268635345369475,-109.3793631
16342,3,30,14,0,8,19,74,38.268635345369475,-109.3790936
16343,3,30,15,0,8,24,80,38.268635345369475,-109.3788241
16344,2,26,15,0,5,25,73,38.268635345369475,-109.3785546
16345,2,24,14,0,3,25,68,38.268635345369475,-109.3782851
16346,3,23,13,2,2,24,67,38.268635345369475,-109.3780156
16347,4,22,12,3,5,17,63,38.268635345369475,-109.3777461
16348,3,27,12,1,8,16,67,38.268635345369475,-109.3774766
16349,3,32,14,4,16,11,80,38.268635345369475,-109.3772071
16350,4,35,13,5,18,9,84,38.268635345369475,-109.3769376
16351,6,36,13,7,17,6,85,38.268635345369475,-109.3766681
16352,8,34,13,12,16,3,86,38.268635345369475,-109.3763986
16353,8,32,13,12,16,4,85,38.268635345369475,-109.3761291
16354,9,31,13,12,16,5,86,38.268635345369475,-109.3758596
16355,10,30,13,13,15,4,85,38.268635345369475,-109.3755901
16356,12,26,12,15,13,3,81,38.268635345369475,-109.3753206
16357,10,18,10,16,14,1,69,38.268635345369475,-109.3750512
16358,10,22,12,13,13,4,74,38.268635345369475,-109.3747817
16359,7,27,13,9,11,8,75,38.268635345369475,-109.3745122
16360,7,30,15,4,7,17,80,38.268635345369475,-109.3742427
16361,10,24,16,2,3,21,76,38.268635345369475,-109.3739732
16362,9,24,13,6,7,13,72,38.268635345369475,-109.3737037
16363,8,22,13,6,7,12,68,38.268635345369475,-109.3734342
16364,7,22,12,5,8,13,67,38.268635345369475,-109.3731647
16365,5,24,12,5,9,12,67,38.268635345369475,-109.3728952
16366,6,29,13,5,6,17,76,38.268635345369475,-109.3726257
16367,4,25,15,1,8,20,73,38.268635345369475,-109.3723562
16368,2,26,16,0,8,26,78,38.268635345369475,-109.3720867
16369,2,28,16,2,8,26,82,38.268635345369475,-109.3718172
16370,3,26,16,4,9,21,79,38.268635345369475,-109.3715477
16371,7,27,13,10,15,3,75,38.268635345369475,-109.3712782
16372,3,31,12,12,18,4,80,38.268635345369475,-109.3710087
16373,4,23,13,17,16,8,81,38.268635345369475,-109.3707392
16374,5,16,12,22,17,6,78,38.268635345369475,-109.3704697
16375,4,9,9,21,16,10,69,38.268635345369475,-109.3702003
16376,4,12,10,16,18,5,65,38.268635345369475,-109.3699308
16377,6,14,12,20,18,7,77,38.268635345369475,-109.3696613
16378,7,19,11,12,19,5,73,38.268635345369475,-109.3693918
16379,9,18,10,11,16,7,71,38.268635345369475,-109.3691223
16380,5,26,11,13,19,1,75,38.268635345369475,-109.3688528
16381,1,19,10,14,16,3,63,38.268635345369475,-109.3685833
16382,2,27,11,7,10,11,68,38.268635345369475,-109.3683138
16383,1,28,12,1,8,20,70,38.268635345369475,-109.3680443
16384,1,23,15,0,3,27,69,38.268635345369475,-109.3677748
16385,1,21,15,0,1,26,64,38.268635345369475,-109.3675053
16386,2,21,13,0,4,18,58,38.268635345369475,-109.3672358
16387,2,21,11,3,5,14,56,38.268635345369475,-109.3669663
16388,2,23,10,3,6,12,56,38.268635345369475,-109.3666968
16389,4,25,9,2,5,10,55,38.268635345369475,-109.3664273
16390,4,22,9,3,4,11,53,38.268635345369475,-109.3661578
16391,5,19,8,3,4,11,50,38.268635345369475,-109.3658883
16392,5,20,7,5,4,9,50,38.268635345369475,-109.3656188
16393,7,19,8,5,5,7,51,38.268635345369475,-109.3653493
16394,9,12,10,8,11,5,55,38.268635345369475,-109.3650799
16395,2,12,13,2,3,22,54,38.268635345369475,-109.3648104
16396,0,19,17,0,3,29,68,38.268635345369475,-109.3645409
16397,0,21,18,0,3,32,74,38.268635345369475,-109.3642714
16398,0,21,17,0,2,33,73,38.268635345369475,-109.3640019
16399,0,22,16,0,1,30,69,38.268635345369475,-109.3637324
16400,0,19,16,0,1,29,65,38.268635345369475,-109.3634629
16401,0,19,15,0,1,28,63,38.268635345369475,-109.3631934
16402,0,18,14,0,1,24,57,38.268635345369475,-109.3629239
16403,1,20,11,2,3,17,54,38.268635345369475,-109.3626544
16404,8,36,7,5,4,5,65,38.268635345369475,-109.3623849
16405,4,25,7,4,6,9,55,38.268635345369475,-109.3621154
16406,5,20,8,3,5,12,53,38.268635345369475,-109.3618459
16407,4,21,7,3,6,13,54,38.268635345369475,-109.3615764
16408,2,18,13,3,4,19,59,38.268635345369475,-109.3613069
16409,2,19,13,2,3,22,61,38.268635345369475,-109.3610374
16410,2,24,14,1,4,21,66,38.268635345369475,-109.3607679
16411,1,26,13,1,4,18,63,38.268635345369475,-109.3604984
16412,2,24,12,5,6,11,60,38.268635345369475,-109.360229
16413,6,25,13,7,9,9,69,38.268635345369475,-109.3599595
16414,4,19,13,5,7,13,61,38.268635345369475,-109.35969
16415,4,31,13,6,6,11,71,38.268635345369475,-109.3594205
16416,2,35,10,5,6,9,67,38.268635345369475,-109.359151
16417,3,41,12,3,5,13,77,38.268635345369475,-109.3588815
16418,0,26,13,0,5,21,65,38.268635345369475,-109.358612
16419,1,29,14,0,9,22,75,38.268635345369475,-109.3583425
16420,1,31,14,5,3,22,76,38.268635345369475,-109.358073
16421,4,26,13,9,4,21,77,38.268635345369475,-109.3578035
16422,5,31,13,10,5,16,80,38.268635345369475,-109.357534
16423,5,25,14,11,7,17,79,38.268635345369475,-109.3572645
16424,3,25,18,7,13,21,87,38.268635345369475,-109.356995
16425,5,25,16,14,11,11,82,38.268635345369475,-109.3567255
16426,17,21,14,15,16,5,88,38.268635345369475,-109.356456
16427,12,28,13,14,17,5,89,38.268635345369475,-109.3561865
16428,8,30,13,15,18,8,92,38.268635345369475,-109.355917
16429,4,28,14,14,19,10,89,38.268635345369475,-109.3556475
16430,7,21,11,24,11,9,83,38.268635345369475,-109.355378
16431,5,21,12,22,15,11,86,38.268635345369475,-109.3551086
16432,5,25,14,13,29,4,90,38.268635345369475,-109.3548391
16433,6,22,13,15,30,4,90,38.268635345369475,-109.3545696
16434,10,15,11,19,18,8,81,38.268635345369475,-109.3543001
16435,7,10,11,19,13,14,74,38.268635345369475,-109.3540306
16436,2,3,9,7,5,22,48,38.268635345369475,-109.3537611
16437,0,0,6,0,0,26,32,38.268635345369475,-109.3534916
16438,1,6,10,3,4,18,42,38.268635345369475,-109.3532221
16439,0,14,17,3,14,21,69,38.268635345369475,-109.3529526
16440,0,18,16,4,5,24,67,38.268635345369475,-109.3526831
16441,0,23,19,0,5,27,74,38.268635345369475,-109.3524136
16442,0,21,18,0,4,29,72,38.268635345369475,-109.3521441
16443,1,24,19,0,6,29,79,38.268635345369475,-109.3518746
16444,1,25,20,1,7,29,83,38.268635345369475,-109.3516051
16445,1,24,20,1,6,31,83,38.268635345369475,-109.3513356
16446,1,25,19,2,7,28,82,38.268635345369475,-109.3510661
16447,1,23,19,3,7,28,81,38.268635345369475,-109.3507966
16448,1,20,19,3,7,29,79,38.268635345369475,-109.3505271
16449,0,20,20,3,6,30,79,38.268635345369475,-109.3502577
16450,1,21,20,3,6,30,81,38.268635345369475,-109.3499882
16451,1,21,20,3,6,29,80,38.268635345369475,-109.3497187
16452,1,19,21,3,6,31,81,38.268635345369475,-109.3494492
16453,1,19,21,4,7,30,82,38.268635345369475,-109.3491797
16454,2,21,21,4,6,29,83,38.268635345369475,-109.3489102
16455,2,22,20,2,7,32,85,38.268635345369475,-109.3486407
16456,3,23,20,1,6,33,86,38.268635345369475,-109.3483712
16457,2,23,20,1,4,31,81,38.268635345369475,-109.3481017
16458,3,21,19,1,3,29,76,38.268635345369475,-109.3478322
16459,1,18,17,0,2,28,66,38.268635345369475,-109.3475627
16460,1,20,16,0,1,27,65,38.268635345369475,-109.3472932
16461,1,19,16,0,1,27,64,38.268635345369475,-109.3470237
16462,1,17,16,0,1,27,62,38.268635345369475,-109.3467542
16463,1,18,17,0,1,26,63,38.268635345369475,-109.3464847
16464,1,17,17,0,1,27,63,38.268635345369475,-109.3462152
16465,2,19,16,0,1,24,62,38.268635345369475,-109.3459457
16466,2,20,17,0,1,26,66,38.268635345369475,-109.3456762
16467,2,22,17,0,3,25,69,38.268635345369475,-109.3454068
16468,3,28,16,4,6,21,78,38.268635345369475,-109.3451373
16469,7,34,14,8,10,11,84,38.268635345369475,-109.3448678
16470,7,37,13,9,12,7,85,38.268635345369475,-109.3445983
16471,6,38,13,8,12,7,84,38.268635345369475,-109.3443288
16472,6,38,14,9,13,6,86,38.268635345369475,-109.3440593
16473,7,41,14,11,14,3,90,38.268635345369475,-109.3437898
16474,9,41,14,14,13,2,93,38.268635345369475,-109.3435203
16475,8,42,13,12,14,2,91,38.268635345369475,-109.3432508
16476,7,43,13,9,14,4,90,38.268635345369475,-109.3429813
16477,7,41,13,8,13,6,88,38.268635345369475,-109.3427118
16478,9,37,13,10,11,7,87,38.268635345369475,-109.3424423
16479,13,33,13,13,9,7,88,38.268635345369475,-109.3421728
16480,14,34,14,13,8,6,89,38.268635345369475,-109.3419033
16481,13,36,14,13,8,6,90,38.268635345369475,-109.3416338
16482,12,38,15,13,9,5,92,38.268635345369475,-109.3413643
16483,13,36,15,15,10,3,92,38.268635345369475,-109.3410948
16484,15,35,16,16,10,3,95,38.268635345369475,-109.3408253
16485,12,38,15,14,10,3,92,38.268635345369475,-109.3405558
16486,9,41,15,11,12,4,92,38.268635345369475,-109.3402864
16487,6,42,14,9,14,4,89,38.268635345369475,-109.3400169
16488,5,43,14,8,14,4,88,38.268635345369475,-109.3397474
16489,6,43,14,8,14,4,89,38.268635345369475,-109.3394779
16490,7,43,14,8,13,5,90,38.268635345369475,-109.3392084
16491,8,42,14,8,13,5,90,38.268635345369475,-109.3389389
16492,8,41,14,9,12,6,90,38.268635345369475,-109.3386694
16493,9,40,14,9,12,5,89,38.268635345369475,-109.3383999
16494,8,40,14,9,13,5,89,38.268635345369475,-109.3381304
16495,6,42,14,8,14,5,89,38.268635345369475,-109.3378609
16496,5,43,13,6,15,5,87,38.268635345369475,-109.3375914
16497,5,45,13,6,15,5,89,38.268635345369475,-109.3373219
16498,1,31,14,4,16,16,82,38.26836585078424,-109.4391909
16499,0,31,13,6,19,10,79,38.26836585078424,-109.4389214
16500,0,28,12,17,17,7,81,38.26836585078424,-109.4386519
16501,3,25,12,24,20,1,85,38.26836585078424,-109.4383824
16502,5,21,11,17,26,2,82,38.26836585078424,-109.4381129
16503,1,17,11,21,24,6,80,38.26836585078424,-109.4378434
16504,2,18,12,24,22,7,85,38.26836585078424,-109.4375739
16505,3,21,12,24,17,8,85,38.26836585078424,-109.4373044
16506,1,25,12,25,17,3,83,38.26836585078424,-109.4370349
16507,3,20,10,31,19,2,85,38.26836585078424,-109.4367654
16508,0,16,6,13,19,6,60,38.26836585078424,-109.4364959
16509,1,19,10,17,18,7,72,38.26836585078424,-109.4362264
16510,2,27,12,13,17,9,80,38.26836585078424,-109.4359569
16511,2,35,12,8,19,6,82,38.26836585078424,-109.4356874
16512,1,38,13,6,20,8,86,38.26836585078424,-109.4354179
16513,0,38,13,1,19,11,82,38.26836585078424,-109.4351484
16514,1,40,11,0,15,13,80,38.26836585078424,-109.434879
16515,3,43,11,0,15,9,81,38.26836585078424,-109.4346095
16516,4,45,12,2,19,4,86,38.26836585078424,-109.43434
16517,2,41,13,0,17,11,84,38.26836585078424,-109.4340705
16518,1,39,13,0,15,15,83,38.26836585078424,-109.433801
16519,1,40,12,0,15,13,81,38.26836585078424,-109.4335315
16520,2,41,12,0,16,10,81,38.26836585078424,-109.433262
16521,2,42,12,0,17,10,83,38.26836585078424,-109.4329925
16522,0,34,12,0,11,17,74,38.26836585078424,-109.432723
16523,1,35,11,0,13,14,74,38.26836585078424,-109.4324535
16524,2,40,12,2,17,7,80,38.26836585078424,-109.432184
16525,3,42,12,4,19,3,83,38.26836585078424,-109.4319145
16526,3,41,11,0,17,8,80,38.26836585078424,-109.431645
16527,1,39,12,0,16,11,79,38.26836585078424,-109.4313755
16528,2,39,12,1,16,9,79,38.26836585078424,-109.431106
16529,2,41,12,0,17,8,80,38.26836585078424,-109.4308365
16530,1,40,12,0,15,10,78,38.26836585078424,-109.430567
16531,1,37,11,0,12,14,75,38.26836585078424,-109.4302975
16532,3,40,11,0,13,11,78,38.26836585078424,-109.430028
16533,4,42,11,1,17,7,82,38.26836585078424,-109.4297586
16534,4,44,12,4,20,2,86,38.26836585078424,-109.4294891
16535,4,45,12,3,20,2,86,38.26836585078424,-109.4292196
16536,3,41,11,2,17,6,80,38.26836585078424,-109.4289501
16537,2,38,12,1,15,8,76,38.26836585078424,-109.4286806
16538,1,36,11,0,14,12,74,38.26836585078424,-109.4284111
16539,0,33,10,0,11,13,67,38.26836585078424,-109.4281416
16540,3,33,11,8,15,3,73,38.26836585078424,-109.4278721
16541,0,33,12,2,16,10,73,38.26836585078424,-109.4276026
16542,0,33,13,0,14,14,74,38.26836585078424,-109.4273331
16543,1,35,13,0,13,16,78,38.26836585078424,-109.4270636
16544,1,32,15,0,10,20,78,38.26836585078424,-109.4267941
16545,1,33,14,0,11,20,79,38.26836585078424,-109.4265246
16546,0,33,13,0,11,18,75,38.26836585078424,-109.4262551
16547,1,34,12,0,12,15,74,38.26836585078424,-109.4259856
16548,1,37,11,0,14,13,76,38.26836585078424,-109.4257161
16549,2,39,12,0,13,13,79,38.26836585078424,-109.4254466
16550,3,41,12,0,15,10,81,38.26836585078424,-109.4251771
16551,2,37,11,1,13,11,75,38.26836585078424,-109.4249077
16552,1,34,11,2,13,10,71,38.26836585078424,-109.4246382
16553,7,42,11,4,15,3,82,38.26836585078424,-109.4243687
16554,5,40,11,8,17,1,82,38.26836585078424,-109.4240992
16555,6,41,12,7,19,1,86,38.26836585078424,-109.4238297
16556,3,40,12,3,19,5,82,38.26836585078424,-109.4235602
16557,2,38,12,5,18,5,80,38.26836585078424,-109.4232907
16558,2,36,12,5,17,7,79,38.26836585078424,-109.4230212
16559,3,35,12,7,16,6,79,38.26836585078424,-109.4227517
16560,2,33,12,3,15,9,74,38.26836585078424,-109.4224822
16561,1,34,12,1,14,12,74,38.26836585078424,-109.4222127
16562,1,34,12,0,13,15,75,38.26836585078424,-109.4219432
16563,1,34,12,2,15,11,75,38.26836585078424,-109.4216737
16564,2,35,12,4,18,7,78,38.26836585078424,-109.4214042
16565,3,37,11,5,18,5,79,38.26836585078424,-109.4211347
16566,4,37,11,7,18,3,80,38.26836585078424,-109.4208652
16567,4,35,11,6,15,5,76,38.26836585078424,-109.4205957
16568,2,34,10,4,12,7,69,38.26836585078424,-109.4203262
16569,3,38,10,4,14,4,73,38.26836585078424,-109.4200568
16570,4,40,10,7,15,1,77,38.26836585078424,-109.4197873
16571,5,41,12,12,14,1,85,38.26836585078424,-109.4195178
16572,5,45,12,11,15,0,88,38.26836585078424,-109.4192483
16573,4,50,13,11,16,0,94,38.26836585078424,-109.4189788
16574,4,51,13,11,16,0,95,38.26836585078424,-109.4187093
16575,5,51,13,9,16,0,94,38.26836585078424,-109.4184398
16576,6,48,13,9,17,0,93,38.26836585078424,-109.4181703
16577,8,47,13,10,15,0,93,38.26836585078424,-109.4179008
16578,7,47,13,10,14,0,91,38.26836585078424,-109.4176313
16579,7,48,13,10,15,0,93,38.26836585078424,-109.4173618
16580,7,47,14,11,15,0,94,38.26836585078424,-109.4170923
16581,9,44,14,13,13,1,94,38.26836585078424,-109.4168228
16582,12,40,15,15,12,1,95,38.26836585078424,-109.4165533
16583,13,40,14,15,12,0,94,38.26836585078424,-109.4162838
16584,13,40,15,14,12,0,94,38.26836585078424,-109.4160143
16585,10,42,14,15,12,0,93,38.26836585078424,-109.4157448
16586,6,45,13,13,13,0,90,38.26836585078424,-109.4154753
16587,8,44,14,13,14,0,93,38.26836585078424,-109.4152058
16588,10,42,14,13,13,0,92,38.26836585078424,-109.4149364
16589,10,41,14,13,13,0,91,38.26836585078424,-109.4146669
16590,9,43,14,12,14,0,92,38.26836585078424,-109.4143974
16591,9,46,13,10,15,0,93,38.26836585078424,-109.4141279
16592,7,48,12,9,17,0,93,38.26836585078424,-109.4138584
16593,6,51,11,8,16,0,92,38.26836585078424,-109.4135889
16594,5,51,10,7,15,0,88,38.26836585078424,-109.4133194
16595,7,49,11,8,15,0,90,38.26836585078424,-109.4130499
16596,8,47,12,7,17,0,91,38.26836585078424,-109.4127804
16597,7,47,13,7,17,0,91,38.26836585078424,-109.4125109
16598,9,46,14,8,16,0,93,38.26836585078424,-109.4122414
16599,11,44,14,8,16,0,93,38.26836585078424,-109.4119719
16600,12,43,13,7,16,0,91,38.26836585078424,-109.4117024
16601,10,43,13,7,17,0,90,38.26836585078424,-109.4114329
16602,7,49,13,5,17,0,91,38.26836585078424,-109.4111634
16603,5,52,13,5,16,1,92,38.26836585078424,-109.4108939
16604,5,52,13,5,16,1,92,38.26836585078424,-109.4106244
16605,6,51,13,6,17,0,93,38.26836585078424,-109.4103549
16606,4,52,13,6,17,1,93,38.26836585078424,-109.4100855
16607,4,52,13,5,16,1,91,38.26836585078424,-109.409816
16608,4,53,13,5,16,1,92,38.26836585078424,-109.4095465
16609,5,53,13,5,16,1,93,38.26836585078424,-109.409277
16610,4,52,12,4,16,2,90,38.26836585078424,-109.4090075
16611,5,50,12,5,17,2,91,38.26836585078424,-109.408738
16612,7,47,12,7,17,1,91,38.26836585078424,-109.4084685
16613,10,44,13,9,16,0,92,38.26836585078424,-109.408199
16614,12,41,13,10,16,0,92,38.26836585078424,-109.4079295
16615,13,42,14,10,15,0,94,38.26836585078424,-109.40766
16616,14,40,14,11,14,0,93,38.26836585078424,-109.4073905
16617,14,40,14,11,15,0,94,38.26836585078424,-109.407121
16618,10,43,13,9,16,1,92,38.26836585078424,-109.4068515
16619,3,35,12,0,7,17,74,38.26836585078424,-109.3879869
16620,3,43,11,0,11,11,79,38.26836585078424,-109.3877174
16621,2,36,11,0,7,16,72,38.26836585078424,-109.3874479
16622,2,28,13,1,5,19,68,38.26836585078424,-109.3871784
16623,3,31,13,2,8,17,74,38.26836585078424,-109.3869089
16624,4,39,13,2,13,13,84,38.26836585078424,-109.3866394
16625,6,35,12,1,11,14,79,38.26836585078424,-109.3863699
16626,4,31,12,0,10,14,71,38.26836585078424,-109.3861004
16627,4,30,12,0,10,15,71,38.26836585078424,-109.3858309
16628,4,34,11,0,12,12,73,38.26836585078424,-109.3855614
16629,4,39,12,1,13,10,79,38.26836585078424,-109.3852919
16630,3,45,11,2,16,6,83,38.26836585078424,-109.3850225
16631,4,43,12,3,17,5,84,38.26836585078424,-109.384753
16632,5,41,12,5,17,5,85,38.26836585078424,-109.3844835
16633,7,40,13,6,15,6,87,38.26836585078424,-109.384214
16634,7,41,14,5,14,5,86,38.26836585078424,-109.3839445
16635,5,43,12,4,15,5,84,38.26836585078424,-109.383675
16636,4,47,12,3,15,6,87,38.26836585078424,-109.3834055
16637,3,49,12,3,14,6,87,38.26836585078424,-109.383136
16638,3,49,12,3,16,5,88,38.26836585078424,-109.3828665
16639,4,45,12,3,17,3,84,38.26836585078424,-109.382597
16640,5,36,12,6,15,5,79,38.26836585078424,-109.3823275
16641,6,32,11,6,13,6,74,38.26836585078424,-109.382058
16642,6,29,11,7,12,7,72,38.26836585078424,-109.3817885
16643,4,30,11,6,12,8,71,38.26836585078424,-109.381519
16644,3,37,11,2,11,11,75,38.26836585078424,-109.3812495
16645,1,35,10,0,9,14,69,38.26836585078424,-109.38098
16646,1,36,10,0,10,13,70,38.26836585078424,-109.3807105
16647,1,35,10,0,10,13,69,38.26836585078424,-109.380441
16648,2,31,11,0,9,14,67,38.26836585078424,-109.3801716
16649,2,36,12,1,12,11,74,38.26836585078424,-109.3799021
16650,3,36,12,4,13,9,77,38.26836585078424,-109.3796326
16651,2,34,12,4,12,10,74,38.26836585078424,-109.3793631
16652,2,32,12,0,11,14,71,38.26836585078424,-109.3790936
16653,1,27,12,0,7,21,68,38.26836585078424,-109.3788241
16654,2,24,11,2,5,18,62,38.26836585078424,-109.3785546
16655,2,23,11,5,7,15,63,38.26836585078424,-109.3782851
16656,2,23,11,4,7,14,61,38.26836585078424,-109.3780156
16657,3,29,11,1,9,12,65,38.26836585078424,-109.3777461
16658,4,32,12,2,12,10,72,38.26836585078424,-109.3774766
16659,4,35,13,6,18,8,84,38.26836585078424,-109.3772071
16660,5,35,13,6,19,7,85,38.26836585078424,-109.3769376
16661,6,35,13,6,16,8,84,38.26836585078424,-109.3766681
16662,6,34,14,8,16,9,87,38.26836585078424,-109.3763986
16663,7,31,14,10,15,7,84,38.26836585078424,-109.3761291
16664,7,31,14,11,15,7,85,38.26836585078424,-109.3758596
16665,7,28,13,13,13,7,81,38.26836585078424,-109.3755901
16666,9,23,12,14,14,4,76,38.26836585078424,-109.3753206
16667,7,19,10,15,16,3,70,38.26836585078424,-109.3750512
16668,12,21,13,10,10,7,73,38.26836585078424,-109.3747817
16669,5,27,12,5,10,11,70,38.26836585078424,-109.3745122
16670,2,26,12,2,8,15,65,38.26836585078424,-109.3742427
16671,2,23,12,4,5,17,63,38.26836585078424,-109.3739732
16672,4,33,11,4,9,11,72,38.26836585078424,-109.3737037
16673,3,28,11,2,7,14,65,38.26836585078424,-109.3734342
16674,2,22,12,1,4,20,61,38.26836585078424,-109.3731647
16675,2,20,13,1,3,24,63,38.26836585078424,-109.3728952
16676,1,16,13,3,3,24,60,38.26836585078424,-109.3726257
16677,2,22,13,5,6,23,71,38.26836585078424,-109.3723562
16678,1,24,14,3,4,27,73,38.26836585078424,-109.3720867
16679,1,28,16,1,7,24,77,38.26836585078424,-109.3718172
16680,1,24,15,2,10,19,71,38.26836585078424,-109.3715477
16681,1,20,13,6,17,13,70,38.26836585078424,-109.3712782
16682,4,16,11,18,19,4,72,38.26836585078424,-109.3710087
16683,3,15,11,27,17,5,78,38.26836585078424,-109.3707392
16684,3,14,10,26,19,5,77,38.26836585078424,-109.3704697
16685,3,19,10,26,15,2,75,38.26836585078424,-109.3702003
16686,6,22,11,20,19,2,80,38.26836585078424,-109.3699308
16687,6,23,11,16,18,3,77,38.26836585078424,-109.3696613
16688,6,27,11,13,18,2,77,38.26836585078424,-109.3693918
16689,7,25,10,12,15,4,73,38.26836585078424,-109.3691223
16690,1,31,12,7,13,8,72,38.26836585078424,-109.3688528
16691,1,32,13,3,10,14,73,38.26836585078424,-109.3685833
16692,0,27,13,0,6,23,69,38.26836585078424,-109.3683138
16693,1,25,13,0,4,23,66,38.26836585078424,-109.3680443
16694,1,27,12,0,3,21,64,38.26836585078424,-109.3677748
16695,1,20,12,3,3,19,58,38.26836585078424,-109.3675053
16696,4,22,9,4,4,12,55,38.26836585078424,-109.3672358
16697,3,27,8,6,7,6,57,38.26836585078424,-109.3669663
16698,3,34,6,5,8,3,59,38.26836585078424,-109.3666968
16699,3,37,6,5,9,3,63,38.26836585078424,-109.3664273
16700,3,31,7,5,8,4,58,38.26836585078424,-109.3661578
16701,3,29,7,6,8,5,58,38.26836585078424,-109.3658883
16702,2,23,8,8,6,8,55,38.26836585078424,-109.3656188
16703,3,17,8,8,8,4,48,38.26836585078424,-109.3653493
16704,12,20,11,10,9,0,62,38.26836585078424,-109.3650799
16705,2,11,11,6,6,15,51,38.26836585078424,-109.3648104
16706,2,16,14,0,2,24,58,38.26836585078424,-109.3645409
16707,1,19,16,0,2,30,68,38.26836585078424,-109.3642714
16708,1,19,16,0,1,31,68,38.26836585078424,-109.3640019
16709,0,19,16,0,1,29,65,38.26836585078424,-109.3637324
16710,0,18,15,0,1,29,63,38.26836585078424,-109.3634629
16711,0,17,15,0,1,26,59,38.26836585078424,-109.3631934
16712,0,19,12,0,2,20,53,38.26836585078424,-109.3629239
16713,5,28,9,2,1,13,58,38.26836585078424,-109.3626544
16714,5,38,6,4,6,5,64,38.26836585078424,-109.3623849
16715,4,24,7,5,7,8,55,38.26836585078424,-109.3621154
16716,5,18,7,3,5,11,49,38.26836585078424,-109.3618459
16717,4,19,11,5,4,12,55,38.26836585078424,-109.3615764
16718,5,21,12,5,6,11,60,38.26836585078424,-109.3613069
16719,2,21,13,3,4,19,62,38.26836585078424,-109.3610374
16720,1,26,12,1,4,19,63,38.26836585078424,-109.3607679
16721,2,26,10,3,5,12,58,38.26836585078424,-109.3604984
16722,5,27,10,5,6,6,59,38.26836585078424,-109.360229
16723,4,30,12,2,9,10,67,38.26836585078424,-109.3599595
16724,6,23,13,9,10,12,73,38.26836585078424,-109.35969
16725,3,33,13,5,7,15,76,38.26836585078424,-109.3594205
16726,2,33,11,5,7,14,72,38.26836585078424,-109.359151
16727,4,31,14,6,9,12,76,38.26836585078424,-109.3588815
16728,3,26,16,0,6,24,75,38.26836585078424,-109.358612
16729,0,27,13,0,6,25,71,38.26836585078424,-109.3583425
16730,2,30,15,1,5,26,79,38.26836585078424,-109.358073
16731,1,27,15,0,8,26,77,38.26836585078424,-109.3578035
16732,2,28,17,2,8,24,81,38.26836585078424,-109.357534
16733,3,30,17,2,9,21,82,38.26836585078424,-109.3572645
16734,3,32,15,5,12,16,83,38.26836585078424,-109.356995
16735,3,29,15,7,8,18,80,38.26836585078424,-109.3567255
16736,7,29,13,14,9,6,78,38.26836585078424,-109.356456
16737,4,24,14,23,14,2,81,38.26836585078424,-109.3561865
16738,15,26,10,20,18,0,89,38.26836585078424,-109.355917
16739,15,27,10,21,17,0,90,38.26836585078424,-109.3556475
16740,6,23,11,23,22,2,87,38.26836585078424,-109.355378
16741,4,20,13,19,18,8,82,38.26836585078424,-109.3551086
16742,5,13,11,26,16,7,78,38.26836585078424,-109.3548391
16743,6,12,11,22,19,6,76,38.26836585078424,-109.3545696
16744,4,8,9,16,15,8,60,38.26836585078424,-109.3543001
16745,0,3,8,6,13,10,40,38.26836585078424,-109.3540306
16746,3,1,4,4,8,6,26,38.26836585078424,-109.3537611
16747,6,7,12,16,14,18,73,38.26836585078424,-109.3534916
16748,6,13,12,12,13,15,71,38.26836585078424,-109.3532221
16749,2,21,18,1,9,24,75,38.26836585078424,-109.3529526
16750,0,22,19,1,5,29,76,38.26836585078424,-109.3526831
16751,0,23,18,0,5,29,75,38.26836585078424,-109.3524136
16752,0,22,18,0,4,28,72,38.26836585078424,-109.3521441
16753,1,23,18,1,5,28,76,38.26836585078424,-109.3518746
16754,1,25,19,2,6,29,82,38.26836585078424,-109.3516051
16755,1,23,19,2,7,31,83,38.26836585078424,-109.3513356
16756,2,21,19,3,7,30,82,38.26836585078424,-109.3510661
16757,2,22,19,4,8,28,83,38.26836585078424,-109.3507966
16758,2,23,19,3,7,28,82,38.26836585078424,-109.3505271
16759,1,22,19,2,5,30,79,38.26836585078424,-109.3502577
16760,1,21,20,1,5,32,80,38.26836585078424,-109.3499882
16761,1,21,21,2,5,32,82,38.26836585078424,-109.3497187
16762,1,20,21,2,6,33,83,38.26836585078424,-109.3494492
16763,2,21,21,2,6,32,84,38.26836585078424,-109.3491797
16764,3,26,19,2,7,29,86,38.26836585078424,-109.3489102
16765,3,27,19,2,8,28,87,38.26836585078424,-109.3486407
16766,3,27,18,3,7,27,85,38.26836585078424,-109.3483712
16767,3,27,19,2,7,28,86,38.26836585078424,-109.3481017
16768,3,25,20,2,6,29,85,38.26836585078424,-109.3478322
16769,3,23,19,1,4,29,79,38.26836585078424,-109.3475627
16770,2,23,18,1,3,27,74,38.26836585078424,-109.3472932
16771,1,20,17,0,2,27,67,38.26836585078424,-109.3470237
16772,1,20,17,0,2,28,68,38.26836585078424,-109.3467542
16773,1,20,18,0,2,29,70,38.26836585078424,-109.3464847
16774,1,19,18,0,1,28,67,38.26836585078424,-109.3462152
16775,3,19,15,0,1,21,59,38.26836585078424,-109.3459457
16776,1,18,16,0,2,24,61,38.26836585078424,-109.3456762
16777,2,21,17,1,3,24,68,38.26836585078424,-109.3454068
16778,3,26,16,3,6,22,76,38.26836585078424,-109.3451373
16779,4,28,15,5,7,19,78,38.26836585078424,-109.3448678
16780,5,32,15,6,10,15,83,38.26836585078424,-109.3445983
16781,6,36,15,7,12,10,86,38.26836585078424,-109.3443288
16782,6,41,15,8,14,6,90,38.26836585078424,-109.3440593
16783,7,42,14,10,14,4,91,38.26836585078424,-109.3437898
16784,7,41,14,10,14,4,90,38.26836585078424,-109.3435203
16785,7,39,14,10,14,4,88,38.26836585078424,-109.3432508
16786,6,39,13,11,13,5,87,38.26836585078424,-109.3429813
16787,6,38,13,10,12,6,85,38.26836585078424,-109.3427118
16788,9,37,14,10,9,8,87,38.26836585078424,-109.3424423
16789,10,36,14,13,8,8,89,38.26836585078424,-109.3421728
16790,10,38,15,13,9,6,91,38.26836585078424,-109.3419033
16791,10,39,15,12,10,5,91,38.26836585078424,-109.3416338
16792,11,38,15,12,11,5,92,38.26836585078424,-109.3413643
16793,14,35,15,14,9,5,92,38.26836585078424,-109.3410948
16794,16,32,16,16,9,4,93,38.26836585078424,-109.3408253
16795,15,35,16,15,9,4,94,38.26836585078424,-109.3405558
16796,12,39,15,13,10,4,93,38.26836585078424,-109.3402864
16797,9,40,15,11,12,4,91,38.26836585078424,-109.3400169
16798,8,41,15,10,13,4,91,38.26836585078424,-109.3397474
16799,8,41,14,9,13,4,89,38.26836585078424,-109.3394779
16800,9,41,14,9,12,5,90,38.26836585078424,-109.3392084
16801,10,41,14,9,11,5,90,38.26836585078424,-109.3389389
16802,9,40,14,10,12,5,90,38.26836585078424,-109.3386694
16803,10,39,14,12,13,3,91,38.26836585078424,-109.3383999
16804,11,40,14,13,13,2,93,38.26836585078424,-109.3381304
16805,9,41,14,12,14,2,92,38.26836585078424,-109.3378609
16806,8,43,14,9,15,3,92,38.26836585078424,-109.3375914
16807,8,42,14,10,13,4,91,38.26836585078424,-109.3373219
16808,0,32,14,0,16,15,77,38.26809635619901,-109.4394604
16809,0,35,14,0,14,17,80,38.26809635619901,-109.4391909
16810,0,35,13,0,15,14,77,38.26809635619901,-109.4389214
16811,0,35,12,1,16,12,76,38.26809635619901,-109.4386519
16812,0,36,12,4,19,8,79,38.26809635619901,-109.4383824
16813,0,34,12,7,20,7,80,38.26809635619901,-109.4381129
16814,0,29,13,17,19,4,82,38.26809635619901,-109.4378434
16815,1,30,12,21,20,3,87,38.26809635619901,-109.4375739
16816,1,30,12,19,20,2,84,38.26809635619901,-109.4373044
16817,2,33,13,12,22,3,85,38.26809635619901,-109.4370349
16818,0,32,12,11,20,8,83,38.26809635619901,-109.4367654
16819,0,31,12,9,17,10,79,38.26809635619901,-109.4364959
16820,1,34,13,7,21,7,83,38.26809635619901,-109.4362264
16821,2,36,13,7,22,6,86,38.26809635619901,-109.4359569
16822,1,38,13,0,20,12,84,38.26809635619901,-109.4356874
16823,3,40,13,0,14,13,83,38.26809635619901,-109.4354179
16824,1,37,11,0,13,15,77,38.26809635619901,-109.4351484
16825,1,33,12,0,11,17,74,38.26809635619901,-109.434879
16826,1,34,11,0,11,16,73,38.26809635619901,-109.4346095
16827,2,40,11,0,15,11,79,38.26809635619901,-109.43434
16828,1,38,12,0,14,14,79,38.26809635619901,-109.4340705
16829,1,35,12,0,13,16,77,38.26809635619901,-109.433801
16830,0,36,12,0,14,14,76,38.26809635619901,-109.4335315
16831,1,41,12,0,17,9,80,38.26809635619901,-109.433262
16832,3,44,12,1,18,6,84,38.26809635619901,-109.4329925
16833,1,40,12,0,15,12,80,38.26809635619901,-109.432723
16834,0,36,12,0,13,15,76,38.26809635619901,-109.4324535
16835,1,38,12,0,15,12,78,38.26809635619901,-109.432184
16836,3,42,12,1,18,6,82,38.26809635619901,-109.4319145
16837,3,43,12,1,18,7,84,38.26809635619901,-109.431645
16838,2,40,11,0,16,11,80,38.26809635619901,-109.4313755
16839,1,40,12,0,14,13,80,38.26809635619901,-109.431106
16840,1,39,12,0,13,14,79,38.26809635619901,-109.4308365
16841,1,37,13,0,11,17,79,38.26809635619901,-109.430567
16842,3,41,13,0,12,15,84,38.26809635619901,-109.4302975
16843,2,37,13,0,10,17,79,38.26809635619901,-109.430028
16844,2,39,12,0,14,13,80,38.26809635619901,-109.4297586
16845,3,43,12,3,19,5,85,38.26809635619901,-109.4294891
16846,5,45,12,6,20,1,89,38.26809635619901,-109.4292196
16847,3,40,12,2,17,6,80,38.26809635619901,-109.4289501
16848,1,38,11,1,14,11,76,38.26809635619901,-109.4286806
16849,0,34,11,0,12,14,71,38.26809635619901,-109.4284111
16850,0,29,10,3,10,12,64,38.26809635619901,-109.4281416
16851,4,33,12,6,17,4,76,38.26809635619901,-109.4278721
16852,1,34,12,0,14,14,75,38.26809635619901,-109.4276026
16853,0,35,13,0,14,14,76,38.26809635619901,-109.4273331
16854,1,37,13,0,15,13,79,38.26809635619901,-109.4270636
16855,1,35,14,0,13,17,80,38.26809635619901,-109.4267941
16856,1,33,14,0,11,19,78,38.26809635619901,-109.4265246
16857,1,34,13,0,11,18,77,38.26809635619901,-109.4262551
16858,1,36,13,0,12,17,79,38.26809635619901,-109.4259856
16859,2,38,12,0,12,15,79,38.26809635619901,-109.4257161
16860,2,39,12,0,14,12,79,38.26809635619901,-109.4254466
16861,3,47,12,0,16,7,85,38.26809635619901,-109.4251771
16862,3,41,11,0,15,8,78,38.26809635619901,-109.4249077
16863,2,37,11,1,14,9,74,38.26809635619901,-109.4246382
16864,5,37,10,2,15,6,75,38.26809635619901,-109.4243687
16865,6,39,11,8,16,1,81,38.26809635619901,-109.4240992
16866,6,43,12,7,18,0,86,38.26809635619901,-109.4238297
16867,6,46,12,4,19,1,88,38.26809635619901,-109.4235602
16868,5,46,12,3,18,3,87,38.26809635619901,-109.4232907
16869,4,44,11,3,17,4,83,38.26809635619901,-109.4230212
16870,4,39,11,3,17,5,79,38.26809635619901,-109.4227517
16871,3,38,12,5,17,5,80,38.26809635619901,-109.4224822
16872,4,38,12,5,17,5,81,38.26809635619901,-109.4222127
16873,4,39,11,4,17,5,80,38.26809635619901,-109.4219432
16874,5,42,12,3,18,3,83,38.26809635619901,-109.4216737
16875,5,43,12,4,19,3,86,38.26809635619901,-109.4214042
16876,6,44,12,6,19,1,88,38.26809635619901,-109.4211347
16877,7,43,12,9,18,0,89,38.26809635619901,-109.4208652
16878,6,42,12,10,17,0,87,38.26809635619901,-109.4205957
16879,4,40,12,9,17,1,83,38.26809635619901,-109.4203262
16880,3,40,11,4,15,5,78,38.26809635619901,-109.4200568
16881,2,38,10,4,14,5,73,38.26809635619901,-109.4197873
16882,3,41,11,7,15,2,79,38.26809635619901,-109.4195178
16883,4,48,12,9,15,0,88,38.26809635619901,-109.4192483
16884,3,52,12,11,13,0,91,38.26809635619901,-109.4189788
16885,4,50,12,11,15,0,92,38.26809635619901,-109.4187093
16886,6,49,13,10,16,0,94,38.26809635619901,-109.4184398
16887,6,49,13,11,15,0,94,38.26809635619901,-109.4181703
16888,5,51,13,10,15,0,94,38.26809635619901,-109.4179008
16889,5,51,13,9,15,0,93,38.26809635619901,-109.4176313
16890,6,50,13,9,16,0,94,38.26809635619901,-109.4173618
16891,8,47,13,10,16,0,94,38.26809635619901,-109.4170923
16892,12,42,14,13,13,0,94,38.26809635619901,-109.4168228
16893,13,39,14,15,12,0,93,38.26809635619901,-109.4165533
16894,14,40,14,14,12,0,94,38.26809635619901,-109.4162838
16895,14,40,15,14,11,0,94,38.26809635619901,-109.4160143
16896,10,43,14,11,14,0,92,38.26809635619901,-109.4157448
16897,6,47,13,10,15,0,91,38.26809635619901,-109.4154753
16898,8,45,14,11,14,0,92,38.26809635619901,-109.4152058
16899,9,46,14,10,15,0,94,38.26809635619901,-109.4149364
16900,8,47,13,9,15,0,92,38.26809635619901,-109.4146669
16901,8,48,13,9,15,0,93,38.26809635619901,-109.4143974
16902,11,45,13,9,14,0,92,38.26809635619901,-109.4141279
16903,7,48,12,8,17,0,92,38.26809635619901,-109.4138584
16904,5,52,11,7,16,0,91,38.26809635619901,-109.4135889
16905,4,51,11,7,16,0,89,38.26809635619901,-109.4133194
16906,5,49,12,8,18,0,92,38.26809635619901,-109.4130499
16907,5,50,13,7,17,1,93,38.26809635619901,-109.4127804
16908,6,49,13,7,18,0,93,38.26809635619901,-109.4125109
16909,7,47,13,7,18,0,92,38.26809635619901,-109.4122414
16910,9,45,13,8,18,0,93,38.26809635619901,-109.4119719
16911,11,44,13,8,17,0,93,38.26809635619901,-109.4117024
16912,9,44,13,8,17,0,91,38.26809635619901,-109.4114329
16913,6,49,13,6,18,0,92,38.26809635619901,-109.4111634
16914,5,52,12,5,17,1,92,38.26809635619901,-109.4108939
16915,5,52,12,5,17,1,92,38.26809635619901,-109.4106244
16916,5,51,13,5,17,1,92,38.26809635619901,-109.4103549
16917,5,50,13,5,18,1,92,38.26809635619901,-109.4100855
16918,5,50,13,5,17,1,91,38.26809635619901,-109.409816
16919,6,50,13,6,17,0,92,38.26809635619901,-109.4095465
16920,6,49,13,5,16,1,90,38.26809635619901,-109.409277
16921,6,48,13,5,17,2,91,38.26809635619901,-109.4090075
16922,6,47,13,6,18,1,91,38.26809635619901,-109.408738
16923,6,47,13,7,17,1,91,38.26809635619901,-109.4084685
16924,8,45,12,8,17,1,91,38.26809635619901,-109.408199
16925,10,43,13,9,17,0,92,38.26809635619901,-109.4079295
16926,9,43,13,9,16,1,91,38.26809635619901,-109.40766
16927,10,42,13,10,15,1,91,38.26809635619901,-109.4073905
16928,10,41,13,9,16,1,90,38.26809635619901,-109.407121
16929,7,43,13,7,17,3,90,38.26809635619901,-109.4068515
16930,3,36,11,1,8,14,73,38.26809635619901,-109.3879869
16931,3,39,11,1,10,13,77,38.26809635619901,-109.3877174
16932,4,39,12,2,10,13,80,38.26809635619901,-109.3874479
16933,3,31,13,2,8,17,74,38.26809635619901,-109.3871784
16934,5,33,13,4,11,14,80,38.26809635619901,-109.3869089
16935,9,35,13,4,13,11,85,38.26809635619901,-109.3866394
16936,4,28,12,1,8,18,71,38.26809635619901,-109.3863699
16937,3,30,12,0,10,15,70,38.26809635619901,-109.3861004
16938,3,33,11,0,12,12,71,38.26809635619901,-109.3858309
16939,4,37,12,2,15,8,78,38.26809635619901,-109.3855614
16940,4,46,12,3,16,4,85,38.26809635619901,-109.3852919
16941,3,50,11,2,17,3,86,38.26809635619901,-109.3850225
16942,5,44,12,5,17,3,86,38.26809635619901,-109.384753
16943,7,43,13,6,17,2,88,38.26809635619901,-109.3844835
16944,7,42,13,6,16,4,88,38.26809635619901,-109.384214
16945,6,43,13,4,15,5,86,38.26809635619901,-109.3839445
16946,4,46,12,3,15,5,85,38.26809635619901,-109.383675
16947,3,50,11,3,14,6,87,38.26809635619901,-109.3834055
16948,3,53,11,2,14,6,89,38.26809635619901,-109.383136
16949,3,54,11,2,15,6,91,38.26809635619901,-109.3828665
16950,3,50,11,1,16,5,86,38.26809635619901,-109.382597
16951,4,36,11,3,14,8,76,38.26809635619901,-109.3823275
16952,5,29,12,4,11,10,71,38.26809635619901,-109.382058
16953,5,25,11,6,9,10,66,38.26809635619901,-109.3817885
16954,3,24,11,8,10,9,65,38.26809635619901,-109.381519
16955,2,39,9,1,13,8,72,38.26809635619901,-109.3812495
16956,1,37,10,0,10,13,71,38.26809635619901,-109.38098
16957,1,34,10,0,9,15,69,38.26809635619901,-109.3807105
16958,2,32,11,0,9,15,69,38.26809635619901,-109.380441
16959,2,31,11,0,8,15,67,38.26809635619901,-109.3801716
16960,2,32,11,0,9,14,68,38.26809635619901,-109.3799021
16961,1,31,12,0,9,15,68,38.26809635619901,-109.3796326
16962,0,31,12,0,10,17,70,38.26809635619901,-109.3793631
16963,0,30,14,0,8,22,74,38.26809635619901,-109.3790936
16964,0,24,13,0,5,24,66,38.26809635619901,-109.3788241
16965,1,25,11,0,5,20,62,38.26809635619901,-109.3785546
16966,1,27,11,0,7,16,62,38.26809635619901,-109.3782851
16967,1,28,11,0,8,15,63,38.26809635619901,-109.3780156
16968,1,25,12,0,7,18,63,38.26809635619901,-109.3777461
16969,1,32,12,2,13,15,75,38.26809635619901,-109.3774766
16970,3,35,13,3,17,12,83,38.26809635619901,-109.3772071
16971,6,34,13,5,18,9,85,38.26809635619901,-109.3769376
16972,8,34,13,5,15,9,84,38.26809635619901,-109.3766681
16973,7,33,14,6,13,12,85,38.26809635619901,-109.3763986
16974,8,31,14,8,13,10,84,38.26809635619901,-109.3761291
16975,9,28,14,12,11,9,83,38.26809635619901,-109.3758596
16976,11,23,12,14,12,5,77,38.26809635619901,-109.3755901
16977,11,20,11,11,14,4,71,38.26809635619901,-109.3753206
16978,7,17,10,15,13,4,66,38.26809635619901,-109.3750512
16979,9,23,13,7,8,13,73,38.26809635619901,-109.3747817
16980,4,22,14,3,5,20,68,38.26809635619901,-109.3745122
16981,3,21,17,0,2,27,70,38.26809635619901,-109.3742427
16982,4,24,17,0,2,25,72,38.26809635619901,-109.3739732
16983,3,25,13,2,6,20,69,38.26809635619901,-109.3737037
16984,1,28,13,0,10,19,71,38.26809635619901,-109.3734342
16985,0,31,13,2,13,16,75,38.26809635619901,-109.3731647
16986,0,33,12,2,11,17,75,38.26809635619901,-109.3728952
16987,1,29,13,1,7,21,72,38.26809635619901,-109.3726257
16988,1,23,14,1,5,25,69,38.26809635619901,-109.3723562
16989,1,22,14,1,3,28,69,38.26809635619901,-109.3720867
16990,1,27,13,0,4,25,70,38.26809635619901,-109.3718172
16991,2,23,12,3,7,20,67,38.26809635619901,-109.3715477
16992,8,14,10,9,14,6,61,38.26809635619901,-109.3712782
16993,4,17,9,16,12,2,60,38.26809635619901,-109.3710087
16994,2,24,10,14,16,1,67,38.26809635619901,-109.3707392
16995,4,30,11,13,15,1,74,38.26809635619901,-109.3704697
16996,5,31,12,13,12,5,78,38.26809635619901,-109.3702003
16997,4,31,14,11,11,8,79,38.26809635619901,-109.3699308
16998,2,33,14,7,13,11,80,38.26809635619901,-109.3696613
16999,0,34,12,4,15,12,77,38.26809635619901,-109.3693918
17000,0,31,12,0,11,16,70,38.26809635619901,-109.3691223
17001,0,31,13,0,7,21,72,38.26809635619901,-109.3688528
17002,0,25,13,0,3,23,64,38.26809635619901,-109.3685833
17003,0,21,12,1,3,22,59,38.26809635619901,-109.3683138
17004,1,19,11,1,4,17,53,38.26809635619901,-109.3680443
17005,3,21,8,3,7,9,51,38.26809635619901,-109.3677748
17006,6,32,7,4,7,6,62,38.26809635619901,-109.3675053
17007,3,34,6,5,8,5,61,38.26809635619901,-109.3672358
17008,3,36,6,5,8,3,61,38.26809635619901,-109.3669663
17009,3,42,7,4,9,2,67,38.26809635619901,-109.3666968
17010,3,42,7,3,10,3,68,38.26809635619901,-109.3664273
17011,2,32,7,4,10,4,59,38.26809635619901,-109.3661578
17012,2,30,9,6,10,6,63,38.26809635619901,-109.3658883
17013,3,14,8,7,9,5,46,38.26809635619901,-109.3656188
17014,1,23,13,4,12,8,61,38.26809635619901,-109.3653493
17015,9,20,12,10,11,1,63,38.26809635619901,-109.3650799
17016,2,14,10,9,11,9,55,38.26809635619901,-109.3648104
17017,1,14,13,3,4,22,57,38.26809635619901,-109.3645409
17018,0,20,16,0,2,30,68,38.26809635619901,-109.3642714
17019,1,20,16,0,2,31,70,38.26809635619901,-109.3640019
17020,1,20,16,0,2,29,68,38.26809635619901,-109.3637324
17021,1,19,16,0,1,29,66,38.26809635619901,-109.3634629
17022,0,19,15,0,0,29,63,38.26809635619901,-109.3631934
17023,0,18,13,0,2,23,56,38.26809635619901,-109.3629239
17024,3,31,8,2,2,13,59,38.26809635619901,-109.3626544
17025,5,40,5,4,6,4,64,38.26809635619901,-109.3623849
17026,6,27,7,5,7,7,59,38.26809635619901,-109.3621154
17027,5,22,8,4,5,12,56,38.26809635619901,-109.3618459
17028,5,21,10,1,3,17,57,38.26809635619901,-109.3615764
17029,4,22,11,4,6,12,59,38.26809635619901,-109.3613069
17030,1,26,11,3,6,15,62,38.26809635619901,-109.3610374
17031,0,28,10,1,6,15,60,38.26809635619901,-109.3607679
17032,2,25,9,3,6,9,54,38.26809635619901,-109.3604984
17033,6,27,10,6,8,4,61,38.26809635619901,-109.360229
17034,3,27,13,3,8,13,67,38.26809635619901,-109.3599595
17035,4,28,14,9,15,12,82,38.26809635619901,-109.35969
17036,1,29,16,2,9,24,81,38.26809635619901,-109.3594205
17037,0,24,16,0,5,29,74,38.26809635619901,-109.359151
17038,0,23,14,0,5,26,68,38.26809635619901,-109.3588815
17039,1,25,13,0,6,22,67,38.26809635619901,-109.358612
17040,1,28,14,0,6,23,72,38.26809635619901,-109.3583425
17041,3,27,15,0,10,23,78,38.26809635619901,-109.358073
17042,2,28,17,2,7,25,81,38.26809635619901,-109.3578035
17043,2,27,17,3,8,25,82,38.26809635619901,-109.357534
17044,2,24,18,2,12,23,81,38.26809635619901,-109.3572645
17045,4,26,16,5,13,17,81,38.26809635619901,-109.356995
17046,9,31,13,12,13,7,85,38.26809635619901,-109.3567255
17047,14,33,12,18,12,1,90,38.26809635619901,-109.356456
17048,5,21,9,21,16,1,73,38.26809635619901,-109.3561865
17049,3,19,12,14,25,8,81,38.26809635619901,-109.355917
17050,4,16,11,20,16,6,73,38.26809635619901,-109.3556475
17051,6,11,11,21,15,6,70,38.26809635619901,-109.355378
17052,6,11,11,22,14,6,70,38.26809635619901,-109.3551086
17053,5,8,10,13,13,10,59,38.26809635619901,-109.3548391
17054,0,2,6,4,10,8,30,38.26809635619901,-109.3545696
17055,0,0,4,6,8,3,21,38.26809635619901,-109.3543001
17056,8,7,9,20,20,3,67,38.26809635619901,-109.3540306
17057,5,12,13,23,12,12,77,38.26809635619901,-109.3537611
17058,6,16,13,16,11,14,76,38.26809635619901,-109.3534916
17059,8,14,14,13,8,21,78,38.26809635619901,-109.3532221
17060,1,24,19,2,6,28,80,38.26809635619901,-109.3529526
17061,1,24,19,2,6,29,81,38.26809635619901,-109.3526831
17062,2,25,18,3,6,27,81,38.26809635619901,-109.3524136
17063,0,24,18,1,4,30,77,38.26809635619901,-109.3521441
17064,1,25,18,1,5,30,80,38.26809635619901,-109.3518746
17065,1,25,19,1,7,30,83,38.26809635619901,-109.3516051
17066,1,22,19,3,7,31,83,38.26809635619901,-109.3513356
17067,2,19,19,4,6,32,82,38.26809635619901,-109.3510661
17068,2,22,19,4,6,29,82,38.26809635619901,-109.3507966
17069,1,23,19,2,6,29,80,38.26809635619901,-109.3505271
17070,1,21,19,3,5,30,79,38.26809635619901,-109.3502577
17071,0,21,20,2,5,33,81,38.26809635619901,-109.3499882
17072,1,21,20,2,6,34,84,38.26809635619901,-109.3497187
17073,0,20,21,1,6,36,84,38.26809635619901,-109.3494492
17074,1,23,20,0,7,33,84,38.26809635619901,-109.3491797
17075,2,26,18,3,8,27,84,38.26809635619901,-109.3489102
17076,3,29,17,5,9,23,86,38.26809635619901,-109.3486407
17077,4,29,17,6,9,21,86,38.26809635619901,-109.3483712
17078,4,28,18,4,9,24,87,38.26809635619901,-109.3481017
17079,3,26,19,3,7,28,86,38.26809635619901,-109.3478322
17080,2,24,20,0,5,32,83,38.26809635619901,-109.3475627
17081,1,21,19,0,3,31,75,38.26809635619901,-109.3472932
17082,2,20,17,0,2,27,68,38.26809635619901,-109.3470237
17083,3,24,18,1,3,25,74,38.26809635619901,-109.3467542
17084,3,26,20,2,5,25,81,38.26809635619901,-109.3464847
17085,2,20,20,1,3,29,75,38.26809635619901,-109.3462152
17086,4,20,17,1,3,20,65,38.26809635619901,-109.3459457
17087,1,18,16,1,2,24,62,38.26809635619901,-109.3456762
17088,2,22,18,1,4,26,73,38.26809635619901,-109.3454068
17089,3,24,18,2,5,27,79,38.26809635619901,-109.3451373
17090,2,25,18,2,4,29,80,38.26809635619901,-109.3448678
17091,3,27,17,3,5,25,80,38.26809635619901,-109.3445983
17092,6,35,15,5,11,14,86,38.26809635619901,-109.3443288
17093,6,39,15,7,13,7,87,38.26809635619901,-109.3440593
17094,6,41,14,8,14,6,89,38.26809635619901,-109.3437898
17095,7,38,14,8,13,7,87,38.26809635619901,-109.3435203
17096,8,36,14,11,11,6,86,38.26809635619901,-109.3432508
17097,8,37,14,12,10,6,87,38.26809635619901,-109.3429813
17098,6,38,13,11,10,7,85,38.26809635619901,-109.3427118
17099,6,38,14,10,9,8,85,38.26809635619901,-109.3424423
17100,7,39,14,11,9,7,87,38.26809635619901,-109.3421728
17101,8,39,15,12,9,6,89,38.26809635619901,-109.3419033
17102,9,40,15,12,10,6,92,38.26809635619901,-109.3416338
17103,10,40,15,11,11,5,92,38.26809635619901,-109.3413643
17104,11,38,15,11,11,6,92,38.26809635619901,-109.3410948
17105,12,36,15,13,11,5,92,38.26809635619901,-109.3408253
17106,11,36,15,13,11,5,91,38.26809635619901,-109.3405558
17107,10,38,15,12,11,5,91,38.26809635619901,-109.3402864
17108,9,39,15,10,12,5,90,38.26809635619901,-109.3400169
17109,10,38,15,11,12,5,91,38.26809635619901,-109.3397474
17110,9,38,14,12,10,6,89,38.26809635619901,-109.3394779
17111,8,38,14,12,10,6,88,38.26809635619901,-109.3392084
17112,7,40,14,12,11,5,89,38.26809635619901,-109.3389389
17113,6,41,13,11,13,3,87,38.26809635619901,-109.3386694
17114,6,41,13,10,14,4,88,38.26809635619901,-109.3383999
17115,8,39,13,11,14,4,89,38.26809635619901,-109.3381304
17116,9,39,13,10,13,5,89,38.26809635619901,-109.3378609
17117,9,40,14,10,12,5,90,38.26809635619901,-109.3375914
17118,8,40,13,11,12,4,88,38.26809635619901,-109.3373219
17119,7,42,13,10,10,6,88,38.26809635619901,-109.3370524
17120,0,35,12,0,15,14,76,38.26782686161377,-109.4397299
17121,0,35,12,0,15,15,77,38.26782686161377,-109.4394604
17122,0,37,13,0,14,16,80,38.26782686161377,-109.4391909
17123,0,38,12,0,14,14,78,38.26782686161377,-109.4389214
17124,0,39,11,0,14,12,76,38.26782686161377,-109.4386519
17125,1,39,11,0,15,11,77,38.26782686161377,-109.4383824
17126,2,41,10,0,16,10,79,38.26782686161377,-109.4381129
17127,1,40,11,0,17,9,78,38.26782686161377,-109.4378434
17128,0,38,11,0,18,9,76,38.26782686161377,-109.4375739
17129,0,36,11,0,15,13,75,38.26782686161377,-109.4373044
17130,0,34,12,1,14,12,73,38.26782686161377,-109.4370349
17131,0,34,12,3,15,11,75,38.26782686161377,-109.4367654
17132,0,35,12,0,14,13,74,38.26782686161377,-109.4364959
17133,0,36,11,0,16,12,75,38.26782686161377,-109.4362264
17134,1,39,11,0,16,11,78,38.26782686161377,-109.4359569
17135,1,40,11,0,15,12,79,38.26782686161377,-109.4356874
17136,1,39,10,0,14,10,74,38.26782686161377,-109.4354179
17137,3,40,12,0,14,11,80,38.26782686161377,-109.4351484
17138,1,40,11,0,15,11,78,38.26782686161377,-109.434879
17139,1,39,11,0,14,12,77,38.26782686161377,-109.4346095
17140,0,36,12,0,14,15,77,38.26782686161377,-109.43434
17141,1,35,14,2,14,13,79,38.26782686161377,-109.4340705
17142,2,37,13,0,13,16,81,38.26782686161377,-109.433801
17143,1,40,12,0,17,11,81,38.26782686161377,-109.4335315
17144,2,42,12,1,19,6,82,38.26782686161377,-109.433262
17145,2,41,12,2,18,7,82,38.26782686161377,-109.4329925
17146,1,35,12,0,14,15,77,38.26782686161377,-109.432723
17147,0,34,14,0,13,18,79,38.26782686161377,-109.4324535
17148,1,35,15,0,13,18,82,38.26782686161377,-109.432184
17149,1,35,15,2,15,14,82,38.26782686161377,-109.4319145
17150,2,35,13,5,15,10,80,38.26782686161377,-109.431645
17151,2,40,12,0,16,11,81,38.26782686161377,-109.4313755
17152,1,36,12,0,13,14,76,38.26782686161377,-109.431106
17153,0,32,12,0,11,18,73,38.26782686161377,-109.4308365
17154,1,34,13,0,10,17,75,38.26782686161377,-109.430567
17155,1,35,13,0,9,18,76,38.26782686161377,-109.4302975
17156,1,35,13,0,10,18,77,38.26782686161377,-109.430028
17157,1,35,13,0,12,16,77,38.26782686161377,-109.4297586
17158,2,39,12,0,15,11,79,38.26782686161377,-109.4294891
17159,3,42,12,1,17,8,83,38.26782686161377,-109.4292196
17160,1,39,12,0,15,11,78,38.26782686161377,-109.4289501
17161,1,37,13,1,16,11,79,38.26782686161377,-109.4286806
17162,1,36,12,2,17,9,77,38.26782686161377,-109.4284111
17163,0,31,12,3,15,10,71,38.26782686161377,-109.4281416
17164,2,34,13,2,19,8,78,38.26782686161377,-109.4278721
17165,1,34,12,0,11,16,74,38.26782686161377,-109.4276026
17166,1,35,12,0,14,14,76,38.26782686161377,-109.4273331
17167,1,36,12,0,15,12,76,38.26782686161377,-109.4270636
17168,2,36,13,0,14,15,80,38.26782686161377,-109.4267941
17169,1,36,12,0,13,14,76,38.26782686161377,-109.4265246
17170,1,36,12,0,13,14,76,38.26782686161377,-109.4262551
17171,1,37,12,0,13,15,78,38.26782686161377,-109.4259856
17172,1,38,12,0,12,15,78,38.26782686161377,-109.4257161
17173,1,37,11,0,13,14,76,38.26782686161377,-109.4254466
17174,3,42,12,1,17,8,83,38.26782686161377,-109.4251771
17175,2,39,12,0,15,12,80,38.26782686161377,-109.4249077
17176,2,37,12,0,13,13,77,38.26782686161377,-109.4246382
17177,2,37,11,1,14,10,75,38.26782686161377,-109.4243687
17178,4,36,12,6,16,4,78,38.26782686161377,-109.4240992
17179,4,38,12,7,17,3,81,38.26782686161377,-109.4238297
17180,5,41,11,4,17,3,81,38.26782686161377,-109.4235602
17181,5,43,11,2,17,3,81,38.26782686161377,-109.4232907
17182,4,42,10,2,16,4,78,38.26782686161377,-109.4230212
17183,5,40,11,6,16,1,79,38.26782686161377,-109.4227517
17184,6,42,12,8,17,1,86,38.26782686161377,-109.4224822
17185,6,43,12,7,18,0,86,38.26782686161377,-109.4222127
17186,6,45,12,6,18,0,87,38.26782686161377,-109.4219432
17187,7,46,12,6,18,0,89,38.26782686161377,-109.4216737
17188,6,44,12,7,18,0,87,38.26782686161377,-109.4214042
17189,7,42,13,11,17,0,90,38.26782686161377,-109.4211347
17190,8,42,13,13,15,0,91,38.26782686161377,-109.4208652
17191,9,42,13,12,15,0,91,38.26782686161377,-109.4205957
17192,9,43,13,11,15,0,91,38.26782686161377,-109.4203262
17193,4,44,11,6,16,1,82,38.26782686161377,-109.4200568
17194,3,45,10,3,14,3,78,38.26782686161377,-109.4197873
17195,3,46,10,5,15,1,80,38.26782686161377,-109.4195178
17196,4,49,12,9,15,0,89,38.26782686161377,-109.4192483
17197,5,51,13,10,16,0,95,38.26782686161377,-109.4189788
17198,5,51,12,9,16,0,93,38.26782686161377,-109.4187093
17199,7,48,13,11,15,0,94,38.26782686161377,-109.4184398
17200,9,47,13,12,14,0,95,38.26782686161377,-109.4181703
17201,7,48,13,10,16,0,94,38.26782686161377,-109.4179008
17202,8,48,13,8,16,0,93,38.26782686161377,-109.4176313
17203,9,46,13,8,16,0,92,38.26782686161377,-109.4173618
17204,9,45,13,10,16,0,93,38.26782686161377,-109.4170923
17205,11,43,14,13,14,0,95,38.26782686161377,-109.4168228
17206,12,43,15,11,14,0,95,38.26782686161377,-109.4165533
17207,14,42,15,12,13,0,96,38.26782686161377,-109.4162838
17208,13,42,15,13,13,0,96,38.26782686161377,-109.4160143
17209,11,43,14,11,15,0,94,38.26782686161377,-109.4157448
17210,9,44,13,11,16,0,93,38.26782686161377,-109.4154753
17211,7,45,13,9,16,0,90,38.26782686161377,-109.4152058
17212,5,50,12,8,17,0,92,38.26782686161377,-109.4149364
17213,5,53,12,7,15,0,92,38.26782686161377,-109.4146669
17214,7,49,12,9,13,0,90,38.26782686161377,-109.4143974
17215,13,44,13,11,11,0,92,38.26782686161377,-109.4141279
17216,7,52,11,8,14,0,92,38.26782686161377,-109.4138584
17217,5,54,10,7,15,0,91,38.26782686161377,-109.4135889
17218,4,53,11,6,17,0,91,38.26782686161377,-109.4133194
17219,4,52,12,6,18,1,93,38.26782686161377,-109.4130499
17220,4,51,13,6,18,0,92,38.26782686161377,-109.4127804
17221,5,50,13,6,19,0,93,38.26782686161377,-109.4125109
17222,6,47,13,7,19,0,92,38.26782686161377,-109.4122414
17223,7,46,13,7,19,0,92,38.26782686161377,-109.4119719
17224,9,45,13,8,18,0,93,38.26782686161377,-109.4117024
17225,9,44,13,8,17,0,91,38.26782686161377,-109.4114329
17226,8,47,13,7,17,0,92,38.26782686161377,-109.4111634
17227,6,50,13,6,17,1,93,38.26782686161377,-109.4108939
17228,5,51,12,5,18,1,92,38.26782686161377,-109.4106244
17229,5,50,12,5,18,1,91,38.26782686161377,-109.4103549
17230,5,49,13,5,18,1,91,38.26782686161377,-109.4100855
17231,6,48,13,6,18,1,92,38.26782686161377,-109.409816
17232,6,47,13,6,18,1,91,38.26782686161377,-109.4095465
17233,7,46,13,8,18,0,92,38.26782686161377,-109.409277
17234,8,45,12,8,18,0,91,38.26782686161377,-109.4090075
17235,7,45,12,7,18,1,90,38.26782686161377,-109.408738
17236,7,45,12,7,18,1,90,38.26782686161377,-109.4084685
17237,7,44,12,8,17,1,89,38.26782686161377,-109.408199
17238,8,42,12,10,17,0,89,38.26782686161377,-109.4079295
17239,8,41,12,9,17,2,89,38.26782686161377,-109.40766
17240,8,41,12,9,16,2,88,38.26782686161377,-109.4073905
17241,8,41,12,9,16,2,88,38.26782686161377,-109.407121
17242,7,42,12,7,17,3,88,38.26782686161377,-109.4068515
17243,4,38,12,2,9,14,79,38.26782686161377,-109.3879869
17244,3,42,12,2,11,10,80,38.26782686161377,-109.3877174
17245,5,44,13,4,13,8,87,38.26782686161377,-109.3874479
17246,5,35,13,5,12,11,81,38.26782686161377,-109.3871784
17247,5,30,13,4,10,16,78,38.26782686161377,-109.3869089
17248,6,30,14,3,11,17,81,38.26782686161377,-109.3866394
17249,4,28,13,1,8,19,73,38.26782686161377,-109.3863699
17250,3,33,12,0,12,13,73,38.26782686161377,-109.3861004
17251,3,36,11,1,14,10,75,38.26782686161377,-109.3858309
17252,3,42,12,2,16,6,81,38.26782686161377,-109.3855614
17253,3,50,12,2,18,3,88,38.26782686161377,-109.3852919
17254,3,51,11,2,17,3,87,38.26782686161377,-109.3850225
17255,5,47,12,5,17,2,88,38.26782686161377,-109.384753
17256,6,45,13,6,17,2,89,38.26782686161377,-109.3844835
17257,7,44,13,6,16,3,89,38.26782686161377,-109.384214
17258,5,44,13,5,16,4,87,38.26782686161377,-109.3839445
17259,4,48,12,3,16,5,88,38.26782686161377,-109.383675
17260,3,52,12,2,15,5,89,38.26782686161377,-109.3834055
17261,3,53,11,2,15,5,89,38.26782686161377,-109.383136
17262,3,49,12,2,15,6,87,38.26782686161377,-109.3828665
17263,3,44,12,2,14,9,84,38.26782686161377,-109.382597
17264,3,40,11,2,12,10,78,38.26782686161377,-109.3823275
17265,2,38,10,0,10,11,71,38.26782686161377,-109.382058
17266,1,34,9,1,8,12,65,38.26782686161377,-109.3817885
17267,1,31,9,4,8,10,63,38.26782686161377,-109.381519
17268,1,44,8,1,12,7,73,38.26782686161377,-109.3812495
17269,1,41,9,0,11,11,73,38.26782686161377,-109.38098
17270,1,34,10,0,9,14,68,38.26782686161377,-109.3807105
17271,2,31,11,0,9,15,68,38.26782686161377,-109.380441
17272,2,35,11,0,10,13,71,38.26782686161377,-109.3801716
17273,1,32,10,0,8,14,65,38.26782686161377,-109.3799021
17274,1,31,12,0,8,19,71,38.26782686161377,-109.3796326
17275,3,31,15,1,8,22,80,38.26782686161377,-109.3793631
17276,2,30,15,0,7,23,77,38.26782686161377,-109.3790936
17277,2,29,14,2,10,20,77,38.26782686161377,-109.3788241
17278,2,29,13,0,7,20,71,38.26782686161377,-109.3785546
17279,2,26,12,0,6,18,64,38.26782686161377,-109.3782851
17280,2,23,12,2,6,19,64,38.26782686161377,-109.3780156
17281,3,23,13,3,9,18,69,38.26782686161377,-109.3777461
17282,2,32,13,5,15,12,79,38.26782686161377,-109.3774766
17283,6,35,13,4,16,11,85,38.26782686161377,-109.3772071
17284,9,34,14,5,14,9,85,38.26782686161377,-109.3769376
17285,8,33,14,6,13,10,84,38.26782686161377,-109.3766681
17286,7,31,13,7,12,11,81,38.26782686161377,-109.3763986
17287,6,29,13,5,9,12,74,38.26782686161377,-109.3761291
17288,8,24,12,8,9,9,70,38.26782686161377,-109.3758596
17289,10,18,12,13,15,4,72,38.26782686161377,-109.3755901
17290,11,17,10,17,16,2,73,38.26782686161377,-109.3753206
17291,8,21,12,16,12,9,78,38.26782686161377,-109.3750512
17292,2,24,16,4,7,27,80,38.26782686161377,-109.3747817
17293,3,22,16,3,4,28,76,38.26782686161377,-109.3745122
17294,3,20,16,2,2,26,69,38.26782686161377,-109.3742427
17295,2,21,13,2,4,21,63,38.26782686161377,-109.3739732
17296,1,23,13,1,5,22,65,38.26782686161377,-109.3737037
17297,0,29,12,4,10,16,71,38.26782686161377,-109.3734342
17298,0,31,11,3,11,15,71,38.26782686161377,-109.3731647
17299,0,29,11,1,8,18,67,38.26782686161377,-109.3728952
17300,1,25,12,3,8,18,67,38.26782686161377,-109.3726257
17301,1,22,14,2,4,25,68,38.26782686161377,-109.3723562
17302,1,21,15,1,3,27,68,38.26782686161377,-109.3720867
17303,1,18,14,2,2,27,64,38.26782686161377,-109.3718172
17304,2,12,13,3,2,25,57,38.26782686161377,-109.3715477
17305,4,16,11,6,9,12,58,38.26782686161377,-109.3712782
17306,16,29,12,10,8,3,78,38.26782686161377,-109.3710087
17307,22,36,10,5,9,0,82,38.26782686161377,-109.3707392
17308,16,44,10,8,8,0,86,38.26782686161377,-109.3704697
17309,2,31,10,7,10,8,68,38.26782686161377,-109.3702003
17310,1,32,11,1,8,15,68,38.26782686161377,-109.3699308
17311,0,28,12,0,6,21,67,38.26782686161377,-109.3696613
17312,0,29,11,0,5,20,65,38.26782686161377,-109.3693918
17313,0,33,10,0,6,19,68,38.26782686161377,-109.3691223
17314,0,30,11,0,4,22,67,38.26782686161377,-109.3688528
17315,3,22,8,1,3,14,51,38.26782686161377,-109.3685833
17316,5,31,6,4,6,8,60,38.26782686161377,-109.3683138
17317,3,35,4,4,7,3,56,38.26782686161377,-109.3680443
17318,2,27,4,2,5,5,45,38.26782686161377,-109.3677748
17319,3,30,6,2,8,4,53,38.26782686161377,-109.3675053
17320,3,23,7,5,8,6,52,38.26782686161377,-109.3672358
17321,3,30,9,5,10,6,63,38.26782686161377,-109.3669663
17322,3,36,9,4,11,6,69,38.26782686161377,-109.3666968
17323,2,36,10,4,11,6,69,38.26782686161377,-109.3664273
17324,1,40,11,1,11,7,71,38.26782686161377,-109.3661578
17325,3,28,13,3,8,14,69,38.26782686161377,-109.3658883
17326,2,28,15,3,11,14,73,38.26782686161377,-109.3656188
17327,2,25,13,3,18,9,70,38.26782686161377,-109.3653493
17328,3,21,9,10,13,2,58,38.26782686161377,-109.3650799
17329,2,27,9,8,10,10,66,38.26782686161377,-109.3648104
17330,0,18,11,3,4,20,56,38.26782686161377,-109.3645409
17331,1,21,17,0,4,30,73,38.26782686161377,-109.3642714
17332,1,21,17,0,2,33,74,38.26782686161377,-109.3640019
17333,1,21,17,0,3,30,72,38.26782686161377,-109.3637324
17334,1,20,16,0,1,29,67,38.26782686161377,-109.3634629
17335,0,19,15,0,1,29,64,38.26782686161377,-109.3631934
17336,0,16,14,0,2,24,56,38.26782686161377,-109.3629239
17337,1,23,11,3,4,13,55,38.26782686161377,-109.3626544
17338,6,38,6,6,5,5,66,38.26782686161377,-109.3623849
17339,5,30,6,5,6,7,59,38.26782686161377,-109.3621154
17340,4,25,7,4,7,10,57,38.26782686161377,-109.3618459
17341,4,23,9,3,5,13,57,38.26782686161377,-109.3615764
17342,2,25,11,3,6,15,62,38.26782686161377,-109.3613069
17343,1,33,10,1,8,15,68,38.26782686161377,-109.3610374
17344,0,31,10,0,7,14,62,38.26782686161377,-109.3607679
17345,2,25,10,3,7,9,56,38.26782686161377,-109.3604984
17346,9,25,12,8,8,5,67,38.26782686161377,-109.360229
17347,3,23,13,4,6,17,66,38.26782686161377,-109.3599595
17348,5,22,13,6,8,16,70,38.26782686161377,-109.35969
17349,3,24,14,0,5,24,70,38.26782686161377,-109.3594205
17350,2,24,14,0,4,25,69,38.26782686161377,-109.359151
17351,1,27,12,0,6,20,66,38.26782686161377,-109.3588815
17352,0,28,11,0,6,19,64,38.26782686161377,-109.358612
17353,1,26,13,0,6,21,67,38.26782686161377,-109.3583425
17354,3,25,15,0,9,20,72,38.26782686161377,-109.358073
17355,2,27,15,0,10,21,75,38.26782686161377,-109.3578035
17356,1,27,16,0,9,25,78,38.26782686161377,-109.357534
17357,2,26,18,2,11,23,82,38.26782686161377,-109.3572645
17358,5,25,17,7,13,15,82,38.26782686161377,-109.356995
17359,8,27,16,9,16,8,84,38.26782686161377,-109.3567255
17360,6,25,14,18,12,2,77,38.26782686161377,-109.356456
17361,3,20,10,17,13,4,67,38.26782686161377,-109.3561865
17362,3,13,9,12,12,6,55,38.26782686161377,-109.355917
17363,0,3,5,2,11,6,27,38.26782686161377,-109.3556475
17364,0,0,3,0,5,8,16,38.26782686161377,-109.355378
17365,1,3,5,4,6,7,26,38.26782686161377,-109.3551086
17366,1,2,8,23,16,9,59,38.26782686161377,-109.3548391
17367,2,10,14,20,15,14,75,38.26782686161377,-109.3545696
17368,1,15,13,18,16,8,71,38.26782686161377,-109.3543001
17369,1,21,14,10,15,12,73,38.26782686161377,-109.3540306
17370,4,20,14,12,8,20,78,38.26782686161377,-109.3537611
17371,6,15,14,11,6,25,77,38.26782686161377,-109.3534916
17372,0,23,17,0,5,29,74,38.26782686161377,-109.3532221
17373,0,23,17,0,5,29,74,38.26782686161377,-109.3529526
17374,0,24,18,0,5,30,77,38.26782686161377,-109.3526831
17375,0,24,18,0,5,31,78,38.26782686161377,-109.3524136
17376,1,24,16,0,4,28,73,38.26782686161377,-109.3521441
17377,1,24,16,0,4,27,72,38.26782686161377,-109.3518746
17378,0,21,17,0,4,30,72,38.26782686161377,-109.3516051
17379,0,19,18,0,4,31,72,38.26782686161377,-109.3513356
17380,1,20,17,1,4,29,72,38.26782686161377,-109.3510661
17381,3,23,18,4,6,26,80,38.26782686161377,-109.3507966
17382,2,23,18,5,6,26,80,38.26782686161377,-109.3505271
17383,2,22,18,5,6,27,80,38.26782686161377,-109.3502577
17384,0,24,20,1,5,34,84,38.26782686161377,-109.3499882
17385,1,23,20,2,6,34,86,38.26782686161377,-109.3497187
17386,1,21,22,0,6,37,87,38.26782686161377,-109.3494492
17387,1,22,21,0,7,35,86,38.26782686161377,-109.3491797
17388,2,24,19,2,8,31,86,38.26782686161377,-109.3489102
17389,3,26,18,4,8,27,86,38.26782686161377,-109.3486407
17390,3,26,19,3,9,27,87,38.26782686161377,-109.3483712
17391,3,26,19,2,7,30,87,38.26782686161377,-109.3481017
17392,2,25,20,0,6,33,86,38.26782686161377,-109.3478322
17393,1,22,20,0,5,34,82,38.26782686161377,-109.3475627
17394,1,20,20,0,3,33,77,38.26782686161377,-109.3472932
17395,1,20,18,0,2,31,72,38.26782686161377,-109.3470237
17396,2,22,18,0,3,29,74,38.26782686161377,-109.3467542
17397,2,25,20,2,5,27,81,38.26782686161377,-109.3464847
17398,2,24,20,2,5,28,81,38.26782686161377,-109.3462152
17399,2,21,19,0,2,27,71,38.26782686161377,-109.3459457
17400,1,22,19,0,2,28,72,38.26782686161377,-109.3456762
17401,2,23,20,1,4,30,80,38.26782686161377,-109.3454068
17402,2,23,20,2,5,31,83,38.26782686161377,-109.3451373
17403,1,22,20,2,4,33,82,38.26782686161377,-109.3448678
17404,2,25,19,3,3,29,81,38.26782686161377,-109.3445983
17405,3,31,16,3,7,19,79,38.26782686161377,-109.3443288
17406,4,37,14,4,12,11,82,38.26782686161377,-109.3440593
17407,6,38,14,8,13,7,86,38.26782686161377,-109.3437898
17408,8,36,14,11,12,7,88,38.26782686161377,-109.3435203
17409,10,36,14,14,10,5,89,38.26782686161377,-109.3432508
17410,8,38,14,12,10,6,88,38.26782686161377,-109.3429813
17411,7,38,14,11,11,5,86,38.26782686161377,-109.3427118
17412,7,38,14,9,10,6,84,38.26782686161377,-109.3424423
17413,6,40,14,9,10,6,85,38.26782686161377,-109.3421728
17414,6,40,13,9,10,6,84,38.26782686161377,-109.3419033
17415,7,40,14,10,11,5,87,38.26782686161377,-109.3416338
17416,8,40,14,11,12,4,89,38.26782686161377,-109.3413643
17417,7,39,14,10,13,5,88,38.26782686161377,-109.3410948
17418,7,39,15,11,14,4,90,38.26782686161377,-109.3408253
17419,8,39,14,11,13,4,89,38.26782686161377,-109.3405558
17420,8,39,14,11,12,5,89,38.26782686161377,-109.3402864
17421,9,38,14,11,12,6,90,38.26782686161377,-109.3400169
17422,11,33,14,12,11,7,88,38.26782686161377,-109.3397474
17423,14,31,14,14,10,6,89,38.26782686161377,-109.3394779
17424,12,33,14,12,12,6,89,38.26782686161377,-109.3392084
17425,6,35,13,9,14,6,83,38.26782686161377,-109.3389389
17426,6,38,13,9,15,5,86,38.26782686161377,-109.3386694
17427,10,39,13,11,15,3,91,38.26782686161377,-109.3383999
17428,15,37,14,11,11,4,92,38.26782686161377,-109.3381304
17429,14,36,14,10,9,7,90,38.26782686161377,-109.3378609
17430,9,39,13,9,10,8,88,38.26782686161377,-109.3375914
17431,5,44,13,9,10,7,88,38.26782686161377,-109.3373219
17432,5,46,13,8,9,7,88,38.26782686161377,-109.3370524
17433,5,45,13,8,10,6,87,38.26782686161377,-109.3367829
17434,1,37,11,0,14,14,77,38.26755736702853,-109.4397299
17435,0,36,12,0,14,16,78,38.26755736702853,-109.4394604
17436,1,37,12,0,13,16,79,38.26755736702853,-109.4391909
17437,2,43,12,0,17,9,83,38.26755736702853,-109.4389214
17438,2,47,11,0,17,8,85,38.26755736702853,-109.4386519
17439,2,46,10,0,15,10,83,38.26755736702853,-109.4383824
17440,1,41,11,0,13,13,79,38.26755736702853,-109.4381129
17441,1,39,11,0,14,13,78,38.26755736702853,-109.4378434
17442,1,36,11,0,12,15,75,38.26755736702853,-109.4375739
17443,2,40,11,0,13,12,78,38.26755736702853,-109.4373044
17444,2,45,11,0,15,11,84,38.26755736702853,-109.4370349
17445,2,44,11,0,16,10,83,38.26755736702853,-109.4367654
17446,0,34,12,0,12,16,74,38.26755736702853,-109.4364959
17447,0,34,13,0,12,16,75,38.26755736702853,-109.4362264
17448,1,35,12,0,12,17,77,38.26755736702853,-109.4359569
17449,1,35,12,0,11,18,77,38.26755736702853,-109.4356874
17450,1,40,11,0,13,14,79,38.26755736702853,-109.4354179
17451,0,36,13,0,15,16,80,38.26755736702853,-109.4351484
17452,0,34,13,2,16,15,80,38.26755736702853,-109.434879
17453,0,35,13,7,18,9,82,38.26755736702853,-109.4346095
17454,2,34,14,7,19,9,85,38.26755736702853,-109.43434
17455,0,34,14,2,18,12,80,38.26755736702853,-109.4340705
17456,1,37,12,0,16,13,79,38.26755736702853,-109.433801
17457,2,40,12,0,18,10,82,38.26755736702853,-109.4335315
17458,2,43,12,0,18,7,82,38.26755736702853,-109.433262
17459,2,40,12,0,16,10,80,38.26755736702853,-109.4329925
17460,0,37,13,0,14,17,81,38.26755736702853,-109.432723
17461,0,34,15,0,17,16,82,38.26755736702853,-109.4324535
17462,1,34,14,3,19,12,83,38.26755736702853,-109.432184
17463,1,34,14,3,18,13,83,38.26755736702853,-109.4319145
17464,0,31,14,0,13,18,76,38.26755736702853,-109.431645
17465,1,37,12,0,13,16,79,38.26755736702853,-109.4313755
17466,0,33,12,0,11,17,73,38.26755736702853,-109.431106
17467,0,31,12,0,10,19,72,38.26755736702853,-109.4308365
17468,2,35,12,0,12,15,76,38.26755736702853,-109.430567
17469,0,32,12,1,11,16,72,38.26755736702853,-109.4302975
17470,0,35,12,0,12,15,74,38.26755736702853,-109.430028
17471,1,36,12,0,13,15,77,38.26755736702853,-109.4297586
17472,1,36,13,0,14,15,79,38.26755736702853,-109.4294891
17473,1,39,13,0,15,13,81,38.26755736702853,-109.4292196
17474,1,38,13,0,14,14,80,38.26755736702853,-109.4289501
17475,0,35,13,0,15,15,78,38.26755736702853,-109.4286806
17476,0,34,14,0,18,14,80,38.26755736702853,-109.4284111
17477,0,35,14,0,19,11,79,38.26755736702853,-109.4281416
17478,1,35,13,0,14,13,76,38.26755736702853,-109.4278721
17479,2,36,12,0,12,14,76,38.26755736702853,-109.4276026
17480,2,35,12,0,14,13,76,38.26755736702853,-109.4273331
17481,2,36,13,0,15,12,78,38.26755736702853,-109.4270636
17482,2,37,12,0,14,14,79,38.26755736702853,-109.4267941
17483,2,38,12,0,14,12,78,38.26755736702853,-109.4265246
17484,2,37,12,0,13,13,77,38.26755736702853,-109.4262551
17485,2,37,12,0,13,14,78,38.26755736702853,-109.4259856
17486,2,38,12,0,12,14,78,38.26755736702853,-109.4257161
17487,1,36,12,0,12,14,75,38.26755736702853,-109.4254466
17488,2,40,12,0,16,10,80,38.26755736702853,-109.4251771
17489,2,37,12,0,12,15,78,38.26755736702853,-109.4249077
17490,2,37,12,0,12,15,78,38.26755736702853,-109.4246382
17491,2,39,12,0,15,9,77,38.26755736702853,-109.4243687
17492,3,41,12,2,17,6,81,38.26755736702853,-109.4240992
17493,3,37,11,2,15,8,76,38.26755736702853,-109.4238297
17494,3,37,11,2,14,7,74,38.26755736702853,-109.4235602
17495,4,40,11,3,15,5,78,38.26755736702853,-109.4232907
17496,4,41,11,5,16,2,79,38.26755736702853,-109.4230212
17497,5,40,11,9,16,1,82,38.26755736702853,-109.4227517
17498,7,41,12,11,15,0,86,38.26755736702853,-109.4224822
17499,8,43,12,10,16,0,89,38.26755736702853,-109.4222127
17500,7,43,13,10,16,0,89,38.26755736702853,-109.4219432
17501,8,43,13,10,17,0,91,38.26755736702853,-109.4216737
17502,7,43,13,10,17,0,90,38.26755736702853,-109.4214042
17503,7,43,14,11,16,0,91,38.26755736702853,-109.4211347
17504,7,45,14,11,16,0,93,38.26755736702853,-109.4208652
17505,9,44,13,11,15,0,92,38.26755736702853,-109.4205957
17506,11,43,13,11,14,0,92,38.26755736702853,-109.4203262
17507,5,49,13,9,16,0,92,38.26755736702853,-109.4200568
17508,5,52,11,5,17,0,90,38.26755736702853,-109.4197873
17509,5,53,11,5,18,0,92,38.26755736702853,-109.4195178
17510,5,51,13,7,19,0,95,38.26755736702853,-109.4192483
17511,6,50,13,8,18,0,95,38.26755736702853,-109.4189788
17512,4,51,12,8,17,0,92,38.26755736702853,-109.4187093
17513,6,49,13,10,16,0,94,38.26755736702853,-109.4184398
17514,9,45,14,12,14,0,94,38.26755736702853,-109.4181703
17515,10,44,14,12,15,0,95,38.26755736702853,-109.4179008
17516,8,45,14,11,16,0,94,38.26755736702853,-109.4176313
17517,8,46,13,9,17,0,93,38.26755736702853,-109.4173618
17518,8,46,13,8,17,0,92,38.26755736702853,-109.4170923
17519,8,45,13,9,17,0,92,38.26755736702853,-109.4168228
17520,9,44,13,9,17,0,92,38.26755736702853,-109.4165533
17521,9,44,13,9,17,0,92,38.26755736702853,-109.4162838
17522,10,43,13,10,16,0,92,38.26755736702853,-109.4160143
17523,10,42,13,10,16,0,91,38.26755736702853,-109.4157448
17524,7,45,13,9,18,0,92,38.26755736702853,-109.4154753
17525,6,47,13,7,17,0,90,38.26755736702853,-109.4152058
17526,5,48,12,7,18,0,90,38.26755736702853,-109.4149364
17527,6,48,12,8,17,0,91,38.26755736702853,-109.4146669
17528,8,47,12,8,16,0,91,38.26755736702853,-109.4143974
17529,11,45,12,9,14,0,91,38.26755736702853,-109.4141279
17530,7,49,11,9,15,0,91,38.26755736702853,-109.4138584
17531,4,51,12,7,18,0,92,38.26755736702853,-109.4135889
17532,4,49,13,9,19,0,94,38.26755736702853,-109.4133194
17533,4,49,13,8,19,0,93,38.26755736702853,-109.4130499
17534,4,50,12,5,19,0,90,38.26755736702853,-109.4127804
17535,5,48,13,6,20,0,92,38.26755736702853,-109.4125109
17536,7,46,13,7,19,0,92,38.26755736702853,-109.4122414
17537,7,47,13,7,19,0,93,38.26755736702853,-109.4119719
17538,6,48,13,6,19,0,92,38.26755736702853,-109.4117024
17539,6,50,12,6,17,0,91,38.26755736702853,-109.4114329
17540,6,49,13,7,18,0,93,38.26755736702853,-109.4111634
17541,6,49,13,7,18,0,93,38.26755736702853,-109.4108939
17542,5,50,13,6,18,0,92,38.26755736702853,-109.4106244
17543,5,51,12,4,17,1,90,38.26755736702853,-109.4103549
17544,7,48,13,7,17,0,92,38.26755736702853,-109.4100855
17545,7,47,13,7,17,1,92,38.26755736702853,-109.409816
17546,7,46,12,6,18,1,90,38.26755736702853,-109.4095465
17547,7,45,12,7,18,0,89,38.26755736702853,-109.409277
17548,7,44,12,8,19,0,90,38.26755736702853,-109.4090075
17549,7,45,12,7,18,1,90,38.26755736702853,-109.408738
17550,7,45,12,7,17,2,90,38.26755736702853,-109.4084685
17551,7,43,12,8,17,1,88,38.26755736702853,-109.408199
17552,7,41,12,9,17,2,88,38.26755736702853,-109.4079295
17553,8,41,12,9,16,2,88,38.26755736702853,-109.40766
17554,8,40,13,10,16,2,89,38.26755736702853,-109.4073905
17555,8,40,13,9,16,3,89,38.26755736702853,-109.407121
17556,7,41,13,7,16,4,88,38.26755736702853,-109.4068515
17557,3,45,12,2,12,10,84,38.26755736702853,-109.3879869
17558,5,47,12,5,13,5,87,38.26755736702853,-109.3877174
17559,7,46,14,9,12,3,91,38.26755736702853,-109.3874479
17560,8,40,12,7,13,6,86,38.26755736702853,-109.3871784
17561,6,30,13,3,10,14,76,38.26755736702853,-109.3869089
17562,4,30,14,1,10,19,78,38.26755736702853,-109.3866394
17563,7,37,13,2,11,13,83,38.26755736702853,-109.3863699
17564,5,41,13,3,15,8,85,38.26755736702853,-109.3861004
17565,4,42,12,3,16,6,83,38.26755736702853,-109.3858309
17566,4,44,12,4,16,5,85,38.26755736702853,-109.3855614
17567,4,46,12,4,17,4,87,38.26755736702853,-109.3852919
17568,4,45,11,4,16,4,84,38.26755736702853,-109.3850225
17569,5,45,12,5,16,2,85,38.26755736702853,-109.384753
17570,6,45,13,6,16,2,88,38.26755736702853,-109.3844835
17571,6,44,13,6,16,3,88,38.26755736702853,-109.384214
17572,5,44,13,4,17,4,87,38.26755736702853,-109.3839445
17573,4,50,13,3,16,5,91,38.26755736702853,-109.383675
17574,3,50,12,2,15,6,88,38.26755736702853,-109.3834055
17575,3,45,12,2,16,6,84,38.26755736702853,-109.383136
17576,4,39,12,3,15,7,80,38.26755736702853,-109.3828665
17577,4,41,11,2,13,8,79,38.26755736702853,-109.382597
17578,2,43,11,0,13,9,78,38.26755736702853,-109.3823275
17579,1,47,9,0,13,7,77,38.26755736702853,-109.382058
17580,1,46,9,0,13,7,76,38.26755736702853,-109.3817885
17581,1,37,9,1,9,11,68,38.26755736702853,-109.381519
17582,1,38,9,0,9,12,69,38.26755736702853,-109.3812495
17583,1,41,9,0,10,11,72,38.26755736702853,-109.38098
17584,1,39,10,0,9,13,72,38.26755736702853,-109.3807105
17585,1,35,10,0,9,14,69,38.26755736702853,-109.380441
17586,2,35,10,1,10,11,69,38.26755736702853,-109.3801716
17587,1,30,11,2,9,14,67,38.26755736702853,-109.3799021
17588,1,27,13,0,6,22,69,38.26755736702853,-109.3796326
17589,3,25,14,2,6,21,71,38.26755736702853,-109.3793631
17590,5,30,13,5,10,14,77,38.26755736702853,-109.3790936
17591,3,33,13,5,14,11,79,38.26755736702853,-109.3788241
17592,2,32,13,2,13,15,77,38.26755736702853,-109.3785546
17593,2,31,13,1,11,17,75,38.26755736702853,-109.3782851
17594,2,29,14,2,11,17,75,38.26755736702853,-109.3780156
17595,3,27,13,8,14,14,79,38.26755736702853,-109.3777461
17596,4,28,13,9,16,11,81,38.26755736702853,-109.3774766
17597,4,25,13,4,9,16,71,38.26755736702853,-109.3772071
17598,6,28,13,4,9,13,73,38.26755736702853,-109.3769376
17599,6,29,12,5,9,12,73,38.26755736702853,-109.3766681
17600,5,28,13,3,7,16,72,38.26755736702853,-109.3763986
17601,4,25,13,2,6,18,68,38.26755736702853,-109.3761291
17602,5,18,12,10,8,12,65,38.26755736702853,-109.3758596
17603,7,17,10,15,12,6,67,38.26755736702853,-109.3755901
17604,7,17,11,14,15,5,69,38.26755736702853,-109.3753206
17605,4,26,15,8,9,21,83,38.26755736702853,-109.3750512
17606,2,25,16,2,5,30,80,38.26755736702853,-109.3747817
17607,2,21,15,2,3,27,70,38.26755736702853,-109.3745122
17608,1,21,13,3,5,20,63,38.26755736702853,-109.3742427
17609,2,23,12,2,6,17,62,38.26755736702853,-109.3739732
17610,2,23,12,1,4,19,61,38.26755736702853,-109.3737037
17611,3,27,12,2,8,16,68,38.26755736702853,-109.3734342
17612,2,29,13,2,6,20,72,38.26755736702853,-109.3731647
17613,1,27,13,1,5,23,70,38.26755736702853,-109.3728952
17614,1,22,13,3,3,24,66,38.26755736702853,-109.3726257
17615,1,26,15,4,5,25,76,38.26755736702853,-109.3723562
17616,1,24,15,2,4,27,73,38.26755736702853,-109.3720867
17617,2,26,11,2,8,16,65,38.26755736702853,-109.3718172
17618,2,28,10,5,8,9,62,38.26755736702853,-109.3715477
17619,2,35,7,5,10,5,64,38.26755736702853,-109.3712782
17620,2,37,7,5,9,6,66,38.26755736702853,-109.3710087
17621,6,42,7,7,7,3,72,38.26755736702853,-109.3707392
17622,9,44,7,9,6,2,77,38.26755736702853,-109.3704697
17623,7,34,7,7,8,4,67,38.26755736702853,-109.3702003
17624,14,27,8,3,9,5,66,38.26755736702853,-109.3699308
17625,2,24,11,2,4,15,58,38.26755736702853,-109.3696613
17626,2,26,9,2,7,12,58,38.26755736702853,-109.3693918
17627,5,25,8,3,5,9,55,38.26755736702853,-109.3691223
17628,4,30,5,3,7,5,54,38.26755736702853,-109.3688528
17629,2,31,4,2,7,4,50,38.26755736702853,-109.3685833
17630,1,33,3,0,6,4,47,38.26755736702853,-109.3683138
17631,2,26,4,0,7,5,44,38.26755736702853,-109.3680443
17632,3,21,5,2,7,5,43,38.26755736702853,-109.3677748
17633,2,24,7,3,8,7,51,38.26755736702853,-109.3675053
17634,3,25,9,5,8,8,58,38.26755736702853,-109.3672358
17635,2,24,11,3,6,13,59,38.26755736702853,-109.3669663
17636,1,29,12,1,6,14,63,38.26755736702853,-109.3666968
17637,3,32,13,2,8,16,74,38.26755736702853,-109.3664273
17638,3,37,13,2,14,9,78,38.26755736702853,-109.3661578
17639,6,29,17,2,9,19,82,38.26755736702853,-109.3658883
17640,3,25,15,7,10,19,79,38.26755736702853,-109.3656188
17641,7,16,12,10,19,5,69,38.26755736702853,-109.3653493
17642,3,16,10,10,13,6,58,38.26755736702853,-109.3650799
17643,2,24,9,8,12,6,61,38.26755736702853,-109.3648104
17644,0,20,11,4,5,19,59,38.26755736702853,-109.3645409
17645,1,19,17,0,3,32,72,38.26755736702853,-109.3642714
17646,1,20,17,0,2,34,74,38.26755736702853,-109.3640019
17647,1,22,16,0,2,29,70,38.26755736702853,-109.3637324
17648,1,22,14,0,2,25,64,38.26755736702853,-109.3634629
17649,1,18,13,1,3,20,56,38.26755736702853,-109.3631934
17650,2,18,10,3,5,13,51,38.26755736702853,-109.3629239
17651,5,30,6,4,7,4,56,38.26755736702853,-109.3626544
17652,4,37,5,3,6,3,58,38.26755736702853,-109.3623849
17653,2,34,4,4,6,4,54,38.26755736702853,-109.3621154
17654,3,23,6,4,8,5,49,38.26755736702853,-109.3618459
17655,3,30,9,5,9,7,63,38.26755736702853,-109.3615764
17656,2,33,10,2,9,12,68,38.26755736702853,-109.3613069
17657,1,39,10,1,12,11,74,38.26755736702853,-109.3610374
17658,0,33,10,0,7,13,63,38.26755736702853,-109.3607679
17659,2,25,11,4,7,10,59,38.26755736702853,-109.3604984
17660,7,22,13,7,7,9,65,38.26755736702853,-109.360229
17661,5,23,13,4,7,15,67,38.26755736702853,-109.3599595
17662,3,25,10,6,9,8,61,38.26755736702853,-109.35969
17663,3,24,11,2,6,15,61,38.26755736702853,-109.3594205
17664,2,25,13,1,6,18,65,38.26755736702853,-109.359151
17665,2,30,12,0,8,17,69,38.26755736702853,-109.3588815
17666,0,28,10,0,7,17,62,38.26755736702853,-109.358612
17667,1,25,12,0,7,21,66,38.26755736702853,-109.3583425
17668,3,24,15,0,10,21,73,38.26755736702853,-109.358073
17669,1,26,14,0,9,21,71,38.26755736702853,-109.3578035
17670,2,27,16,2,9,22,78,38.26755736702853,-109.357534
17671,3,27,15,5,13,16,79,38.26755736702853,-109.3572645
17672,2,23,14,7,14,15,75,38.26755736702853,-109.356995
17673,1,20,14,11,19,11,76,38.26755736702853,-109.3567255
17674,3,15,14,19,21,4,76,38.26755736702853,-109.356456
17675,2,3,9,27,14,1,56,38.26755736702853,-109.3561865
17676,5,6,11,29,17,4,72,38.26755736702853,-109.355917
17677,5,14,14,25,19,5,82,38.26755736702853,-109.3556475
17678,3,14,15,23,15,14,84,38.26755736702853,-109.355378
17679,4,13,15,18,15,16,81,38.26755736702853,-109.3551086
17680,1,23,17,7,12,19,79,38.26755736702853,-109.3548391
17681,1,24,16,12,9,20,82,38.26755736702853,-109.3545696
17682,1,27,17,4,11,22,82,38.26755736702853,-109.3543001
17683,1,25,18,1,8,26,79,38.26755736702853,-109.3540306
17684,2,21,19,2,6,31,81,38.26755736702853,-109.3537611
17685,0,21,19,1,5,32,78,38.26755736702853,-109.3534916
17686,0,22,18,0,5,31,76,38.26755736702853,-109.3532221
17687,0,22,17,0,4,30,73,38.26755736702853,-109.3529526
17688,0,24,18,0,4,31,77,38.26755736702853,-109.3526831
17689,0,23,18,0,4,32,77,38.26755736702853,-109.3524136
17690,1,20,17,0,2,32,72,38.26755736702853,-109.3521441
17691,2,20,17,0,2,30,71,38.26755736702853,-109.3518746
17692,2,19,16,0,2,30,69,38.26755736702853,-109.3516051
17693,1,17,16,0,1,30,65,38.26755736702853,-109.3513356
17694,3,20,15,0,2,25,65,38.26755736702853,-109.3510661
17695,1,17,14,0,1,27,60,38.26755736702853,-109.3507966
17696,0,15,16,0,1,30,62,38.26755736702853,-109.3505271
17697,1,17,18,0,1,31,68,38.26755736702853,-109.3502577
17698,1,20,18,1,4,32,76,38.26755736702853,-109.3499882
17699,1,22,20,1,6,34,84,38.26755736702853,-109.3497187
17700,1,20,21,0,7,36,85,38.26755736702853,-109.3494492
17701,1,20,22,0,7,37,87,38.26755736702853,-109.3491797
17702,1,21,21,0,6,37,86,38.26755736702853,-109.3489102
17703,1,23,21,0,7,35,87,38.26755736702853,-109.3486407
17704,1,23,21,1,7,35,88,38.26755736702853,-109.3483712
17705,1,22,21,0,6,36,86,38.26755736702853,-109.3481017
17706,1,22,21,0,5,36,85,38.26755736702853,-109.3478322
17707,1,20,20,0,3,35,79,38.26755736702853,-109.3475627
17708,0,20,20,0,3,34,77,38.26755736702853,-109.3472932
17709,0,18,19,0,1,35,73,38.26755736702853,-109.3470237
17710,0,18,20,0,2,35,75,38.26755736702853,-109.3467542
17711,0,20,20,0,3,35,78,38.26755736702853,-109.3464847
17712,1,21,20,0,4,33,79,38.26755736702853,-109.3462152
17713,1,19,19,0,1,31,71,38.26755736702853,-109.3459457
17714,2,20,19,0,1,29,71,38.26755736702853,-109.3456762
17715,2,22,19,0,2,30,75,38.26755736702853,-109.3454068
17716,2,22,19,1,3,31,78,38.26755736702853,-109.3451373
17717,1,22,19,2,3,32,79,38.26755736702853,-109.3448678
17718,2,27,17,2,4,27,79,38.26755736702853,-109.3445983
17719,2,29,15,2,6,23,77,38.26755736702853,-109.3443288
17720,3,34,13,3,10,15,78,38.26755736702853,-109.3440593
17721,7,36,14,10,12,7,86,38.26755736702853,-109.3437898
17722,9,35,14,14,11,5,88,38.26755736702853,-109.3435203
17723,9,38,14,13,11,4,89,38.26755736702853,-109.3432508
17724,7,41,14,10,11,5,88,38.26755736702853,-109.3429813
17725,7,39,14,9,11,6,86,38.26755736702853,-109.3427118
17726,6,38,14,9,11,7,85,38.26755736702853,-109.3424423
17727,7,40,14,10,12,5,88,38.26755736702853,-109.3421728
17728,7,40,14,10,11,5,87,38.26755736702853,-109.3419033
17729,9,39,14,11,11,5,89,38.26755736702853,-109.3416338
17730,10,37,14,12,11,5,89,38.26755736702853,-109.3413643
17731,9,37,14,12,11,5,88,38.26755736702853,-109.3410948
17732,8,38,14,13,12,4,89,38.26755736702853,-109.3408253
17733,8,39,14,12,12,5,90,38.26755736702853,-109.3405558
17734,10,36,14,12,11,6,89,38.26755736702853,-109.3402864
17735,15,30,13,14,11,6,89,38.26755736702853,-109.3400169
17736,26,24,11,15,11,4,91,38.26755736702853,-109.3397474
17737,27,25,12,17,9,3,93,38.26755736702853,-109.3394779
17738,22,27,13,15,10,5,92,38.26755736702853,-109.3392084
17739,19,29,13,13,10,6,90,38.26755736702853,-109.3389389
17740,18,34,13,11,10,5,91,38.26755736702853,-109.3386694
17741,18,35,13,11,8,6,91,38.26755736702853,-109.3383999
17742,16,35,13,12,7,7,90,38.26755736702853,-109.3381304
17743,10,37,13,12,8,7,87,38.26755736702853,-109.3378609
17744,6,42,13,8,9,9,87,38.26755736702853,-109.3375914
17745,5,44,12,8,8,7,84,38.26755736702853,-109.3373219
17746,5,46,12,8,9,6,86,38.26755736702853,-109.3370524
17747,5,44,14,9,10,7,89,38.26755736702853,-109.3367829
17748,0,36,11,0,12,16,75,38.26728787,-109.4399993
17749,1,36,11,0,12,17,77,38.26728787,-109.4397299
17750,1,38,12,0,12,16,79,38.26728787,-109.4394604
17751,3,43,12,0,15,12,85,38.26728787,-109.4391909
17752,3,52,11,0,19,4,89,38.26728787,-109.4389214
17753,2,52,11,0,18,5,88,38.26728787,-109.4386519
17754,2,48,10,0,15,8,83,38.26728787,-109.4383824
17755,2,42,10,0,13,12,79,38.26728787,-109.4381129
17756,2,39,10,0,13,12,76,38.26728787,-109.4378434
17757,2,39,11,0,13,12,77,38.26728787,-109.4375739
17758,3,44,11,0,15,9,82,38.26728787,-109.4373044
17759,4,48,11,0,16,8,87,38.26728787,-109.4370349
17760,3,41,12,0,15,11,82,38.26728787,-109.4367654
17761,2,37,13,0,12,17,81,38.26728787,-109.4364959
17762,2,36,14,0,12,20,84,38.26728787,-109.4362264
17763,1,33,15,0,12,23,84,38.26728787,-109.4359569
17764,0,34,15,0,14,20,83,38.26728787,-109.4356874
17765,1,37,13,5,17,11,84,38.26728787,-109.4354179
17766,3,34,15,1,17,14,84,38.26728787,-109.4351484
17767,3,34,15,2,17,13,84,38.26728787,-109.434879
17768,2,34,14,4,20,10,84,38.26728787,-109.4346095
17769,2,36,14,7,20,5,84,38.26728787,-109.43434
17770,4,35,13,4,17,10,83,38.26728787,-109.4340705
17771,3,36,13,4,18,7,81,38.26728787,-109.433801
17772,3,41,11,4,19,4,82,38.26728787,-109.4335315
17773,4,43,11,4,18,3,83,38.26728787,-109.433262
17774,4,42,12,1,16,9,84,38.26728787,-109.4329925
17775,2,37,14,1,16,13,83,38.26728787,-109.432723
17776,1,36,14,3,17,13,84,38.26728787,-109.4324535
17777,2,35,14,6,20,9,86,38.26728787,-109.432184
17778,1,35,14,7,19,9,85,38.26728787,-109.4319145
17779,0,34,14,2,15,15,80,38.26728787,-109.431645
17780,1,35,13,0,14,17,80,38.26728787,-109.4313755
17781,0,34,13,0,13,18,78,38.26728787,-109.431106
17782,0,34,13,0,12,19,78,38.26728787,-109.4308365
17783,0,33,13,0,14,16,76,38.26728787,-109.430567
17784,0,33,13,0,13,16,75,38.26728787,-109.4302975
17785,3,38,13,0,14,13,81,38.26728787,-109.430028
17786,1,35,14,0,16,14,80,38.26728787,-109.4297586
17787,0,31,14,0,13,19,77,38.26728787,-109.4294891
17788,0,33,14,0,12,19,78,38.26728787,-109.4292196
17789,1,38,14,0,14,17,84,38.26728787,-109.4289501
17790,0,34,15,0,13,20,82,38.26728787,-109.4286806
17791,0,34,14,0,13,19,80,38.26728787,-109.4284111
17792,1,36,12,0,11,17,77,38.26728787,-109.4281416
17793,1,34,12,0,10,17,74,38.26728787,-109.4278721
17794,2,35,12,0,11,16,76,38.26728787,-109.4276026
17795,2,36,12,0,13,14,77,38.26728787,-109.4273331
17796,3,37,12,0,15,11,78,38.26728787,-109.4270636
17797,2,39,12,0,17,9,79,38.26728787,-109.4267941
17798,3,40,12,0,16,10,81,38.26728787,-109.4265246
17799,3,38,12,0,15,11,79,38.26728787,-109.4262551
17800,2,39,12,0,15,12,80,38.26728787,-109.4259856
17801,2,41,11,0,15,10,79,38.26728787,-109.4257161
17802,2,42,12,0,15,9,80,38.26728787,-109.4254466
17803,3,43,12,0,16,9,83,38.26728787,-109.4251771
17804,3,40,12,0,15,11,81,38.26728787,-109.4249077
17805,2,40,12,0,15,11,80,38.26728787,-109.4246382
17806,4,44,12,1,17,7,85,38.26728787,-109.4243687
17807,5,48,12,3,18,3,89,38.26728787,-109.4240992
17808,5,44,12,3,18,4,86,38.26728787,-109.4238297
17809,6,43,12,4,17,3,85,38.26728787,-109.4235602
17810,6,45,12,5,17,2,87,38.26728787,-109.4232907
17811,6,45,12,6,17,1,87,38.26728787,-109.4230212
17812,7,42,12,9,16,0,86,38.26728787,-109.4227517
17813,9,41,12,11,15,0,88,38.26728787,-109.4224822
17814,11,40,13,11,15,0,90,38.26728787,-109.4222127
17815,12,40,13,11,15,0,91,38.26728787,-109.4219432
17816,9,43,13,11,16,0,92,38.26728787,-109.4216737
17817,8,44,13,10,16,0,91,38.26728787,-109.4214042
17818,7,46,13,9,17,0,92,38.26728787,-109.4211347
17819,8,46,13,9,17,0,93,38.26728787,-109.4208652
17820,9,44,14,11,15,0,93,38.26728787,-109.4205957
17821,9,44,13,10,16,0,92,38.26728787,-109.4203262
17822,7,46,13,10,16,0,92,38.26728787,-109.4200568
17823,7,48,13,9,16,0,93,38.26728787,-109.4197873
17824,7,47,13,8,17,0,92,38.26728787,-109.4195178
17825,6,47,13,9,17,0,92,38.26728787,-109.4192483
17826,7,47,13,8,17,0,92,38.26728787,-109.4189788
17827,6,50,12,8,17,0,93,38.26728787,-109.4187093
17828,7,48,13,10,16,0,94,38.26728787,-109.4184398
17829,9,45,14,12,14,0,94,38.26728787,-109.4181703
17830,9,45,14,11,14,0,93,38.26728787,-109.4179008
17831,8,44,14,12,14,0,92,38.26728787,-109.4176313
17832,7,46,13,9,16,0,91,38.26728787,-109.4173618
17833,8,46,13,7,17,0,91,38.26728787,-109.4170923
17834,8,46,12,7,17,0,90,38.26728787,-109.4168228
17835,8,45,13,7,17,0,90,38.26728787,-109.4165533
17836,8,46,12,7,17,0,90,38.26728787,-109.4162838
17837,7,45,13,7,19,0,91,38.26728787,-109.4160143
17838,7,46,13,7,19,0,92,38.26728787,-109.4157448
17839,6,46,13,7,19,0,91,38.26728787,-109.4154753
17840,7,46,13,8,18,0,92,38.26728787,-109.4152058
17841,6,47,13,6,19,0,91,38.26728787,-109.4149364
17842,6,47,12,6,19,0,90,38.26728787,-109.4146669
17843,5,50,11,6,18,0,90,38.26728787,-109.4143974
17844,5,55,10,7,15,0,92,38.26728787,-109.4141279
17845,4,52,11,6,18,0,91,38.26728787,-109.4138584
17846,4,49,12,6,19,1,91,38.26728787,-109.4135889
17847,4,48,13,7,20,0,92,38.26728787,-109.4133194
17848,4,48,13,6,20,0,91,38.26728787,-109.4130499
17849,4,48,13,6,20,0,91,38.26728787,-109.4127804
17850,4,48,12,5,20,1,90,38.26728787,-109.4125109
17851,5,47,13,6,20,0,91,38.26728787,-109.4122414
17852,5,49,13,6,20,0,93,38.26728787,-109.4119719
17853,4,51,13,5,20,0,93,38.26728787,-109.4117024
17854,5,50,12,5,19,0,91,38.26728787,-109.4114329
17855,6,48,13,7,19,0,93,38.26728787,-109.4111634
17856,6,48,13,7,19,0,93,38.26728787,-109.4108939
17857,6,49,12,6,19,0,92,38.26728787,-109.4106244
17858,6,48,12,6,18,0,90,38.26728787,-109.4103549
17859,7,47,13,7,18,0,92,38.26728787,-109.4100855
17860,6,47,13,6,18,1,91,38.26728787,-109.409816
17861,6,48,12,6,18,1,91,38.26728787,-109.4095465
17862,6,47,12,6,18,0,89,38.26728787,-109.409277
17863,6,46,12,6,18,1,89,38.26728787,-109.4090075
17864,6,47,13,6,17,2,91,38.26728787,-109.408738
17865,6,46,13,6,17,2,90,38.26728787,-109.4084685
17866,6,44,13,6,17,4,90,38.26728787,-109.408199
17867,6,42,13,7,16,4,88,38.26728787,-109.4079295
17868,6,43,13,8,16,3,89,38.26728787,-109.40766
17869,5,42,13,7,15,5,87,38.26728787,-109.4073905
17870,5,41,13,6,15,7,87,38.26728787,-109.407121
17871,5,38,13,5,14,8,83,38.26728787,-109.4068515
17872,3,51,12,3,14,5,88,38.26728787,-109.3879869
17873,6,48,13,7,14,3,91,38.26728787,-109.3877174
17874,7,42,13,10,12,3,87,38.26728787,-109.3874479
17875,7,36,12,7,13,6,81,38.26728787,-109.3871784
17876,4,31,12,1,10,13,71,38.26728787,-109.3869089
17877,4,33,13,2,10,15,77,38.26728787,-109.3866394
17878,6,41,13,5,13,7,85,38.26728787,-109.3863699
17879,8,45,13,6,16,2,90,38.26728787,-109.3861004
17880,6,45,12,6,17,2,88,38.26728787,-109.3858309
17881,6,44,13,5,17,3,88,38.26728787,-109.3855614
17882,6,43,13,5,16,4,87,38.26728787,-109.3852919
17883,5,39,12,7,16,2,81,38.26728787,-109.3850225
17884,7,43,13,7,15,1,86,38.26728787,-109.384753
17885,7,43,13,7,15,2,87,38.26728787,-109.3844835
17886,6,43,13,6,16,3,87,38.26728787,-109.384214
17887,4,45,13,4,17,5,88,38.26728787,-109.3839445
17888,4,52,13,4,15,5,93,38.26728787,-109.383675
17889,4,46,12,3,16,6,87,38.26728787,-109.3834055
17890,5,36,12,5,15,7,80,38.26728787,-109.383136
17891,5,32,12,5,12,10,76,38.26728787,-109.3828665
17892,5,34,12,3,12,9,75,38.26728787,-109.382597
17893,2,38,9,1,12,9,71,38.26728787,-109.3823275
17894,1,49,9,0,13,5,77,38.26728787,-109.382058
17895,1,47,9,0,13,7,77,38.26728787,-109.3817885
17896,1,37,10,0,10,12,70,38.26728787,-109.381519
17897,1,32,10,1,9,13,66,38.26728787,-109.3812495
17898,1,32,11,1,9,13,67,38.26728787,-109.38098
17899,1,36,10,0,10,11,68,38.26728787,-109.3807105
17900,1,38,10,1,11,10,71,38.26728787,-109.380441
17901,2,31,11,5,11,10,70,38.26728787,-109.3801716
17902,1,33,14,1,12,17,78,38.26728787,-109.3799021
17903,1,25,14,0,6,24,70,38.26728787,-109.3796326
17904,3,24,13,0,5,20,65,38.26728787,-109.3793631
17905,5,25,12,6,9,12,69,38.26728787,-109.3790936
17906,5,27,12,12,13,5,74,38.26728787,-109.3788241
17907,6,31,13,11,15,4,80,38.26728787,-109.3785546
17908,6,31,13,9,15,8,82,38.26728787,-109.3782851
17909,4,31,13,9,17,10,84,38.26728787,-109.3780156
17910,4,28,13,10,18,10,83,38.26728787,-109.3777461
17911,6,28,14,11,14,12,85,38.26728787,-109.3774766
17912,7,27,14,5,10,16,79,38.26728787,-109.3772071
17913,6,30,14,2,9,16,77,38.26728787,-109.3769376
17914,4,30,13,1,9,17,74,38.26728787,-109.3766681
17915,4,28,14,2,8,20,76,38.26728787,-109.3763986
17916,7,30,15,4,8,16,80,38.26728787,-109.3761291
17917,8,21,11,12,11,8,71,38.26728787,-109.3758596
17918,11,19,11,12,14,5,72,38.26728787,-109.3755901
17919,10,22,11,13,13,8,77,38.26728787,-109.3753206
17920,5,22,17,6,7,26,83,38.26728787,-109.3750512
17921,6,21,17,4,2,25,75,38.26728787,-109.3747817
17922,4,23,15,3,3,22,70,38.26728787,-109.3745122
17923,3,26,13,2,4,21,69,38.26728787,-109.3742427
17924,3,23,15,2,3,23,69,38.26728787,-109.3739732
17925,4,25,15,0,3,25,72,38.26728787,-109.3737037
17926,4,26,13,0,5,21,69,38.26728787,-109.3734342
17927,2,27,14,1,2,24,70,38.26728787,-109.3731647
17928,2,24,14,3,3,27,73,38.26728787,-109.3728952
17929,2,20,13,6,4,28,73,38.26728787,-109.3726257
17930,1,21,13,6,5,28,74,38.26728787,-109.3723562
17931,2,23,13,3,4,19,64,38.26728787,-109.3720867
17932,1,40,9,0,11,10,71,38.26728787,-109.3718172
17933,2,45,8,2,11,7,75,38.26728787,-109.3715477
17934,2,48,8,3,11,5,77,38.26728787,-109.3712782
17935,2,42,7,4,10,6,71,38.26728787,-109.3710087
17936,2,43,7,4,9,6,71,38.26728787,-109.3707392
17937,3,45,6,5,8,4,71,38.26728787,-109.3704697
17938,3,43,6,7,6,4,69,38.26728787,-109.3702003
17939,3,41,6,8,6,4,68,38.26728787,-109.3699308
17940,3,34,6,7,9,4,63,38.26728787,-109.3696613
17941,4,36,5,6,8,3,62,38.26728787,-109.3693918
17942,2,36,4,4,6,3,55,38.26728787,-109.3691223
17943,3,35,4,0,6,3,51,38.26728787,-109.3688528
17944,4,34,4,0,6,3,51,38.26728787,-109.3685833
17945,4,28,5,0,6,5,48,38.26728787,-109.3683138
17946,3,20,5,2,6,6,42,38.26728787,-109.3680443
17947,5,22,8,4,7,7,53,38.26728787,-109.3677748
17948,3,29,11,5,8,9,65,38.26728787,-109.3675053
17949,4,28,13,4,8,12,69,38.26728787,-109.3672358
17950,3,34,13,1,5,19,75,38.26728787,-109.3669663
17951,4,29,15,0,4,23,75,38.26728787,-109.3666968
17952,4,25,15,2,4,25,75,38.26728787,-109.3664273
17953,5,20,16,7,6,25,79,38.26728787,-109.3661578
17954,3,23,15,5,8,19,73,38.26728787,-109.3658883
17955,2,22,16,0,13,18,71,38.26728787,-109.3656188
17956,4,14,11,12,20,4,65,38.26728787,-109.3653493
17957,6,13,10,8,17,5,59,38.26728787,-109.3650799
17958,4,23,10,10,14,6,67,38.26728787,-109.3648104
17959,2,22,14,5,7,22,72,38.26728787,-109.3645409
17960,0,20,17,0,3,32,72,38.26728787,-109.3642714
17961,1,20,17,0,2,31,71,38.26728787,-109.3640019
17962,1,21,15,0,2,27,66,38.26728787,-109.3637324
17963,2,23,13,0,0,24,62,38.26728787,-109.3634629
17964,4,21,11,1,2,15,54,38.26728787,-109.3631934
17965,2,23,6,3,7,5,46,38.26728787,-109.3629239
17966,2,31,4,2,8,3,50,38.26728787,-109.3626544
17967,2,30,4,2,7,5,50,38.26728787,-109.3623849
17968,2,29,5,1,8,4,49,38.26728787,-109.3621154
17969,3,29,7,3,9,4,55,38.26728787,-109.3618459
17970,2,32,8,6,10,6,64,38.26728787,-109.3615764
17971,1,36,9,1,9,10,66,38.26728787,-109.3613069
17972,1,37,9,1,11,9,68,38.26728787,-109.3610374
17973,1,29,10,1,6,11,58,38.26728787,-109.3607679
17974,2,22,11,4,6,11,56,38.26728787,-109.3604984
17975,4,20,14,6,6,14,64,38.26728787,-109.360229
17976,3,25,12,5,9,12,66,38.26728787,-109.3599595
17977,1,30,9,5,6,8,59,38.26728787,-109.35969
17978,2,29,10,5,7,8,61,38.26728787,-109.3594205
17979,2,27,11,1,8,13,62,38.26728787,-109.359151
17980,2,28,12,0,6,18,66,38.26728787,-109.3588815
17981,1,28,12,1,10,13,65,38.26728787,-109.358612
17982,0,25,10,0,7,16,58,38.26728787,-109.3583425
17983,1,24,14,0,8,21,68,38.26728787,-109.358073
17984,4,27,15,1,6,21,74,38.26728787,-109.3578035
17985,2,30,14,1,13,16,76,38.26728787,-109.357534
17986,5,29,14,6,14,9,77,38.26728787,-109.3572645
17987,7,23,14,3,11,15,73,38.26728787,-109.356995
17988,5,20,14,6,16,10,71,38.26728787,-109.3567255
17989,4,13,12,16,18,3,66,38.26728787,-109.356456
17990,6,5,9,31,14,0,65,38.26728787,-109.3561865
17991,3,14,12,20,14,3,66,38.26728787,-109.355917
17992,0,26,16,7,12,18,79,38.26728787,-109.3556475
17993,1,25,17,7,7,26,83,38.26728787,-109.355378
17994,0,24,19,0,10,27,80,38.26728787,-109.3551086
17995,0,24,18,2,9,29,82,38.26728787,-109.3548391
17996,0,24,20,1,6,32,83,38.26728787,-109.3545696
17997,1,24,19,1,6,32,83,38.26728787,-109.3543001
17998,1,24,19,0,6,32,82,38.26728787,-109.3540306
17999,1,24,20,0,5,32,82,38.26728787,-109.3537611
18000,0,23,18,0,5,32,78,38.26728787,-109.3534916
18001,0,19,17,0,3,33,72,38.26728787,-109.3532221
18002,0,21,17,0,3,31,72,38.26728787,-109.3529526
18003,0,23,17,0,4,31,75,38.26728787,-109.3526831
18004,1,23,18,0,4,32,78,38.26728787,-109.3524136
18005,2,21,17,0,2,32,74,38.26728787,-109.3521441
18006,3,20,16,0,1,29,69,38.26728787,-109.3518746
18007,3,19,16,0,1,27,66,38.26728787,-109.3516051
18008,3,19,15,1,2,26,66,38.26728787,-109.3513356
18009,4,20,15,0,1,24,64,38.26728787,-109.3510661
18010,2,18,14,0,1,26,61,38.26728787,-109.3507966
18011,2,16,15,0,1,28,62,38.26728787,-109.3505271
18012,1,16,17,0,0,30,64,38.26728787,-109.3502577
18013,1,17,19,0,1,33,71,38.26728787,-109.3499882
18014,0,20,20,0,4,36,80,38.26728787,-109.3497187
18015,1,19,21,0,7,37,85,38.26728787,-109.3494492
18016,1,18,22,0,7,39,87,38.26728787,-109.3491797
18017,1,18,22,0,6,40,87,38.26728787,-109.3489102
18018,0,22,21,0,6,36,85,38.26728787,-109.3486407
18019,0,22,21,0,6,36,85,38.26728787,-109.3483712
18020,0,21,21,0,6,36,84,38.26728787,-109.3481017
18021,1,20,20,0,4,35,80,38.26728787,-109.3478322
18022,1,19,20,0,2,34,76,38.26728787,-109.3475627
18023,1,18,18,0,2,33,72,38.26728787,-109.3472932
18024,1,16,19,0,1,35,72,38.26728787,-109.3470237
18025,0,16,20,0,1,37,74,38.26728787,-109.3467542
18026,0,17,20,0,2,36,75,38.26728787,-109.3464847
18027,1,16,19,0,2,33,71,38.26728787,-109.3462152
18028,1,15,18,0,2,27,63,38.26728787,-109.3459457
18029,2,19,17,0,2,24,64,38.26728787,-109.3456762
18030,2,22,17,1,3,26,71,38.26728787,-109.3454068
18031,2,24,18,2,4,27,77,38.26728787,-109.3451373
18032,2,26,16,2,5,25,76,38.26728787,-109.3448678
18033,4,34,15,2,9,18,82,38.26728787,-109.3445983
18034,4,34,14,5,11,14,82,38.26728787,-109.3443288
18035,5,35,13,8,12,9,82,38.26728787,-109.3440593
18036,6,37,14,12,14,5,88,38.26728787,-109.3437898
18037,8,37,14,12,11,5,87,38.26728787,-109.3435203
18038,7,40,14,11,13,4,89,38.26728787,-109.3432508
18039,6,41,14,10,12,5,88,38.26728787,-109.3429813
18040,6,40,13,8,11,6,84,38.26728787,-109.3427118
18041,6,39,14,9,10,7,85,38.26728787,-109.3424423
18042,9,40,14,12,10,5,90,38.26728787,-109.3421728
18043,11,37,14,12,10,5,89,38.26728787,-109.3419033
18044,11,36,14,13,10,5,89,38.26728787,-109.3416338
18045,12,35,14,14,10,4,89,38.26728787,-109.3413643
18046,10,36,14,13,9,6,88,38.26728787,-109.3410948
18047,9,36,14,13,11,5,88,38.26728787,-109.3408253
18048,10,35,14,13,12,5,89,38.26728787,-109.3405558
18049,16,29,13,14,11,6,89,38.26728787,-109.3402864
18050,25,25,12,14,10,5,91,38.26728787,-109.3400169
18051,29,23,13,15,7,4,91,38.26728787,-109.3397474
18052,21,28,13,14,9,5,90,38.26728787,-109.3394779
18053,23,29,13,11,9,6,91,38.26728787,-109.3392084
18054,26,29,13,11,8,5,92,38.26728787,-109.3389389
18055,24,29,13,11,7,6,90,38.26728787,-109.3386694
18056,18,31,13,13,7,6,88,38.26728787,-109.3383999
18057,11,38,14,14,7,6,90,38.26728787,-109.3381304
18058,6,44,13,11,9,5,88,38.26728787,-109.3378609
18059,6,46,13,9,9,6,89,38.26728787,-109.3375914
18060,5,46,13,9,9,6,88,38.26728787,-109.3373219
18061,5,44,14,9,10,6,88,38.26728787,-109.3370524
18062,6,43,14,10,11,7,91,38.26728787,-109.3367829
18063,7,42,14,10,9,8,90,38.26728787,-109.3365134
18064,0,37,11,0,15,14,77,38.267018377858065,-109.4399993
18065,0,36,11,0,14,14,75,38.267018377858065,-109.4397299
18066,1,38,12,0,13,14,78,38.267018377858065,-109.4394604
18067,2,36,12,0,10,18,78,38.267018377858065,-109.4391909
18068,2,47,11,0,15,10,85,38.267018377858065,-109.4389214
18069,2,45,11,0,14,11,83,38.267018377858065,-109.4386519
18070,2,38,11,0,12,14,77,38.267018377858065,-109.4383824
18071,1,36,11,0,10,16,74,38.267018377858065,-109.4381129
18072,2,42,11,0,12,11,78,38.267018377858065,-109.4378434
18073,1,37,11,0,13,14,76,38.267018377858065,-109.4375739
18074,1,37,11,0,15,12,76,38.267018377858065,-109.4373044
18075,0,37,11,0,15,14,77,38.267018377858065,-109.4370349
18076,0,36,13,0,13,18,80,38.267018377858065,-109.4367654
18077,0,31,14,0,15,18,78,38.267018377858065,-109.4364959
18078,0,33,14,0,14,18,79,38.267018377858065,-109.4362264
18079,0,36,13,0,14,17,80,38.267018377858065,-109.4359569
18080,0,37,12,0,13,17,79,38.267018377858065,-109.4356874
18081,0,34,12,0,10,18,74,38.267018377858065,-109.4354179
18082,1,38,11,0,13,14,77,38.267018377858065,-109.4351484
18083,2,39,11,0,15,12,79,38.267018377858065,-109.434879
18084,2,38,11,0,15,12,78,38.267018377858065,-109.4346095
18085,2,37,12,0,15,13,79,38.267018377858065,-109.43434
18086,5,36,13,0,12,15,81,38.267018377858065,-109.4340705
18087,4,38,13,1,17,11,84,38.267018377858065,-109.433801
18088,6,37,14,6,19,4,86,38.267018377858065,-109.4335315
18089,6,37,13,8,20,2,86,38.267018377858065,-109.433262
18090,2,36,13,1,17,12,81,38.267018377858065,-109.4329925
18091,2,34,15,6,18,10,85,38.267018377858065,-109.432723
18092,0,33,15,2,18,15,83,38.267018377858065,-109.4324535
18093,0,33,15,0,17,16,81,38.267018377858065,-109.432184
18094,0,33,15,0,16,16,80,38.267018377858065,-109.4319145
18095,0,34,14,1,15,16,80,38.267018377858065,-109.431645
18096,0,33,15,0,15,17,80,38.267018377858065,-109.4313755
18097,0,32,14,0,13,18,77,38.267018377858065,-109.431106
18098,0,33,13,0,12,19,77,38.267018377858065,-109.4308365
18099,1,33,13,0,12,19,78,38.267018377858065,-109.430567
18100,0,36,14,0,15,17,82,38.267018377858065,-109.4302975
18101,1,36,14,0,14,17,82,38.267018377858065,-109.430028
18102,1,33,14,0,13,19,80,38.267018377858065,-109.4297586
18103,0,31,15,0,12,21,79,38.267018377858065,-109.4294891
18104,0,32,14,0,12,21,79,38.267018377858065,-109.4292196
18105,0,35,14,0,14,18,81,38.267018377858065,-109.4289501
18106,0,34,14,0,13,19,80,38.267018377858065,-109.4286806
18107,0,35,12,0,11,18,76,38.267018377858065,-109.4284111
18108,1,36,12,0,11,16,76,38.267018377858065,-109.4281416
18109,1,36,12,0,10,17,76,38.267018377858065,-109.4278721
18110,2,36,13,0,11,16,78,38.267018377858065,-109.4276026
18111,3,37,12,0,14,13,79,38.267018377858065,-109.4273331
18112,3,37,12,1,17,8,78,38.267018377858065,-109.4270636
18113,3,41,12,4,19,4,83,38.267018377858065,-109.4267941
18114,3,43,12,1,17,7,83,38.267018377858065,-109.4265246
18115,3,41,12,0,17,8,81,38.267018377858065,-109.4262551
18116,2,40,11,0,16,9,78,38.267018377858065,-109.4259856
18117,2,40,11,0,15,9,77,38.267018377858065,-109.4257161
18118,2,41,12,0,16,9,80,38.267018377858065,-109.4254466
18119,3,45,12,0,17,8,85,38.267018377858065,-109.4251771
18120,3,45,12,1,16,8,85,38.267018377858065,-109.4249077
18121,4,44,12,2,17,6,85,38.267018377858065,-109.4246382
18122,5,45,12,2,18,5,87,38.267018377858065,-109.4243687
18123,5,49,12,4,18,2,90,38.267018377858065,-109.4240992
18124,6,47,12,6,18,1,90,38.267018377858065,-109.4238297
18125,8,45,13,7,18,1,92,38.267018377858065,-109.4235602
18126,8,44,12,8,18,0,90,38.267018377858065,-109.4232907
18127,8,43,12,9,17,0,89,38.267018377858065,-109.4230212
18128,10,41,13,10,16,0,90,38.267018377858065,-109.4227517
18129,11,40,13,11,16,0,91,38.267018377858065,-109.4224822
18130,13,39,13,11,14,0,90,38.267018377858065,-109.4222127
18131,15,39,13,11,14,0,92,38.267018377858065,-109.4219432
18132,13,41,14,12,14,0,94,38.267018377858065,-109.4216737
18133,9,44,13,10,16,0,92,38.267018377858065,-109.4214042
18134,8,46,12,8,17,0,91,38.267018377858065,-109.4211347
18135,8,45,13,8,17,0,91,38.267018377858065,-109.4208652
18136,9,43,13,11,15,0,91,38.267018377858065,-109.4205957
18137,9,42,14,12,15,0,92,38.267018377858065,-109.4203262
18138,9,44,13,11,15,0,92,38.267018377858065,-109.4200568
18139,9,43,13,11,15,0,91,38.267018377858065,-109.4197873
18140,9,43,13,10,16,0,91,38.267018377858065,-109.4195178
18141,9,43,13,10,15,0,90,38.267018377858065,-109.4192483
18142,11,42,13,10,15,0,91,38.267018377858065,-109.4189788
18143,9,44,13,9,16,0,91,38.267018377858065,-109.4187093
18144,10,44,13,10,15,0,92,38.267018377858065,-109.4184398
18145,10,44,13,10,14,0,91,38.267018377858065,-109.4181703
18146,8,46,14,11,15,0,94,38.267018377858065,-109.4179008
18147,5,46,12,10,16,0,89,38.267018377858065,-109.4176313
18148,6,47,13,9,17,0,92,38.267018377858065,-109.4173618
18149,7,46,13,7,18,0,91,38.267018377858065,-109.4170923
18150,7,46,13,7,18,0,91,38.267018377858065,-109.4168228
18151,9,45,13,8,18,0,93,38.267018377858065,-109.4165533
18152,6,46,13,6,19,0,90,38.267018377858065,-109.4162838
18153,6,47,13,6,19,0,91,38.267018377858065,-109.4160143
18154,6,46,13,7,19,0,91,38.267018377858065,-109.4157448
18155,7,46,13,7,18,0,91,38.267018377858065,-109.4154753
18156,6,46,12,7,18,0,89,38.267018377858065,-109.4152058
18157,5,47,12,6,19,0,89,38.267018377858065,-109.4149364
18158,6,50,12,6,18,0,92,38.267018377858065,-109.4146669
18159,6,55,10,5,15,0,91,38.267018377858065,-109.4143974
18160,5,58,10,5,14,0,92,38.267018377858065,-109.4141279
18161,5,50,12,5,19,0,91,38.267018377858065,-109.4138584
18162,5,48,13,5,20,0,91,38.267018377858065,-109.4135889
18163,5,47,13,6,20,0,91,38.267018377858065,-109.4133194
18164,5,46,13,7,20,0,91,38.267018377858065,-109.4130499
18165,5,46,13,7,20,0,91,38.267018377858065,-109.4127804
18166,5,46,13,6,20,0,90,38.267018377858065,-109.4125109
18167,7,47,13,6,20,0,93,38.267018377858065,-109.4122414
18168,6,48,12,5,20,0,91,38.267018377858065,-109.4119719
18169,5,50,12,4,20,0,91,38.267018377858065,-109.4117024
18170,5,50,12,4,19,0,90,38.267018377858065,-109.4114329
18171,4,50,12,5,20,0,91,38.267018377858065,-109.4111634
18172,5,49,13,5,20,0,92,38.267018377858065,-109.4108939
18173,5,49,13,6,19,0,92,38.267018377858065,-109.4106244
18174,5,49,12,6,19,1,92,38.267018377858065,-109.4103549
18175,5,49,13,5,19,1,92,38.267018377858065,-109.4100855
18176,4,50,12,4,18,2,90,38.267018377858065,-109.409816
18177,5,49,12,4,18,2,90,38.267018377858065,-109.4095465
18178,5,48,12,5,18,2,90,38.267018377858065,-109.409277
18179,6,47,12,6,18,1,90,38.267018377858065,-109.4090075
18180,6,47,13,8,18,0,92,38.267018377858065,-109.408738
18181,6,48,13,6,17,1,91,38.267018377858065,-109.4084685
18182,6,46,13,7,17,2,91,38.267018377858065,-109.408199
18183,7,44,13,9,16,1,90,38.267018377858065,-109.4079295
18184,8,44,14,10,16,1,93,38.267018377858065,-109.40766
18185,7,44,14,7,15,3,90,38.267018377858065,-109.4073905
18186,6,43,13,5,15,5,87,38.267018377858065,-109.407121
18187,6,38,13,6,14,6,83,38.267018377858065,-109.4068515
18188,3,48,13,4,16,5,89,38.267018377858065,-109.3879869
18189,7,44,14,9,16,1,91,38.267018377858065,-109.3877174
18190,9,35,13,9,12,6,84,38.267018377858065,-109.3874479
18191,5,31,12,2,9,13,72,38.267018377858065,-109.3871784
18192,3,30,12,0,8,15,68,38.267018377858065,-109.3869089
18193,3,34,12,0,11,14,74,38.267018377858065,-109.3866394
18194,3,43,13,4,15,6,84,38.267018377858065,-109.3863699
18195,7,45,13,6,17,1,89,38.267018377858065,-109.3861004
18196,6,43,13,6,17,2,87,38.267018377858065,-109.3858309
18197,6,42,13,6,17,3,87,38.267018377858065,-109.3855614
18198,6,39,13,7,16,3,84,38.267018377858065,-109.3852919
18199,6,36,12,10,16,2,82,38.267018377858065,-109.3850225
18200,9,39,13,9,15,1,86,38.267018377858065,-109.384753
18201,8,41,13,7,15,3,87,38.267018377858065,-109.3844835
18202,6,44,13,5,17,4,89,38.267018377858065,-109.384214
18203,4,48,13,4,16,4,89,38.267018377858065,-109.3839445
18204,4,50,13,4,16,5,92,38.267018377858065,-109.383675
18205,5,45,13,4,16,5,88,38.267018377858065,-109.3834055
18206,6,35,12,6,13,7,79,38.267018377858065,-109.383136
18207,6,31,12,6,11,9,75,38.267018377858065,-109.3828665
18208,4,35,10,3,11,9,72,38.267018377858065,-109.382597
18209,1,46,8,2,11,6,74,38.267018377858065,-109.3823275
18210,1,49,9,2,13,4,78,38.267018377858065,-109.382058
18211,1,44,10,2,13,5,75,38.267018377858065,-109.3817885
18212,1,35,10,2,11,8,67,38.267018377858065,-109.381519
18213,2,34,11,4,9,9,69,38.267018377858065,-109.3812495
18214,1,31,11,3,8,12,66,38.267018377858065,-109.38098
18215,1,30,11,3,9,12,66,38.267018377858065,-109.3807105
18216,1,31,11,2,11,12,68,38.267018377858065,-109.380441
18217,1,35,12,2,13,13,76,38.267018377858065,-109.3801716
18218,4,34,15,3,12,16,84,38.267018377858065,-109.3799021
18219,1,27,15,0,8,23,74,38.267018377858065,-109.3796326
18220,2,26,14,0,7,22,71,38.267018377858065,-109.3793631
18221,4,27,13,1,9,16,70,38.267018377858065,-109.3790936
18222,6,27,12,7,13,9,74,38.267018377858065,-109.3788241
18223,8,30,12,11,15,3,79,38.267018377858065,-109.3785546
18224,6,29,12,11,15,4,77,38.267018377858065,-109.3782851
18225,6,30,13,11,16,5,81,38.267018377858065,-109.3780156
18226,6,32,13,10,17,5,83,38.267018377858065,-109.3777461
18227,9,30,14,9,14,8,84,38.267018377858065,-109.3774766
18228,9,30,14,7,12,10,82,38.267018377858065,-109.3772071
18229,9,30,14,7,13,9,82,38.267018377858065,-109.3769376
18230,9,31,14,7,13,9,83,38.267018377858065,-109.3766681
18231,10,32,14,6,11,10,83,38.267018377858065,-109.3763986
18232,11,28,13,9,9,9,79,38.267018377858065,-109.3761291
18233,11,19,11,13,12,6,72,38.267018377858065,-109.3758596
18234,13,20,12,12,12,7,76,38.267018377858065,-109.3755901
18235,11,21,14,13,9,13,81,38.267018377858065,-109.3753206
18236,11,16,16,10,11,22,86,38.267018377858065,-109.3750512
18237,14,19,17,9,5,17,81,38.267018377858065,-109.3747817
18238,5,25,12,6,7,15,70,38.267018377858065,-109.3745122
18239,2,28,12,3,7,17,69,38.267018377858065,-109.3742427
18240,3,25,14,4,5,19,70,38.267018377858065,-109.3739732
18241,4,26,13,4,6,17,70,38.267018377858065,-109.3737037
18242,5,27,12,5,7,14,70,38.267018377858065,-109.3734342
18243,6,27,13,4,3,18,71,38.267018377858065,-109.3731647
18244,6,25,13,6,3,20,73,38.267018377858065,-109.3728952
18245,4,16,11,7,6,20,64,38.267018377858065,-109.3726257
18246,5,19,12,7,7,22,72,38.267018377858065,-109.3723562
18247,3,23,13,3,5,19,66,38.267018377858065,-109.3720867
18248,2,37,10,1,10,12,72,38.267018377858065,-109.3718172
18249,4,41,11,4,10,8,78,38.267018377858065,-109.3715477
18250,1,46,8,3,11,4,73,38.267018377858065,-109.3712782
18251,1,55,7,4,10,2,79,38.267018377858065,-109.3710087
18252,2,52,7,5,11,3,80,38.267018377858065,-109.3707392
18253,3,47,7,4,11,4,76,38.267018377858065,-109.3704697
18254,2,46,6,4,10,4,72,38.267018377858065,-109.3702003
18255,2,50,7,4,9,3,75,38.267018377858065,-109.3699308
18256,2,49,6,4,8,3,72,38.267018377858065,-109.3696613
18257,3,49,5,3,6,3,69,38.267018377858065,-109.3693918
18258,3,40,5,3,6,3,60,38.267018377858065,-109.3691223
18259,3,33,5,2,6,3,52,38.267018377858065,-109.3688528
18260,3,30,5,1,8,3,50,38.267018377858065,-109.3685833
18261,4,21,7,2,6,7,47,38.267018377858065,-109.3683138
18262,4,22,8,3,6,8,51,38.267018377858065,-109.3680443
18263,6,28,11,5,8,8,66,38.267018377858065,-109.3677748
18264,1,24,12,3,5,15,60,38.267018377858065,-109.3675053
18265,2,25,13,2,5,19,66,38.267018377858065,-109.3672358
18266,3,21,14,2,4,23,67,38.267018377858065,-109.3669663
18267,3,29,16,1,4,26,79,38.267018377858065,-109.3666968
18268,3,29,16,1,6,25,80,38.267018377858065,-109.3664273
18269,6,27,15,5,8,18,79,38.267018377858065,-109.3661578
18270,3,22,14,3,7,24,73,38.267018377858065,-109.3658883
18271,1,16,13,4,13,17,64,38.267018377858065,-109.3656188
18272,2,14,11,8,18,9,62,38.267018377858065,-109.3653493
18273,6,17,10,14,13,8,68,38.267018377858065,-109.3650799
18274,2,23,13,8,8,19,73,38.267018377858065,-109.3648104
18275,1,28,15,1,5,26,76,38.267018377858065,-109.3645409
18276,0,21,16,0,2,31,70,38.267018377858065,-109.3642714
18277,0,19,15,0,1,28,63,38.267018377858065,-109.3640019
18278,1,22,12,0,1,24,60,38.267018377858065,-109.3637324
18279,4,21,11,1,3,15,55,38.267018377858065,-109.3634629
18280,2,29,6,3,7,6,53,38.267018377858065,-109.3631934
18281,2,28,5,1,8,4,48,38.267018377858065,-109.3629239
18282,4,29,6,2,8,3,52,38.267018377858065,-109.3626544
18283,4,28,7,4,8,6,57,38.267018377858065,-109.3623849
18284,2,32,6,3,9,6,58,38.267018377858065,-109.3621154
18285,2,34,8,5,11,7,67,38.267018377858065,-109.3618459
18286,1,35,9,4,11,8,68,38.267018377858065,-109.3615764
18287,1,33,9,1,9,10,63,38.267018377858065,-109.3613069
18288,2,25,9,3,8,9,56,38.267018377858065,-109.3610374
18289,2,24,9,3,7,9,54,38.267018377858065,-109.3607679
18290,3,19,11,5,6,10,54,38.267018377858065,-109.3604984
18291,4,20,14,6,6,13,63,38.267018377858065,-109.360229
18292,3,28,11,4,9,9,64,38.267018377858065,-109.3599595
18293,2,32,9,6,6,7,62,38.267018377858065,-109.35969
18294,2,32,10,6,7,7,64,38.267018377858065,-109.3594205
18295,1,28,12,0,7,18,66,38.267018377858065,-109.359151
18296,1,26,13,0,5,23,68,38.267018377858065,-109.3588815
18297,1,26,12,0,6,20,65,38.267018377858065,-109.358612
18298,0,25,12,0,6,22,65,38.267018377858065,-109.3583425
18299,0,24,13,0,6,23,66,38.267018377858065,-109.358073
18300,0,25,12,0,7,21,65,38.267018377858065,-109.3578035
18301,3,27,12,0,8,16,66,38.267018377858065,-109.357534
18302,1,24,12,3,12,13,65,38.267018377858065,-109.3572645
18303,2,28,13,1,14,10,68,38.267018377858065,-109.356995
18304,3,29,15,1,13,11,72,38.267018377858065,-109.3567255
18305,4,22,14,13,16,5,74,38.267018377858065,-109.356456
18306,3,14,9,28,15,0,69,38.267018377858065,-109.3561865
18307,2,21,13,8,12,12,68,38.267018377858065,-109.355917
18308,0,25,19,0,6,29,79,38.267018377858065,-109.3556475
18309,0,22,19,0,3,35,79,38.267018377858065,-109.355378
18310,0,21,19,0,3,36,79,38.267018377858065,-109.3551086
18311,0,23,19,0,4,35,81,38.267018377858065,-109.3548391
18312,0,23,19,0,4,35,81,38.267018377858065,-109.3545696
18313,0,21,19,0,3,35,78,38.267018377858065,-109.3543001
18314,0,20,18,0,2,34,74,38.267018377858065,-109.3540306
18315,1,19,17,0,2,32,71,38.267018377858065,-109.3537611
18316,1,20,15,0,3,26,65,38.267018377858065,-109.3534916
18317,0,19,15,0,2,28,64,38.267018377858065,-109.3532221
18318,0,19,16,0,3,30,68,38.267018377858065,-109.3529526
18319,1,20,17,0,2,31,71,38.267018377858065,-109.3526831
18320,2,19,17,0,1,32,71,38.267018377858065,-109.3524136
18321,1,19,16,0,1,31,68,38.267018377858065,-109.3521441
18322,1,18,16,0,1,30,66,38.267018377858065,-109.3518746
18323,2,17,16,0,1,28,64,38.267018377858065,-109.3516051
18324,3,18,16,0,1,27,65,38.267018377858065,-109.3513356
18325,2,17,16,0,1,28,64,38.267018377858065,-109.3510661
18326,2,16,15,0,0,29,62,38.267018377858065,-109.3507966
18327,2,15,15,1,1,28,62,38.267018377858065,-109.3505271
18328,1,14,16,1,1,28,61,38.267018377858065,-109.3502577
18329,0,15,17,0,0,30,62,38.267018377858065,-109.3499882
18330,1,18,19,0,2,35,75,38.267018377858065,-109.3497187
18331,0,19,21,0,6,38,84,38.267018377858065,-109.3494492
18332,1,17,22,0,6,39,85,38.267018377858065,-109.3491797
18333,1,18,22,0,6,39,86,38.267018377858065,-109.3489102
18334,1,19,21,0,6,36,83,38.267018377858065,-109.3486407
18335,1,20,19,0,4,34,78,38.267018377858065,-109.3483712
18336,1,19,19,0,3,34,76,38.267018377858065,-109.3481017
18337,0,19,19,0,2,34,74,38.267018377858065,-109.3478322
18338,0,19,19,0,1,34,73,38.267018377858065,-109.3475627
18339,1,17,19,0,1,33,71,38.267018377858065,-109.3472932
18340,0,16,19,0,1,34,70,38.267018377858065,-109.3470237
18341,1,14,19,0,1,36,71,38.267018377858065,-109.3467542
18342,2,14,19,0,1,34,70,38.267018377858065,-109.3464847
18343,2,16,18,0,2,28,66,38.267018377858065,-109.3462152
18344,1,16,15,1,2,23,58,38.267018377858065,-109.3459457
18345,2,21,14,2,4,20,63,38.267018377858065,-109.3456762
18346,2,26,15,3,6,19,71,38.267018377858065,-109.3454068
18347,3,29,15,4,8,19,78,38.267018377858065,-109.3451373
18348,5,33,15,5,10,16,84,38.267018377858065,-109.3448678
18349,6,35,14,8,11,10,84,38.267018377858065,-109.3445983
18350,6,36,14,10,14,6,86,38.267018377858065,-109.3443288
18351,6,37,14,11,15,5,88,38.267018377858065,-109.3440593
18352,7,38,14,11,16,4,90,38.267018377858065,-109.3437898
18353,6,41,14,10,15,4,90,38.267018377858065,-109.3435203
18354,6,42,14,10,14,3,89,38.267018377858065,-109.3432508
18355,6,42,13,9,13,4,87,38.267018377858065,-109.3429813
18356,5,41,13,9,13,5,86,38.267018377858065,-109.3427118
18357,6,39,13,10,11,6,85,38.267018377858065,-109.3424423
18358,9,39,14,12,10,5,89,38.267018377858065,-109.3421728
18359,12,36,14,14,9,5,90,38.267018377858065,-109.3419033
18360,12,35,14,14,10,4,89,38.267018377858065,-109.3416338
18361,12,36,14,13,11,5,91,38.267018377858065,-109.3413643
18362,10,36,14,12,12,6,90,38.267018377858065,-109.3410948
18363,12,35,13,12,12,5,89,38.267018377858065,-109.3408253
18364,17,31,13,14,11,5,91,38.267018377858065,-109.3405558
18365,22,27,12,16,10,4,91,38.267018377858065,-109.3402864
18366,19,27,13,16,9,6,90,38.267018377858065,-109.3400169
18367,10,36,14,13,9,7,89,38.267018377858065,-109.3397474
18368,9,39,13,11,10,6,88,38.267018377858065,-109.3394779
18369,12,36,14,10,10,7,89,38.267018377858065,-109.3392084
18370,15,32,14,11,10,8,90,38.267018377858065,-109.3389389
18371,14,33,14,12,9,7,89,38.267018377858065,-109.3386694
18372,12,38,14,13,8,6,91,38.267018377858065,-109.3383999
18373,7,44,14,11,9,5,90,38.267018377858065,-109.3381304
18374,7,45,14,11,9,5,91,38.267018377858065,-109.3378609
18375,6,45,14,10,9,6,90,38.267018377858065,-109.3375914
18376,5,45,13,9,10,6,88,38.267018377858065,-109.3373219
18377,5,44,14,10,10,7,90,38.267018377858065,-109.3370524
18378,6,43,14,9,10,8,90,38.267018377858065,-109.3367829
18379,7,43,14,10,9,7,90,38.267018377858065,-109.3365134
18380,1,37,11,0,19,11,79,38.266748883272825,-109.4402688
18381,0,36,11,0,19,11,77,38.266748883272825,-109.4399993
18382,0,37,11,0,17,13,78,38.266748883272825,-109.4397299
18383,1,39,12,0,15,15,82,38.266748883272825,-109.4394604
18384,0,36,13,0,10,20,79,38.266748883272825,-109.4391909
18385,1,38,11,0,12,16,78,38.266748883272825,-109.4389214
18386,2,39,11,0,11,15,78,38.266748883272825,-109.4386519
18387,2,36,12,0,11,16,77,38.266748883272825,-109.4383824
18388,3,38,13,0,11,17,82,38.266748883272825,-109.4381129
18389,0,35,12,3,18,11,79,38.266748883272825,-109.4378434
18390,2,38,12,1,20,9,82,38.266748883272825,-109.4375739
18391,3,39,13,0,18,11,84,38.266748883272825,-109.4373044
18392,3,40,12,0,17,11,83,38.266748883272825,-109.4370349
18393,1,38,12,0,16,13,80,38.266748883272825,-109.4367654
18394,2,39,12,0,14,12,79,38.266748883272825,-109.4364959
18395,2,39,12,0,14,14,81,38.266748883272825,-109.4362264
18396,1,37,13,0,13,16,80,38.266748883272825,-109.4359569
18397,1,36,13,0,14,16,80,38.266748883272825,-109.4356874
18398,1,39,12,0,18,12,82,38.266748883272825,-109.4354179
18399,1,38,12,0,20,10,81,38.266748883272825,-109.4351484
18400,0,37,11,1,18,9,76,38.266748883272825,-109.434879
18401,0,38,11,0,17,10,76,38.266748883272825,-109.4346095
18402,1,39,12,0,15,13,80,38.266748883272825,-109.43434
18403,1,34,13,0,12,19,79,38.266748883272825,-109.4340705
18404,1,35,14,0,12,20,82,38.266748883272825,-109.433801
18405,1,34,14,0,15,17,81,38.266748883272825,-109.4335315
18406,1,33,14,0,18,15,81,38.266748883272825,-109.433262
18407,0,34,13,0,14,17,78,38.266748883272825,-109.4329925
18408,0,33,15,1,16,17,82,38.266748883272825,-109.432723
18409,2,33,15,1,16,17,84,38.266748883272825,-109.4324535
18410,1,34,15,2,18,14,84,38.266748883272825,-109.432184
18411,2,36,13,0,18,14,83,38.266748883272825,-109.4319145
18412,2,36,14,1,16,14,83,38.266748883272825,-109.431645
18413,2,35,14,0,17,13,81,38.266748883272825,-109.4313755
18414,1,35,14,0,17,14,81,38.266748883272825,-109.431106
18415,1,34,13,0,15,15,78,38.266748883272825,-109.4308365
18416,0,33,13,0,13,16,75,38.266748883272825,-109.430567
18417,1,33,13,0,14,15,76,38.266748883272825,-109.4302975
18418,1,35,14,0,14,14,78,38.266748883272825,-109.430028
18419,0,35,13,0,14,14,76,38.266748883272825,-109.4297586
18420,0,35,13,0,15,14,77,38.266748883272825,-109.4294891
18421,0,35,13,0,14,15,77,38.266748883272825,-109.4292196
18422,1,38,13,0,15,14,81,38.266748883272825,-109.4289501
18423,1,37,12,0,14,16,80,38.266748883272825,-109.4286806
18424,1,36,12,0,12,17,78,38.266748883272825,-109.4284111
18425,1,36,12,0,12,17,78,38.266748883272825,-109.4281416
18426,1,36,13,0,11,18,79,38.266748883272825,-109.4278721
18427,1,36,13,0,12,17,79,38.266748883272825,-109.4276026
18428,2,37,12,0,14,13,78,38.266748883272825,-109.4273331
18429,3,39,12,0,18,8,80,38.266748883272825,-109.4270636
18430,3,42,12,1,19,6,83,38.266748883272825,-109.4267941
18431,4,45,12,2,16,6,85,38.266748883272825,-109.4265246
18432,4,45,12,0,18,7,86,38.266748883272825,-109.4262551
18433,2,42,12,0,17,8,81,38.266748883272825,-109.4259856
18434,2,38,11,0,14,11,76,38.266748883272825,-109.4257161
18435,2,38,11,0,14,12,77,38.266748883272825,-109.4254466
18436,2,40,12,1,17,8,80,38.266748883272825,-109.4251771
18437,3,42,12,1,16,8,82,38.266748883272825,-109.4249077
18438,5,43,12,2,17,6,85,38.266748883272825,-109.4246382
18439,6,45,12,4,17,4,88,38.266748883272825,-109.4243687
18440,5,48,12,5,17,2,89,38.266748883272825,-109.4240992
18441,6,49,12,5,16,2,90,38.266748883272825,-109.4238297
18442,7,45,13,8,17,1,91,38.266748883272825,-109.4235602
18443,8,43,13,8,17,0,89,38.266748883272825,-109.4232907
18444,8,43,12,9,17,0,89,38.266748883272825,-109.4230212
18445,11,40,13,10,16,0,90,38.266748883272825,-109.4227517
18446,12,39,13,11,16,0,91,38.266748883272825,-109.4224822
18447,13,38,13,12,15,0,91,38.266748883272825,-109.4222127
18448,13,39,14,12,14,0,92,38.266748883272825,-109.4219432
18449,12,40,13,12,15,0,92,38.266748883272825,-109.4216737
18450,9,43,13,10,16,0,91,38.266748883272825,-109.4214042
18451,8,45,12,8,17,0,90,38.266748883272825,-109.4211347
18452,8,46,12,8,16,0,90,38.266748883272825,-109.4208652
18453,10,44,13,10,15,0,92,38.266748883272825,-109.4205957
18454,11,42,13,12,14,0,92,38.266748883272825,-109.4203262
18455,11,42,13,11,15,0,92,38.266748883272825,-109.4200568
18456,11,42,13,11,15,0,92,38.266748883272825,-109.4197873
18457,11,41,13,11,15,0,91,38.266748883272825,-109.4195178
18458,14,40,14,11,14,0,93,38.266748883272825,-109.4192483
18459,17,36,13,12,13,0,91,38.266748883272825,-109.4189788
18460,12,41,13,10,15,0,91,38.266748883272825,-109.4187093
18461,10,43,13,10,16,0,92,38.266748883272825,-109.4184398
18462,8,44,13,10,16,0,91,38.266748883272825,-109.4181703
18463,7,45,13,9,17,0,91,38.266748883272825,-109.4179008
18464,6,47,13,8,17,0,91,38.266748883272825,-109.4176313
18465,6,47,13,8,18,0,92,38.266748883272825,-109.4173618
18466,6,48,13,7,18,0,92,38.266748883272825,-109.4170923
18467,5,48,12,7,18,0,90,38.266748883272825,-109.4168228
18468,5,49,12,6,18,0,90,38.266748883272825,-109.4165533
18469,6,48,13,7,18,0,92,38.266748883272825,-109.4162838
18470,7,45,13,8,18,0,91,38.266748883272825,-109.4160143
18471,7,45,13,8,18,0,91,38.266748883272825,-109.4157448
18472,5,47,12,6,19,0,89,38.266748883272825,-109.4154753
18473,6,47,12,7,17,0,89,38.266748883272825,-109.4152058
18474,5,48,12,5,18,0,88,38.266748883272825,-109.4149364
18475,6,49,11,7,17,0,90,38.266748883272825,-109.4146669
18476,6,49,11,7,17,0,90,38.266748883272825,-109.4143974
18477,6,47,12,6,19,0,90,38.266748883272825,-109.4141279
18478,6,47,13,6,19,0,91,38.266748883272825,-109.4138584
18479,6,45,13,6,20,0,90,38.266748883272825,-109.4135889
18480,6,45,13,7,20,0,91,38.266748883272825,-109.4133194
18481,6,45,13,7,19,0,90,38.266748883272825,-109.4130499
18482,6,46,13,6,19,0,90,38.266748883272825,-109.4127804
18483,7,45,13,7,19,0,91,38.266748883272825,-109.4125109
18484,7,46,13,7,18,0,91,38.266748883272825,-109.4122414
18485,6,48,13,6,18,0,91,38.266748883272825,-109.4119719
18486,6,49,12,5,18,0,90,38.266748883272825,-109.4117024
18487,6,49,12,5,18,0,90,38.266748883272825,-109.4114329
18488,5,51,12,4,18,0,90,38.266748883272825,-109.4111634
18489,5,50,12,4,19,1,91,38.266748883272825,-109.4108939
18490,5,49,13,5,20,0,92,38.266748883272825,-109.4106244
18491,5,48,13,5,20,0,91,38.266748883272825,-109.4103549
18492,5,48,13,5,20,1,92,38.266748883272825,-109.4100855
18493,4,50,12,4,20,2,92,38.266748883272825,-109.409816
18494,5,50,12,4,19,2,92,38.266748883272825,-109.4095465
18495,5,50,12,4,18,1,90,38.266748883272825,-109.409277
18496,5,49,13,6,19,1,93,38.266748883272825,-109.4090075
18497,5,49,13,7,18,0,92,38.266748883272825,-109.408738
18498,6,48,14,10,17,0,95,38.266748883272825,-109.4084685
18499,6,47,14,11,16,0,94,38.266748883272825,-109.408199
18500,7,45,14,13,15,0,94,38.266748883272825,-109.4079295
18501,8,44,14,12,15,0,93,38.266748883272825,-109.40766
18502,5,45,13,6,16,4,89,38.266748883272825,-109.4073905
18503,4,43,13,6,16,4,86,38.266748883272825,-109.407121
18504,5,40,12,6,15,4,82,38.266748883272825,-109.4068515
18505,4,42,13,3,15,6,83,38.266748883272825,-109.3879869
18506,8,39,13,7,14,5,86,38.266748883272825,-109.3877174
18507,8,31,13,6,10,11,79,38.266748883272825,-109.3874479
18508,4,30,12,1,8,15,70,38.266748883272825,-109.3871784
18509,2,27,11,0,7,16,63,38.266748883272825,-109.3869089
18510,2,29,11,0,10,14,66,38.266748883272825,-109.3866394
18511,2,37,12,1,14,9,75,38.266748883272825,-109.3863699
18512,5,43,13,3,16,4,84,38.266748883272825,-109.3861004
18513,5,42,13,4,16,5,85,38.266748883272825,-109.3858309
18514,6,41,13,7,16,4,87,38.266748883272825,-109.3855614
18515,7,39,13,10,17,2,88,38.266748883272825,-109.3852919
18516,7,34,13,13,16,1,84,38.266748883272825,-109.3850225
18517,9,35,13,10,16,2,85,38.266748883272825,-109.384753
18518,7,38,13,6,16,4,84,38.266748883272825,-109.3844835
18519,5,43,12,5,17,3,85,38.266748883272825,-109.384214
18520,4,48,12,4,16,4,88,38.266748883272825,-109.3839445
18521,4,45,13,5,16,5,88,38.266748883272825,-109.383675
18522,4,42,13,4,15,7,85,38.266748883272825,-109.3834055
18523,4,36,12,4,13,8,77,38.266748883272825,-109.383136
18524,3,33,10,4,10,9,69,38.266748883272825,-109.3828665
18525,1,37,9,3,10,9,69,38.266748883272825,-109.382597
18526,0,47,8,2,11,5,73,38.266748883272825,-109.3823275
18527,1,43,9,3,10,6,72,38.266748883272825,-109.382058
18528,2,37,11,4,10,6,70,38.266748883272825,-109.3817885
18529,2,35,11,4,9,7,68,38.266748883272825,-109.381519
18530,2,35,11,6,7,8,69,38.266748883272825,-109.3812495
18531,1,28,11,3,11,12,66,38.266748883272825,-109.38098
18532,1,26,11,3,10,15,66,38.266748883272825,-109.3807105
18533,2,27,13,2,10,17,71,38.266748883272825,-109.380441
18534,3,28,14,1,10,18,74,38.266748883272825,-109.3801716
18535,4,30,14,3,10,15,76,38.266748883272825,-109.3799021
18536,4,31,15,5,11,15,81,38.266748883272825,-109.3796326
18537,2,28,15,2,9,21,77,38.266748883272825,-109.3793631
18538,2,24,14,0,7,23,70,38.266748883272825,-109.3790936
18539,3,26,13,1,8,18,69,38.266748883272825,-109.3788241
18540,7,32,13,5,14,10,81,38.266748883272825,-109.3785546
18541,5,33,13,7,17,8,83,38.266748883272825,-109.3782851
18542,6,31,13,10,17,5,82,38.266748883272825,-109.3780156
18543,9,30,13,13,16,3,84,38.266748883272825,-109.3777461
18544,14,29,13,10,13,3,82,38.266748883272825,-109.3774766
18545,11,28,13,10,15,4,81,38.266748883272825,-109.3772071
18546,10,30,12,9,16,5,82,38.266748883272825,-109.3769376
18547,9,31,12,7,17,6,82,38.266748883272825,-109.3766681
18548,10,30,13,7,15,6,81,38.266748883272825,-109.3763986
18549,11,24,12,11,11,7,76,38.266748883272825,-109.3761291
18550,15,18,11,11,11,4,70,38.266748883272825,-109.3758596
18551,14,20,12,11,10,7,74,38.266748883272825,-109.3755901
18552,10,25,14,10,9,13,81,38.266748883272825,-109.3753206
18553,12,19,15,13,8,14,81,38.266748883272825,-109.3750512
18554,11,17,13,13,11,9,74,38.266748883272825,-109.3747817
18555,10,22,12,10,8,9,71,38.266748883272825,-109.3745122
18556,9,25,12,7,8,8,69,38.266748883272825,-109.3742427
18557,8,24,12,6,9,9,68,38.266748883272825,-109.3739732
18558,10,26,11,6,10,7,70,38.266748883272825,-109.3737037
18559,11,25,11,6,9,7,69,38.266748883272825,-109.3734342
18560,11,26,12,6,7,10,72,38.266748883272825,-109.3731647
18561,10,25,12,6,7,12,72,38.266748883272825,-109.3728952
18562,11,22,11,8,9,10,71,38.266748883272825,-109.3726257
18563,13,18,12,11,9,9,72,38.266748883272825,-109.3723562
18564,9,29,12,5,7,9,71,38.266748883272825,-109.3720867
18565,4,39,10,2,12,8,75,38.266748883272825,-109.3718172
18566,2,39,9,2,13,8,73,38.266748883272825,-109.3715477
18567,0,41,9,1,13,6,70,38.266748883272825,-109.3712782
18568,1,52,8,3,11,4,79,38.266748883272825,-109.3710087
18569,2,53,9,5,11,2,82,38.266748883272825,-109.3707392
18570,2,54,7,4,11,2,80,38.266748883272825,-109.3704697
18571,2,56,7,4,10,3,82,38.266748883272825,-109.3702003
18572,2,58,7,3,11,3,84,38.266748883272825,-109.3699308
18573,2,55,7,4,11,2,81,38.266748883272825,-109.3696613
18574,3,47,7,4,10,4,75,38.266748883272825,-109.3693918
18575,2,39,6,4,7,5,63,38.266748883272825,-109.3691223
18576,4,34,6,3,7,3,57,38.266748883272825,-109.3688528
18577,3,27,7,1,8,4,50,38.266748883272825,-109.3685833
18578,4,25,8,2,7,9,55,38.266748883272825,-109.3683138
18579,4,24,9,3,5,12,57,38.266748883272825,-109.3680443
18580,6,28,14,3,4,16,71,38.266748883272825,-109.3677748
18581,2,22,14,1,4,20,63,38.266748883272825,-109.3675053
18582,6,24,16,0,5,28,79,38.266748883272825,-109.3672358
18583,3,25,16,0,4,29,77,38.266748883272825,-109.3669663
18584,2,29,14,1,4,29,79,38.266748883272825,-109.3666968
18585,2,27,15,1,8,23,76,38.266748883272825,-109.3664273
18586,3,26,16,3,10,21,79,38.266748883272825,-109.3661578
18587,3,21,13,6,12,15,70,38.266748883272825,-109.3658883
18588,2,16,12,5,15,16,66,38.266748883272825,-109.3656188
18589,1,13,11,8,14,10,57,38.266748883272825,-109.3653493
18590,3,19,10,7,14,7,60,38.266748883272825,-109.3650799
18591,1,25,12,2,9,19,68,38.266748883272825,-109.3648104
18592,0,31,14,0,3,29,77,38.266748883272825,-109.3645409
18593,0,20,14,0,1,28,63,38.266748883272825,-109.3642714
18594,1,21,12,0,3,19,56,38.266748883272825,-109.3640019
18595,4,22,10,1,3,15,55,38.266748883272825,-109.3637324
18596,2,27,6,3,8,5,51,38.266748883272825,-109.3634629
18597,3,31,5,1,8,4,52,38.266748883272825,-109.3631934
18598,4,26,7,0,7,5,49,38.266748883272825,-109.3629239
18599,3,24,8,3,8,6,52,38.266748883272825,-109.3626544
18600,3,33,8,5,10,7,66,38.266748883272825,-109.3623849
18601,2,34,8,4,10,8,66,38.266748883272825,-109.3621154
18602,2,35,8,3,10,8,66,38.266748883272825,-109.3618459
18603,2,34,8,3,10,9,66,38.266748883272825,-109.3615764
18604,1,26,8,2,8,8,53,38.266748883272825,-109.3613069
18605,2,19,9,4,9,7,50,38.266748883272825,-109.3610374
18606,3,21,11,5,7,9,56,38.266748883272825,-109.3607679
18607,4,20,14,9,7,12,66,38.266748883272825,-109.3604984
18608,6,26,15,11,11,9,78,38.266748883272825,-109.360229
18609,1,27,11,7,11,9,66,38.266748883272825,-109.3599595
18610,2,29,10,5,7,8,61,38.266748883272825,-109.35969
18611,1,29,12,2,7,13,64,38.266748883272825,-109.3594205
18612,1,27,13,0,5,22,68,38.266748883272825,-109.359151
18613,1,26,13,0,5,23,68,38.266748883272825,-109.3588815
18614,2,24,12,0,6,20,64,38.266748883272825,-109.358612
18615,2,22,13,0,4,23,64,38.266748883272825,-109.3583425
18616,1,21,14,0,4,26,66,38.266748883272825,-109.358073
18617,3,25,16,0,6,27,77,38.266748883272825,-109.3578035
18618,3,27,15,0,6,24,75,38.266748883272825,-109.357534
18619,2,26,12,1,11,14,66,38.266748883272825,-109.3572645
18620,6,27,14,9,5,12,73,38.266748883272825,-109.356995
18621,4,30,14,7,10,9,74,38.266748883272825,-109.3567255
18622,5,27,12,11,10,5,70,38.266748883272825,-109.356456
18623,10,24,11,15,10,3,73,38.266748883272825,-109.3561865
18624,9,26,11,14,8,8,76,38.266748883272825,-109.355917
18625,0,19,14,0,3,27,63,38.266748883272825,-109.3556475
18626,0,18,17,0,1,35,71,38.266748883272825,-109.355378
18627,0,19,18,0,1,35,73,38.266748883272825,-109.3551086
18628,0,19,18,0,2,35,74,38.266748883272825,-109.3548391
18629,1,17,18,0,1,35,72,38.266748883272825,-109.3545696
18630,1,16,18,0,1,33,69,38.266748883272825,-109.3543001
18631,2,16,17,0,1,30,66,38.266748883272825,-109.3540306
18632,2,16,16,0,1,28,63,38.266748883272825,-109.3537611
18633,2,17,13,1,3,21,57,38.266748883272825,-109.3534916
18634,2,15,13,2,3,20,55,38.266748883272825,-109.3532221
18635,1,13,14,1,3,25,57,38.266748883272825,-109.3529526
18636,1,14,16,0,1,30,62,38.266748883272825,-109.3526831
18637,2,19,16,0,0,30,67,38.266748883272825,-109.3524136
18638,0,19,16,0,2,29,66,38.266748883272825,-109.3521441
18639,0,19,16,0,2,29,66,38.266748883272825,-109.3518746
18640,1,17,16,0,1,29,64,38.266748883272825,-109.3516051
18641,2,16,16,0,1,28,63,38.266748883272825,-109.3513356
18642,2,15,15,0,1,28,61,38.266748883272825,-109.3510661
18643,3,15,15,1,1,28,63,38.266748883272825,-109.3507966
18644,2,14,15,0,0,28,59,38.266748883272825,-109.3505271
18645,1,13,15,1,1,26,57,38.266748883272825,-109.3502577
18646,1,13,14,2,2,24,56,38.266748883272825,-109.3499882
18647,1,14,16,0,1,30,62,38.266748883272825,-109.3497187
18648,1,19,19,0,3,35,77,38.266748883272825,-109.3494492
18649,0,20,20,0,6,37,83,38.266748883272825,-109.3491797
18650,0,20,21,0,6,38,85,38.266748883272825,-109.3489102
18651,1,20,20,0,5,36,82,38.266748883272825,-109.3486407
18652,2,22,20,2,4,31,81,38.266748883272825,-109.3483712
18653,1,21,19,1,3,32,77,38.266748883272825,-109.3481017
18654,1,20,19,0,2,33,75,38.266748883272825,-109.3478322
18655,0,19,19,0,2,34,74,38.266748883272825,-109.3475627
18656,1,17,19,0,1,33,71,38.266748883272825,-109.3472932
18657,1,18,19,0,1,34,73,38.266748883272825,-109.3470237
18658,1,16,19,0,2,34,72,38.266748883272825,-109.3467542
18659,1,17,19,0,2,31,70,38.266748883272825,-109.3464847
18660,2,18,16,0,2,26,64,38.266748883272825,-109.3462152
18661,1,19,14,0,3,22,59,38.266748883272825,-109.3459457
18662,2,23,14,3,6,20,68,38.266748883272825,-109.3456762
18663,4,30,15,5,11,16,81,38.266748883272825,-109.3454068
18664,5,31,14,9,11,13,83,38.266748883272825,-109.3451373
18665,6,33,14,12,11,8,84,38.266748883272825,-109.3448678
18666,5,35,14,9,12,10,85,38.266748883272825,-109.3445983
18667,6,35,14,10,14,7,86,38.266748883272825,-109.3443288
18668,6,35,14,11,15,6,87,38.266748883272825,-109.3440593
18669,8,36,14,12,14,5,89,38.266748883272825,-109.3437898
18670,7,39,14,11,15,4,90,38.266748883272825,-109.3435203
18671,7,41,14,9,13,5,89,38.266748883272825,-109.3432508
18672,7,41,14,9,12,5,88,38.266748883272825,-109.3429813
18673,7,40,13,10,12,5,87,38.266748883272825,-109.3427118
18674,8,38,14,10,11,6,87,38.266748883272825,-109.3424423
18675,10,37,14,13,10,5,89,38.266748883272825,-109.3421728
18676,9,38,14,13,11,6,91,38.266748883272825,-109.3419033
18677,9,39,15,11,13,5,92,38.266748883272825,-109.3416338
18678,10,38,15,11,13,4,91,38.266748883272825,-109.3413643
18679,14,33,14,12,9,7,89,38.266748883272825,-109.3410948
18680,18,31,14,13,8,7,91,38.266748883272825,-109.3408253
18681,20,30,13,13,7,7,90,38.266748883272825,-109.3405558
18682,18,30,13,15,8,6,90,38.266748883272825,-109.3402864
18683,13,34,14,15,9,4,89,38.266748883272825,-109.3400169
18684,7,40,14,13,10,5,89,38.266748883272825,-109.3397474
18685,9,38,14,14,9,5,89,38.266748883272825,-109.3394779
18686,10,37,14,13,9,7,90,38.266748883272825,-109.3392084
18687,10,36,14,12,11,6,89,38.266748883272825,-109.3389389
18688,9,38,14,12,10,6,89,38.266748883272825,-109.3386694
18689,10,41,14,12,8,6,91,38.266748883272825,-109.3383999
18690,7,45,14,12,8,4,90,38.266748883272825,-109.3381304
18691,8,43,14,13,8,4,90,38.266748883272825,-109.3378609
18692,8,41,15,11,8,7,90,38.266748883272825,-109.3375914
18693,5,42,14,10,10,8,89,38.266748883272825,-109.3373219
18694,5,42,14,11,10,6,88,38.266748883272825,-109.3370524
18695,5,44,14,10,10,7,90,38.266748883272825,-109.3367829
18696,6,43,14,12,10,5,90,38.266748883272825,-109.3365134
18697,8,42,15,13,9,5,92,38.266748883272825,-109.3362439
18698,0,35,12,0,16,12,75,38.26647938868759,-109.4402688
18699,0,35,11,0,15,14,75,38.26647938868759,-109.4399993
18700,0,34,11,0,14,15,74,38.26647938868759,-109.4397299
18701,1,34,12,0,13,15,75,38.26647938868759,-109.4394604
18702,1,37,11,0,12,16,77,38.26647938868759,-109.4391909
18703,1,41,11,0,12,14,79,38.26647938868759,-109.4389214
18704,1,40,11,0,13,10,75,38.26647938868759,-109.4386519
18705,1,36,12,1,13,11,74,38.26647938868759,-109.4383824
18706,1,34,11,1,13,13,73,38.26647938868759,-109.4381129
18707,1,36,11,0,15,13,76,38.26647938868759,-109.4378434
18708,3,38,12,0,14,15,82,38.26647938868759,-109.4375739
18709,3,37,13,0,11,16,80,38.26647938868759,-109.4373044
18710,2,37,12,0,12,16,79,38.26647938868759,-109.4370349
18711,2,39,11,0,13,14,79,38.26647938868759,-109.4367654
18712,1,36,13,0,12,15,77,38.26647938868759,-109.4364959
18713,0,35,14,0,13,17,79,38.26647938868759,-109.4362264
18714,3,27,13,6,5,19,73,38.26647938868759,-109.4359569
18715,4,28,14,9,7,15,77,38.26647938868759,-109.4356874
18716,1,31,12,9,19,7,79,38.26647938868759,-109.4354179
18717,2,33,13,10,22,6,86,38.26647938868759,-109.4351484
18718,2,32,14,7,17,10,82,38.26647938868759,-109.434879
18719,1,31,13,1,16,12,74,38.26647938868759,-109.4346095
18720,0,33,12,0,16,12,73,38.26647938868759,-109.43434
18721,0,30,12,4,14,13,73,38.26647938868759,-109.4340705
18722,2,29,12,8,14,6,71,38.26647938868759,-109.433801
18723,3,30,13,6,18,6,76,38.26647938868759,-109.4335315
18724,3,32,14,6,17,11,83,38.26647938868759,-109.433262
18725,1,34,14,0,14,17,80,38.26647938868759,-109.4329925
18726,1,33,15,0,14,18,81,38.26647938868759,-109.432723
18727,2,34,15,0,15,17,83,38.26647938868759,-109.4324535
18728,1,35,14,0,15,17,82,38.26647938868759,-109.432184
18729,1,34,13,0,14,18,80,38.26647938868759,-109.4319145
18730,1,35,14,0,16,15,81,38.26647938868759,-109.431645
18731,1,35,13,0,16,14,79,38.26647938868759,-109.4313755
18732,1,36,13,0,16,14,80,38.26647938868759,-109.431106
18733,1,38,12,0,15,14,80,38.26647938868759,-109.4308365
18734,0,37,11,0,14,15,77,38.26647938868759,-109.430567
18735,0,32,12,0,13,14,71,38.26647938868759,-109.4302975
18736,0,31,12,0,12,15,70,38.26647938868759,-109.430028
18737,0,33,11,0,12,14,70,38.26647938868759,-109.4297586
18738,1,38,11,0,13,12,75,38.26647938868759,-109.4294891
18739,2,37,11,0,14,11,75,38.26647938868759,-109.4292196
18740,1,36,12,0,14,14,77,38.26647938868759,-109.4289501
18741,1,34,13,0,11,18,77,38.26647938868759,-109.4286806
18742,1,34,13,0,11,19,78,38.26647938868759,-109.4284111
18743,0,33,13,0,10,18,74,38.26647938868759,-109.4281416
18744,0,33,12,0,10,19,74,38.26647938868759,-109.4278721
18745,1,35,12,0,11,16,75,38.26647938868759,-109.4276026
18746,1,35,12,0,13,15,76,38.26647938868759,-109.4273331
18747,1,36,12,0,15,13,77,38.26647938868759,-109.4270636
18748,2,38,12,0,15,13,80,38.26647938868759,-109.4267941
18749,2,41,13,0,15,11,82,38.26647938868759,-109.4265246
18750,3,44,13,0,18,9,87,38.26647938868759,-109.4262551
18751,3,41,12,0,17,9,82,38.26647938868759,-109.4259856
18752,2,38,11,0,14,12,77,38.26647938868759,-109.4257161
18753,2,37,12,0,13,13,77,38.26647938868759,-109.4254466
18754,3,39,12,0,15,11,80,38.26647938868759,-109.4251771
18755,3,38,12,1,15,11,80,38.26647938868759,-109.4249077
18756,5,41,12,3,17,6,84,38.26647938868759,-109.4246382
18757,6,45,12,5,17,4,89,38.26647938868759,-109.4243687
18758,7,46,13,6,16,3,91,38.26647938868759,-109.4240992
18759,7,45,13,7,17,2,91,38.26647938868759,-109.4238297
18760,8,43,13,9,17,1,91,38.26647938868759,-109.4235602
18761,9,42,13,10,17,0,91,38.26647938868759,-109.4232907
18762,11,41,13,10,16,0,91,38.26647938868759,-109.4230212
18763,14,39,13,10,15,0,91,38.26647938868759,-109.4227517
18764,15,37,13,11,14,0,90,38.26647938868759,-109.4224822
18765,15,36,13,12,14,0,90,38.26647938868759,-109.4222127
18766,15,37,14,13,14,0,93,38.26647938868759,-109.4219432
18767,14,38,14,12,15,0,93,38.26647938868759,-109.4216737
18768,10,42,13,10,15,0,90,38.26647938868759,-109.4214042
18769,10,42,13,10,15,0,90,38.26647938868759,-109.4211347
18770,14,39,13,11,14,0,91,38.26647938868759,-109.4208652
18771,18,38,13,10,13,0,92,38.26647938868759,-109.4205957
18772,16,38,13,11,13,0,91,38.26647938868759,-109.4203262
18773,17,38,13,10,13,0,91,38.26647938868759,-109.4200568
18774,15,39,13,11,14,0,92,38.26647938868759,-109.4197873
18775,15,39,13,11,14,0,92,38.26647938868759,-109.4195178
18776,17,37,14,10,13,0,91,38.26647938868759,-109.4192483
18777,20,35,13,10,13,0,91,38.26647938868759,-109.4189788
18778,13,40,13,9,15,0,90,38.26647938868759,-109.4187093
18779,10,42,13,10,16,0,91,38.26647938868759,-109.4184398
18780,10,43,13,10,16,0,92,38.26647938868759,-109.4181703
18781,8,44,13,9,17,0,91,38.26647938868759,-109.4179008
18782,7,45,13,8,17,0,90,38.26647938868759,-109.4176313
18783,7,45,13,8,18,0,91,38.26647938868759,-109.4173618
18784,6,46,12,8,18,0,90,38.26647938868759,-109.4170923
18785,5,47,12,7,18,0,89,38.26647938868759,-109.4168228
18786,5,49,12,6,17,1,90,38.26647938868759,-109.4165533
18787,6,49,12,5,17,1,90,38.26647938868759,-109.4162838
18788,6,48,12,6,18,0,90,38.26647938868759,-109.4160143
18789,5,49,12,5,18,1,90,38.26647938868759,-109.4157448
18790,4,50,12,4,19,1,90,38.26647938868759,-109.4154753
18791,5,49,12,5,18,0,89,38.26647938868759,-109.4152058
18792,5,52,11,6,16,0,90,38.26647938868759,-109.4149364
18793,5,52,11,7,16,0,91,38.26647938868759,-109.4146669
18794,6,49,12,6,17,0,90,38.26647938868759,-109.4143974
18795,7,46,13,5,20,0,91,38.26647938868759,-109.4141279
18796,6,46,13,6,20,0,91,38.26647938868759,-109.4138584
18797,7,47,13,6,19,0,92,38.26647938868759,-109.4135889
18798,7,47,13,6,19,0,92,38.26647938868759,-109.4133194
18799,7,46,13,7,19,0,92,38.26647938868759,-109.4130499
18800,8,46,13,7,18,0,92,38.26647938868759,-109.4127804
18801,9,44,13,8,18,0,92,38.26647938868759,-109.4125109
18802,8,44,13,8,18,0,91,38.26647938868759,-109.4122414
18803,8,45,14,8,18,0,93,38.26647938868759,-109.4119719
18804,8,47,13,7,18,0,93,38.26647938868759,-109.4117024
18805,7,47,13,7,18,0,92,38.26647938868759,-109.4114329
18806,7,47,13,7,19,0,93,38.26647938868759,-109.4111634
18807,6,48,13,7,19,0,93,38.26647938868759,-109.4108939
18808,6,48,13,7,19,0,93,38.26647938868759,-109.4106244
18809,6,47,13,7,19,0,92,38.26647938868759,-109.4103549
18810,6,48,13,7,18,0,92,38.26647938868759,-109.4100855
18811,5,49,13,5,19,0,91,38.26647938868759,-109.409816
18812,6,50,13,4,18,0,91,38.26647938868759,-109.4095465
18813,7,51,12,4,17,0,91,38.26647938868759,-109.409277
18814,7,50,13,6,17,0,93,38.26647938868759,-109.4090075
18815,6,50,13,7,17,0,93,38.26647938868759,-109.408738
18816,6,49,13,8,17,0,93,38.26647938868759,-109.4084685
18817,7,46,13,10,16,0,92,38.26647938868759,-109.408199
18818,8,44,14,10,17,1,94,38.26647938868759,-109.4079295
18819,5,43,13,6,17,3,87,38.26647938868759,-109.40766
18820,3,44,12,3,16,7,85,38.26647938868759,-109.4073905
18821,3,45,12,3,16,7,86,38.26647938868759,-109.407121
18822,3,46,12,4,16,5,86,38.26647938868759,-109.4068515
18823,4,47,13,3,16,5,88,38.26647938868759,-109.3879869
18824,5,44,13,5,15,5,87,38.26647938868759,-109.3877174
18825,5,33,13,3,12,12,78,38.26647938868759,-109.3874479
18826,2,31,11,0,9,14,67,38.26647938868759,-109.3871784
18827,1,28,11,0,8,14,62,38.26647938868759,-109.3869089
18828,1,27,11,0,9,14,62,38.26647938868759,-109.3866394
18829,3,32,12,0,9,14,70,38.26647938868759,-109.3863699
18830,3,42,12,1,15,8,81,38.26647938868759,-109.3861004
18831,3,42,12,2,16,7,82,38.26647938868759,-109.3858309
18832,5,41,13,5,16,5,85,38.26647938868759,-109.3855614
18833,6,40,13,8,16,4,87,38.26647938868759,-109.3852919
18834,5,37,13,8,15,5,83,38.26647938868759,-109.3850225
18835,7,38,12,6,15,5,83,38.26647938868759,-109.384753
18836,7,40,12,7,16,2,84,38.26647938868759,-109.3844835
18837,4,46,13,6,17,2,88,38.26647938868759,-109.384214
18838,3,47,13,4,16,4,87,38.26647938868759,-109.3839445
18839,4,46,13,4,16,6,89,38.26647938868759,-109.383675
18840,3,41,13,3,15,9,84,38.26647938868759,-109.3834055
18841,3,36,12,3,12,10,76,38.26647938868759,-109.383136
18842,2,37,10,2,11,10,72,38.26647938868759,-109.3828665
18843,1,45,8,1,11,7,73,38.26647938868759,-109.382597
18844,0,45,8,1,13,5,72,38.26647938868759,-109.3823275
18845,1,35,10,1,10,10,67,38.26647938868759,-109.382058
18846,1,31,11,4,10,10,67,38.26647938868759,-109.3817885
18847,2,32,12,5,12,8,71,38.26647938868759,-109.381519
18848,0,32,11,2,10,14,69,38.26647938868759,-109.3812495
18849,1,29,13,1,11,17,72,38.26647938868759,-109.38098
18850,2,22,13,7,10,16,70,38.26647938868759,-109.3807105
18851,3,20,12,10,9,13,67,38.26647938868759,-109.380441
18852,5,24,11,6,11,10,67,38.26647938868759,-109.3801716
18853,4,31,13,6,12,10,76,38.26647938868759,-109.3799021
18854,5,35,13,5,14,10,82,38.26647938868759,-109.3796326
18855,5,33,14,4,13,13,82,38.26647938868759,-109.3793631
18856,4,31,14,3,12,16,80,38.26647938868759,-109.3790936
18857,4,30,13,2,11,16,76,38.26647938868759,-109.3788241
18858,5,33,13,3,15,12,81,38.26647938868759,-109.3785546
18859,5,32,13,8,18,8,84,38.26647938868759,-109.3782851
18860,7,28,13,14,16,4,82,38.26647938868759,-109.3780156
18861,14,23,13,18,14,2,84,38.26647938868759,-109.3777461
18862,13,25,13,19,13,2,85,38.26647938868759,-109.3774766
18863,13,29,12,12,14,3,83,38.26647938868759,-109.3772071
18864,8,34,12,8,17,5,84,38.26647938868759,-109.3769376
18865,7,36,12,7,17,4,83,38.26647938868759,-109.3766681
18866,8,31,12,10,15,3,79,38.26647938868759,-109.3763986
18867,12,23,10,11,14,2,72,38.26647938868759,-109.3761291
18868,15,22,12,11,12,2,74,38.26647938868759,-109.3758596
18869,12,27,12,9,13,4,77,38.26647938868759,-109.3755901
18870,10,28,12,10,12,6,78,38.26647938868759,-109.3753206
18871,15,19,13,10,9,8,74,38.26647938868759,-109.3750512
18872,12,18,13,12,11,7,73,38.26647938868759,-109.3747817
18873,17,24,12,8,10,5,76,38.26647938868759,-109.3745122
18874,17,27,12,7,9,5,77,38.26647938868759,-109.3742427
18875,15,26,11,7,9,6,74,38.26647938868759,-109.3739732
18876,11,26,11,6,9,8,71,38.26647938868759,-109.3737037
18877,14,27,12,6,9,8,76,38.26647938868759,-109.3734342
18878,15,28,13,7,9,8,80,38.26647938868759,-109.3731647
18879,15,30,14,7,8,9,83,38.26647938868759,-109.3728952
18880,15,29,13,5,8,10,80,38.26647938868759,-109.3726257
18881,18,27,13,5,7,8,78,38.26647938868759,-109.3723562
18882,21,31,14,5,7,6,84,38.26647938868759,-109.3720867
18883,10,37,12,2,9,9,79,38.26647938868759,-109.3718172
18884,3,36,10,1,10,11,71,38.26647938868759,-109.3715477
18885,3,33,10,2,8,13,69,38.26647938868759,-109.3712782
18886,1,43,9,0,11,10,74,38.26647938868759,-109.3710087
18887,0,49,7,1,9,4,70,38.26647938868759,-109.3707392
18888,0,57,6,2,9,3,77,38.26647938868759,-109.3704697
18889,1,59,6,3,10,2,81,38.26647938868759,-109.3702003
18890,1,56,7,2,11,3,80,38.26647938868759,-109.3699308
18891,2,47,8,3,12,4,76,38.26647938868759,-109.3696613
18892,0,51,8,2,11,6,78,38.26647938868759,-109.3693918
18893,0,48,7,2,10,5,72,38.26647938868759,-109.3691223
18894,3,37,6,2,10,3,61,38.26647938868759,-109.3688528
18895,4,31,10,3,8,8,64,38.26647938868759,-109.3685833
18896,3,25,10,3,6,13,60,38.26647938868759,-109.3683138
18897,5,27,10,1,5,15,63,38.26647938868759,-109.3680443
18898,2,24,13,1,5,20,65,38.26647938868759,-109.3677748
18899,1,27,14,0,3,25,70,38.26647938868759,-109.3675053
18900,1,23,15,0,2,29,70,38.26647938868759,-109.3672358
18901,2,25,14,0,7,24,72,38.26647938868759,-109.3669663
18902,3,26,14,0,9,24,76,38.26647938868759,-109.3666968
18903,3,28,15,0,10,22,78,38.26647938868759,-109.3664273
18904,3,27,15,3,10,20,78,38.26647938868759,-109.3661578
18905,3,20,12,8,13,13,69,38.26647938868759,-109.3658883
18906,1,15,12,8,16,12,64,38.26647938868759,-109.3656188
18907,1,14,11,8,18,8,60,38.26647938868759,-109.3653493
18908,2,18,10,8,16,7,61,38.26647938868759,-109.3650799
18909,2,25,13,4,7,18,69,38.26647938868759,-109.3648104
18910,1,20,14,0,1,27,63,38.26647938868759,-109.3645409
18911,0,21,13,0,2,21,57,38.26647938868759,-109.3642714
18912,3,27,8,2,4,11,55,38.26647938868759,-109.3640019
18913,3,28,4,3,7,5,50,38.26647938868759,-109.3637324
18914,2,26,5,2,7,4,46,38.26647938868759,-109.3634629
18915,4,27,6,2,8,5,52,38.26647938868759,-109.3631934
18916,3,25,8,3,8,7,54,38.26647938868759,-109.3629239
18917,2,28,8,4,9,9,60,38.26647938868759,-109.3626544
18918,2,31,9,4,9,10,65,38.26647938868759,-109.3623849
18919,2,31,9,3,9,11,65,38.26647938868759,-109.3621154
18920,1,25,9,1,8,10,54,38.26647938868759,-109.3618459
18921,1,22,9,3,8,7,50,38.26647938868759,-109.3615764
18922,3,24,7,6,6,7,53,38.26647938868759,-109.3613069
18923,6,25,9,6,7,7,60,38.26647938868759,-109.3610374
18924,10,28,15,6,9,9,77,38.26647938868759,-109.3607679
18925,2,26,15,8,12,18,81,38.26647938868759,-109.3604984
18926,2,28,16,2,11,22,81,38.26647938868759,-109.360229
18927,2,27,14,1,8,23,75,38.26647938868759,-109.3599595
18928,0,24,14,1,6,25,70,38.26647938868759,-109.35969
18929,0,24,14,0,5,25,68,38.26647938868759,-109.3594205
18930,1,25,14,0,5,24,69,38.26647938868759,-109.359151
18931,0,27,13,0,5,22,67,38.26647938868759,-109.3588815
18932,0,25,13,1,6,20,65,38.26647938868759,-109.358612
18933,1,23,12,2,6,18,62,38.26647938868759,-109.3583425
18934,2,23,12,0,5,20,62,38.26647938868759,-109.358073
18935,7,24,14,5,5,23,78,38.26647938868759,-109.3578035
18936,7,25,14,5,6,22,79,38.26647938868759,-109.357534
18937,2,25,13,0,9,20,69,38.26647938868759,-109.3572645
18938,9,25,12,11,8,13,78,38.26647938868759,-109.356995
18939,1,25,14,3,9,15,67,38.26647938868759,-109.3567255
18940,3,23,13,5,10,12,66,38.26647938868759,-109.356456
18941,5,23,12,7,11,7,65,38.26647938868759,-109.3561865
18942,3,21,10,6,12,6,58,38.26647938868759,-109.355917
18943,1,16,12,2,7,18,56,38.26647938868759,-109.3556475
18944,1,12,13,1,2,25,54,38.26647938868759,-109.355378
18945,0,15,14,0,1,27,57,38.26647938868759,-109.3551086
18946,3,14,14,2,1,23,57,38.26647938868759,-109.3548391
18947,5,16,11,1,2,17,52,38.26647938868759,-109.3545696
18948,4,20,8,6,5,9,52,38.26647938868759,-109.3543001
18949,3,28,7,6,8,7,59,38.26647938868759,-109.3540306
18950,4,32,8,6,9,6,65,38.26647938868759,-109.3537611
18951,3,32,8,5,9,6,63,38.26647938868759,-109.3534916
18952,3,26,7,5,9,8,58,38.26647938868759,-109.3532221
18953,3,18,8,6,6,10,51,38.26647938868759,-109.3529526
18954,4,11,10,5,3,14,47,38.26647938868759,-109.3526831
18955,3,7,12,6,4,17,49,38.26647938868759,-109.3524136
18956,1,12,14,3,3,22,55,38.26647938868759,-109.3521441
18957,2,15,14,2,3,23,59,38.26647938868759,-109.3518746
18958,2,15,14,1,3,23,58,38.26647938868759,-109.3516051
18959,1,12,13,2,3,23,54,38.26647938868759,-109.3513356
18960,1,10,12,3,3,20,49,38.26647938868759,-109.3510661
18961,2,11,13,4,4,20,54,38.26647938868759,-109.3507966
18962,1,12,13,3,3,23,55,38.26647938868759,-109.3505271
18963,1,12,13,3,3,23,55,38.26647938868759,-109.3502577
18964,1,12,13,4,3,22,55,38.26647938868759,-109.3499882
18965,2,13,15,2,2,26,60,38.26647938868759,-109.3497187
18966,1,16,17,0,2,31,67,38.26647938868759,-109.3494492
18967,0,19,19,0,2,34,74,38.26647938868759,-109.3491797
18968,1,19,19,0,3,33,75,38.26647938868759,-109.3489102
18969,1,20,19,1,3,31,75,38.26647938868759,-109.3486407
18970,1,20,20,1,3,32,77,38.26647938868759,-109.3483712
18971,1,21,19,0,2,32,75,38.26647938868759,-109.3481017
18972,1,22,18,0,2,31,74,38.26647938868759,-109.3478322
18973,1,22,18,0,3,30,74,38.26647938868759,-109.3475627
18974,1,21,18,0,2,29,71,38.26647938868759,-109.3472932
18975,1,20,18,0,1,30,70,38.26647938868759,-109.3470237
18976,1,20,19,0,3,31,74,38.26647938868759,-109.3467542
18977,1,22,18,0,4,30,75,38.26647938868759,-109.3464847
18978,1,22,18,0,5,28,74,38.26647938868759,-109.3462152
18979,1,23,17,0,5,27,73,38.26647938868759,-109.3459457
18980,1,26,17,2,8,24,78,38.26647938868759,-109.3456762
18981,5,30,16,6,11,16,84,38.26647938868759,-109.3454068
18982,6,32,15,8,10,13,84,38.26647938868759,-109.3451373
18983,5,32,15,6,10,14,82,38.26647938868759,-109.3448678
18984,5,32,15,5,9,16,82,38.26647938868759,-109.3445983
18985,6,29,16,8,12,15,86,38.26647938868759,-109.3443288
18986,7,28,16,11,13,14,89,38.26647938868759,-109.3440593
18987,9,30,16,13,12,10,90,38.26647938868759,-109.3437898
18988,8,36,15,12,13,6,90,38.26647938868759,-109.3435203
18989,6,40,14,10,14,5,89,38.26647938868759,-109.3432508
18990,6,39,13,9,13,6,86,38.26647938868759,-109.3429813
18991,7,39,14,11,11,6,88,38.26647938868759,-109.3427118
18992,9,38,14,12,11,5,89,38.26647938868759,-109.3424423
18993,10,37,15,13,11,5,91,38.26647938868759,-109.3421728
18994,7,40,15,12,12,4,90,38.26647938868759,-109.3419033
18995,8,40,15,12,13,4,92,38.26647938868759,-109.3416338
18996,10,38,15,12,12,5,92,38.26647938868759,-109.3413643
18997,14,34,15,12,9,7,91,38.26647938868759,-109.3410948
18998,15,33,14,14,9,5,90,38.26647938868759,-109.3408253
18999,14,33,14,14,8,6,89,38.26647938868759,-109.3405558
19000,11,35,15,14,9,6,90,38.26647938868759,-109.3402864
19001,8,38,14,13,10,6,89,38.26647938868759,-109.3400169
19002,7,39,14,12,10,6,88,38.26647938868759,-109.3397474
19003,9,37,14,15,11,5,91,38.26647938868759,-109.3394779
19004,9,37,14,15,10,5,90,38.26647938868759,-109.3392084
19005,8,38,14,14,11,6,91,38.26647938868759,-109.3389389
19006,8,41,14,11,11,6,91,38.26647938868759,-109.3386694
19007,7,46,14,10,9,5,91,38.26647938868759,-109.3383999
19008,7,46,13,11,8,5,90,38.26647938868759,-109.3381304
19009,7,42,14,13,8,5,89,38.26647938868759,-109.3378609
19010,7,41,14,13,8,6,89,38.26647938868759,-109.3375914
19011,7,39,14,12,9,7,88,38.26647938868759,-109.3373219
19012,7,38,14,14,9,6,88,38.26647938868759,-109.3370524
19013,8,37,14,14,10,5,88,38.26647938868759,-109.3367829
19014,8,38,14,14,9,5,88,38.26647938868759,-109.3365134
19015,9,39,14,15,8,5,90,38.26647938868759,-109.3362439
19016,0,33,12,0,14,16,75,38.26620989410235,-109.4405383
19017,1,40,11,0,15,13,80,38.26620989410235,-109.4402688
19018,1,37,11,0,13,15,77,38.26620989410235,-109.4399993
19019,1,38,11,0,13,14,77,38.26620989410235,-109.4397299
19020,2,44,10,0,13,11,80,38.26620989410235,-109.4394604
19021,2,52,10,0,14,9,87,38.26620989410235,-109.4391909
19022,2,49,11,0,14,9,85,38.26620989410235,-109.4389214
19023,2,40,11,0,13,11,77,38.26620989410235,-109.4386519
19024,1,36,11,0,13,14,75,38.26620989410235,-109.4383824
19025,0,37,11,0,13,16,77,38.26620989410235,-109.4381129
19026,1,37,11,0,11,17,77,38.26620989410235,-109.4378434
19027,1,37,12,0,12,16,78,38.26620989410235,-109.4375739
19028,2,37,13,0,11,17,80,38.26620989410235,-109.4373044
19029,2,37,12,0,12,17,80,38.26620989410235,-109.4370349
19030,2,39,11,0,13,14,79,38.26620989410235,-109.4367654
19031,1,35,12,0,13,15,76,38.26620989410235,-109.4364959
19032,0,34,12,3,15,13,77,38.26620989410235,-109.4362264
19033,5,31,13,11,10,11,81,38.26620989410235,-109.4359569
19034,5,30,14,9,10,12,80,38.26620989410235,-109.4356874
19035,2,33,14,2,15,14,80,38.26620989410235,-109.4354179
19036,5,31,13,5,17,8,79,38.26620989410235,-109.4351484
19037,4,32,14,7,15,9,81,38.26620989410235,-109.434879
19038,3,29,13,6,16,8,75,38.26620989410235,-109.4346095
19039,5,31,13,6,15,7,77,38.26620989410235,-109.43434
19040,5,31,14,6,16,9,81,38.26620989410235,-109.4340705
19041,7,30,13,9,16,6,81,38.26620989410235,-109.433801
19042,4,32,12,6,18,5,77,38.26620989410235,-109.4335315
19043,4,34,14,8,19,5,84,38.26620989410235,-109.433262
19044,3,32,14,5,18,9,81,38.26620989410235,-109.4329925
19045,1,32,13,2,14,13,75,38.26620989410235,-109.432723
19046,2,32,13,2,16,11,76,38.26620989410235,-109.4324535
19047,1,32,13,0,12,17,75,38.26620989410235,-109.432184
19048,1,32,13,0,11,19,76,38.26620989410235,-109.4319145
19049,1,33,12,0,12,17,75,38.26620989410235,-109.431645
19050,0,31,12,0,14,15,72,38.26620989410235,-109.4313755
19051,1,32,12,0,11,18,74,38.26620989410235,-109.431106
19052,1,34,12,0,11,18,76,38.26620989410235,-109.4308365
19053,0,34,12,0,13,17,76,38.26620989410235,-109.430567
19054,1,36,11,0,13,14,75,38.26620989410235,-109.4302975
19055,0,34,11,0,12,17,74,38.26620989410235,-109.430028
19056,0,32,11,0,11,16,70,38.26620989410235,-109.4297586
19057,0,32,11,0,11,14,68,38.26620989410235,-109.4294891
19058,0,32,11,0,12,14,69,38.26620989410235,-109.4292196
19059,0,32,11,0,10,16,69,38.26620989410235,-109.4289501
19060,1,35,11,0,11,15,73,38.26620989410235,-109.4286806
19061,2,36,11,0,12,15,76,38.26620989410235,-109.4284111
19062,1,35,11,0,12,15,74,38.26620989410235,-109.4281416
19063,1,34,11,0,11,16,73,38.26620989410235,-109.4278721
19064,1,34,11,0,12,15,73,38.26620989410235,-109.4276026
19065,1,33,11,0,12,15,72,38.26620989410235,-109.4273331
19066,1,33,12,0,10,17,73,38.26620989410235,-109.4270636
19067,1,32,12,0,9,19,73,38.26620989410235,-109.4267941
19068,2,37,13,0,13,15,80,38.26620989410235,-109.4265246
19069,2,37,12,0,15,13,79,38.26620989410235,-109.4262551
19070,2,34,12,0,13,14,75,38.26620989410235,-109.4259856
19071,2,34,12,0,12,15,75,38.26620989410235,-109.4257161
19072,3,36,12,0,13,14,78,38.26620989410235,-109.4254466
19073,3,36,12,0,13,15,79,38.26620989410235,-109.4251771
19074,2,37,12,1,14,12,78,38.26620989410235,-109.4249077
19075,3,41,12,2,16,9,83,38.26620989410235,-109.4246382
19076,5,46,12,4,16,6,89,38.26620989410235,-109.4243687
19077,7,46,13,5,16,4,91,38.26620989410235,-109.4240992
19078,9,42,13,8,17,2,91,38.26620989410235,-109.4238297
19079,12,38,13,10,16,1,90,38.26620989410235,-109.4235602
19080,16,36,13,11,14,1,91,38.26620989410235,-109.4232907
19081,17,35,13,12,14,1,92,38.26620989410235,-109.4230212
19082,15,36,13,10,14,1,89,38.26620989410235,-109.4227517
19083,19,33,13,12,14,0,91,38.26620989410235,-109.4224822
19084,19,33,13,12,14,0,91,38.26620989410235,-109.4222127
19085,19,33,13,13,14,0,92,38.26620989410235,-109.4219432
19086,19,33,13,13,14,0,92,38.26620989410235,-109.4216737
19087,15,36,13,11,14,0,89,38.26620989410235,-109.4214042
19088,16,37,13,11,14,0,91,38.26620989410235,-109.4211347
19089,21,35,12,10,13,0,91,38.26620989410235,-109.4208652
19090,25,33,12,9,11,0,90,38.26620989410235,-109.4205957
19091,23,34,12,10,12,0,91,38.26620989410235,-109.4203262
19092,23,34,12,9,13,0,91,38.26620989410235,-109.4200568
19093,25,33,12,9,12,0,91,38.26620989410235,-109.4197873
19094,27,31,12,10,11,0,91,38.26620989410235,-109.4195178
19095,28,31,12,10,11,0,92,38.26620989410235,-109.4192483
19096,25,33,12,9,11,0,90,38.26620989410235,-109.4189788
19097,18,37,13,9,13,0,90,38.26620989410235,-109.4187093
19098,14,40,13,10,15,0,92,38.26620989410235,-109.4184398
19099,12,42,13,9,16,0,92,38.26620989410235,-109.4181703
19100,10,43,13,9,16,0,91,38.26620989410235,-109.4179008
19101,8,43,13,9,18,0,91,38.26620989410235,-109.4176313
19102,6,46,12,7,19,0,90,38.26620989410235,-109.4173618
19103,5,47,12,6,19,1,90,38.26620989410235,-109.4170923
19104,5,47,12,6,18,1,89,38.26620989410235,-109.4168228
19105,5,48,12,5,18,1,89,38.26620989410235,-109.4165533
19106,5,48,12,6,18,0,89,38.26620989410235,-109.4162838
19107,5,47,12,5,19,1,89,38.26620989410235,-109.4160143
19108,5,47,12,5,19,1,89,38.26620989410235,-109.4157448
19109,5,48,12,5,18,0,88,38.26620989410235,-109.4154753
19110,5,51,11,5,17,0,89,38.26620989410235,-109.4152058
19111,5,51,10,6,15,0,87,38.26620989410235,-109.4149364
19112,5,49,11,6,17,0,88,38.26620989410235,-109.4146669
19113,6,46,12,6,18,0,88,38.26620989410235,-109.4143974
19114,7,46,13,6,19,0,91,38.26620989410235,-109.4141279
19115,7,47,12,6,17,0,89,38.26620989410235,-109.4138584
19116,7,46,13,6,17,0,89,38.26620989410235,-109.4135889
19117,7,46,13,6,18,0,90,38.26620989410235,-109.4133194
19118,7,46,13,6,19,0,91,38.26620989410235,-109.4130499
19119,7,46,13,5,19,0,90,38.26620989410235,-109.4127804
19120,8,44,13,8,18,0,91,38.26620989410235,-109.4125109
19121,9,43,13,8,18,0,91,38.26620989410235,-109.4122414
19122,9,45,13,7,18,0,92,38.26620989410235,-109.4119719
19123,8,46,13,7,18,0,92,38.26620989410235,-109.4117024
19124,7,47,13,7,18,0,92,38.26620989410235,-109.4114329
19125,6,47,13,7,19,0,92,38.26620989410235,-109.4111634
19126,6,48,13,7,19,0,93,38.26620989410235,-109.4108939
19127,6,48,13,7,18,0,92,38.26620989410235,-109.4106244
19128,6,49,13,8,18,0,94,38.26620989410235,-109.4103549
19129,6,49,13,8,17,0,93,38.26620989410235,-109.4100855
19130,6,48,13,8,17,0,92,38.26620989410235,-109.409816
19131,6,49,14,7,18,0,94,38.26620989410235,-109.4095465
19132,6,50,13,7,17,0,93,38.26620989410235,-109.409277
19133,7,50,13,7,17,0,94,38.26620989410235,-109.4090075
19134,8,48,13,9,15,0,93,38.26620989410235,-109.408738
19135,7,49,13,8,17,0,94,38.26620989410235,-109.4084685
19136,7,47,13,7,17,1,92,38.26620989410235,-109.408199
19137,7,45,14,7,17,3,93,38.26620989410235,-109.4079295
19138,5,45,13,5,18,4,90,38.26620989410235,-109.40766
19139,3,47,12,2,16,7,87,38.26620989410235,-109.4073905
19140,2,48,12,1,16,7,86,38.26620989410235,-109.407121
19141,2,49,11,2,16,6,86,38.26620989410235,-109.4068515
19142,3,46,13,1,14,9,86,38.26620989410235,-109.3879869
19143,3,49,13,2,15,6,88,38.26620989410235,-109.3877174
19144,3,46,12,1,13,9,84,38.26620989410235,-109.3874479
19145,2,36,11,0,11,12,72,38.26620989410235,-109.3871784
19146,1,30,11,0,10,13,65,38.26620989410235,-109.3869089
19147,1,30,11,0,10,14,66,38.26620989410235,-109.3866394
19148,1,29,11,0,9,16,66,38.26620989410235,-109.3863699
19149,1,33,12,0,11,13,70,38.26620989410235,-109.3861004
19150,2,39,12,1,15,9,78,38.26620989410235,-109.3858309
19151,3,40,13,3,16,6,81,38.26620989410235,-109.3855614
19152,3,41,13,4,16,6,83,38.26620989410235,-109.3852919
19153,4,38,13,4,15,7,81,38.26620989410235,-109.3850225
19154,4,39,12,4,15,6,80,38.26620989410235,-109.384753
19155,4,46,12,4,16,4,86,38.26620989410235,-109.3844835
19156,3,48,12,4,15,5,87,38.26620989410235,-109.384214
19157,3,46,12,3,14,7,85,38.26620989410235,-109.3839445
19158,3,46,13,4,14,7,87,38.26620989410235,-109.383675
19159,3,38,13,3,12,12,81,38.26620989410235,-109.3834055
19160,2,38,11,2,11,12,76,38.26620989410235,-109.383136
19161,1,41,9,0,12,9,72,38.26620989410235,-109.3828665
19162,0,53,8,0,13,5,79,38.26620989410235,-109.382597
19163,1,43,9,0,12,7,72,38.26620989410235,-109.3823275
19164,1,30,10,2,8,12,63,38.26620989410235,-109.382058
19165,2,28,13,4,9,13,69,38.26620989410235,-109.3817885
19166,1,31,13,3,12,14,74,38.26620989410235,-109.381519
19167,0,30,14,0,11,21,76,38.26620989410235,-109.3812495
19168,1,27,15,0,8,24,75,38.26620989410235,-109.38098
19169,2,18,12,6,7,17,62,38.26620989410235,-109.3807105
19170,3,19,10,10,11,7,60,38.26620989410235,-109.380441
19171,6,27,10,14,11,1,69,38.26620989410235,-109.3801716
19172,5,33,11,7,13,6,75,38.26620989410235,-109.3799021
19173,7,37,12,6,16,5,83,38.26620989410235,-109.3796326
19174,8,37,13,6,15,6,85,38.26620989410235,-109.3793631
19175,9,36,13,6,14,7,85,38.26620989410235,-109.3790936
19176,8,35,13,7,16,7,86,38.26620989410235,-109.3788241
19177,6,35,13,7,19,6,86,38.26620989410235,-109.3785546
19178,6,33,13,11,18,4,85,38.26620989410235,-109.3782851
19179,9,28,13,16,16,2,84,38.26620989410235,-109.3780156
19180,15,23,12,19,14,1,84,38.26620989410235,-109.3777461
19181,17,23,13,18,13,1,85,38.26620989410235,-109.3774766
19182,11,31,12,12,16,1,83,38.26620989410235,-109.3772071
19183,9,37,12,9,16,1,84,38.26620989410235,-109.3769376
19184,10,34,12,11,15,1,83,38.26620989410235,-109.3766681
19185,13,23,12,14,13,2,77,38.26620989410235,-109.3763986
19186,16,18,11,14,13,0,72,38.26620989410235,-109.3761291
19187,15,23,12,10,12,2,74,38.26620989410235,-109.3758596
19188,10,32,12,10,13,4,81,38.26620989410235,-109.3755901
19189,11,31,12,11,12,4,81,38.26620989410235,-109.3753206
19190,18,24,13,11,11,3,80,38.26620989410235,-109.3750512
19191,14,21,12,12,11,4,74,38.26620989410235,-109.3747817
19192,14,28,13,8,10,7,80,38.26620989410235,-109.3745122
19193,11,32,13,7,11,8,82,38.26620989410235,-109.3742427
19194,10,32,14,7,12,9,84,38.26620989410235,-109.3739732
19195,10,33,14,6,11,10,84,38.26620989410235,-109.3737037
19196,11,33,14,6,12,9,85,38.26620989410235,-109.3734342
19197,13,33,14,6,11,8,85,38.26620989410235,-109.3731647
19198,14,33,14,6,11,8,86,38.26620989410235,-109.3728952
19199,15,31,14,6,10,7,83,38.26620989410235,-109.3726257
19200,18,28,13,6,8,7,80,38.26620989410235,-109.3723562
19201,24,27,14,4,6,6,81,38.26620989410235,-109.3720867
19202,14,32,13,3,8,8,78,38.26620989410235,-109.3718172
19203,6,38,12,3,10,9,78,38.26620989410235,-109.3715477
19204,3,40,11,1,10,11,76,38.26620989410235,-109.3712782
19205,1,41,10,0,12,10,74,38.26620989410235,-109.3710087
19206,0,47,7,1,10,5,70,38.26620989410235,-109.3707392
19207,0,53,6,1,9,3,72,38.26620989410235,-109.3704697
19208,1,59,6,3,10,1,80,38.26620989410235,-109.3702003
19209,0,54,6,2,11,3,76,38.26620989410235,-109.3699308
19210,1,53,8,4,11,2,79,38.26620989410235,-109.3696613
19211,0,54,8,2,11,4,79,38.26620989410235,-109.3693918
19212,0,52,7,2,11,5,77,38.26620989410235,-109.3691223
19213,1,38,8,2,10,7,66,38.26620989410235,-109.3688528
19214,10,32,13,0,4,16,75,38.26620989410235,-109.3685833
19215,3,22,13,3,2,19,62,38.26620989410235,-109.3683138
19216,3,21,15,1,2,24,66,38.26620989410235,-109.3680443
19217,3,21,16,1,2,26,69,38.26620989410235,-109.3677748
19218,2,28,17,0,4,28,79,38.26620989410235,-109.3675053
19219,2,27,16,0,4,28,77,38.26620989410235,-109.3672358
19220,3,24,15,0,6,24,72,38.26620989410235,-109.3669663
19221,4,24,14,1,2,24,69,38.26620989410235,-109.3666968
19222,7,28,15,0,6,23,79,38.26620989410235,-109.3664273
19223,2,27,14,0,11,18,72,38.26620989410235,-109.3661578
19224,1,26,13,4,18,12,74,38.26620989410235,-109.3658883
19225,2,22,13,8,15,12,72,38.26620989410235,-109.3656188
19226,1,16,11,8,19,7,62,38.26620989410235,-109.3653493
19227,2,21,10,9,9,10,61,38.26620989410235,-109.3650799
19228,1,22,11,4,7,16,61,38.26620989410235,-109.3648104
19229,0,20,12,0,3,20,55,38.26620989410235,-109.3645409
19230,5,24,9,2,1,14,55,38.26620989410235,-109.3642714
19231,5,35,5,3,6,5,59,38.26620989410235,-109.3640019
19232,2,40,4,3,7,3,59,38.26620989410235,-109.3637324
19233,5,25,6,3,7,4,50,38.26620989410235,-109.3634629
19234,4,23,8,3,7,8,53,38.26620989410235,-109.3631934
19235,2,28,9,3,9,10,61,38.26620989410235,-109.3629239
19236,2,29,10,3,9,12,65,38.26620989410235,-109.3626544
19237,3,33,9,4,9,10,68,38.26620989410235,-109.3623849
19238,4,30,9,3,8,9,63,38.26620989410235,-109.3621154
19239,1,19,9,2,7,9,47,38.26620989410235,-109.3618459
19240,1,15,9,5,8,8,46,38.26620989410235,-109.3615764
19241,7,21,9,9,8,6,60,38.26620989410235,-109.3613069
19242,5,26,14,6,9,11,71,38.26620989410235,-109.3610374
19243,4,25,15,9,12,12,77,38.26620989410235,-109.3607679
19244,1,26,16,3,9,24,79,38.26620989410235,-109.3604984
19245,1,28,18,0,7,29,83,38.26620989410235,-109.360229
19246,2,27,18,0,5,30,82,38.26620989410235,-109.3599595
19247,1,23,17,0,5,31,77,38.26620989410235,-109.35969
19248,2,26,17,0,6,28,79,38.26620989410235,-109.3594205
19249,1,26,16,0,5,28,76,38.26620989410235,-109.359151
19250,0,24,16,0,4,29,73,38.26620989410235,-109.3588815
19251,0,23,15,0,3,29,70,38.26620989410235,-109.358612
19252,0,21,15,0,4,27,67,38.26620989410235,-109.3583425
19253,1,22,14,0,5,24,66,38.26620989410235,-109.358073
19254,6,24,13,5,7,22,77,38.26620989410235,-109.3578035
19255,9,21,12,10,10,15,77,38.26620989410235,-109.357534
19256,12,19,12,11,10,13,77,38.26620989410235,-109.3572645
19257,9,25,11,14,9,10,78,38.26620989410235,-109.356995
19258,3,33,14,5,13,9,77,38.26620989410235,-109.3567255
19259,1,25,12,2,14,8,62,38.26620989410235,-109.356456
19260,0,20,10,4,12,9,55,38.26620989410235,-109.3561865
19261,5,18,11,5,13,10,62,38.26620989410235,-109.355917
19262,4,17,12,6,6,12,57,38.26620989410235,-109.3556475
19263,6,23,11,3,4,11,58,38.26620989410235,-109.355378
19264,4,24,8,4,6,8,54,38.26620989410235,-109.3551086
19265,2,29,6,5,7,5,54,38.26620989410235,-109.3548391
19266,4,26,5,5,7,4,51,38.26620989410235,-109.3545696
19267,4,25,7,4,7,6,53,38.26620989410235,-109.3543001
19268,4,25,8,5,8,6,56,38.26620989410235,-109.3540306
19269,3,27,7,6,9,6,58,38.26620989410235,-109.3537611
19270,4,37,8,5,9,6,69,38.26620989410235,-109.3534916
19271,3,37,8,5,8,6,67,38.26620989410235,-109.3532221
19272,3,35,8,5,8,6,65,38.26620989410235,-109.3529526
19273,3,32,7,6,8,8,64,38.26620989410235,-109.3526831
19274,3,24,8,8,8,8,59,38.26620989410235,-109.3524136
19275,1,23,8,6,4,11,53,38.26620989410235,-109.3521441
19276,3,18,8,5,8,11,53,38.26620989410235,-109.3518746
19277,3,20,8,5,7,10,53,38.26620989410235,-109.3516051
19278,4,20,9,6,6,11,56,38.26620989410235,-109.3513356
19279,5,21,10,5,6,11,58,38.26620989410235,-109.3510661
19280,4,24,9,6,8,10,61,38.26620989410235,-109.3507966
19281,2,18,11,6,5,15,57,38.26620989410235,-109.3505271
19282,2,9,13,7,5,16,52,38.26620989410235,-109.3502577
19283,1,12,13,4,4,21,55,38.26620989410235,-109.3499882
19284,1,11,14,2,2,26,56,38.26620989410235,-109.3497187
19285,1,12,15,1,1,29,59,38.26620989410235,-109.3494492
19286,1,17,16,0,1,29,64,38.26620989410235,-109.3491797
19287,2,19,17,0,1,29,68,38.26620989410235,-109.3489102
19288,1,21,17,0,2,30,71,38.26620989410235,-109.3486407
19289,1,20,19,1,2,32,75,38.26620989410235,-109.3483712
19290,1,21,17,0,2,30,71,38.26620989410235,-109.3481017
19291,2,23,17,1,2,27,72,38.26620989410235,-109.3478322
19292,2,24,16,1,3,25,71,38.26620989410235,-109.3475627
19293,1,23,16,0,3,25,68,38.26620989410235,-109.3472932
19294,2,22,16,0,2,27,69,38.26620989410235,-109.3470237
19295,1,22,18,0,3,30,74,38.26620989410235,-109.3467542
19296,1,23,18,0,5,30,77,38.26620989410235,-109.3464847
19297,1,25,19,1,8,30,84,38.26620989410235,-109.3462152
19298,1,23,19,1,7,32,83,38.26620989410235,-109.3459457
19299,1,27,20,0,8,29,85,38.26620989410235,-109.3456762
19300,3,28,18,1,7,25,82,38.26620989410235,-109.3454068
19301,3,29,17,1,7,24,81,38.26620989410235,-109.3451373
19302,2,27,18,0,5,26,78,38.26620989410235,-109.3448678
19303,4,27,18,3,7,25,84,38.26620989410235,-109.3445983
19304,3,28,18,2,10,26,87,38.26620989410235,-109.3443288
19305,4,27,18,5,12,22,88,38.26620989410235,-109.3440593
19306,8,28,17,9,11,17,90,38.26620989410235,-109.3437898
19307,10,33,16,11,11,10,91,38.26620989410235,-109.3435203
19308,8,39,14,12,11,5,89,38.26620989410235,-109.3432508
19309,7,40,14,12,11,5,89,38.26620989410235,-109.3429813
19310,8,39,14,12,11,5,89,38.26620989410235,-109.3427118
19311,9,39,14,13,11,5,91,38.26620989410235,-109.3424423
19312,8,39,14,13,11,4,89,38.26620989410235,-109.3421728
19313,8,41,14,11,11,5,90,38.26620989410235,-109.3419033
19314,8,41,14,11,11,5,90,38.26620989410235,-109.3416338
19315,7,40,14,11,11,6,89,38.26620989410235,-109.3413643
19316,8,39,14,13,9,6,89,38.26620989410235,-109.3410948
19317,9,37,15,16,11,4,92,38.26620989410235,-109.3408253
19318,10,35,15,14,9,6,89,38.26620989410235,-109.3405558
19319,9,36,14,13,9,6,87,38.26620989410235,-109.3402864
19320,8,37,14,12,10,6,87,38.26620989410235,-109.3400169
19321,9,37,14,13,9,6,88,38.26620989410235,-109.3397474
19322,10,37,15,14,10,5,91,38.26620989410235,-109.3394779
19323,10,37,15,13,10,5,90,38.26620989410235,-109.3392084
19324,9,39,15,14,10,5,92,38.26620989410235,-109.3389389
19325,8,42,15,13,10,4,92,38.26620989410235,-109.3386694
19326,8,44,14,12,8,5,91,38.26620989410235,-109.3383999
19327,8,43,14,12,9,5,91,38.26620989410235,-109.3381304
19328,10,40,14,13,8,5,90,38.26620989410235,-109.3378609
19329,11,38,14,14,8,6,91,38.26620989410235,-109.3375914
19330,9,37,14,14,9,6,89,38.26620989410235,-109.3373219
19331,8,38,14,13,11,6,90,38.26620989410235,-109.3370524
19332,9,36,14,14,12,5,90,38.26620989410235,-109.3367829
19333,9,38,15,12,12,6,92,38.26620989410235,-109.3365134
19334,8,40,14,12,10,6,90,38.26620989410235,-109.3362439
19335,11,38,15,15,8,4,91,38.26620989410235,-109.3359744
19336,0,34,12,0,14,17,77,38.26594039951712,-109.4408078
19337,0,34,12,0,12,18,76,38.26594039951712,-109.4405383
19338,1,36,12,0,11,17,77,38.26594039951712,-109.4402688
19339,1,37,11,0,12,16,77,38.26594039951712,-109.4399993
19340,1,38,11,0,13,15,78,38.26594039951712,-109.4397299
19341,2,45,11,0,14,11,83,38.26594039951712,-109.4394604
19342,1,54,10,0,15,8,88,38.26594039951712,-109.4391909
19343,1,50,10,0,16,6,83,38.26594039951712,-109.4389214
19344,2,41,11,0,13,10,77,38.26594039951712,-109.4386519
19345,1,36,11,0,13,14,75,38.26594039951712,-109.4383824
19346,0,37,11,0,14,14,76,38.26594039951712,-109.4381129
19347,1,34,12,0,16,15,78,38.26594039951712,-109.4378434
19348,0,36,12,0,13,16,77,38.26594039951712,-109.4375739
19349,0,34,13,0,12,18,77,38.26594039951712,-109.4373044
19350,0,33,13,0,12,20,78,38.26594039951712,-109.4370349
19351,0,30,14,0,11,21,76,38.26594039951712,-109.4367654
19352,0,31,14,2,15,16,78,38.26594039951712,-109.4364959
19353,0,32,15,6,17,12,82,38.26594039951712,-109.4362264
19354,1,32,14,3,15,15,80,38.26594039951712,-109.4359569
19355,2,34,14,3,16,15,84,38.26594039951712,-109.4356874
19356,1,32,14,2,16,13,78,38.26594039951712,-109.4354179
19357,1,31,12,3,15,14,76,38.26594039951712,-109.4351484
19358,2,30,13,5,13,13,76,38.26594039951712,-109.434879
19359,0,30,11,0,16,13,70,38.26594039951712,-109.4346095
19360,3,33,13,3,13,11,76,38.26594039951712,-109.43434
19361,4,32,14,2,13,10,75,38.26594039951712,-109.4340705
19362,3,29,13,3,14,11,73,38.26594039951712,-109.433801
19363,3,31,13,3,15,9,74,38.26594039951712,-109.4335315
19364,2,33,13,5,18,8,79,38.26594039951712,-109.433262
19365,1,31,12,2,17,10,73,38.26594039951712,-109.4329925
19366,2,31,14,0,13,16,76,38.26594039951712,-109.432723
19367,3,32,13,0,10,19,77,38.26594039951712,-109.4324535
19368,2,29,13,0,9,21,74,38.26594039951712,-109.432184
19369,2,28,14,0,8,21,73,38.26594039951712,-109.4319145
19370,3,31,14,0,9,19,76,38.26594039951712,-109.431645
19371,4,34,13,0,13,15,79,38.26594039951712,-109.4313755
19372,4,35,14,0,12,16,81,38.26594039951712,-109.431106
19373,3,33,13,0,11,18,78,38.26594039951712,-109.4308365
19374,2,30,14,0,8,21,75,38.26594039951712,-109.430567
19375,1,28,14,0,7,23,73,38.26594039951712,-109.4302975
19376,3,29,14,0,8,21,75,38.26594039951712,-109.430028
19377,1,32,12,0,10,18,73,38.26594039951712,-109.4297586
19378,1,34,11,0,11,15,72,38.26594039951712,-109.4294891
19379,1,34,11,0,11,15,72,38.26594039951712,-109.4292196
19380,1,34,11,0,12,14,72,38.26594039951712,-109.4289501
19381,1,34,11,0,12,15,73,38.26594039951712,-109.4286806
19382,1,36,11,0,13,14,75,38.26594039951712,-109.4284111
19383,1,36,11,0,13,14,75,38.26594039951712,-109.4281416
19384,1,34,11,0,13,14,73,38.26594039951712,-109.4278721
19385,1,33,11,0,12,15,72,38.26594039951712,-109.4276026
19386,0,33,11,0,11,15,70,38.26594039951712,-109.4273331
19387,0,32,11,0,10,18,71,38.26594039951712,-109.4270636
19388,1,29,12,0,7,20,69,38.26594039951712,-109.4267941
19389,3,31,12,0,7,19,72,38.26594039951712,-109.4265246
19390,2,30,12,0,8,19,71,38.26594039951712,-109.4262551
19391,2,28,14,0,6,22,72,38.26594039951712,-109.4259856
19392,2,29,14,0,7,22,74,38.26594039951712,-109.4257161
19393,2,31,13,0,8,20,74,38.26594039951712,-109.4254466
19394,3,32,13,0,9,19,76,38.26594039951712,-109.4251771
19395,2,40,12,1,14,12,81,38.26594039951712,-109.4249077
19396,3,43,12,2,15,10,85,38.26594039951712,-109.4246382
19397,5,45,12,2,15,8,87,38.26594039951712,-109.4243687
19398,6,47,12,5,16,5,91,38.26594039951712,-109.4240992
19399,8,45,13,6,16,3,91,38.26594039951712,-109.4238297
19400,12,39,13,9,16,2,91,38.26594039951712,-109.4235602
19401,16,34,13,11,15,1,90,38.26594039951712,-109.4232907
19402,18,32,13,11,14,1,89,38.26594039951712,-109.4230212
19403,15,36,13,10,15,1,90,38.26594039951712,-109.4227517
19404,18,33,13,11,15,1,91,38.26594039951712,-109.4224822
19405,17,33,13,12,15,0,90,38.26594039951712,-109.4222127
19406,19,31,13,13,15,0,91,38.26594039951712,-109.4219432
19407,24,29,13,12,14,0,92,38.26594039951712,-109.4216737
19408,24,31,12,10,13,0,90,38.26594039951712,-109.4214042
19409,24,32,12,10,13,0,91,38.26594039951712,-109.4211347
19410,26,32,12,9,12,0,91,38.26594039951712,-109.4208652
19411,26,32,11,10,11,0,90,38.26594039951712,-109.4205957
19412,24,33,12,10,12,0,91,38.26594039951712,-109.4203262
19413,22,35,12,9,12,0,90,38.26594039951712,-109.4200568
19414,21,35,12,9,12,0,89,38.26594039951712,-109.4197873
19415,23,33,12,10,12,0,90,38.26594039951712,-109.4195178
19416,25,32,12,10,12,0,91,38.26594039951712,-109.4192483
19417,23,34,12,10,12,0,91,38.26594039951712,-109.4189788
19418,15,39,13,10,14,0,91,38.26594039951712,-109.4187093
19419,11,42,13,10,16,0,92,38.26594039951712,-109.4184398
19420,11,42,13,9,16,0,91,38.26594039951712,-109.4181703
19421,13,41,13,9,15,0,91,38.26594039951712,-109.4179008
19422,9,43,12,8,17,0,89,38.26594039951712,-109.4176313
19423,6,46,12,6,18,1,89,38.26594039951712,-109.4173618
19424,5,47,12,5,18,2,89,38.26594039951712,-109.4170923
19425,5,47,12,5,18,2,89,38.26594039951712,-109.4168228
19426,5,47,12,5,18,1,88,38.26594039951712,-109.4165533
19427,5,46,12,6,19,1,89,38.26594039951712,-109.4162838
19428,5,46,12,5,20,1,89,38.26594039951712,-109.4160143
19429,4,48,12,4,19,1,88,38.26594039951712,-109.4157448
19430,4,52,11,4,17,0,88,38.26594039951712,-109.4154753
19431,5,55,9,6,14,0,89,38.26594039951712,-109.4152058
19432,5,50,10,6,16,0,87,38.26594039951712,-109.4149364
19433,7,48,11,6,17,0,89,38.26594039951712,-109.4146669
19434,8,46,12,7,18,0,91,38.26594039951712,-109.4143974
19435,8,45,13,7,18,0,91,38.26594039951712,-109.4141279
19436,7,47,13,5,18,0,90,38.26594039951712,-109.4138584
19437,7,47,13,6,18,0,91,38.26594039951712,-109.4135889
19438,9,45,13,7,17,0,91,38.26594039951712,-109.4133194
19439,9,44,13,7,18,0,91,38.26594039951712,-109.4130499
19440,8,45,12,6,19,0,90,38.26594039951712,-109.4127804
19441,8,43,12,8,18,0,89,38.26594039951712,-109.4125109
19442,7,44,12,7,18,0,88,38.26594039951712,-109.4122414
19443,8,45,12,7,17,0,89,38.26594039951712,-109.4119719
19444,8,45,13,8,17,0,91,38.26594039951712,-109.4117024
19445,7,47,12,7,17,0,90,38.26594039951712,-109.4114329
19446,6,48,12,5,18,1,90,38.26594039951712,-109.4111634
19447,6,48,13,6,17,0,90,38.26594039951712,-109.4108939
19448,6,48,13,6,17,1,91,38.26594039951712,-109.4106244
19449,6,49,13,6,17,1,92,38.26594039951712,-109.4103549
19450,5,50,13,7,17,0,92,38.26594039951712,-109.4100855
19451,5,51,13,6,17,1,93,38.26594039951712,-109.409816
19452,5,52,13,6,16,1,93,38.26594039951712,-109.4095465
19453,5,53,12,6,17,0,93,38.26594039951712,-109.409277
19454,5,53,13,6,17,0,94,38.26594039951712,-109.4090075
19455,8,50,13,9,16,0,96,38.26594039951712,-109.408738
19456,7,49,13,8,17,0,94,38.26594039951712,-109.4084685
19457,7,48,14,7,18,1,95,38.26594039951712,-109.408199
19458,6,48,14,6,19,1,94,38.26594039951712,-109.4079295
19459,4,49,13,4,19,3,92,38.26594039951712,-109.40766
19460,3,49,12,1,16,7,88,38.26594039951712,-109.4073905
19461,2,49,11,1,15,7,85,38.26594039951712,-109.407121
19462,2,50,10,0,15,7,84,38.26594039951712,-109.4068515
19463,3,44,12,1,12,10,82,38.26594039951712,-109.3879869
19464,3,49,11,1,13,8,85,38.26594039951712,-109.3877174
19465,3,48,11,2,14,6,84,38.26594039951712,-109.3874479
19466,2,35,11,1,12,10,71,38.26594039951712,-109.3871784
19467,1,29,12,1,10,14,67,38.26594039951712,-109.3869089
19468,2,29,13,0,10,15,69,38.26594039951712,-109.3866394
19469,1,29,12,0,10,16,68,38.26594039951712,-109.3863699
19470,2,31,14,1,10,16,74,38.26594039951712,-109.3861004
19471,2,35,12,1,12,12,74,38.26594039951712,-109.3858309
19472,3,40,12,2,15,8,80,38.26594039951712,-109.3855614
19473,3,42,12,2,15,7,81,38.26594039951712,-109.3852919
19474,3,41,11,1,14,8,78,38.26594039951712,-109.3850225
19475,3,43,11,2,15,7,81,38.26594039951712,-109.384753
19476,3,49,11,2,14,6,85,38.26594039951712,-109.3844835
19477,2,50,11,2,14,7,86,38.26594039951712,-109.384214
19478,2,47,11,2,13,7,82,38.26594039951712,-109.3839445
19479,3,46,12,3,14,7,85,38.26594039951712,-109.383675
19480,3,39,11,3,12,10,78,38.26594039951712,-109.3834055
19481,2,40,10,1,12,10,75,38.26594039951712,-109.383136
19482,1,44,9,0,13,8,75,38.26594039951712,-109.3828665
19483,0,48,8,0,13,5,74,38.26594039951712,-109.382597
19484,1,39,10,2,9,7,68,38.26594039951712,-109.3823275
19485,1,28,10,1,9,12,61,38.26594039951712,-109.382058
19486,1,26,12,1,9,16,65,38.26594039951712,-109.3817885
19487,0,30,14,0,11,21,76,38.26594039951712,-109.381519
19488,1,28,14,0,8,22,73,38.26594039951712,-109.3812495
19489,2,27,14,1,8,21,73,38.26594039951712,-109.38098
19490,4,27,13,2,7,16,69,38.26594039951712,-109.3807105
19491,10,24,11,8,10,7,70,38.26594039951712,-109.380441
19492,11,27,10,13,11,1,73,38.26594039951712,-109.3801716
19493,9,32,12,9,15,3,80,38.26594039951712,-109.3799021
19494,8,37,12,6,16,4,83,38.26594039951712,-109.3796326
19495,8,38,13,6,15,5,85,38.26594039951712,-109.3793631
19496,7,36,13,5,15,7,83,38.26594039951712,-109.3790936
19497,6,33,14,12,16,6,87,38.26594039951712,-109.3788241
19498,6,31,13,11,17,6,84,38.26594039951712,-109.3785546
19499,8,32,12,12,16,2,82,38.26594039951712,-109.3782851
19500,10,31,12,13,16,1,83,38.26594039951712,-109.3780156
19501,12,30,12,14,15,1,84,38.26594039951712,-109.3777461
19502,14,28,12,14,14,1,83,38.26594039951712,-109.3774766
19503,8,36,12,11,17,1,85,38.26594039951712,-109.3772071
19504,8,37,12,10,16,1,84,38.26594039951712,-109.3769376
19505,13,28,12,12,14,1,80,38.26594039951712,-109.3766681
19506,17,18,12,13,12,2,74,38.26594039951712,-109.3763986
19507,21,19,11,12,13,1,77,38.26594039951712,-109.3761291
19508,16,29,12,10,12,3,82,38.26594039951712,-109.3758596
19509,11,35,13,9,12,5,85,38.26594039951712,-109.3755901
19510,13,33,12,9,11,5,83,38.26594039951712,-109.3753206
19511,18,27,12,8,10,3,78,38.26594039951712,-109.3750512
19512,15,28,12,11,11,3,80,38.26594039951712,-109.3747817
19513,11,34,13,7,11,7,83,38.26594039951712,-109.3745122
19514,11,35,15,6,11,10,88,38.26594039951712,-109.3742427
19515,12,33,15,7,10,10,87,38.26594039951712,-109.3739732
19516,11,33,15,6,9,11,85,38.26594039951712,-109.3737037
19517,11,34,14,5,11,10,85,38.26594039951712,-109.3734342
19518,11,33,14,5,10,11,84,38.26594039951712,-109.3731647
19519,12,32,14,6,8,10,82,38.26594039951712,-109.3728952
19520,20,30,14,7,6,8,85,38.26594039951712,-109.3726257
19521,21,32,13,8,8,5,87,38.26594039951712,-109.3723562
19522,15,33,13,5,9,7,82,38.26594039951712,-109.3720867
19523,9,35,11,4,10,8,77,38.26594039951712,-109.3718172
19524,5,38,11,3,11,7,75,38.26594039951712,-109.3715477
19525,4,42,11,2,12,8,79,38.26594039951712,-109.3712782
19526,3,40,10,1,12,9,75,38.26594039951712,-109.3710087
19527,1,42,9,0,12,9,73,38.26594039951712,-109.3707392
19528,0,46,8,0,11,6,71,38.26594039951712,-109.3704697
19529,0,52,8,2,11,4,77,38.26594039951712,-109.3702003
19530,0,50,8,2,11,4,75,38.26594039951712,-109.3699308
19531,1,52,8,2,12,3,78,38.26594039951712,-109.3696613
19532,0,49,8,2,13,4,76,38.26594039951712,-109.3693918
19533,0,44,8,0,12,6,70,38.26594039951712,-109.3691223
19534,0,38,9,2,10,9,68,38.26594039951712,-109.3688528
19535,4,29,13,4,4,17,71,38.26594039951712,-109.3685833
19536,3,23,15,1,2,25,69,38.26594039951712,-109.3683138
19537,4,24,16,1,2,26,73,38.26594039951712,-109.3680443
19538,4,24,17,0,3,28,76,38.26594039951712,-109.3677748
19539,2,28,15,1,4,26,76,38.26594039951712,-109.3675053
19540,2,29,15,1,4,27,78,38.26594039951712,-109.3672358
19541,2,24,15,0,7,26,74,38.26594039951712,-109.3669663
19542,3,25,15,2,2,26,73,38.26594039951712,-109.3666968
19543,3,27,16,0,11,22,79,38.26594039951712,-109.3664273
19544,2,26,15,0,10,21,74,38.26594039951712,-109.3661578
19545,3,24,14,2,12,17,72,38.26594039951712,-109.3658883
19546,3,19,13,9,14,12,70,38.26594039951712,-109.3656188
19547,3,21,11,11,20,7,73,38.26594039951712,-109.3653493
19548,1,21,9,6,12,9,58,38.26594039951712,-109.3650799
19549,4,25,10,4,8,12,63,38.26594039951712,-109.3648104
19550,6,29,9,2,3,11,60,38.26594039951712,-109.3645409
19551,5,35,5,4,5,4,58,38.26594039951712,-109.3642714
19552,2,39,4,2,7,3,57,38.26594039951712,-109.3640019
19553,2,33,4,1,7,3,50,38.26594039951712,-109.3637324
19554,4,27,8,2,7,5,53,38.26594039951712,-109.3634629
19555,4,29,9,3,8,6,59,38.26594039951712,-109.3631934
19556,2,28,10,3,9,9,61,38.26594039951712,-109.3629239
19557,2,27,10,3,9,9,60,38.26594039951712,-109.3626544
19558,5,27,10,4,10,6,62,38.26594039951712,-109.3623849
19559,2,22,9,3,8,7,51,38.26594039951712,-109.3621154
19560,2,16,10,6,6,9,49,38.26594039951712,-109.3618459
19561,4,20,14,9,7,10,64,38.26594039951712,-109.3615764
19562,2,23,14,7,10,15,71,38.26594039951712,-109.3613069
19563,0,30,15,3,11,23,82,38.26594039951712,-109.3610374
19564,1,28,16,3,10,25,83,38.26594039951712,-109.3607679
19565,0,23,17,0,5,31,76,38.26594039951712,-109.3604984
19566,1,21,17,0,2,32,73,38.26594039951712,-109.360229
19567,1,21,17,0,3,32,74,38.26594039951712,-109.3599595
19568,2,24,16,0,4,27,73,38.26594039951712,-109.35969
19569,4,29,15,1,6,22,77,38.26594039951712,-109.3594205
19570,3,29,14,1,8,20,75,38.26594039951712,-109.359151
19571,2,25,15,0,7,24,73,38.26594039951712,-109.3588815
19572,0,25,15,0,5,27,72,38.26594039951712,-109.358612
19573,0,23,14,0,4,28,69,38.26594039951712,-109.3583425
19574,0,23,13,0,5,24,65,38.26594039951712,-109.358073
19575,0,28,15,0,5,27,75,38.26594039951712,-109.3578035
19576,4,22,14,5,6,22,73,38.26594039951712,-109.357534
19577,7,26,13,15,8,13,82,38.26594039951712,-109.3572645
19578,9,22,11,15,10,10,77,38.26594039951712,-109.356995
19579,8,22,10,14,11,9,74,38.26594039951712,-109.3567255
19580,7,25,10,15,13,6,76,38.26594039951712,-109.356456
19581,3,28,11,9,13,5,69,38.26594039951712,-109.3561865
19582,10,14,13,6,10,7,60,38.26594039951712,-109.355917
19583,12,33,8,4,6,5,68,38.26594039951712,-109.3556475
19584,3,40,6,6,7,3,65,38.26594039951712,-109.355378
19585,2,40,5,2,7,3,59,38.26594039951712,-109.3551086
19586,3,39,6,3,7,4,62,38.26594039951712,-109.3548391
19587,9,34,9,4,8,4,68,38.26594039951712,-109.3545696
19588,9,29,10,6,8,6,68,38.26594039951712,-109.3543001
19589,5,21,8,5,7,9,55,38.26594039951712,-109.3540306
19590,4,22,9,6,7,9,57,38.26594039951712,-109.3537611
19591,6,25,11,6,8,9,65,38.26594039951712,-109.3534916
19592,5,26,9,6,9,8,63,38.26594039951712,-109.3532221
19593,4,32,7,5,9,7,64,38.26594039951712,-109.3529526
19594,4,38,7,7,9,6,71,38.26594039951712,-109.3526831
19595,3,41,8,7,9,5,73,38.26594039951712,-109.3524136
19596,3,40,8,6,8,4,69,38.26594039951712,-109.3521441
19597,5,35,7,4,7,6,64,38.26594039951712,-109.3518746
19598,4,27,7,5,6,6,55,38.26594039951712,-109.3516051
19599,3,31,7,5,7,5,58,38.26594039951712,-109.3513356
19600,2,30,6,5,5,8,56,38.26594039951712,-109.3510661
19601,2,29,7,7,6,7,58,38.26594039951712,-109.3507966
19602,4,27,8,7,6,8,60,38.26594039951712,-109.3505271
19603,3,18,10,7,6,11,55,38.26594039951712,-109.3502577
19604,3,10,11,7,8,13,52,38.26594039951712,-109.3499882
19605,1,12,13,3,3,21,53,38.26594039951712,-109.3497187
19606,2,14,14,3,4,21,58,38.26594039951712,-109.3494492
19607,1,14,14,0,2,25,56,38.26594039951712,-109.3491797
19608,1,16,16,0,1,28,62,38.26594039951712,-109.3489102
19609,1,18,17,0,1,30,67,38.26594039951712,-109.3486407
19610,1,19,17,0,1,30,68,38.26594039951712,-109.3483712
19611,1,23,16,1,1,27,69,38.26594039951712,-109.3481017
19612,2,24,15,1,3,25,70,38.26594039951712,-109.3478322
19613,2,23,15,1,3,24,68,38.26594039951712,-109.3475627
19614,1,23,16,0,4,27,71,38.26594039951712,-109.3472932
19615,2,23,18,0,3,29,75,38.26594039951712,-109.3470237
19616,1,22,19,0,4,32,78,38.26594039951712,-109.3467542
19617,0,24,20,0,6,31,81,38.26594039951712,-109.3464847
19618,1,24,19,2,8,29,83,38.26594039951712,-109.3462152
19619,2,22,20,3,7,29,83,38.26594039951712,-109.3459457
19620,2,25,18,0,4,29,78,38.26594039951712,-109.3456762
19621,1,23,17,0,3,28,72,38.26594039951712,-109.3454068
19622,1,23,18,0,3,29,74,38.26594039951712,-109.3451373
19623,1,24,19,0,5,32,81,38.26594039951712,-109.3448678
19624,1,24,21,0,7,33,86,38.26594039951712,-109.3445983
19625,1,26,20,0,7,31,85,38.26594039951712,-109.3443288
19626,4,27,18,3,10,25,87,38.26594039951712,-109.3440593
19627,9,29,17,7,9,18,89,38.26594039951712,-109.3437898
19628,12,33,16,9,8,11,89,38.26594039951712,-109.3435203
19629,9,39,14,11,11,6,90,38.26594039951712,-109.3432508
19630,8,40,14,11,11,4,88,38.26594039951712,-109.3429813
19631,8,40,14,12,12,4,90,38.26594039951712,-109.3427118
19632,8,40,14,13,12,4,91,38.26594039951712,-109.3424423
19633,9,41,14,13,12,3,92,38.26594039951712,-109.3421728
19634,8,42,14,12,11,3,90,38.26594039951712,-109.3419033
19635,8,40,14,12,11,4,89,38.26594039951712,-109.3416338
19636,7,40,14,13,11,4,89,38.26594039951712,-109.3413643
19637,7,40,15,13,10,4,89,38.26594039951712,-109.3410948
19638,7,39,14,14,12,3,89,38.26594039951712,-109.3408253
19639,9,36,15,14,11,5,90,38.26594039951712,-109.3405558
19640,9,35,14,14,11,6,89,38.26594039951712,-109.3402864
19641,8,36,14,13,12,6,89,38.26594039951712,-109.3400169
19642,8,38,14,12,11,6,89,38.26594039951712,-109.3397474
19643,9,39,15,13,11,5,92,38.26594039951712,-109.3394779
19644,8,39,15,12,10,6,90,38.26594039951712,-109.3392084
19645,8,39,15,12,10,6,90,38.26594039951712,-109.3389389
19646,9,41,15,13,10,5,93,38.26594039951712,-109.3386694
19647,12,38,14,12,8,6,90,38.26594039951712,-109.3383999
19648,11,38,14,12,7,6,88,38.26594039951712,-109.3381304
19649,12,37,14,13,8,6,90,38.26594039951712,-109.3378609
19650,11,37,14,14,8,6,90,38.26594039951712,-109.3375914
19651,9,37,14,14,9,6,89,38.26594039951712,-109.3373219
19652,9,36,14,12,11,6,88,38.26594039951712,-109.3370524
19653,8,35,14,12,12,7,88,38.26594039951712,-109.3367829
19654,9,37,14,14,12,6,92,38.26594039951712,-109.3365134
19655,9,38,15,14,10,5,91,38.26594039951712,-109.3362439
19656,10,37,15,13,11,5,91,38.26594039951712,-109.3359744
19657,2,39,11,0,15,14,81,38.26567090493188,-109.4408078
19658,2,40,11,0,16,12,81,38.26567090493188,-109.4405383
19659,2,40,11,0,14,12,79,38.26567090493188,-109.4402688
19660,1,39,11,0,15,12,78,38.26567090493188,-109.4399993
19661,1,38,11,0,15,12,77,38.26567090493188,-109.4397299
19662,1,39,11,0,14,12,77,38.26567090493188,-109.4394604
19663,2,42,11,0,14,11,80,38.26567090493188,-109.4391909
19664,2,40,11,1,14,7,75,38.26567090493188,-109.4389214
19665,2,36,11,2,12,12,75,38.26567090493188,-109.4386519
19666,1,35,12,1,12,14,75,38.26567090493188,-109.4383824
19667,1,35,11,0,13,14,74,38.26567090493188,-109.4381129
19668,1,36,11,0,12,16,76,38.26567090493188,-109.4378434
19669,2,39,11,0,13,13,78,38.26567090493188,-109.4375739
19670,1,36,11,0,12,15,75,38.26567090493188,-109.4373044
19671,0,34,12,0,13,18,77,38.26567090493188,-109.4370349
19672,0,32,14,2,18,12,78,38.26567090493188,-109.4367654
19673,0,32,14,2,18,14,80,38.26567090493188,-109.4364959
19674,2,35,13,2,17,13,82,38.26567090493188,-109.4362264
19675,2,36,14,2,19,11,84,38.26567090493188,-109.4359569
19676,2,35,14,4,20,8,83,38.26567090493188,-109.4356874
19677,4,33,13,3,18,11,82,38.26567090493188,-109.4354179
19678,2,35,13,0,14,17,81,38.26567090493188,-109.4351484
19679,1,34,14,0,15,17,81,38.26567090493188,-109.434879
19680,0,32,13,2,13,15,75,38.26567090493188,-109.4346095
19681,0,29,12,1,11,15,68,38.26567090493188,-109.43434
19682,0,29,12,4,15,11,71,38.26567090493188,-109.4340705
19683,4,33,13,2,14,12,78,38.26567090493188,-109.433801
19684,2,30,15,1,10,19,77,38.26567090493188,-109.4335315
19685,1,27,14,0,9,21,72,38.26567090493188,-109.433262
19686,2,29,13,0,9,20,73,38.26567090493188,-109.4329925
19687,2,28,14,0,9,21,74,38.26567090493188,-109.432723
19688,5,32,14,1,9,20,81,38.26567090493188,-109.4324535
19689,5,31,15,2,9,18,80,38.26567090493188,-109.432184
19690,5,27,14,5,10,15,76,38.26567090493188,-109.4319145
19691,8,28,13,6,9,12,76,38.26567090493188,-109.431645
19692,7,28,15,5,10,14,79,38.26567090493188,-109.4313755
19693,6,27,15,4,10,15,77,38.26567090493188,-109.431106
19694,5,29,15,3,10,17,79,38.26567090493188,-109.4308365
19695,6,32,15,2,9,18,82,38.26567090493188,-109.430567
19696,6,31,15,1,7,21,81,38.26567090493188,-109.4302975
19697,5,29,15,1,7,21,78,38.26567090493188,-109.430028
19698,3,29,14,0,8,20,74,38.26567090493188,-109.4297586
19699,3,32,13,0,11,17,76,38.26567090493188,-109.4294891
19700,4,36,12,0,12,14,78,38.26567090493188,-109.4292196
19701,3,36,12,0,13,13,77,38.26567090493188,-109.4289501
19702,2,33,11,0,12,14,72,38.26567090493188,-109.4286806
19703,1,32,11,0,10,16,70,38.26567090493188,-109.4284111
19704,2,32,12,0,10,17,73,38.26567090493188,-109.4281416
19705,2,35,11,0,12,14,74,38.26567090493188,-109.4278721
19706,1,34,11,0,11,16,73,38.26567090493188,-109.4276026
19707,1,32,12,0,9,18,72,38.26567090493188,-109.4273331
19708,1,30,12,0,7,20,70,38.26567090493188,-109.4270636
19709,2,29,13,0,7,21,72,38.26567090493188,-109.4267941
19710,3,29,13,0,6,21,72,38.26567090493188,-109.4265246
19711,3,30,12,0,9,18,72,38.26567090493188,-109.4262551
19712,3,30,13,0,8,19,73,38.26567090493188,-109.4259856
19713,3,29,13,0,8,20,73,38.26567090493188,-109.4257161
19714,3,31,13,1,8,20,76,38.26567090493188,-109.4254466
19715,3,31,14,1,6,20,75,38.26567090493188,-109.4251771
19716,3,41,12,0,13,13,82,38.26567090493188,-109.4249077
19717,3,44,12,1,14,10,84,38.26567090493188,-109.4246382
19718,3,45,12,3,16,7,86,38.26567090493188,-109.4243687
19719,6,49,13,5,16,4,93,38.26567090493188,-109.4240992
19720,7,49,12,6,16,3,93,38.26567090493188,-109.4238297
19721,8,44,12,6,16,3,89,38.26567090493188,-109.4235602
19722,9,38,12,7,16,3,85,38.26567090493188,-109.4232907
19723,11,33,13,8,15,4,84,38.26567090493188,-109.4230212
19724,11,32,13,8,14,4,82,38.26567090493188,-109.4227517
19725,13,32,13,11,16,2,87,38.26567090493188,-109.4224822
19726,11,34,13,13,17,1,89,38.26567090493188,-109.4222127
19727,11,34,13,13,17,1,89,38.26567090493188,-109.4219432
19728,16,32,12,12,15,1,88,38.26567090493188,-109.4216737
19729,19,33,12,10,14,1,89,38.26567090493188,-109.4214042
19730,24,31,12,9,13,1,90,38.26567090493188,-109.4211347
19731,26,29,12,9,12,1,89,38.26567090493188,-109.4208652
19732,26,30,12,10,12,1,91,38.26567090493188,-109.4205957
19733,26,31,12,10,11,0,90,38.26567090493188,-109.4203262
19734,21,35,12,7,12,2,89,38.26567090493188,-109.4200568
19735,15,35,12,8,14,1,85,38.26567090493188,-109.4197873
19736,18,35,12,10,13,0,88,38.26567090493188,-109.4195178
19737,21,34,12,9,13,0,89,38.26567090493188,-109.4192483
19738,18,36,12,10,14,0,90,38.26567090493188,-109.4189788
19739,12,41,13,10,15,0,91,38.26567090493188,-109.4187093
19740,8,45,13,9,17,0,92,38.26567090493188,-109.4184398
19741,7,45,13,9,17,0,91,38.26567090493188,-109.4181703
19742,10,42,13,9,16,0,90,38.26567090493188,-109.4179008
19743,9,42,12,9,16,0,88,38.26567090493188,-109.4176313
19744,6,46,12,7,18,0,89,38.26567090493188,-109.4173618
19745,6,47,12,6,18,0,89,38.26567090493188,-109.4170923
19746,6,47,12,6,19,1,91,38.26567090493188,-109.4168228
19747,5,46,12,5,19,2,89,38.26567090493188,-109.4165533
19748,5,47,12,5,19,1,89,38.26567090493188,-109.4162838
19749,5,48,12,4,19,1,89,38.26567090493188,-109.4160143
19750,5,51,11,4,18,0,89,38.26567090493188,-109.4157448
19751,4,54,10,5,16,0,89,38.26567090493188,-109.4154753
19752,4,54,9,5,15,0,87,38.26567090493188,-109.4152058
19753,6,50,11,6,18,0,91,38.26567090493188,-109.4149364
19754,8,46,12,7,18,0,91,38.26567090493188,-109.4146669
19755,8,45,12,7,18,0,90,38.26567090493188,-109.4143974
19756,8,45,12,6,18,0,89,38.26567090493188,-109.4141279
19757,8,45,13,6,18,0,90,38.26567090493188,-109.4138584
19758,9,44,13,7,17,0,90,38.26567090493188,-109.4135889
19759,10,44,13,7,17,0,91,38.26567090493188,-109.4133194
19760,11,42,12,7,17,0,89,38.26567090493188,-109.4130499
19761,11,42,12,7,17,0,89,38.26567090493188,-109.4127804
19762,11,41,12,8,17,0,89,38.26567090493188,-109.4125109
19763,9,44,12,7,17,0,89,38.26567090493188,-109.4122414
19764,7,45,12,6,17,1,88,38.26567090493188,-109.4119719
19765,7,44,13,7,18,0,89,38.26567090493188,-109.4117024
19766,7,45,12,8,18,0,90,38.26567090493188,-109.4114329
19767,7,47,13,7,17,1,92,38.26567090493188,-109.4111634
19768,7,47,13,7,17,1,92,38.26567090493188,-109.4108939
19769,6,47,13,6,17,1,90,38.26567090493188,-109.4106244
19770,6,47,13,6,17,1,90,38.26567090493188,-109.4103549
19771,6,48,13,7,17,0,91,38.26567090493188,-109.4100855
19772,6,51,13,5,17,1,93,38.26567090493188,-109.409816
19773,5,53,13,5,16,1,93,38.26567090493188,-109.4095465
19774,5,54,12,5,17,1,94,38.26567090493188,-109.409277
19775,5,54,12,5,17,1,94,38.26567090493188,-109.4090075
19776,8,50,13,7,17,0,95,38.26567090493188,-109.408738
19777,7,49,13,7,18,0,94,38.26567090493188,-109.4084685
19778,5,48,13,5,19,2,92,38.26567090493188,-109.408199
19779,4,46,13,2,17,5,87,38.26567090493188,-109.4079295
19780,3,46,12,1,15,8,85,38.26567090493188,-109.40766
19781,2,48,12,1,16,7,86,38.26567090493188,-109.4073905
19782,2,49,11,1,15,7,85,38.26567090493188,-109.407121
19783,2,47,10,1,15,6,81,38.26567090493188,-109.4068515
19784,4,46,11,3,12,8,84,38.26567090493188,-109.3879869
19785,3,48,12,4,14,5,86,38.26567090493188,-109.3877174
19786,3,44,11,4,15,5,82,38.26567090493188,-109.3874479
19787,2,33,11,0,11,12,69,38.26567090493188,-109.3871784
19788,1,30,11,0,9,14,65,38.26567090493188,-109.3869089
19789,1,29,11,0,9,16,66,38.26567090493188,-109.3866394
19790,0,28,11,0,8,16,63,38.26567090493188,-109.3863699
19791,2,33,12,2,10,15,74,38.26567090493188,-109.3861004
19792,3,40,12,1,13,11,80,38.26567090493188,-109.3858309
19793,3,45,12,1,14,9,84,38.26567090493188,-109.3855614
19794,3,48,11,1,14,8,85,38.26567090493188,-109.3852919
19795,3,47,11,1,12,8,82,38.26567090493188,-109.3850225
19796,3,46,11,1,12,8,81,38.26567090493188,-109.384753
19797,3,49,10,2,13,6,83,38.26567090493188,-109.3844835
19798,2,50,10,2,13,6,83,38.26567090493188,-109.384214
19799,2,47,11,4,14,6,84,38.26567090493188,-109.3839445
19800,3,44,12,4,15,5,83,38.26567090493188,-109.383675
19801,2,40,11,2,12,9,76,38.26567090493188,-109.3834055
19802,1,41,10,1,12,9,74,38.26567090493188,-109.383136
19803,1,42,10,1,12,8,74,38.26567090493188,-109.3828665
19804,1,38,10,1,10,9,69,38.26567090493188,-109.382597
19805,2,33,11,4,8,8,66,38.26567090493188,-109.3823275
19806,2,24,11,2,8,13,60,38.26567090493188,-109.382058
19807,1,29,12,0,9,17,68,38.26567090493188,-109.3817885
19808,1,32,13,0,9,20,75,38.26567090493188,-109.381519
19809,2,30,13,1,8,18,72,38.26567090493188,-109.3812495
19810,4,29,13,5,11,13,75,38.26567090493188,-109.38098
19811,6,29,13,5,11,11,75,38.26567090493188,-109.3807105
19812,8,28,12,9,11,8,76,38.26567090493188,-109.380441
19813,14,25,12,12,11,3,77,38.26567090493188,-109.3801716
19814,11,25,12,14,14,2,78,38.26567090493188,-109.3799021
19815,8,31,12,9,13,4,77,38.26567090493188,-109.3796326
19816,8,34,12,7,13,5,79,38.26567090493188,-109.3793631
19817,7,33,13,7,13,8,81,38.26567090493188,-109.3790936
19818,6,31,14,7,14,10,82,38.26567090493188,-109.3788241
19819,6,32,13,10,16,7,84,38.26567090493188,-109.3785546
19820,7,33,13,12,17,4,86,38.26567090493188,-109.3782851
19821,10,33,12,11,16,2,84,38.26567090493188,-109.3780156
19822,10,34,12,11,16,1,84,38.26567090493188,-109.3777461
19823,9,34,12,13,16,1,85,38.26567090493188,-109.3774766
19824,7,38,12,10,17,1,85,38.26567090493188,-109.3772071
19825,7,35,12,11,17,1,83,38.26567090493188,-109.3769376
19826,13,24,12,13,14,1,77,38.26567090493188,-109.3766681
19827,16,17,11,15,13,1,73,38.26567090493188,-109.3763986
19828,16,22,12,12,12,3,77,38.26567090493188,-109.3761291
19829,14,28,13,10,12,4,81,38.26567090493188,-109.3758596
19830,14,30,12,10,12,4,82,38.26567090493188,-109.3755901
19831,19,27,12,9,11,3,81,38.26567090493188,-109.3753206
19832,22,24,12,9,11,2,80,38.26567090493188,-109.3750512
19833,18,27,13,10,10,4,82,38.26567090493188,-109.3747817
19834,15,31,14,9,10,7,86,38.26567090493188,-109.3745122
19835,14,33,15,8,11,9,90,38.26567090493188,-109.3742427
19836,12,34,14,7,10,9,86,38.26567090493188,-109.3739732
19837,9,35,13,6,11,8,82,38.26567090493188,-109.3737037
19838,13,36,12,6,13,3,83,38.26567090493188,-109.3734342
19839,11,38,12,6,10,5,82,38.26567090493188,-109.3731647
19840,20,40,12,6,5,4,87,38.26567090493188,-109.3728952
19841,33,37,11,5,2,1,89,38.26567090493188,-109.3726257
19842,26,43,11,8,2,0,90,38.26567090493188,-109.3723562
19843,14,37,10,6,9,3,79,38.26567090493188,-109.3720867
19844,5,36,10,4,11,8,74,38.26567090493188,-109.3718172
19845,2,39,10,3,12,8,74,38.26567090493188,-109.3715477
19846,2,40,10,2,12,8,74,38.26567090493188,-109.3712782
19847,2,38,10,1,11,10,72,38.26567090493188,-109.3710087
19848,1,30,10,1,8,14,64,38.26567090493188,-109.3707392
19849,0,32,10,0,8,14,64,38.26567090493188,-109.3704697
19850,0,37,9,0,10,12,68,38.26567090493188,-109.3702003
19851,1,39,10,0,12,11,73,38.26567090493188,-109.3699308
19852,1,34,10,0,9,13,67,38.26567090493188,-109.3696613
19853,1,37,10,1,12,10,71,38.26567090493188,-109.3693918
19854,1,34,10,0,10,12,67,38.26567090493188,-109.3691223
19855,2,27,11,0,7,18,65,38.26567090493188,-109.3688528
19856,3,26,15,0,4,24,72,38.26567090493188,-109.3685833
19857,2,25,16,0,4,26,73,38.26567090493188,-109.3683138
19858,3,25,15,0,4,24,71,38.26567090493188,-109.3680443
19859,3,25,14,0,4,23,69,38.26567090493188,-109.3677748
19860,3,25,15,0,5,22,70,38.26567090493188,-109.3675053
19861,4,27,14,1,5,21,72,38.26567090493188,-109.3672358
19862,5,28,13,0,4,21,71,38.26567090493188,-109.3669663
19863,2,28,14,0,12,19,75,38.26567090493188,-109.3666968
19864,1,28,16,1,10,22,78,38.26567090493188,-109.3664273
19865,3,25,16,2,11,21,78,38.26567090493188,-109.3661578
19866,4,19,14,7,8,19,71,38.26567090493188,-109.3658883
19867,0,23,13,4,16,11,67,38.26567090493188,-109.3656188
19868,1,23,9,12,14,5,64,38.26567090493188,-109.3653493
19869,6,26,9,7,8,4,60,38.26567090493188,-109.3650799
19870,7,40,6,6,2,5,66,38.26567090493188,-109.3648104
19871,4,46,4,6,6,3,69,38.26567090493188,-109.3645409
19872,2,42,4,2,7,2,59,38.26567090493188,-109.3642714
19873,3,37,5,1,8,3,57,38.26567090493188,-109.3640019
19874,4,31,6,3,8,4,56,38.26567090493188,-109.3637324
19875,2,28,8,4,9,6,57,38.26567090493188,-109.3634629
19876,2,29,9,4,9,7,60,38.26567090493188,-109.3631934
19877,1,30,9,2,9,9,60,38.26567090493188,-109.3629239
19878,2,25,9,3,9,8,56,38.26567090493188,-109.3626544
19879,3,25,9,5,8,6,56,38.26567090493188,-109.3623849
19880,2,24,9,3,8,7,53,38.26567090493188,-109.3621154
19881,7,22,14,12,8,8,71,38.26567090493188,-109.3618459
19882,7,26,15,15,14,9,86,38.26567090493188,-109.3615764
19883,0,30,17,2,10,24,83,38.26567090493188,-109.3613069
19884,0,27,16,1,7,27,78,38.26567090493188,-109.3610374
19885,1,24,16,0,3,30,74,38.26567090493188,-109.3607679
19886,2,22,17,0,3,31,75,38.26567090493188,-109.3604984
19887,2,19,17,0,2,32,72,38.26567090493188,-109.360229
19888,2,19,17,0,2,31,71,38.26567090493188,-109.3599595
19889,3,23,16,1,2,27,72,38.26567090493188,-109.35969
19890,3,27,14,0,5,22,71,38.26567090493188,-109.3594205
19891,2,26,14,0,6,23,71,38.26567090493188,-109.359151
19892,1,23,15,0,5,26,70,38.26567090493188,-109.3588815
19893,0,23,14,0,5,25,67,38.26567090493188,-109.358612
19894,0,22,14,0,5,25,66,38.26567090493188,-109.3583425
19895,0,25,16,0,9,26,76,38.26567090493188,-109.358073
19896,2,28,17,2,9,21,79,38.26567090493188,-109.3578035
19897,3,29,17,4,7,22,82,38.26567090493188,-109.357534
19898,8,36,13,5,12,13,87,38.26567090493188,-109.3572645
19899,9,31,13,8,18,6,85,38.26567090493188,-109.356995
19900,4,30,14,1,20,6,75,38.26567090493188,-109.3567255
19901,4,23,11,7,17,1,63,38.26567090493188,-109.356456
19902,7,23,10,12,9,1,62,38.26567090493188,-109.3561865
19903,4,39,7,6,7,4,67,38.26567090493188,-109.355917
19904,4,35,6,3,7,4,59,38.26567090493188,-109.3556475
19905,2,30,6,3,7,4,52,38.26567090493188,-109.355378
19906,1,28,7,4,8,5,53,38.26567090493188,-109.3551086
19907,4,31,9,4,9,4,61,38.26567090493188,-109.3548391
19908,5,24,9,5,8,8,59,38.26567090493188,-109.3545696
19909,11,21,10,6,8,7,63,38.26567090493188,-109.3543001
19910,3,16,9,4,5,13,50,38.26567090493188,-109.3540306
19911,4,25,13,5,7,11,65,38.26567090493188,-109.3537611
19912,7,25,12,6,7,9,66,38.26567090493188,-109.3534916
19913,7,23,12,6,5,11,64,38.26567090493188,-109.3532221
19914,4,27,11,5,7,9,63,38.26567090493188,-109.3529526
19915,3,30,8,6,10,7,64,38.26567090493188,-109.3526831
19916,3,32,8,6,9,6,64,38.26567090493188,-109.3524136
19917,3,35,7,5,8,6,64,38.26567090493188,-109.3521441
19918,5,34,8,5,9,6,67,38.26567090493188,-109.3518746
19919,4,25,8,5,7,8,57,38.26567090493188,-109.3516051
19920,3,25,7,6,8,7,56,38.26567090493188,-109.3513356
19921,3,30,6,6,7,6,58,38.26567090493188,-109.3510661
19922,3,28,7,7,6,8,59,38.26567090493188,-109.3507966
19923,5,28,8,6,6,8,61,38.26567090493188,-109.3505271
19924,3,27,10,7,6,10,63,38.26567090493188,-109.3502577
19925,3,12,11,8,10,10,54,38.26567090493188,-109.3499882
19926,4,10,11,8,7,11,51,38.26567090493188,-109.3497187
19927,3,13,12,7,7,14,56,38.26567090493188,-109.3494492
19928,1,14,13,2,3,22,55,38.26567090493188,-109.3491797
19929,1,14,15,0,1,27,58,38.26567090493188,-109.3489102
19930,1,15,17,0,0,30,63,38.26567090493188,-109.3486407
19931,0,17,17,0,0,31,65,38.26567090493188,-109.3483712
19932,1,20,16,1,1,29,68,38.26567090493188,-109.3481017
19933,1,22,16,1,2,28,70,38.26567090493188,-109.3478322
19934,2,22,17,1,3,28,73,38.26567090493188,-109.3475627
19935,2,25,19,1,6,31,84,38.26567090493188,-109.3472932
19936,1,21,21,0,6,34,83,38.26567090493188,-109.3470237
19937,1,20,21,2,6,33,83,38.26567090493188,-109.3467542
19938,2,21,21,3,6,31,84,38.26567090493188,-109.3464847
19939,2,24,20,3,7,28,84,38.26567090493188,-109.3462152
19940,2,26,19,3,6,26,82,38.26567090493188,-109.3459457
19941,1,24,17,0,4,27,73,38.26567090493188,-109.3456762
19942,1,23,18,0,3,28,73,38.26567090493188,-109.3454068
19943,1,22,18,0,3,30,74,38.26567090493188,-109.3451373
19944,1,23,20,0,5,33,82,38.26567090493188,-109.3448678
19945,0,23,21,0,7,34,85,38.26567090493188,-109.3445983
19946,1,24,21,0,7,34,87,38.26567090493188,-109.3443288
19947,2,25,19,1,7,30,84,38.26567090493188,-109.3440593
19948,7,29,18,4,7,21,86,38.26567090493188,-109.3437898
19949,12,34,15,9,9,9,88,38.26567090493188,-109.3435203
19950,10,39,14,9,11,7,90,38.26567090493188,-109.3432508
19951,9,39,14,10,12,5,89,38.26567090493188,-109.3429813
19952,10,39,14,11,13,5,92,38.26567090493188,-109.3427118
19953,10,39,14,11,13,4,91,38.26567090493188,-109.3424423
19954,10,39,14,12,13,3,91,38.26567090493188,-109.3421728
19955,8,40,14,11,12,4,89,38.26567090493188,-109.3419033
19956,7,39,14,11,13,5,89,38.26567090493188,-109.3416338
19957,7,39,14,11,12,5,88,38.26567090493188,-109.3413643
19958,7,39,14,11,11,5,87,38.26567090493188,-109.3410948
19959,7,38,14,12,12,5,88,38.26567090493188,-109.3408253
19960,8,37,14,12,12,6,89,38.26567090493188,-109.3405558
19961,8,37,14,13,12,5,89,38.26567090493188,-109.3402864
19962,7,39,14,12,12,4,88,38.26567090493188,-109.3400169
19963,7,42,14,10,11,4,88,38.26567090493188,-109.3397474
19964,7,41,14,13,12,4,91,38.26567090493188,-109.3394779
19965,7,42,14,11,11,5,90,38.26567090493188,-109.3392084
19966,7,43,14,11,11,5,91,38.26567090493188,-109.3389389
19967,7,43,14,11,11,5,91,38.26567090493188,-109.3386694
19968,9,41,14,12,8,6,90,38.26567090493188,-109.3383999
19969,12,36,13,12,7,5,85,38.26567090493188,-109.3381304
19970,13,35,14,15,6,5,88,38.26567090493188,-109.3378609
19971,11,35,14,17,7,5,89,38.26567090493188,-109.3375914
19972,9,35,14,17,9,5,89,38.26567090493188,-109.3373219
19973,8,37,14,12,12,7,90,38.26567090493188,-109.3370524
19974,8,36,14,13,12,6,89,38.26567090493188,-109.3367829
19975,8,37,14,12,12,6,89,38.26567090493188,-109.3365134
19976,8,38,14,12,11,6,89,38.26567090493188,-109.3362439
19977,9,37,15,13,12,6,92,38.26567090493188,-109.3359744
19978,10,37,14,12,15,3,91,38.26567090493188,-109.3357049
19979,1,37,11,0,12,16,77,38.26540141034665,-109.4410773
19980,1,38,10,0,13,14,76,38.26540141034665,-109.4408078
19981,1,39,11,0,15,12,78,38.26540141034665,-109.4405383
19982,1,38,11,0,14,13,77,38.26540141034665,-109.4402688
19983,1,38,11,0,14,12,76,38.26540141034665,-109.4399993
19984,2,39,11,0,14,12,78,38.26540141034665,-109.4397299
19985,2,42,11,0,13,11,79,38.26540141034665,-109.4394604
19986,2,43,11,0,14,10,80,38.26540141034665,-109.4391909
19987,3,42,11,0,14,7,77,38.26540141034665,-109.4389214
19988,1,33,11,1,11,14,71,38.26540141034665,-109.4386519
19989,0,33,12,0,12,16,73,38.26540141034665,-109.4383824
19990,1,39,12,0,18,11,81,38.26540141034665,-109.4381129
19991,1,37,12,0,16,12,78,38.26540141034665,-109.4378434
19992,1,37,11,0,14,14,77,38.26540141034665,-109.4375739
19993,0,32,12,0,12,17,73,38.26540141034665,-109.4373044
19994,0,31,12,0,12,17,72,38.26540141034665,-109.4370349
19995,1,36,12,0,19,11,79,38.26540141034665,-109.4367654
19996,1,36,13,0,16,14,80,38.26540141034665,-109.4364959
19997,1,34,13,1,16,13,78,38.26540141034665,-109.4362264
19998,1,32,13,3,15,13,77,38.26540141034665,-109.4359569
19999,2,32,13,4,14,13,78,38.26540141034665,-109.4356874
20000,1,31,12,3,13,13,73,38.26540141034665,-109.4354179
20001,1,31,14,4,12,15,77,38.26540141034665,-109.4351484
20002,3,30,14,7,13,11,78,38.26540141034665,-109.434879
20003,2,29,14,6,12,12,75,38.26540141034665,-109.4346095
20004,1,29,13,0,11,18,72,38.26540141034665,-109.43434
20005,5,25,15,1,6,21,73,38.26540141034665,-109.4340705
20006,7,25,15,1,4,23,75,38.26540141034665,-109.433801
20007,3,24,13,0,2,21,63,38.26540141034665,-109.4335315
20008,3,32,13,0,10,18,76,38.26540141034665,-109.433262
20009,3,29,13,1,9,19,74,38.26540141034665,-109.4329925
20010,6,29,14,4,10,16,79,38.26540141034665,-109.432723
20011,9,29,13,8,13,9,81,38.26540141034665,-109.4324535
20012,10,28,13,11,13,7,82,38.26540141034665,-109.432184
20013,10,27,14,12,12,7,82,38.26540141034665,-109.4319145
20014,13,27,13,11,11,6,81,38.26540141034665,-109.431645
20015,13,24,14,10,11,8,80,38.26540141034665,-109.4313755
20016,11,24,14,9,10,10,78,38.26540141034665,-109.431106
20017,11,25,14,10,10,9,79,38.26540141034665,-109.4308365
20018,10,27,13,9,11,8,78,38.26540141034665,-109.430567
20019,10,29,13,6,10,12,80,38.26540141034665,-109.4302975
20020,11,28,14,6,10,13,82,38.26540141034665,-109.430028
20021,9,29,14,6,12,12,82,38.26540141034665,-109.4297586
20022,8,30,13,6,13,10,80,38.26540141034665,-109.4294891
20023,9,32,13,7,13,7,81,38.26540141034665,-109.4292196
20024,4,31,12,2,12,12,73,38.26540141034665,-109.4289501
20025,3,31,12,0,10,15,71,38.26540141034665,-109.4286806
20026,4,31,13,0,7,18,73,38.26540141034665,-109.4284111
20027,4,31,13,0,7,20,75,38.26540141034665,-109.4281416
20028,4,30,12,0,8,17,71,38.26540141034665,-109.4278721
20029,5,33,12,0,10,14,74,38.26540141034665,-109.4276026
20030,4,32,13,0,10,17,76,38.26540141034665,-109.4273331
20031,4,32,13,0,10,18,77,38.26540141034665,-109.4270636
20032,4,33,13,0,10,17,77,38.26540141034665,-109.4267941
20033,4,34,12,0,11,15,76,38.26540141034665,-109.4265246
20034,8,37,12,3,14,8,82,38.26540141034665,-109.4262551
20035,6,39,12,2,15,7,81,38.26540141034665,-109.4259856
20036,5,40,12,2,16,8,83,38.26540141034665,-109.4257161
20037,5,41,12,2,15,9,84,38.26540141034665,-109.4254466
20038,4,36,13,1,11,15,80,38.26540141034665,-109.4251771
20039,3,45,12,0,14,10,84,38.26540141034665,-109.4249077
20040,3,48,12,0,15,9,87,38.26540141034665,-109.4246382
20041,3,48,13,2,16,7,89,38.26540141034665,-109.4243687
20042,5,49,13,4,17,4,92,38.26540141034665,-109.4240992
20043,7,49,13,6,16,2,93,38.26540141034665,-109.4238297
20044,8,48,13,6,16,2,93,38.26540141034665,-109.4235602
20045,8,44,12,5,17,3,89,38.26540141034665,-109.4232907
20046,7,36,12,4,15,7,81,38.26540141034665,-109.4230212
20047,9,30,12,5,13,9,78,38.26540141034665,-109.4227517
20048,11,27,13,9,13,7,80,38.26540141034665,-109.4224822
20049,11,30,13,10,14,4,82,38.26540141034665,-109.4222127
20050,12,32,13,10,15,4,86,38.26540141034665,-109.4219432
20051,10,33,13,9,15,5,85,38.26540141034665,-109.4216737
20052,8,35,12,6,15,5,81,38.26540141034665,-109.4214042
20053,12,37,13,7,15,4,88,38.26540141034665,-109.4211347
20054,15,36,13,8,14,3,89,38.26540141034665,-109.4208652
20055,18,33,13,9,12,2,87,38.26540141034665,-109.4205957
20056,22,30,13,9,12,2,88,38.26540141034665,-109.4203262
20057,13,35,12,6,13,4,83,38.26540141034665,-109.4200568
20058,14,34,12,8,14,2,84,38.26540141034665,-109.4197873
20059,21,33,11,9,13,0,87,38.26540141034665,-109.4195178
20060,24,33,11,9,12,0,89,38.26540141034665,-109.4192483
20061,18,36,12,10,13,0,89,38.26540141034665,-109.4189788
20062,11,42,12,9,15,0,89,38.26540141034665,-109.4187093
20063,8,45,12,9,17,0,91,38.26540141034665,-109.4184398
20064,8,44,12,9,17,0,90,38.26540141034665,-109.4181703
20065,11,41,13,9,16,0,90,38.26540141034665,-109.4179008
20066,11,40,12,10,15,0,88,38.26540141034665,-109.4176313
20067,8,45,12,8,17,0,90,38.26540141034665,-109.4173618
20068,7,46,12,8,18,0,91,38.26540141034665,-109.4170923
20069,6,47,12,7,18,0,90,38.26540141034665,-109.4168228
20070,6,47,12,6,18,1,90,38.26540141034665,-109.4165533
20071,6,47,12,5,19,1,90,38.26540141034665,-109.4162838
20072,4,51,12,4,18,1,90,38.26540141034665,-109.4160143
20073,4,54,10,5,17,0,90,38.26540141034665,-109.4157448
20074,4,55,10,5,16,0,90,38.26540141034665,-109.4154753
20075,4,54,11,3,17,1,90,38.26540141034665,-109.4152058
20076,6,49,12,5,18,1,91,38.26540141034665,-109.4149364
20077,7,47,12,7,18,0,91,38.26540141034665,-109.4146669
20078,8,47,12,7,17,0,91,38.26540141034665,-109.4143974
20079,9,46,13,8,17,0,93,38.26540141034665,-109.4141279
20080,9,44,12,7,17,0,89,38.26540141034665,-109.4138584
20081,10,42,12,8,17,0,89,38.26540141034665,-109.4135889
20082,12,40,12,9,16,0,89,38.26540141034665,-109.4133194
20083,14,38,12,9,15,0,88,38.26540141034665,-109.4130499
20084,14,38,12,9,15,0,88,38.26540141034665,-109.4127804
20085,11,41,12,7,17,0,88,38.26540141034665,-109.4125109
20086,8,45,12,6,18,0,89,38.26540141034665,-109.4122414
20087,7,46,13,5,18,1,90,38.26540141034665,-109.4119719
20088,6,46,13,6,18,1,90,38.26540141034665,-109.4117024
20089,6,46,12,7,17,1,89,38.26540141034665,-109.4114329
20090,7,47,12,7,16,1,90,38.26540141034665,-109.4111634
20091,7,46,13,6,16,1,89,38.26540141034665,-109.4108939
20092,7,47,13,6,17,1,91,38.26540141034665,-109.4106244
20093,7,48,13,6,18,0,92,38.26540141034665,-109.4103549
20094,6,48,13,7,16,0,90,38.26540141034665,-109.4100855
20095,6,51,13,7,16,0,93,38.26540141034665,-109.409816
20096,6,53,13,6,16,1,95,38.26540141034665,-109.4095465
20097,6,53,13,6,16,1,95,38.26540141034665,-109.409277
20098,6,52,13,7,16,1,95,38.26540141034665,-109.4090075
20099,8,49,13,6,17,0,93,38.26540141034665,-109.408738
20100,7,48,13,6,18,1,93,38.26540141034665,-109.4084685
20101,6,45,12,5,17,3,88,38.26540141034665,-109.408199
20102,4,43,12,3,15,7,84,38.26540141034665,-109.4079295
20103,3,43,12,3,14,8,83,38.26540141034665,-109.40766
20104,3,46,11,2,14,7,83,38.26540141034665,-109.4073905
20105,2,50,10,1,15,4,82,38.26540141034665,-109.407121
20106,1,51,9,1,15,4,81,38.26540141034665,-109.4068515
20107,5,47,12,4,13,6,87,38.26540141034665,-109.3879869
20108,5,49,12,5,15,2,88,38.26540141034665,-109.3877174
20109,4,37,11,2,13,8,75,38.26540141034665,-109.3874479
20110,2,34,11,0,11,13,71,38.26540141034665,-109.3871784
20111,1,32,12,0,9,17,71,38.26540141034665,-109.3869089
20112,2,30,11,0,8,17,68,38.26540141034665,-109.3866394
20113,2,32,11,0,9,15,69,38.26540141034665,-109.3863699
20114,3,38,12,2,12,11,78,38.26540141034665,-109.3861004
20115,3,42,12,2,13,9,81,38.26540141034665,-109.3858309
20116,3,47,12,1,14,8,85,38.26540141034665,-109.3855614
20117,3,49,11,1,13,7,84,38.26540141034665,-109.3852919
20118,3,47,11,2,12,8,83,38.26540141034665,-109.3850225
20119,2,46,11,3,13,7,82,38.26540141034665,-109.384753
20120,2,45,11,2,14,6,80,38.26540141034665,-109.3844835
20121,3,45,11,3,14,6,82,38.26540141034665,-109.384214
20122,3,44,11,5,14,5,82,38.26540141034665,-109.3839445
20123,3,40,11,5,14,5,78,38.26540141034665,-109.383675
20124,1,39,10,1,9,12,72,38.26540141034665,-109.3834055
20125,1,42,9,0,11,10,73,38.26540141034665,-109.383136
20126,1,41,10,0,11,10,73,38.26540141034665,-109.3828665
20127,2,37,11,1,10,10,71,38.26540141034665,-109.382597
20128,2,31,11,4,7,10,65,38.26540141034665,-109.3823275
20129,2,28,11,1,8,12,62,38.26540141034665,-109.382058
20130,1,31,12,0,9,15,68,38.26540141034665,-109.3817885
20131,1,30,13,1,9,20,74,38.26540141034665,-109.381519
20132,2,29,14,2,9,18,74,38.26540141034665,-109.3812495
20133,3,27,12,6,13,9,70,38.26540141034665,-109.38098
20134,3,25,11,6,12,9,66,38.26540141034665,-109.3807105
20135,5,27,12,7,12,8,71,38.26540141034665,-109.380441
20136,7,26,13,11,13,6,76,38.26540141034665,-109.3801716
20137,7,24,11,17,14,2,75,38.26540141034665,-109.3799021
20138,7,24,11,15,13,3,73,38.26540141034665,-109.3796326
20139,6,27,12,9,13,5,72,38.26540141034665,-109.3793631
20140,5,29,12,7,14,6,73,38.26540141034665,-109.3790936
20141,5,30,12,9,16,5,77,38.26540141034665,-109.3788241
20142,5,30,13,14,17,4,83,38.26540141034665,-109.3785546
20143,8,28,13,14,15,5,83,38.26540141034665,-109.3782851
20144,11,29,13,13,15,3,84,38.26540141034665,-109.3780156
20145,10,32,12,11,15,2,82,38.26540141034665,-109.3777461
20146,6,37,12,10,17,2,84,38.26540141034665,-109.3774766
20147,6,39,12,8,18,2,85,38.26540141034665,-109.3772071
20148,8,33,12,10,15,1,79,38.26540141034665,-109.3769376
20149,12,23,12,14,14,1,76,38.26540141034665,-109.3766681
20150,15,18,11,16,14,1,75,38.26540141034665,-109.3763986
20151,19,24,13,10,11,3,80,38.26540141034665,-109.3761291
20152,24,25,12,11,12,1,85,38.26540141034665,-109.3758596
20153,26,23,13,10,11,1,84,38.26540141034665,-109.3755901
20154,26,20,13,9,11,1,80,38.26540141034665,-109.3753206
20155,22,21,12,11,11,1,78,38.26540141034665,-109.3750512
20156,19,27,13,11,12,2,84,38.26540141034665,-109.3747817
20157,16,30,13,10,11,4,84,38.26540141034665,-109.3745122
20158,13,34,14,8,10,7,86,38.26540141034665,-109.3742427
20159,12,34,14,6,10,8,84,38.26540141034665,-109.3739732
20160,13,34,13,6,11,5,82,38.26540141034665,-109.3737037
20161,16,35,12,5,12,2,82,38.26540141034665,-109.3734342
20162,13,37,11,6,11,3,81,38.26540141034665,-109.3731647
20163,17,43,12,6,6,2,86,38.26540141034665,-109.3728952
20164,27,48,11,6,2,0,94,38.26540141034665,-109.3726257
20165,24,45,12,9,3,0,93,38.26540141034665,-109.3723562
20166,8,41,10,5,11,4,79,38.26540141034665,-109.3720867
20167,3,43,10,3,14,5,78,38.26540141034665,-109.3718172
20168,2,41,10,2,14,7,76,38.26540141034665,-109.3715477
20169,2,34,10,4,12,9,71,38.26540141034665,-109.3712782
20170,2,26,11,5,7,14,65,38.26540141034665,-109.3710087
20171,1,19,12,4,5,20,61,38.26540141034665,-109.3707392
20172,1,19,13,1,4,22,60,38.26540141034665,-109.3704697
20173,1,23,13,0,5,21,63,38.26540141034665,-109.3702003
20174,2,24,13,0,6,20,65,38.26540141034665,-109.3699308
20175,1,24,13,0,4,23,65,38.26540141034665,-109.3696613
20176,3,29,12,0,7,19,70,38.26540141034665,-109.3693918
20177,2,29,13,0,7,20,71,38.26540141034665,-109.3691223
20178,2,25,14,0,4,25,70,38.26540141034665,-109.3688528
20179,2,26,15,0,4,25,72,38.26540141034665,-109.3685833
20180,2,26,16,0,4,26,74,38.26540141034665,-109.3683138
20181,2,26,15,0,5,25,73,38.26540141034665,-109.3680443
20182,2,26,14,0,5,23,70,38.26540141034665,-109.3677748
20183,6,26,14,7,5,20,78,38.26540141034665,-109.3675053
20184,6,28,14,8,5,18,79,38.26540141034665,-109.3672358
20185,2,32,13,0,9,16,72,38.26540141034665,-109.3669663
20186,2,34,13,2,5,19,75,38.26540141034665,-109.3666968
20187,2,33,13,2,7,19,76,38.26540141034665,-109.3664273
20188,4,27,15,4,10,17,77,38.26540141034665,-109.3661578
20189,4,25,13,12,10,15,79,38.26540141034665,-109.3658883
20190,3,25,12,6,18,8,72,38.26540141034665,-109.3656188
20191,2,22,9,10,12,7,62,38.26540141034665,-109.3653493
20192,4,29,9,5,6,5,58,38.26540141034665,-109.3650799
20193,2,38,4,5,5,4,58,38.26540141034665,-109.3648104
20194,1,39,3,4,6,3,56,38.26540141034665,-109.3645409
20195,2,35,5,1,7,3,53,38.26540141034665,-109.3642714
20196,3,32,6,3,8,4,56,38.26540141034665,-109.3640019
20197,2,28,8,5,9,6,58,38.26540141034665,-109.3637324
20198,2,34,8,6,10,7,67,38.26540141034665,-109.3634629
20199,1,39,9,3,10,9,71,38.26540141034665,-109.3631934
20200,0,34,9,1,9,10,63,38.26540141034665,-109.3629239
20201,1,29,9,3,8,9,59,38.26540141034665,-109.3626544
20202,4,29,10,6,7,5,61,38.26540141034665,-109.3623849
20203,4,26,11,4,7,7,59,38.26540141034665,-109.3621154
20204,4,19,14,8,10,12,67,38.26540141034665,-109.3618459
20205,4,25,16,6,9,20,80,38.26540141034665,-109.3615764
20206,2,27,17,3,6,27,82,38.26540141034665,-109.3613069
20207,0,22,18,0,3,35,78,38.26540141034665,-109.3610374
20208,3,24,17,0,4,29,77,38.26540141034665,-109.3607679
20209,2,23,17,0,3,30,75,38.26540141034665,-109.3604984
20210,2,23,17,0,3,30,75,38.26540141034665,-109.360229
20211,2,23,18,0,3,30,76,38.26540141034665,-109.3599595
20212,1,21,16,0,2,30,70,38.26540141034665,-109.35969
20213,1,22,15,0,3,27,68,38.26540141034665,-109.3594205
20214,2,24,15,0,5,27,73,38.26540141034665,-109.359151
20215,1,26,16,0,8,26,77,38.26540141034665,-109.3588815
20216,2,26,17,2,7,26,80,38.26540141034665,-109.358612
20217,2,28,15,8,6,21,80,38.26540141034665,-109.3583425
20218,2,31,16,10,8,17,84,38.26540141034665,-109.358073
20219,5,30,16,9,13,10,83,38.26540141034665,-109.3578035
20220,6,30,14,12,16,6,84,38.26540141034665,-109.357534
20221,10,34,11,18,13,1,87,38.26540141034665,-109.3572645
20222,0,33,11,5,19,6,74,38.26540141034665,-109.356995
20223,0,25,7,10,15,3,60,38.26540141034665,-109.3567255
20224,2,26,9,6,9,2,54,38.26540141034665,-109.356456
20225,2,39,8,4,11,6,70,38.26540141034665,-109.3561865
20226,3,31,8,4,9,6,61,38.26540141034665,-109.355917
20227,2,27,8,4,9,7,57,38.26540141034665,-109.3556475
20228,3,27,9,5,9,6,59,38.26540141034665,-109.355378
20229,2,31,10,5,10,8,66,38.26540141034665,-109.3551086
20230,3,31,10,7,10,5,66,38.26540141034665,-109.3548391
20231,4,26,9,8,11,6,64,38.26540141034665,-109.3545696
20232,2,17,11,7,7,13,57,38.26540141034665,-109.3543001
20233,1,23,10,5,8,11,58,38.26540141034665,-109.3540306
20234,1,28,10,4,11,8,62,38.26540141034665,-109.3537611
20235,2,29,9,5,10,7,62,38.26540141034665,-109.3534916
20236,0,36,8,1,9,7,61,38.26540141034665,-109.3532221
20237,2,35,9,3,10,6,65,38.26540141034665,-109.3529526
20238,2,30,9,4,10,8,63,38.26540141034665,-109.3526831
20239,2,29,9,4,10,8,62,38.26540141034665,-109.3524136
20240,3,34,8,5,11,6,67,38.26540141034665,-109.3521441
20241,6,30,10,6,9,7,68,38.26540141034665,-109.3518746
20242,2,21,9,5,8,10,55,38.26540141034665,-109.3516051
20243,2,21,8,5,7,10,53,38.26540141034665,-109.3513356
20244,3,26,8,5,7,10,59,38.26540141034665,-109.3510661
20245,7,30,10,5,7,8,67,38.26540141034665,-109.3507966
20246,3,26,9,5,7,9,59,38.26540141034665,-109.3505271
20247,4,31,9,7,6,7,64,38.26540141034665,-109.3502577
20248,4,27,9,8,7,8,63,38.26540141034665,-109.3499882
20249,4,15,11,9,10,7,56,38.26540141034665,-109.3497187
20250,6,12,11,8,10,8,55,38.26540141034665,-109.3494492
20251,3,11,12,7,7,13,53,38.26540141034665,-109.3491797
20252,1,14,13,2,3,22,55,38.26540141034665,-109.3489102
20253,1,15,15,0,1,27,59,38.26540141034665,-109.3486407
20254,0,16,17,0,0,31,64,38.26540141034665,-109.3483712
20255,1,18,18,0,1,33,71,38.26540141034665,-109.3481017
20256,1,19,19,0,2,33,74,38.26540141034665,-109.3478322
20257,1,21,19,1,3,32,77,38.26540141034665,-109.3475627
20258,1,23,20,1,6,33,84,38.26540141034665,-109.3472932
20259,1,18,21,0,6,37,83,38.26540141034665,-109.3470237
20260,1,18,22,1,7,35,84,38.26540141034665,-109.3467542
20261,2,20,21,1,6,32,82,38.26540141034665,-109.3464847
20262,2,23,20,1,6,30,82,38.26540141034665,-109.3462152
20263,1,24,19,1,5,30,80,38.26540141034665,-109.3459457
20264,0,20,19,0,4,32,75,38.26540141034665,-109.3456762
20265,0,20,20,0,2,33,75,38.26540141034665,-109.3454068
20266,0,20,19,0,3,33,75,38.26540141034665,-109.3451373
20267,0,21,20,0,4,35,80,38.26540141034665,-109.3448678
20268,0,23,21,0,6,35,85,38.26540141034665,-109.3445983
20269,1,25,21,0,7,34,88,38.26540141034665,-109.3443288
20270,2,26,19,0,7,31,85,38.26540141034665,-109.3440593
20271,5,30,18,3,7,23,86,38.26540141034665,-109.3437898
20272,8,35,15,8,9,12,87,38.26540141034665,-109.3435203
20273,7,38,14,9,11,8,87,38.26540141034665,-109.3432508
20274,7,38,14,9,13,7,88,38.26540141034665,-109.3429813
20275,9,39,15,9,13,6,91,38.26540141034665,-109.3427118
20276,11,39,14,11,13,5,93,38.26540141034665,-109.3424423
20277,10,38,14,12,12,4,90,38.26540141034665,-109.3421728
20278,7,39,14,11,13,5,89,38.26540141034665,-109.3419033
20279,7,39,14,12,13,5,90,38.26540141034665,-109.3416338
20280,7,40,14,11,12,5,89,38.26540141034665,-109.3413643
20281,10,39,15,11,12,4,91,38.26540141034665,-109.3410948
20282,10,37,15,13,13,4,92,38.26540141034665,-109.3408253
20283,9,38,14,12,12,5,90,38.26540141034665,-109.3405558
20284,9,38,14,12,12,5,90,38.26540141034665,-109.3402864
20285,8,39,14,12,12,4,89,38.26540141034665,-109.3400169
20286,7,42,14,11,12,4,90,38.26540141034665,-109.3397474
20287,6,41,14,12,12,4,89,38.26540141034665,-109.3394779
20288,6,42,14,11,11,5,89,38.26540141034665,-109.3392084
20289,6,44,14,12,10,5,91,38.26540141034665,-109.3389389
20290,7,45,14,12,10,4,92,38.26540141034665,-109.3386694
20291,8,44,14,13,9,4,92,38.26540141034665,-109.3383999
20292,13,35,14,13,6,4,85,38.26540141034665,-109.3381304
20293,13,36,14,14,7,5,89,38.26540141034665,-109.3378609
20294,9,38,14,14,10,6,91,38.26540141034665,-109.3375914
20295,6,38,13,13,12,6,88,38.26540141034665,-109.3373219
20296,6,38,13,11,13,7,88,38.26540141034665,-109.3370524
20297,7,38,14,12,10,7,88,38.26540141034665,-109.3367829
20298,7,38,14,11,11,9,90,38.26540141034665,-109.3365134
20299,6,38,14,11,11,8,88,38.26540141034665,-109.3362439
20300,7,37,14,11,12,8,89,38.26540141034665,-109.3359744
20301,7,36,14,11,14,6,88,38.26540141034665,-109.3357049
20302,6,36,14,9,14,8,87,38.26540141034665,-109.3354355
20303,1,37,11,0,13,16,78,38.265131915761415,-109.4410773
20304,0,34,11,0,12,17,74,38.265131915761415,-109.4408078
20305,0,36,11,0,11,17,75,38.265131915761415,-109.4405383
20306,0,37,11,0,11,17,76,38.265131915761415,-109.4402688
20307,1,38,11,0,12,14,76,38.265131915761415,-109.4399993
20308,2,39,11,0,12,13,77,38.265131915761415,-109.4397299
20309,2,43,11,0,13,11,80,38.265131915761415,-109.4394604
20310,2,43,11,0,15,9,80,38.265131915761415,-109.4391909
20311,2,40,11,0,15,9,77,38.265131915761415,-109.4389214
20312,0,33,11,0,12,15,71,38.265131915761415,-109.4386519
20313,0,33,12,0,13,16,74,38.265131915761415,-109.4383824
20314,0,37,12,0,15,14,78,38.265131915761415,-109.4381129
20315,1,39,12,0,17,10,79,38.265131915761415,-109.4378434
20316,0,33,12,0,11,17,73,38.265131915761415,-109.4375739
20317,1,36,12,0,14,15,78,38.265131915761415,-109.4373044
20318,1,37,12,0,18,12,80,38.265131915761415,-109.4370349
20319,1,36,12,0,18,10,77,38.265131915761415,-109.4367654
20320,2,37,12,0,19,9,79,38.265131915761415,-109.4364959
20321,2,39,11,0,17,11,80,38.265131915761415,-109.4362264
20322,1,37,10,0,16,13,77,38.265131915761415,-109.4359569
20323,0,34,11,0,16,12,73,38.265131915761415,-109.4356874
20324,1,34,11,1,17,9,73,38.265131915761415,-109.4354179
20325,0,30,12,3,12,14,71,38.265131915761415,-109.4351484
20326,1,30,12,0,12,17,72,38.265131915761415,-109.434879
20327,1,30,13,0,8,21,73,38.265131915761415,-109.4346095
20328,1,28,14,0,6,25,74,38.265131915761415,-109.43434
20329,3,31,14,0,6,23,77,38.265131915761415,-109.4340705
20330,3,28,12,0,6,20,69,38.265131915761415,-109.433801
20331,3,35,12,1,11,12,74,38.265131915761415,-109.4335315
20332,5,34,12,5,13,9,78,38.265131915761415,-109.433262
20333,11,29,12,8,12,6,78,38.265131915761415,-109.4329925
20334,16,25,13,11,12,4,81,38.265131915761415,-109.432723
20335,21,26,13,12,12,2,86,38.265131915761415,-109.4324535
20336,22,26,13,13,11,2,87,38.265131915761415,-109.432184
20337,21,25,14,14,12,2,88,38.265131915761415,-109.4319145
20338,22,24,13,12,11,2,84,38.265131915761415,-109.431645
20339,21,23,13,11,12,2,82,38.265131915761415,-109.4313755
20340,17,26,13,10,11,3,80,38.265131915761415,-109.431106
20341,12,28,12,9,11,4,76,38.265131915761415,-109.4308365
20342,12,28,12,10,12,3,77,38.265131915761415,-109.430567
20343,16,27,12,11,12,2,80,38.265131915761415,-109.4302975
20344,17,24,13,11,12,3,80,38.265131915761415,-109.430028
20345,18,23,13,11,12,3,80,38.265131915761415,-109.4297586
20346,17,25,13,11,12,4,82,38.265131915761415,-109.4294891
20347,13,29,13,9,13,5,82,38.265131915761415,-109.4292196
20348,9,30,13,7,13,7,79,38.265131915761415,-109.4289501
20349,6,29,13,6,12,11,77,38.265131915761415,-109.4286806
20350,6,30,13,3,10,15,77,38.265131915761415,-109.4284111
20351,6,30,14,3,9,17,79,38.265131915761415,-109.4281416
20352,9,29,14,4,9,14,79,38.265131915761415,-109.4278721
20353,9,32,13,6,13,9,82,38.265131915761415,-109.4276026
20354,9,32,13,6,13,9,82,38.265131915761415,-109.4273331
20355,10,33,13,5,13,10,84,38.265131915761415,-109.4270636
20356,10,36,13,4,14,8,85,38.265131915761415,-109.4267941
20357,9,41,13,4,16,4,87,38.265131915761415,-109.4265246
20358,13,41,13,6,15,2,90,38.265131915761415,-109.4262551
20359,8,45,13,4,16,3,89,38.265131915761415,-109.4259856
20360,6,48,13,4,17,3,91,38.265131915761415,-109.4257161
20361,6,48,13,3,17,3,90,38.265131915761415,-109.4254466
20362,6,45,13,2,16,6,88,38.265131915761415,-109.4251771
20363,5,49,12,1,16,6,89,38.265131915761415,-109.4249077
20364,4,51,12,2,16,6,91,38.265131915761415,-109.4246382
20365,4,49,13,3,16,6,91,38.265131915761415,-109.4243687
20366,5,50,13,4,17,4,93,38.265131915761415,-109.4240992
20367,6,51,13,6,16,2,94,38.265131915761415,-109.4238297
20368,7,49,13,7,16,1,93,38.265131915761415,-109.4235602
20369,8,47,12,6,17,1,91,38.265131915761415,-109.4232907
20370,8,40,12,5,16,4,85,38.265131915761415,-109.4230212
20371,10,34,12,7,15,5,83,38.265131915761415,-109.4227517
20372,12,29,13,10,14,4,82,38.265131915761415,-109.4224822
20373,17,28,12,10,14,2,83,38.265131915761415,-109.4222127
20374,20,28,12,10,14,2,86,38.265131915761415,-109.4219432
20375,19,30,12,10,13,2,86,38.265131915761415,-109.4216737
20376,13,35,13,7,15,3,86,38.265131915761415,-109.4214042
20377,13,38,13,7,15,2,88,38.265131915761415,-109.4211347
20378,11,40,13,8,16,1,89,38.265131915761415,-109.4208652
20379,12,38,13,9,16,1,89,38.265131915761415,-109.4205957
20380,17,35,13,9,13,2,89,38.265131915761415,-109.4203262
20381,10,39,12,7,15,2,85,38.265131915761415,-109.4200568
20382,10,37,11,7,15,2,82,38.265131915761415,-109.4197873
20383,18,35,12,9,13,0,87,38.265131915761415,-109.4195178
20384,23,33,12,10,12,0,90,38.265131915761415,-109.4192483
20385,19,36,12,10,13,0,90,38.265131915761415,-109.4189788
20386,9,44,12,9,16,0,90,38.265131915761415,-109.4187093
20387,7,45,12,8,17,0,89,38.265131915761415,-109.4184398
20388,7,44,12,9,17,0,89,38.265131915761415,-109.4181703
20389,8,43,12,9,17,0,89,38.265131915761415,-109.4179008
20390,9,41,13,9,17,0,89,38.265131915761415,-109.4176313
20391,11,42,12,9,16,0,90,38.265131915761415,-109.4173618
20392,10,44,12,9,16,0,91,38.265131915761415,-109.4170923
20393,7,47,12,8,17,0,91,38.265131915761415,-109.4168228
20394,6,47,12,6,18,0,89,38.265131915761415,-109.4165533
20395,6,50,12,5,18,1,92,38.265131915761415,-109.4162838
20396,4,54,10,4,17,1,90,38.265131915761415,-109.4160143
20397,4,55,10,5,17,0,91,38.265131915761415,-109.4157448
20398,4,53,11,6,17,0,91,38.265131915761415,-109.4154753
20399,5,49,12,5,19,1,91,38.265131915761415,-109.4152058
20400,6,48,12,6,18,1,91,38.265131915761415,-109.4149364
20401,7,47,12,7,18,0,91,38.265131915761415,-109.4146669
20402,7,47,12,7,18,0,91,38.265131915761415,-109.4143974
20403,8,46,12,7,18,0,91,38.265131915761415,-109.4141279
20404,8,45,12,7,17,0,89,38.265131915761415,-109.4138584
20405,12,41,13,9,16,0,91,38.265131915761415,-109.4135889
20406,15,37,13,10,15,0,90,38.265131915761415,-109.4133194
20407,16,37,12,10,14,0,89,38.265131915761415,-109.4130499
20408,11,40,12,9,16,0,88,38.265131915761415,-109.4127804
20409,10,42,12,8,18,0,90,38.265131915761415,-109.4125109
20410,8,44,13,8,18,0,91,38.265131915761415,-109.4122414
20411,7,46,13,6,19,0,91,38.265131915761415,-109.4119719
20412,6,48,13,5,18,1,91,38.265131915761415,-109.4117024
20413,5,49,12,6,18,1,91,38.265131915761415,-109.4114329
20414,6,48,13,6,17,1,91,38.265131915761415,-109.4111634
20415,8,47,13,6,16,1,91,38.265131915761415,-109.4108939
20416,7,48,13,5,17,1,91,38.265131915761415,-109.4106244
20417,6,49,13,5,18,1,92,38.265131915761415,-109.4103549
20418,5,50,13,6,17,1,92,38.265131915761415,-109.4100855
20419,6,51,13,6,16,1,93,38.265131915761415,-109.409816
20420,6,52,13,6,16,1,94,38.265131915761415,-109.4095465
20421,7,52,13,7,15,1,95,38.265131915761415,-109.409277
20422,7,50,13,7,16,1,94,38.265131915761415,-109.4090075
20423,8,48,13,6,16,1,92,38.265131915761415,-109.408738
20424,6,46,12,5,17,2,88,38.265131915761415,-109.4084685
20425,4,44,11,4,15,4,82,38.265131915761415,-109.408199
20426,3,44,11,4,14,6,82,38.265131915761415,-109.4079295
20427,3,44,10,4,14,4,79,38.265131915761415,-109.40766
20428,3,46,10,4,14,4,81,38.265131915761415,-109.4073905
20429,3,50,10,5,14,2,84,38.265131915761415,-109.407121
20430,3,53,10,5,14,2,87,38.265131915761415,-109.4068515
20431,5,46,13,4,14,6,88,38.265131915761415,-109.3879869
20432,4,41,12,3,14,7,81,38.265131915761415,-109.3877174
20433,2,35,11,2,12,10,72,38.265131915761415,-109.3874479
20434,0,30,12,0,8,18,68,38.265131915761415,-109.3871784
20435,1,28,12,0,6,20,67,38.265131915761415,-109.3869089
20436,2,32,12,0,8,18,72,38.265131915761415,-109.3866394
20437,3,38,12,2,12,12,79,38.265131915761415,-109.3863699
20438,4,41,12,2,14,9,82,38.265131915761415,-109.3861004
20439,4,46,12,1,14,7,84,38.265131915761415,-109.3858309
20440,3,49,11,1,14,6,84,38.265131915761415,-109.3855614
20441,3,47,11,2,14,5,82,38.265131915761415,-109.3852919
20442,4,41,11,5,14,5,80,38.265131915761415,-109.3850225
20443,4,39,12,7,15,4,81,38.265131915761415,-109.384753
20444,4,40,12,6,15,4,81,38.265131915761415,-109.3844835
20445,4,39,12,5,14,6,80,38.265131915761415,-109.384214
20446,4,39,12,5,13,7,80,38.265131915761415,-109.3839445
20447,4,36,12,5,12,9,78,38.265131915761415,-109.383675
20448,2,36,10,1,9,13,71,38.265131915761415,-109.3834055
20449,2,39,10,0,11,10,72,38.265131915761415,-109.383136
20450,2,38,10,1,11,10,72,38.265131915761415,-109.3828665
20451,2,33,11,1,8,12,67,38.265131915761415,-109.382597
20452,3,36,10,2,9,9,69,38.265131915761415,-109.3823275
20453,1,30,12,2,10,11,66,38.265131915761415,-109.382058
20454,1,28,13,0,9,19,70,38.265131915761415,-109.3817885
20455,2,28,15,0,7,26,78,38.265131915761415,-109.381519
20456,3,27,15,1,7,22,75,38.265131915761415,-109.3812495
20457,9,23,12,12,10,8,74,38.265131915761415,-109.38098
20458,9,24,12,12,11,7,75,38.265131915761415,-109.3807105
20459,7,29,13,10,13,8,80,38.265131915761415,-109.380441
20460,7,33,13,9,15,6,83,38.265131915761415,-109.3801716
20461,7,30,12,11,14,4,78,38.265131915761415,-109.3799021
20462,8,32,13,11,14,3,81,38.265131915761415,-109.3796326
20463,7,33,13,9,16,4,82,38.265131915761415,-109.3793631
20464,5,33,13,9,17,6,83,38.265131915761415,-109.3790936
20465,5,32,12,16,16,3,84,38.265131915761415,-109.3788241
20466,10,27,13,16,15,1,82,38.265131915761415,-109.3785546
20467,9,25,13,17,15,3,82,38.265131915761415,-109.3782851
20468,11,26,12,16,14,2,81,38.265131915761415,-109.3780156
20469,13,30,12,12,15,2,84,38.265131915761415,-109.3777461
20470,9,38,12,8,17,1,85,38.265131915761415,-109.3774766
20471,9,38,12,9,17,1,86,38.265131915761415,-109.3772071
20472,18,25,12,9,12,1,77,38.265131915761415,-109.3769376
20473,19,21,12,12,12,1,77,38.265131915761415,-109.3766681
20474,18,21,12,13,12,1,77,38.265131915761415,-109.3763986
20475,24,24,13,9,12,1,83,38.265131915761415,-109.3761291
20476,28,22,13,10,11,1,85,38.265131915761415,-109.3758596
20477,31,20,13,9,10,1,84,38.265131915761415,-109.3755901
20478,28,20,13,9,10,1,81,38.265131915761415,-109.3753206
20479,23,22,13,11,11,1,81,38.265131915761415,-109.3750512
20480,20,26,13,12,13,1,85,38.265131915761415,-109.3747817
20481,19,29,13,13,13,1,88,38.265131915761415,-109.3745122
20482,16,32,13,11,12,2,86,38.265131915761415,-109.3742427
20483,15,33,13,8,11,4,84,38.265131915761415,-109.3739732
20484,22,30,12,6,10,3,83,38.265131915761415,-109.3737037
20485,21,30,12,7,10,2,82,38.265131915761415,-109.3734342
20486,17,32,12,9,13,2,85,38.265131915761415,-109.3731647
20487,16,32,12,11,13,1,85,38.265131915761415,-109.3728952
20488,16,34,12,10,12,1,85,38.265131915761415,-109.3726257
20489,15,34,13,10,11,1,84,38.265131915761415,-109.3723562
20490,6,38,12,6,12,5,79,38.265131915761415,-109.3720867
20491,2,36,11,3,10,11,73,38.265131915761415,-109.3718172
20492,2,27,11,5,7,15,67,38.265131915761415,-109.3715477
20493,2,19,12,7,5,18,63,38.265131915761415,-109.3712782
20494,1,18,13,4,4,21,61,38.265131915761415,-109.3710087
20495,2,18,12,4,5,19,60,38.265131915761415,-109.3707392
20496,2,23,13,1,7,19,65,38.265131915761415,-109.3704697
20497,3,27,13,0,7,20,70,38.265131915761415,-109.3702003
20498,3,28,14,0,7,21,73,38.265131915761415,-109.3699308
20499,3,29,13,0,7,21,73,38.265131915761415,-109.3696613
20500,2,27,13,0,7,19,68,38.265131915761415,-109.3693918
20501,3,27,12,1,7,18,68,38.265131915761415,-109.3691223
20502,4,28,13,1,7,17,70,38.265131915761415,-109.3688528
20503,6,33,13,3,9,14,78,38.265131915761415,-109.3685833
20504,6,30,15,1,6,20,78,38.265131915761415,-109.3683138
20505,3,30,16,0,5,24,78,38.265131915761415,-109.3680443
20506,3,29,16,0,5,25,78,38.265131915761415,-109.3677748
20507,2,29,15,0,7,23,76,38.265131915761415,-109.3675053
20508,2,31,13,0,9,19,74,38.265131915761415,-109.3672358
20509,1,33,14,0,6,22,76,38.265131915761415,-109.3669663
20510,2,34,13,1,7,19,76,38.265131915761415,-109.3666968
20511,3,33,12,3,8,17,76,38.265131915761415,-109.3664273
20512,3,32,12,4,9,17,77,38.265131915761415,-109.3661578
20513,3,28,13,8,20,7,79,38.265131915761415,-109.3658883
20514,6,21,12,10,20,2,71,38.265131915761415,-109.3656188
20515,5,18,10,9,18,4,64,38.265131915761415,-109.3653493
20516,4,19,9,5,9,8,54,38.265131915761415,-109.3650799
20517,4,29,5,6,5,5,54,38.265131915761415,-109.3648104
20518,2,34,5,2,6,4,53,38.265131915761415,-109.3645409
20519,2,32,7,3,8,4,56,38.265131915761415,-109.3642714
20520,3,33,8,4,10,4,62,38.265131915761415,-109.3640019
20521,1,34,8,3,9,9,64,38.265131915761415,-109.3637324
20522,2,38,8,4,9,8,69,38.265131915761415,-109.3634629
20523,2,36,10,3,10,9,70,38.265131915761415,-109.3631934
20524,1,32,10,2,8,11,64,38.265131915761415,-109.3629239
20525,2,32,10,3,7,9,63,38.265131915761415,-109.3626544
20526,4,30,10,5,7,6,62,38.265131915761415,-109.3623849
20527,9,25,15,4,6,8,67,38.265131915761415,-109.3621154
20528,6,20,13,5,8,17,69,38.265131915761415,-109.3618459
20529,3,27,16,5,8,21,80,38.265131915761415,-109.3615764
20530,3,25,17,3,4,28,80,38.265131915761415,-109.3613069
20531,1,20,18,0,2,34,75,38.265131915761415,-109.3610374
20532,6,26,16,1,4,24,77,38.265131915761415,-109.3607679
20533,7,28,16,3,5,21,80,38.265131915761415,-109.3604984
20534,7,29,15,5,7,18,81,38.265131915761415,-109.360229
20535,7,30,16,3,8,19,83,38.265131915761415,-109.3599595
20536,2,25,16,0,6,26,75,38.265131915761415,-109.35969
20537,1,24,16,0,5,26,72,38.265131915761415,-109.3594205
20538,1,23,15,0,5,25,69,38.265131915761415,-109.359151
20539,1,25,14,0,6,24,70,38.265131915761415,-109.3588815
20540,3,28,15,1,9,21,77,38.265131915761415,-109.358612
20541,3,32,15,2,13,16,81,38.265131915761415,-109.3583425
20542,6,30,15,6,17,10,84,38.265131915761415,-109.358073
20543,8,28,14,16,17,2,85,38.265131915761415,-109.3578035
20544,7,30,15,14,21,1,88,38.265131915761415,-109.357534
20545,8,31,13,12,20,1,85,38.265131915761415,-109.3572645
20546,3,34,11,12,15,0,75,38.265131915761415,-109.356995
20547,5,39,12,5,12,1,74,38.265131915761415,-109.3567255
20548,2,40,9,4,11,5,71,38.265131915761415,-109.356456
20549,1,42,9,2,9,12,75,38.265131915761415,-109.3561865
20550,3,37,9,4,9,9,71,38.265131915761415,-109.355917
20551,2,29,10,5,9,10,65,38.265131915761415,-109.3556475
20552,2,25,10,4,8,11,60,38.265131915761415,-109.355378
20553,2,23,12,4,5,14,60,38.265131915761415,-109.3551086
20554,1,21,12,4,6,18,62,38.265131915761415,-109.3548391
20555,1,18,13,2,4,21,59,38.265131915761415,-109.3545696
20556,1,19,11,4,6,16,57,38.265131915761415,-109.3543001
20557,1,26,10,4,9,11,61,38.265131915761415,-109.3540306
20558,0,30,10,3,10,10,63,38.265131915761415,-109.3537611
20559,1,30,10,4,10,9,64,38.265131915761415,-109.3534916
20560,1,39,9,2,11,7,69,38.265131915761415,-109.3532221
20561,0,40,8,1,10,6,65,38.265131915761415,-109.3529526
20562,1,35,9,3,10,7,65,38.265131915761415,-109.3526831
20563,2,33,10,4,13,6,68,38.265131915761415,-109.3524136
20564,6,21,11,6,11,5,60,38.265131915761415,-109.3521441
20565,3,18,11,7,10,9,58,38.265131915761415,-109.3518746
20566,0,23,10,4,10,10,57,38.265131915761415,-109.3516051
20567,1,28,8,3,9,10,59,38.265131915761415,-109.3513356
20568,3,28,10,3,9,10,63,38.265131915761415,-109.3510661
20569,12,21,13,5,6,8,65,38.265131915761415,-109.3507966
20570,1,25,9,4,7,10,56,38.265131915761415,-109.3505271
20571,1,33,7,5,6,7,59,38.265131915761415,-109.3502577
20572,7,43,8,8,7,3,76,38.265131915761415,-109.3499882
20573,7,31,10,9,7,6,70,38.265131915761415,-109.3497187
20574,2,16,10,7,10,9,54,38.265131915761415,-109.3494492
20575,2,13,11,8,10,9,53,38.265131915761415,-109.3491797
20576,3,11,11,8,8,11,52,38.265131915761415,-109.3489102
20577,3,10,13,8,6,15,55,38.265131915761415,-109.3486407
20578,0,10,14,3,3,23,53,38.265131915761415,-109.3483712
20579,1,13,17,1,3,30,65,38.265131915761415,-109.3481017
20580,0,17,19,0,3,33,72,38.265131915761415,-109.3478322
20581,1,20,20,0,4,33,78,38.265131915761415,-109.3475627
20582,1,21,19,1,5,32,79,38.265131915761415,-109.3472932
20583,1,19,20,0,5,35,80,38.265131915761415,-109.3470237
20584,1,19,20,0,4,35,79,38.265131915761415,-109.3467542
20585,1,18,19,0,2,34,74,38.265131915761415,-109.3464847
20586,1,17,19,0,1,33,71,38.265131915761415,-109.3462152
20587,1,17,19,0,1,33,71,38.265131915761415,-109.3459457
20588,0,17,18,0,1,31,67,38.265131915761415,-109.3456762
20589,0,15,19,0,1,32,67,38.265131915761415,-109.3454068
20590,0,17,19,0,2,33,71,38.265131915761415,-109.3451373
20591,0,21,20,0,4,34,79,38.265131915761415,-109.3448678
20592,1,25,20,0,6,35,87,38.265131915761415,-109.3445983
20593,3,26,20,1,8,29,87,38.265131915761415,-109.3443288
20594,4,29,18,3,11,22,87,38.265131915761415,-109.3440593
20595,6,33,15,7,12,14,87,38.265131915761415,-109.3437898
20596,7,38,14,9,13,7,88,38.265131915761415,-109.3435203
20597,7,38,14,9,12,7,87,38.265131915761415,-109.3432508
20598,7,38,14,10,13,6,88,38.265131915761415,-109.3429813
20599,9,39,14,10,13,6,91,38.265131915761415,-109.3427118
20600,9,39,14,11,13,5,91,38.265131915761415,-109.3424423
20601,7,37,13,11,13,5,86,38.265131915761415,-109.3421728
20602,8,36,13,11,12,6,86,38.265131915761415,-109.3419033
20603,7,37,14,12,12,6,88,38.265131915761415,-109.3416338
20604,8,38,14,13,12,5,90,38.265131915761415,-109.3413643
20605,10,38,14,13,11,4,90,38.265131915761415,-109.3410948
20606,10,37,15,13,12,4,91,38.265131915761415,-109.3408253
20607,8,37,15,11,13,6,90,38.265131915761415,-109.3405558
20608,7,38,14,11,12,6,88,38.265131915761415,-109.3402864
20609,7,40,14,11,12,5,89,38.265131915761415,-109.3400169
20610,6,41,14,11,12,5,89,38.265131915761415,-109.3397474
20611,7,41,14,12,12,4,90,38.265131915761415,-109.3394779
20612,7,43,14,12,10,5,91,38.265131915761415,-109.3392084
20613,6,44,14,12,10,4,90,38.265131915761415,-109.3389389
20614,6,44,14,13,11,4,92,38.265131915761415,-109.3386694
20615,9,42,15,12,12,4,94,38.265131915761415,-109.3383999
20616,11,38,15,12,10,6,92,38.265131915761415,-109.3381304
20617,10,37,14,15,9,6,91,38.265131915761415,-109.3378609
20618,8,37,13,15,10,6,89,38.265131915761415,-109.3375914
20619,7,39,13,14,13,4,90,38.265131915761415,-109.3373219
20620,7,38,14,14,14,3,90,38.265131915761415,-109.3370524
20621,6,38,14,15,13,5,91,38.265131915761415,-109.3367829
20622,7,39,14,12,13,6,91,38.265131915761415,-109.3365134
20623,7,39,14,11,13,5,89,38.265131915761415,-109.3362439
20624,6,38,14,11,13,6,88,38.265131915761415,-109.3359744
20625,5,36,14,10,15,8,88,38.265131915761415,-109.3357049
20626,5,39,13,8,15,7,87,38.265131915761415,-109.3354355
20627,4,44,12,0,18,7,85,38.264862421176176,-109.4413468
20628,1,38,11,0,16,12,78,38.264862421176176,-109.4410773
20629,1,36,11,0,13,15,76,38.264862421176176,-109.4408078
20630,2,40,12,0,12,14,80,38.264862421176176,-109.4405383
20631,1,36,10,0,10,17,74,38.264862421176176,-109.4402688
20632,1,38,11,0,11,15,76,38.264862421176176,-109.4399993
20633,2,40,11,0,12,13,78,38.264862421176176,-109.4397299
20634,2,42,11,0,12,11,78,38.264862421176176,-109.4394604
20635,2,42,11,0,14,9,78,38.264862421176176,-109.4391909
20636,1,38,11,0,14,13,77,38.264862421176176,-109.4389214
20637,0,33,11,0,11,17,72,38.264862421176176,-109.4386519
20638,0,33,11,0,12,17,73,38.264862421176176,-109.4383824
20639,1,39,11,0,15,13,79,38.264862421176176,-109.4381129
20640,1,39,11,0,16,12,79,38.264862421176176,-109.4378434
20641,0,30,13,0,12,17,72,38.264862421176176,-109.4375739
20642,0,34,12,0,17,13,76,38.264862421176176,-109.4373044
20643,1,37,12,0,18,10,78,38.264862421176176,-109.4370349
20644,2,37,11,0,16,11,77,38.264862421176176,-109.4367654
20645,3,38,10,0,17,9,77,38.264862421176176,-109.4364959
20646,2,36,10,0,16,12,76,38.264862421176176,-109.4362264
20647,2,36,10,0,14,14,76,38.264862421176176,-109.4359569
20648,2,34,11,0,11,17,75,38.264862421176176,-109.4356874
20649,2,33,10,0,10,17,72,38.264862421176176,-109.4354179
20650,1,31,10,1,12,12,67,38.264862421176176,-109.4351484
20651,2,30,10,1,10,12,65,38.264862421176176,-109.434879
20652,1,27,11,1,6,16,62,38.264862421176176,-109.4346095
20653,2,28,11,0,6,18,65,38.264862421176176,-109.43434
20654,5,37,12,0,8,13,75,38.264862421176176,-109.4340705
20655,2,36,10,2,12,9,71,38.264862421176176,-109.433801
20656,5,39,10,3,13,6,76,38.264862421176176,-109.4335315
20657,7,34,11,5,12,5,74,38.264862421176176,-109.433262
20658,9,25,11,8,10,7,70,38.264862421176176,-109.4329925
20659,18,24,13,9,10,5,79,38.264862421176176,-109.432723
20660,25,26,14,12,10,2,89,38.264862421176176,-109.4324535
20661,24,27,15,13,9,1,89,38.264862421176176,-109.432184
20662,22,26,15,13,9,2,87,38.264862421176176,-109.4319145
20663,23,26,15,12,9,1,86,38.264862421176176,-109.431645
20664,23,27,15,11,9,1,86,38.264862421176176,-109.4313755
20665,16,29,14,11,11,1,82,38.264862421176176,-109.431106
20666,13,31,13,10,13,1,81,38.264862421176176,-109.4308365
20667,13,31,13,11,13,1,82,38.264862421176176,-109.430567
20668,17,27,13,12,12,1,82,38.264862421176176,-109.4302975
20669,18,26,14,11,11,1,81,38.264862421176176,-109.430028
20670,21,25,14,11,10,2,83,38.264862421176176,-109.4297586
20671,23,23,13,10,11,1,81,38.264862421176176,-109.4294891
20672,23,23,13,10,12,2,83,38.264862421176176,-109.4292196
20673,22,24,13,12,12,2,85,38.264862421176176,-109.4289501
20674,16,26,13,12,13,3,83,38.264862421176176,-109.4286806
20675,17,26,13,11,13,4,84,38.264862421176176,-109.4284111
20676,17,27,13,10,12,6,85,38.264862421176176,-109.4281416
20677,16,29,13,9,12,6,85,38.264862421176176,-109.4278721
20678,16,32,14,10,14,3,89,38.264862421176176,-109.4276026
20679,13,32,14,9,15,4,87,38.264862421176176,-109.4273331
20680,14,33,14,8,15,4,88,38.264862421176176,-109.4270636
20681,14,35,13,8,15,3,88,38.264862421176176,-109.4267941
20682,11,40,13,8,17,1,90,38.264862421176176,-109.4265246
20683,12,41,14,8,16,1,92,38.264862421176176,-109.4262551
20684,9,45,13,7,17,1,92,38.264862421176176,-109.4259856
20685,8,47,13,6,17,1,92,38.264862421176176,-109.4257161
20686,8,47,13,5,17,1,91,38.264862421176176,-109.4254466
20687,8,47,13,4,17,2,91,38.264862421176176,-109.4251771
20688,6,49,12,3,17,3,90,38.264862421176176,-109.4249077
20689,5,51,13,3,17,4,93,38.264862421176176,-109.4246382
20690,5,51,13,4,16,3,92,38.264862421176176,-109.4243687
20691,5,51,13,5,16,3,93,38.264862421176176,-109.4240992
20692,5,52,13,6,16,2,94,38.264862421176176,-109.4238297
20693,6,50,13,6,16,1,92,38.264862421176176,-109.4235602
20694,7,47,13,7,17,1,92,38.264862421176176,-109.4232907
20695,9,42,13,8,16,2,90,38.264862421176176,-109.4230212
20696,12,38,13,8,16,2,89,38.264862421176176,-109.4227517
20697,14,34,12,10,15,2,87,38.264862421176176,-109.4224822
20698,22,31,12,9,14,1,89,38.264862421176176,-109.4222127
20699,28,29,12,7,13,0,89,38.264862421176176,-109.4219432
20700,30,28,12,7,13,0,90,38.264862421176176,-109.4216737
20701,27,30,12,7,13,0,89,38.264862421176176,-109.4214042
20702,28,31,12,7,12,0,90,38.264862421176176,-109.4211347
20703,25,32,12,8,12,0,89,38.264862421176176,-109.4208652
20704,18,36,13,9,14,0,90,38.264862421176176,-109.4205957
20705,10,41,13,9,16,0,89,38.264862421176176,-109.4203262
20706,8,45,12,9,16,0,90,38.264862421176176,-109.4200568
20707,12,41,12,8,15,0,88,38.264862421176176,-109.4197873
20708,19,37,11,8,13,0,88,38.264862421176176,-109.4195178
20709,22,36,12,8,12,0,90,38.264862421176176,-109.4192483
20710,20,38,12,9,13,0,92,38.264862421176176,-109.4189788
20711,11,44,12,8,15,0,90,38.264862421176176,-109.4187093
20712,7,47,12,8,16,0,90,38.264862421176176,-109.4184398
20713,6,48,12,7,17,0,90,38.264862421176176,-109.4181703
20714,5,47,12,6,18,1,89,38.264862421176176,-109.4179008
20715,5,47,12,7,18,1,90,38.264862421176176,-109.4176313
20716,6,47,12,7,18,0,90,38.264862421176176,-109.4173618
20717,6,47,12,7,17,0,89,38.264862421176176,-109.4170923
20718,6,46,12,7,18,1,90,38.264862421176176,-109.4168228
20719,6,46,12,8,18,0,90,38.264862421176176,-109.4165533
20720,4,53,11,5,18,1,92,38.264862421176176,-109.4162838
20721,4,55,10,5,16,1,91,38.264862421176176,-109.4160143
20722,3,54,11,5,17,1,91,38.264862421176176,-109.4157448
20723,4,50,12,5,18,1,90,38.264862421176176,-109.4154753
20724,6,48,12,5,19,1,91,38.264862421176176,-109.4152058
20725,6,47,12,6,18,1,90,38.264862421176176,-109.4149364
20726,7,46,13,7,18,0,91,38.264862421176176,-109.4146669
20727,7,46,12,7,18,0,90,38.264862421176176,-109.4143974
20728,7,45,13,7,18,0,90,38.264862421176176,-109.4141279
20729,8,45,13,7,18,0,91,38.264862421176176,-109.4138584
20730,10,43,13,8,17,0,91,38.264862421176176,-109.4135889
20731,12,41,13,8,17,0,91,38.264862421176176,-109.4133194
20732,11,41,13,8,17,0,90,38.264862421176176,-109.4130499
20733,9,44,12,8,18,0,91,38.264862421176176,-109.4127804
20734,8,44,13,9,17,0,91,38.264862421176176,-109.4125109
20735,7,45,13,8,18,0,91,38.264862421176176,-109.4122414
20736,7,47,13,6,18,0,91,38.264862421176176,-109.4119719
20737,6,49,13,6,18,0,92,38.264862421176176,-109.4117024
20738,5,49,13,5,19,1,92,38.264862421176176,-109.4114329
20739,5,50,13,5,17,1,91,38.264862421176176,-109.4111634
20740,6,50,13,6,17,1,93,38.264862421176176,-109.4108939
20741,6,49,13,6,18,1,93,38.264862421176176,-109.4106244
20742,6,49,13,6,18,1,93,38.264862421176176,-109.4103549
20743,5,50,13,6,16,1,91,38.264862421176176,-109.4100855
20744,5,51,13,6,16,1,92,38.264862421176176,-109.409816
20745,6,51,13,7,16,1,94,38.264862421176176,-109.4095465
20746,7,50,13,8,15,1,94,38.264862421176176,-109.409277
20747,7,48,13,7,15,1,91,38.264862421176176,-109.4090075
20748,7,48,13,7,16,1,92,38.264862421176176,-109.408738
20749,6,49,12,5,17,2,91,38.264862421176176,-109.4084685
20750,4,47,11,4,16,3,85,38.264862421176176,-109.408199
20751,3,46,11,3,15,4,82,38.264862421176176,-109.4079295
20752,4,45,11,4,15,4,83,38.264862421176176,-109.40766
20753,5,46,13,7,16,1,88,38.264862421176176,-109.4073905
20754,6,48,13,8,16,1,92,38.264862421176176,-109.407121
20755,4,49,12,7,15,1,88,38.264862421176176,-109.4068515
20756,4,44,12,3,13,8,84,38.264862421176176,-109.3879869
20757,3,37,12,2,11,12,77,38.264862421176176,-109.3877174
20758,1,31,12,0,9,17,70,38.264862421176176,-109.3874479
20759,0,28,11,0,6,20,65,38.264862421176176,-109.3871784
20760,0,30,12,0,7,19,68,38.264862421176176,-109.3869089
20761,3,36,12,1,11,14,77,38.264862421176176,-109.3866394
20762,4,41,12,3,14,9,83,38.264862421176176,-109.3863699
20763,4,45,13,3,15,7,87,38.264862421176176,-109.3861004
20764,4,51,11,1,15,5,87,38.264862421176176,-109.3858309
20765,3,52,11,2,16,4,88,38.264862421176176,-109.3855614
20766,3,47,11,4,16,3,84,38.264862421176176,-109.3852919
20767,5,39,12,8,15,3,82,38.264862421176176,-109.3850225
20768,7,37,13,10,15,2,84,38.264862421176176,-109.384753
20769,6,37,13,8,14,3,81,38.264862421176176,-109.3844835
20770,5,39,12,4,13,7,80,38.264862421176176,-109.384214
20771,3,42,12,3,11,10,81,38.264862421176176,-109.3839445
20772,4,38,12,4,11,9,78,38.264862421176176,-109.383675
20773,3,37,11,3,11,11,76,38.264862421176176,-109.3834055
20774,2,36,11,1,11,11,72,38.264862421176176,-109.383136
20775,2,33,10,2,9,11,67,38.264862421176176,-109.3828665
20776,2,31,10,2,8,12,65,38.264862421176176,-109.382597
20777,3,35,11,2,13,9,73,38.264862421176176,-109.3823275
20778,0,31,13,1,12,15,72,38.264862421176176,-109.382058
20779,1,32,15,0,10,21,79,38.264862421176176,-109.3817885
20780,2,28,14,0,8,22,74,38.264862421176176,-109.381519
20781,6,24,13,7,7,15,72,38.264862421176176,-109.3812495
20782,20,21,11,14,11,3,80,38.264862421176176,-109.38098
20783,22,26,11,12,11,3,85,38.264862421176176,-109.3807105
20784,18,26,12,12,11,3,82,38.264862421176176,-109.380441
20785,13,26,12,12,12,3,78,38.264862421176176,-109.3801716
20786,10,26,11,13,11,3,74,38.264862421176176,-109.3799021
20787,11,31,12,11,13,2,80,38.264862421176176,-109.3796326
20788,9,33,13,11,14,2,82,38.264862421176176,-109.3793631
20789,9,33,13,14,14,3,86,38.264862421176176,-109.3790936
20790,7,29,12,22,15,1,86,38.264862421176176,-109.3788241
20791,10,23,11,27,13,0,84,38.264862421176176,-109.3785546
20792,10,26,13,19,15,1,84,38.264862421176176,-109.3782851
20793,10,29,13,18,15,1,86,38.264862421176176,-109.3780156
20794,10,32,12,14,16,1,85,38.264862421176176,-109.3777461
20795,9,35,12,10,17,1,84,38.264862421176176,-109.3774766
20796,13,29,12,12,15,1,82,38.264862421176176,-109.3772071
20797,20,17,12,13,11,1,74,38.264862421176176,-109.3769376
20798,22,16,12,14,10,1,75,38.264862421176176,-109.3766681
20799,24,21,13,11,11,1,81,38.264862421176176,-109.3763986
20800,21,24,13,16,12,1,87,38.264862421176176,-109.3761291
20801,22,24,13,17,11,1,88,38.264862421176176,-109.3758596
20802,26,20,14,13,9,0,82,38.264862421176176,-109.3755901
20803,25,21,13,12,10,0,81,38.264862421176176,-109.3753206
20804,21,23,13,13,11,0,81,38.264862421176176,-109.3750512
20805,23,25,13,12,12,0,85,38.264862421176176,-109.3747817
20806,23,27,13,11,12,0,86,38.264862421176176,-109.3745122
20807,21,29,13,10,12,1,86,38.264862421176176,-109.3742427
20808,20,29,12,6,10,3,80,38.264862421176176,-109.3739732
20809,17,28,12,6,8,5,76,38.264862421176176,-109.3737037
20810,15,24,12,8,11,5,75,38.264862421176176,-109.3734342
20811,21,26,12,8,10,3,80,38.264862421176176,-109.3731647
20812,20,23,12,7,11,2,75,38.264862421176176,-109.3728952
20813,14,23,10,9,10,3,69,38.264862421176176,-109.3726257
20814,13,27,10,12,6,2,70,38.264862421176176,-109.3723562
20815,3,21,12,5,4,16,61,38.264862421176176,-109.3720867
20816,2,16,14,5,3,23,63,38.264862421176176,-109.3718172
20817,5,16,16,5,4,23,69,38.264862421176176,-109.3715477
20818,4,16,16,5,4,25,70,38.264862421176176,-109.3712782
20819,2,23,15,1,5,26,72,38.264862421176176,-109.3710087
20820,3,26,16,1,9,22,77,38.264862421176176,-109.3707392
20821,4,29,16,1,8,22,80,38.264862421176176,-109.3704697
20822,4,30,15,0,5,23,77,38.264862421176176,-109.3702003
20823,4,31,14,0,6,22,77,38.264862421176176,-109.3699308
20824,5,33,14,0,6,20,78,38.264862421176176,-109.3696613
20825,4,32,12,0,7,18,73,38.264862421176176,-109.3693918
20826,7,33,12,2,10,13,77,38.264862421176176,-109.3691223
20827,10,35,13,6,11,8,83,38.264862421176176,-109.3688528
20828,14,35,13,9,10,7,88,38.264862421176176,-109.3685833
20829,12,32,14,7,9,11,85,38.264862421176176,-109.3683138
20830,9,32,15,3,7,16,82,38.264862421176176,-109.3680443
20831,5,31,15,0,6,21,78,38.264862421176176,-109.3677748
20832,3,31,15,0,6,23,78,38.264862421176176,-109.3675053
20833,3,34,14,0,9,19,79,38.264862421176176,-109.3672358
20834,2,32,13,0,9,20,76,38.264862421176176,-109.3669663
20835,4,32,13,1,11,18,79,38.264862421176176,-109.3666968
20836,5,31,15,5,14,15,85,38.264862421176176,-109.3664273
20837,4,28,13,9,16,10,80,38.264862421176176,-109.3661578
20838,4,28,12,9,15,9,77,38.264862421176176,-109.3658883
20839,2,24,11,6,20,5,68,38.264862421176176,-109.3656188
20840,1,19,11,4,15,9,59,38.264862421176176,-109.3653493
20841,4,22,10,5,7,10,58,38.264862421176176,-109.3650799
20842,3,35,7,5,6,4,60,38.264862421176176,-109.3648104
20843,2,36,7,3,8,4,60,38.264862421176176,-109.3645409
20844,2,35,7,4,10,3,61,38.264862421176176,-109.3642714
20845,3,35,9,6,10,4,67,38.264862421176176,-109.3640019
20846,2,36,10,2,8,10,68,38.264862421176176,-109.3637324
20847,3,35,12,0,8,15,73,38.264862421176176,-109.3634629
20848,2,35,11,0,8,15,71,38.264862421176176,-109.3631934
20849,2,32,11,2,8,11,66,38.264862421176176,-109.3629239
20850,4,33,11,4,7,7,66,38.264862421176176,-109.3626544
20851,6,28,13,8,8,5,68,38.264862421176176,-109.3623849
20852,5,23,15,6,8,17,74,38.264862421176176,-109.3621154
20853,2,24,14,5,9,22,76,38.264862421176176,-109.3618459
20854,2,25,15,4,9,21,76,38.264862421176176,-109.3615764
20855,3,26,16,1,6,24,76,38.264862421176176,-109.3613069
20856,2,22,16,0,3,28,71,38.264862421176176,-109.3610374
20857,7,27,15,3,5,20,77,38.264862421176176,-109.3607679
20858,11,28,16,6,6,17,84,38.264862421176176,-109.3604984
20859,12,28,17,7,6,17,87,38.264862421176176,-109.360229
20860,10,29,16,4,7,19,85,38.264862421176176,-109.3599595
20861,6,31,16,2,7,22,84,38.264862421176176,-109.35969
20862,3,28,17,0,5,28,81,38.264862421176176,-109.3594205
20863,2,27,17,0,5,28,79,38.264862421176176,-109.359151
20864,0,26,14,0,5,25,70,38.264862421176176,-109.3588815
20865,0,24,13,0,6,25,68,38.264862421176176,-109.358612
20866,1,29,15,0,9,23,77,38.264862421176176,-109.3583425
20867,1,32,12,0,11,17,73,38.264862421176176,-109.358073
20868,9,31,12,9,21,0,82,38.264862421176176,-109.3578035
20869,5,28,12,8,23,0,76,38.264862421176176,-109.357534
20870,0,13,9,8,16,2,48,38.264862421176176,-109.3572645
20871,1,35,8,5,9,5,63,38.264862421176176,-109.356995
20872,2,34,9,4,10,8,67,38.264862421176176,-109.3567255
20873,2,31,12,3,8,11,67,38.264862421176176,-109.356456
20874,3,30,13,0,2,20,68,38.264862421176176,-109.3561865
20875,4,29,13,3,6,16,71,38.264862421176176,-109.355917
20876,1,21,12,2,3,20,59,38.264862421176176,-109.3556475
20877,2,25,11,3,6,16,63,38.264862421176176,-109.355378
20878,2,28,11,3,8,14,66,38.264862421176176,-109.3551086
20879,2,22,14,2,4,21,65,38.264862421176176,-109.3548391
20880,2,22,15,0,3,25,67,38.264862421176176,-109.3545696
20881,1,27,12,1,8,16,65,38.264862421176176,-109.3543001
20882,1,29,11,0,11,14,66,38.264862421176176,-109.3540306
20883,0,28,11,1,11,14,65,38.264862421176176,-109.3537611
20884,1,27,11,4,12,11,66,38.264862421176176,-109.3534916
20885,0,31,11,2,10,13,67,38.264862421176176,-109.3532221
20886,1,35,11,0,11,12,70,38.264862421176176,-109.3529526
20887,1,32,11,2,12,10,68,38.264862421176176,-109.3526831
20888,6,19,13,9,10,9,66,38.264862421176176,-109.3524136
20889,6,21,11,8,11,6,63,38.264862421176176,-109.3521441
20890,0,33,10,2,13,7,65,38.264862421176176,-109.3518746
20891,0,38,8,2,11,6,65,38.264862421176176,-109.3516051
20892,1,35,10,3,11,9,69,38.264862421176176,-109.3513356
20893,3,26,12,4,13,9,67,38.264862421176176,-109.3510661
20894,5,15,12,6,5,15,58,38.264862421176176,-109.3507966
20895,2,18,10,5,6,13,54,38.264862421176176,-109.3505271
20896,1,22,10,4,10,9,56,38.264862421176176,-109.3502577
20897,1,24,9,5,10,6,55,38.264862421176176,-109.3499882
20898,2,28,9,4,8,8,59,38.264862421176176,-109.3497187
20899,4,31,10,8,7,9,69,38.264862421176176,-109.3494492
20900,1,25,8,5,9,9,57,38.264862421176176,-109.3491797
20901,4,36,9,5,8,10,72,38.264862421176176,-109.3489102
20902,2,15,11,7,10,11,56,38.264862421176176,-109.3486407
20903,2,8,11,7,6,15,49,38.264862421176176,-109.3483712
20904,2,8,13,7,5,19,54,38.264862421176176,-109.3481017
20905,1,12,16,3,3,27,62,38.264862421176176,-109.3478322
20906,1,16,18,0,3,32,70,38.264862421176176,-109.3475627
20907,1,18,19,0,2,32,72,38.264862421176176,-109.3472932
20908,1,15,20,0,1,34,71,38.264862421176176,-109.3470237
20909,1,17,19,0,0,33,70,38.264862421176176,-109.3467542
20910,1,17,19,0,0,31,68,38.264862421176176,-109.3464847
20911,1,17,18,0,0,29,65,38.264862421176176,-109.3462152
20912,1,16,17,0,0,30,64,38.264862421176176,-109.3459457
20913,1,16,18,0,0,30,65,38.264862421176176,-109.3456762
20914,0,16,18,0,1,32,67,38.264862421176176,-109.3454068
20915,0,17,19,0,2,34,72,38.264862421176176,-109.3451373
20916,0,22,20,0,5,33,80,38.264862421176176,-109.3448678
20917,1,26,20,1,8,30,86,38.264862421176176,-109.3445983
20918,4,27,18,3,11,22,85,38.264862421176176,-109.3443288
20919,6,31,16,8,13,14,88,38.264862421176176,-109.3440593
20920,7,34,14,9,13,9,86,38.264862421176176,-109.3437898
20921,8,36,14,8,14,7,87,38.264862421176176,-109.3435203
20922,7,38,14,9,14,6,88,38.264862421176176,-109.3432508
20923,10,37,14,11,13,5,90,38.264862421176176,-109.3429813
20924,9,38,14,12,13,5,91,38.264862421176176,-109.3427118
20925,8,38,14,12,13,5,90,38.264862421176176,-109.3424423
20926,8,37,14,12,12,5,88,38.264862421176176,-109.3421728
20927,8,37,14,11,14,5,89,38.264862421176176,-109.3419033
20928,8,37,14,11,15,5,90,38.264862421176176,-109.3416338
20929,8,36,14,11,13,6,88,38.264862421176176,-109.3413643
20930,10,35,14,11,12,7,89,38.264862421176176,-109.3410948
20931,9,35,14,13,11,7,89,38.264862421176176,-109.3408253
20932,7,37,14,12,12,6,88,38.264862421176176,-109.3405558
20933,7,38,14,12,12,6,89,38.264862421176176,-109.3402864
20934,7,38,14,12,12,6,89,38.264862421176176,-109.3400169
20935,6,38,14,12,12,6,88,38.264862421176176,-109.3397474
20936,8,40,14,12,11,5,90,38.264862421176176,-109.3394779
20937,8,42,14,11,10,6,91,38.264862421176176,-109.3392084
20938,6,43,14,11,10,5,89,38.264862421176176,-109.3389389
20939,6,42,14,13,11,5,91,38.264862421176176,-109.3386694
20940,8,40,14,14,11,5,92,38.264862421176176,-109.3383999
20941,8,37,14,14,11,6,90,38.264862421176176,-109.3381304
20942,7,37,14,14,10,6,88,38.264862421176176,-109.3378609
20943,7,38,13,14,10,6,88,38.264862421176176,-109.3375914
20944,8,39,13,14,10,5,89,38.264862421176176,-109.3373219
20945,7,39,14,14,9,6,89,38.264862421176176,-109.3370524
20946,7,39,14,12,10,7,89,38.264862421176176,-109.3367829
20947,6,38,14,12,12,7,89,38.264862421176176,-109.3365134
20948,6,37,14,11,13,7,88,38.264862421176176,-109.3362439
20949,7,36,14,9,15,8,89,38.264862421176176,-109.3359744
20950,6,34,14,11,16,8,89,38.264862421176176,-109.3357049
20951,6,35,14,10,16,7,88,38.264862421176176,-109.3354355
20952,5,38,14,10,17,5,89,38.264862421176176,-109.335166
20953,4,47,12,3,16,6,88,38.264592926590936,-109.4413468
20954,2,43,11,2,16,8,82,38.264592926590936,-109.4410773
20955,2,43,11,1,16,9,82,38.264592926590936,-109.4408078
20956,3,47,11,0,15,9,85,38.264592926590936,-109.4405383
20957,2,43,11,0,13,12,81,38.264592926590936,-109.4402688
20958,2,44,11,0,12,13,82,38.264592926590936,-109.4399993
20959,2,45,11,0,12,12,82,38.264592926590936,-109.4397299
20960,2,45,10,0,13,10,80,38.264592926590936,-109.4394604
20961,3,43,11,0,14,10,81,38.264592926590936,-109.4391909
20962,1,38,11,0,12,15,77,38.264592926590936,-109.4389214
20963,1,36,11,0,12,15,75,38.264592926590936,-109.4386519
20964,0,34,10,0,13,14,71,38.264592926590936,-109.4383824
20965,0,35,11,1,15,11,73,38.264592926590936,-109.4381129
20966,0,33,11,0,16,12,72,38.264592926590936,-109.4378434
20967,0,31,11,0,13,14,69,38.264592926590936,-109.4375739
20968,0,36,11,0,15,11,73,38.264592926590936,-109.4373044
20969,1,37,10,0,17,9,74,38.264592926590936,-109.4370349
20970,1,36,9,0,14,11,71,38.264592926590936,-109.4367654
20971,1,37,10,0,16,8,72,38.264592926590936,-109.4364959
20972,1,32,10,0,15,12,70,38.264592926590936,-109.4362264
20973,1,33,10,0,11,14,69,38.264592926590936,-109.4359569
20974,3,37,11,0,9,14,74,38.264592926590936,-109.4356874
20975,3,35,11,0,8,14,71,38.264592926590936,-109.4354179
20976,2,33,11,1,9,12,68,38.264592926590936,-109.4351484
20977,2,33,9,1,9,12,66,38.264592926590936,-109.434879
20978,2,35,9,1,9,11,67,38.264592926590936,-109.4346095
20979,1,36,9,2,10,9,67,38.264592926590936,-109.43434
20980,1,37,9,3,11,7,68,38.264592926590936,-109.4340705
20981,2,38,9,3,13,6,71,38.264592926590936,-109.433801
20982,6,36,11,4,14,4,75,38.264592926590936,-109.4335315
20983,10,30,11,6,13,4,74,38.264592926590936,-109.433262
20984,14,25,12,9,11,4,75,38.264592926590936,-109.4329925
20985,25,25,13,10,11,2,86,38.264592926590936,-109.432723
20986,27,26,13,11,10,1,88,38.264592926590936,-109.4324535
20987,23,28,14,12,10,1,88,38.264592926590936,-109.432184
20988,23,28,15,12,9,1,88,38.264592926590936,-109.4319145
20989,24,27,15,12,9,1,88,38.264592926590936,-109.431645
20990,23,27,15,11,8,1,85,38.264592926590936,-109.4313755
20991,18,28,14,11,12,1,84,38.264592926590936,-109.431106
20992,15,29,13,12,14,1,84,38.264592926590936,-109.4308365
20993,15,29,13,12,13,1,83,38.264592926590936,-109.430567
20994,17,28,14,11,12,2,84,38.264592926590936,-109.4302975
20995,22,26,15,11,10,2,86,38.264592926590936,-109.430028
20996,25,26,16,10,9,2,88,38.264592926590936,-109.4297586
20997,25,25,15,10,9,1,85,38.264592926590936,-109.4294891
20998,25,23,14,12,10,1,85,38.264592926590936,-109.4292196
20999,31,23,14,10,11,0,89,38.264592926590936,-109.4289501
21000,30,22,13,9,11,1,86,38.264592926590936,-109.4286806
21001,31,22,13,9,11,1,87,38.264592926590936,-109.4284111
21002,30,22,13,9,12,1,87,38.264592926590936,-109.4281416
21003,25,23,13,9,11,2,83,38.264592926590936,-109.4278721
21004,23,27,14,11,12,1,88,38.264592926590936,-109.4276026
21005,19,29,14,12,14,1,89,38.264592926590936,-109.4273331
21006,18,31,14,12,15,1,91,38.264592926590936,-109.4270636
21007,17,33,14,10,15,1,90,38.264592926590936,-109.4267941
21008,14,38,14,10,16,0,92,38.264592926590936,-109.4265246
21009,11,41,14,9,16,1,92,38.264592926590936,-109.4262551
21010,11,42,14,9,16,1,93,38.264592926590936,-109.4259856
21011,13,41,14,9,15,0,92,38.264592926590936,-109.4257161
21012,17,39,13,9,13,0,91,38.264592926590936,-109.4254466
21013,15,40,13,8,14,0,90,38.264592926590936,-109.4251771
21014,9,47,13,6,16,1,92,38.264592926590936,-109.4249077
21015,7,50,13,5,17,1,93,38.264592926590936,-109.4246382
21016,6,51,13,5,17,1,93,38.264592926590936,-109.4243687
21017,6,51,13,6,16,1,93,38.264592926590936,-109.4240992
21018,6,51,13,6,16,2,94,38.264592926590936,-109.4238297
21019,7,49,13,6,17,2,94,38.264592926590936,-109.4235602
21020,8,47,13,7,17,1,93,38.264592926590936,-109.4232907
21021,8,44,13,9,17,1,92,38.264592926590936,-109.4230212
21022,9,41,13,10,16,1,90,38.264592926590936,-109.4227517
21023,10,39,13,10,17,1,90,38.264592926590936,-109.4224822
21024,16,36,13,10,15,0,90,38.264592926590936,-109.4222127
21025,25,33,13,7,13,0,91,38.264592926590936,-109.4219432
21026,27,32,13,7,13,0,92,38.264592926590936,-109.4216737
21027,26,32,13,8,13,0,92,38.264592926590936,-109.4214042
21028,32,29,12,7,11,0,91,38.264592926590936,-109.4211347
21029,32,28,11,6,9,0,86,38.264592926590936,-109.4208652
21030,24,33,12,7,11,0,87,38.264592926590936,-109.4205957
21031,11,43,13,8,16,0,91,38.264592926590936,-109.4203262
21032,9,47,12,7,16,0,91,38.264592926590936,-109.4200568
21033,8,47,12,6,17,0,90,38.264592926590936,-109.4197873
21034,10,44,12,8,16,0,90,38.264592926590936,-109.4195178
21035,13,41,12,9,15,0,90,38.264592926590936,-109.4192483
21036,15,42,12,7,14,0,90,38.264592926590936,-109.4189788
21037,11,46,12,6,16,0,91,38.264592926590936,-109.4187093
21038,8,47,12,5,17,0,89,38.264592926590936,-109.4184398
21039,7,49,12,5,17,1,91,38.264592926590936,-109.4181703
21040,6,49,12,5,18,1,91,38.264592926590936,-109.4179008
21041,6,47,12,6,17,1,89,38.264592926590936,-109.4176313
21042,5,48,12,6,18,1,90,38.264592926590936,-109.4173618
21043,5,46,12,6,18,2,89,38.264592926590936,-109.4170923
21044,6,44,12,7,17,2,88,38.264592926590936,-109.4168228
21045,6,46,11,7,17,1,88,38.264592926590936,-109.4165533
21046,4,53,10,5,16,1,89,38.264592926590936,-109.4162838
21047,3,54,11,5,17,1,91,38.264592926590936,-109.4160143
21048,4,51,12,5,18,2,92,38.264592926590936,-109.4157448
21049,4,47,12,5,18,3,89,38.264592926590936,-109.4154753
21050,6,46,12,5,18,2,89,38.264592926590936,-109.4152058
21051,5,46,13,6,18,2,90,38.264592926590936,-109.4149364
21052,6,45,12,7,18,1,89,38.264592926590936,-109.4146669
21053,6,45,12,7,18,1,89,38.264592926590936,-109.4143974
21054,7,45,13,8,18,0,91,38.264592926590936,-109.4141279
21055,7,45,13,8,17,0,90,38.264592926590936,-109.4138584
21056,10,43,13,8,17,0,91,38.264592926590936,-109.4135889
21057,11,41,13,8,17,0,90,38.264592926590936,-109.4133194
21058,11,42,13,8,17,0,91,38.264592926590936,-109.4130499
21059,9,44,13,7,17,1,91,38.264592926590936,-109.4127804
21060,8,45,13,8,16,0,90,38.264592926590936,-109.4125109
21061,8,45,13,9,17,0,92,38.264592926590936,-109.4122414
21062,8,45,13,8,17,0,91,38.264592926590936,-109.4119719
21063,7,47,13,7,17,0,91,38.264592926590936,-109.4117024
21064,5,49,13,6,18,1,92,38.264592926590936,-109.4114329
21065,5,50,13,5,18,1,92,38.264592926590936,-109.4111634
21066,5,50,13,5,17,1,91,38.264592926590936,-109.4108939
21067,5,50,13,7,17,1,93,38.264592926590936,-109.4106244
21068,5,51,13,6,16,1,92,38.264592926590936,-109.4103549
21069,5,51,13,6,15,2,92,38.264592926590936,-109.4100855
21070,5,53,13,5,16,2,94,38.264592926590936,-109.409816
21071,5,52,13,6,16,1,93,38.264592926590936,-109.4095465
21072,6,49,13,8,16,1,93,38.264592926590936,-109.409277
21073,8,46,13,8,16,1,92,38.264592926590936,-109.4090075
21074,8,44,13,8,17,1,91,38.264592926590936,-109.408738
21075,7,45,13,6,17,2,90,38.264592926590936,-109.4084685
21076,5,45,12,5,16,3,86,38.264592926590936,-109.408199
21077,4,44,12,5,17,3,85,38.264592926590936,-109.4079295
21078,5,46,13,6,17,2,89,38.264592926590936,-109.40766
21079,5,48,13,6,17,2,91,38.264592926590936,-109.4073905
21080,5,49,13,7,16,2,92,38.264592926590936,-109.407121
21081,4,48,12,7,16,1,88,38.264592926590936,-109.4068515
21082,3,38,12,2,11,12,78,38.264592926590936,-109.3879869
21083,3,34,13,3,10,15,78,38.264592926590936,-109.3877174
21084,1,28,12,0,6,21,68,38.264592926590936,-109.3874479
21085,1,32,12,0,8,18,71,38.264592926590936,-109.3871784
21086,3,37,13,2,11,13,79,38.264592926590936,-109.3869089
21087,4,41,13,3,13,10,84,38.264592926590936,-109.3866394
21088,4,44,13,3,14,8,86,38.264592926590936,-109.3863699
21089,4,46,13,5,16,5,89,38.264592926590936,-109.3861004
21090,4,51,12,3,16,4,90,38.264592926590936,-109.3858309
21091,4,50,12,4,16,3,89,38.264592926590936,-109.3855614
21092,4,48,13,7,17,2,91,38.264592926590936,-109.3852919
21093,5,44,13,7,17,2,88,38.264592926590936,-109.3850225
21094,4,45,13,5,16,4,87,38.264592926590936,-109.384753
21095,3,44,12,4,14,6,83,38.264592926590936,-109.3844835
21096,3,46,11,3,13,7,83,38.264592926590936,-109.384214
21097,2,49,9,3,12,7,82,38.264592926590936,-109.3839445
21098,2,45,9,4,11,7,78,38.264592926590936,-109.383675
21099,3,42,9,3,10,8,75,38.264592926590936,-109.3834055
21100,2,36,10,2,9,9,68,38.264592926590936,-109.383136
21101,1,32,10,3,9,10,65,38.264592926590936,-109.3828665
21102,1,31,10,1,10,11,64,38.264592926590936,-109.382597
21103,1,36,13,1,13,13,77,38.264592926590936,-109.3823275
21104,0,33,13,0,10,20,76,38.264592926590936,-109.382058
21105,2,36,14,0,12,17,81,38.264592926590936,-109.3817885
21106,3,36,12,1,13,12,77,38.264592926590936,-109.381519
21107,6,30,12,7,13,8,76,38.264592926590936,-109.3812495
21108,12,25,12,13,11,6,79,38.264592926590936,-109.38098
21109,19,28,12,13,11,2,85,38.264592926590936,-109.3807105
21110,19,28,13,13,12,2,87,38.264592926590936,-109.380441
21111,19,25,12,13,11,2,82,38.264592926590936,-109.3801716
21112,20,24,11,14,11,1,81,38.264592926590936,-109.3799021
21113,19,28,12,13,13,1,86,38.264592926590936,-109.3796326
21114,15,29,13,15,14,1,87,38.264592926590936,-109.3793631
21115,12,30,13,17,14,1,87,38.264592926590936,-109.3790936
21116,15,28,13,18,13,1,88,38.264592926590936,-109.3788241
21117,20,24,12,20,11,0,87,38.264592926590936,-109.3785546
21118,13,23,12,17,14,1,80,38.264592926590936,-109.3782851
21119,10,27,12,17,14,1,81,38.264592926590936,-109.3780156
21120,9,29,12,16,16,1,83,38.264592926590936,-109.3777461
21121,13,26,12,14,15,1,81,38.264592926590936,-109.3774766
21122,14,18,12,17,13,2,76,38.264592926590936,-109.3772071
21123,22,14,12,16,11,1,76,38.264592926590936,-109.3769376
21124,24,16,13,13,11,1,78,38.264592926590936,-109.3766681
21125,22,23,13,13,12,1,84,38.264592926590936,-109.3763986
21126,21,23,13,18,11,1,87,38.264592926590936,-109.3761291
21127,20,23,13,20,11,0,87,38.264592926590936,-109.3758596
21128,23,21,14,16,10,0,84,38.264592926590936,-109.3755901
21129,22,22,14,15,9,0,82,38.264592926590936,-109.3753206
21130,21,25,13,12,10,1,82,38.264592926590936,-109.3750512
21131,19,27,13,10,12,1,82,38.264592926590936,-109.3747817
21132,23,27,12,9,11,1,83,38.264592926590936,-109.3745122
21133,23,29,12,8,12,1,85,38.264592926590936,-109.3742427
21134,20,30,12,9,12,1,84,38.264592926590936,-109.3739732
21135,15,31,11,9,11,2,79,38.264592926590936,-109.3737037
21136,13,27,11,8,10,4,73,38.264592926590936,-109.3734342
21137,14,27,11,7,9,5,73,38.264592926590936,-109.3731647
21138,15,25,11,7,9,5,72,38.264592926590936,-109.3728952
21139,14,23,10,8,9,5,69,38.264592926590936,-109.3726257
21140,9,25,10,7,9,6,66,38.264592926590936,-109.3723562
21141,2,20,13,4,3,20,62,38.264592926590936,-109.3720867
21142,5,14,17,5,3,24,68,38.264592926590936,-109.3718172
21143,5,14,17,4,4,25,69,38.264592926590936,-109.3715477
21144,2,18,16,1,2,28,67,38.264592926590936,-109.3712782
21145,4,27,15,0,4,25,75,38.264592926590936,-109.3710087
21146,4,29,14,0,6,21,74,38.264592926590936,-109.3707392
21147,4,29,14,0,6,22,75,38.264592926590936,-109.3704697
21148,5,29,14,0,6,21,75,38.264592926590936,-109.3702003
21149,8,32,14,2,7,17,80,38.264592926590936,-109.3699308
21150,7,35,14,2,8,16,82,38.264592926590936,-109.3696613
21151,8,35,13,4,9,12,81,38.264592926590936,-109.3693918
21152,11,35,13,5,10,9,83,38.264592926590936,-109.3691223
21153,13,33,13,7,9,8,83,38.264592926590936,-109.3688528
21154,17,32,13,8,8,7,85,38.264592926590936,-109.3685833
21155,16,32,14,8,8,8,86,38.264592926590936,-109.3683138
21156,15,32,14,7,9,9,86,38.264592926590936,-109.3680443
21157,10,32,14,5,9,12,82,38.264592926590936,-109.3677748
21158,6,31,14,1,8,18,78,38.264592926590936,-109.3675053
21159,5,34,15,0,10,19,83,38.264592926590936,-109.3672358
21160,3,33,14,0,12,18,80,38.264592926590936,-109.3669663
21161,4,29,15,4,13,17,82,38.264592926590936,-109.3666968
21162,4,27,15,6,15,16,83,38.264592926590936,-109.3664273
21163,4,25,13,11,15,9,77,38.264592926590936,-109.3661578
21164,3,21,11,11,13,6,65,38.264592926590936,-109.3658883
21165,3,22,10,9,20,2,66,38.264592926590936,-109.3656188
21166,3,17,11,5,9,10,55,38.264592926590936,-109.3653493
21167,2,30,8,2,6,9,57,38.264592926590936,-109.3650799
21168,2,34,7,2,9,5,59,38.264592926590936,-109.3648104
21169,2,34,6,1,8,6,57,38.264592926590936,-109.3645409
21170,2,34,7,2,9,7,61,38.264592926590936,-109.3642714
21171,1,35,8,2,10,8,64,38.264592926590936,-109.3640019
21172,3,36,11,2,9,11,72,38.264592926590936,-109.3637324
21173,3,35,12,1,9,14,74,38.264592926590936,-109.3634629
21174,2,33,11,1,9,14,70,38.264592926590936,-109.3631934
21175,3,30,11,3,8,10,65,38.264592926590936,-109.3629239
21176,6,32,12,5,6,7,68,38.264592926590936,-109.3626544
21177,11,31,16,9,8,3,78,38.264592926590936,-109.3623849
21178,3,26,15,7,11,19,81,38.264592926590936,-109.3621154
21179,2,21,14,6,7,23,73,38.264592926590936,-109.3618459
21180,2,21,16,3,4,25,71,38.264592926590936,-109.3615764
21181,4,24,15,0,4,24,71,38.264592926590936,-109.3613069
21182,5,25,15,1,4,22,72,38.264592926590936,-109.3610374
21183,6,26,15,2,5,22,76,38.264592926590936,-109.3607679
21184,10,28,16,3,6,20,83,38.264592926590936,-109.3604984
21185,11,28,16,3,6,20,84,38.264592926590936,-109.360229
21186,7,27,16,2,7,23,82,38.264592926590936,-109.3599595
21187,2,28,17,0,7,27,81,38.264592926590936,-109.35969
21188,2,27,16,0,6,27,78,38.264592926590936,-109.3594205
21189,2,26,15,0,5,26,74,38.264592926590936,-109.359151
21190,3,26,15,0,4,24,72,38.264592926590936,-109.3588815
21191,3,26,17,0,7,29,82,38.264592926590936,-109.358612
21192,0,29,16,0,3,29,77,38.264592926590936,-109.3583425
21193,4,32,14,3,14,11,78,38.264592926590936,-109.358073
21194,8,31,10,2,14,5,70,38.264592926590936,-109.3578035
21195,2,25,9,5,9,2,52,38.264592926590936,-109.357534
21196,1,46,8,3,11,6,75,38.264592926590936,-109.3572645
21197,2,40,8,5,10,8,73,38.264592926590936,-109.356995
21198,2,33,10,4,8,11,68,38.264592926590936,-109.3567255
21199,0,29,11,3,7,13,63,38.264592926590936,-109.356456
21200,2,29,13,1,7,16,68,38.264592926590936,-109.3561865
21201,1,33,11,0,7,14,66,38.264592926590936,-109.355917
21202,1,33,11,1,10,13,69,38.264592926590936,-109.3556475
21203,1,31,10,1,9,13,65,38.264592926590936,-109.355378
21204,2,30,11,1,8,14,66,38.264592926590936,-109.3551086
21205,1,28,11,1,6,17,64,38.264592926590936,-109.3548391
21206,1,27,11,2,9,14,64,38.264592926590936,-109.3545696
21207,2,28,10,2,9,11,62,38.264592926590936,-109.3543001
21208,1,25,10,2,8,14,60,38.264592926590936,-109.3540306
21209,0,25,11,1,8,15,60,38.264592926590936,-109.3537611
21210,3,30,11,1,10,12,67,38.264592926590936,-109.3534916
21211,1,29,11,0,7,16,64,38.264592926590936,-109.3532221
21212,1,29,11,0,9,16,66,38.264592926590936,-109.3529526
21213,5,27,15,7,5,21,80,38.264592926590936,-109.3526831
21214,6,24,16,6,4,22,78,38.264592926590936,-109.3524136
21215,3,31,13,2,8,14,71,38.264592926590936,-109.3521441
21216,3,40,11,4,8,12,78,38.264592926590936,-109.3518746
21217,0,44,10,0,11,10,75,38.264592926590936,-109.3516051
21218,1,33,13,4,11,12,74,38.264592926590936,-109.3513356
21219,5,25,12,5,13,8,68,38.264592926590936,-109.3510661
21220,4,19,14,6,6,14,63,38.264592926590936,-109.3507966
21221,3,22,11,3,8,12,59,38.264592926590936,-109.3505271
21222,2,24,12,5,11,11,65,38.264592926590936,-109.3502577
21223,3,27,11,6,12,8,67,38.264592926590936,-109.3499882
21224,5,40,9,5,8,7,74,38.264592926590936,-109.3497187
21225,4,29,11,9,8,8,69,38.264592926590936,-109.3494492
21226,2,23,9,5,9,9,57,38.264592926590936,-109.3491797
21227,4,26,9,5,9,9,62,38.264592926590936,-109.3489102
21228,2,22,10,8,8,11,61,38.264592926590936,-109.3486407
21229,2,19,10,6,7,12,56,38.264592926590936,-109.3483712
21230,3,13,11,5,9,13,54,38.264592926590936,-109.3481017
21231,3,10,13,7,5,20,58,38.264592926590936,-109.3478322
21232,2,12,16,2,3,28,63,38.264592926590936,-109.3475627
21233,2,14,18,1,2,31,68,38.264592926590936,-109.3472932
21234,2,15,20,0,0,32,69,38.264592926590936,-109.3470237
21235,1,18,18,0,0,30,67,38.264592926590936,-109.3467542
21236,1,18,17,0,0,30,66,38.264592926590936,-109.3464847
21237,1,18,17,0,0,30,66,38.264592926590936,-109.3462152
21238,1,18,17,0,0,30,66,38.264592926590936,-109.3459457
21239,0,16,18,0,1,32,67,38.264592926590936,-109.3456762
21240,0,18,19,0,3,33,73,38.264592926590936,-109.3454068
21241,0,21,20,0,5,34,80,38.264592926590936,-109.3451373
21242,0,23,21,0,8,33,85,38.264592926590936,-109.3448678
21243,1,25,20,1,9,30,86,38.264592926590936,-109.3445983
21244,3,28,18,2,10,24,85,38.264592926590936,-109.3443288
21245,6,31,16,7,11,16,87,38.264592926590936,-109.3440593
21246,10,32,14,10,10,11,87,38.264592926590936,-109.3437898
21247,12,34,15,10,10,9,90,38.264592926590936,-109.3435203
21248,13,37,15,11,11,5,92,38.264592926590936,-109.3432508
21249,13,34,14,13,12,5,91,38.264592926590936,-109.3429813
21250,10,34,14,13,14,5,90,38.264592926590936,-109.3427118
21251,8,35,14,14,14,4,89,38.264592926590936,-109.3424423
21252,9,36,13,14,12,4,88,38.264592926590936,-109.3421728
21253,9,36,14,11,13,6,89,38.264592926590936,-109.3419033
21254,10,35,14,12,13,6,90,38.264592926590936,-109.3416338
21255,9,35,14,13,12,6,89,38.264592926590936,-109.3413643
21256,8,34,14,12,12,7,87,38.264592926590936,-109.3410948
21257,8,35,15,12,14,6,90,38.264592926590936,-109.3408253
21258,9,35,14,14,11,6,89,38.264592926590936,-109.3405558
21259,9,35,14,14,11,6,89,38.264592926590936,-109.3402864
21260,9,36,14,14,11,6,90,38.264592926590936,-109.3400169
21261,8,39,14,13,11,6,91,38.264592926590936,-109.3397474
21262,7,41,14,11,11,6,90,38.264592926590936,-109.3394779
21263,7,41,14,11,10,7,90,38.264592926590936,-109.3392084
21264,6,41,14,12,10,7,90,38.264592926590936,-109.3389389
21265,6,40,14,12,11,6,89,38.264592926590936,-109.3386694
21266,6,38,14,11,13,7,89,38.264592926590936,-109.3383999
21267,7,37,13,13,13,6,89,38.264592926590936,-109.3381304
21268,8,36,13,13,11,7,88,38.264592926590936,-109.3378609
21269,7,37,13,13,11,7,88,38.264592926590936,-109.3375914
21270,7,38,13,12,11,8,89,38.264592926590936,-109.3373219
21271,7,38,14,11,11,8,89,38.264592926590936,-109.3370524
21272,6,38,14,9,12,10,89,38.264592926590936,-109.3367829
21273,6,36,14,9,11,12,88,38.264592926590936,-109.3365134
21274,6,34,14,8,12,12,86,38.264592926590936,-109.3362439
21275,7,33,15,9,13,11,88,38.264592926590936,-109.3359744
21276,8,28,15,15,15,7,88,38.264592926590936,-109.3357049
21277,7,29,15,14,16,7,88,38.264592926590936,-109.3354355
21278,7,32,14,11,15,7,86,38.264592926590936,-109.335166
21279,3,45,11,2,13,8,82,38.26432343,-109.4416163
21280,3,45,11,3,14,7,83,38.26432343,-109.4413468
21281,3,44,11,2,14,8,82,38.26432343,-109.4410773
21282,3,46,11,2,15,7,84,38.26432343,-109.4408078
21283,3,47,11,3,16,5,85,38.26432343,-109.4405383
21284,3,45,11,3,15,5,82,38.26432343,-109.4402688
21285,2,44,11,2,14,7,80,38.26432343,-109.4399993
21286,2,45,11,2,14,8,82,38.26432343,-109.4397299
21287,2,45,11,2,14,8,82,38.26432343,-109.4394604
21288,3,45,12,2,15,8,85,38.26432343,-109.4391909
21289,2,43,10,0,12,14,81,38.26432343,-109.4389214
21290,1,35,10,0,11,15,72,38.26432343,-109.4386519
21291,0,33,10,0,10,16,69,38.26432343,-109.4383824
21292,0,36,10,0,11,14,71,38.26432343,-109.4381129
21293,0,37,9,0,10,14,70,38.26432343,-109.4378434
21294,0,35,9,0,9,13,66,38.26432343,-109.4375739
21295,0,39,9,0,12,10,70,38.26432343,-109.4373044
21296,1,42,9,0,15,8,75,38.26432343,-109.4370349
21297,0,36,8,0,16,8,68,38.26432343,-109.4367654
21298,1,33,10,0,13,11,68,38.26432343,-109.4364959
21299,1,33,10,0,10,14,68,38.26432343,-109.4362264
21300,2,42,9,0,12,10,75,38.26432343,-109.4359569
21301,2,47,10,0,13,8,80,38.26432343,-109.4356874
21302,3,40,10,1,11,10,75,38.26432343,-109.4354179
21303,3,35,10,2,12,8,70,38.26432343,-109.4351484
21304,3,36,9,2,12,8,70,38.26432343,-109.434879
21305,2,34,10,2,11,10,69,38.26432343,-109.4346095
21306,2,36,10,1,11,10,70,38.26432343,-109.43434
21307,2,41,10,1,11,10,75,38.26432343,-109.4340705
21308,2,36,10,2,12,10,72,38.26432343,-109.433801
21309,4,33,11,4,13,7,72,38.26432343,-109.4335315
21310,6,29,11,6,12,6,70,38.26432343,-109.433262
21311,10,26,12,9,12,5,74,38.26432343,-109.4329925
21312,23,25,13,10,12,2,85,38.26432343,-109.432723
21313,20,24,13,13,12,1,83,38.26432343,-109.4324535
21314,19,24,13,13,11,1,81,38.26432343,-109.432184
21315,20,25,13,12,11,1,82,38.26432343,-109.4319145
21316,23,25,13,12,11,1,85,38.26432343,-109.431645
21317,25,26,14,12,11,0,88,38.26432343,-109.4313755
21318,20,28,14,12,12,0,86,38.26432343,-109.431106
21319,18,29,14,12,13,0,86,38.26432343,-109.4308365
21320,17,30,14,12,13,1,87,38.26432343,-109.430567
21321,16,30,14,12,12,1,85,38.26432343,-109.4302975
21322,21,29,15,11,10,1,87,38.26432343,-109.430028
21323,24,28,15,11,10,1,89,38.26432343,-109.4297586
21324,25,28,15,10,10,1,89,38.26432343,-109.4294891
21325,25,27,14,11,10,0,87,38.26432343,-109.4292196
21326,27,27,14,11,10,0,89,38.26432343,-109.4289501
21327,26,24,13,11,11,0,85,38.26432343,-109.4286806
21328,26,23,13,11,11,1,85,38.26432343,-109.4284111
21329,25,23,13,10,11,1,83,38.26432343,-109.4281416
21330,23,24,13,10,12,1,83,38.26432343,-109.4278721
21331,21,28,14,11,12,1,87,38.26432343,-109.4276026
21332,19,30,14,12,14,1,90,38.26432343,-109.4273331
21333,19,31,14,11,14,1,90,38.26432343,-109.4270636
21334,19,32,14,10,14,1,90,38.26432343,-109.4267941
21335,18,32,14,10,14,1,89,38.26432343,-109.4265246
21336,15,34,14,12,14,1,90,38.26432343,-109.4262551
21337,14,37,14,12,14,1,92,38.26432343,-109.4259856
21338,19,35,14,11,13,1,93,38.26432343,-109.4257161
21339,24,31,13,10,12,1,91,38.26432343,-109.4254466
21340,24,32,13,9,11,0,89,38.26432343,-109.4251771
21341,19,36,13,9,13,1,91,38.26432343,-109.4249077
21342,13,43,13,9,14,0,92,38.26432343,-109.4246382
21343,12,44,13,9,15,0,93,38.26432343,-109.4243687
21344,12,43,13,9,15,1,93,38.26432343,-109.4240992
21345,9,45,13,8,16,1,92,38.26432343,-109.4238297
21346,10,45,13,9,16,1,94,38.26432343,-109.4235602
21347,9,44,14,9,16,1,93,38.26432343,-109.4232907
21348,9,42,14,10,16,1,92,38.26432343,-109.4230212
21349,9,40,14,10,16,1,90,38.26432343,-109.4227517
21350,9,40,14,11,17,1,92,38.26432343,-109.4224822
21351,11,39,14,10,16,0,90,38.26432343,-109.4222127
21352,15,37,13,9,16,0,90,38.26432343,-109.4219432
21353,17,36,13,9,15,0,90,38.26432343,-109.4216737
21354,20,33,13,9,14,0,89,38.26432343,-109.4214042
21355,22,32,13,9,14,0,90,38.26432343,-109.4211347
21356,25,32,13,9,13,0,92,38.26432343,-109.4208652
21357,23,33,13,8,12,0,89,38.26432343,-109.4205957
21358,14,40,13,7,15,0,89,38.26432343,-109.4203262
21359,9,48,12,6,16,0,91,38.26432343,-109.4200568
21360,7,50,12,5,17,1,92,38.26432343,-109.4197873
21361,7,49,12,6,16,1,91,38.26432343,-109.4195178
21362,7,48,12,6,16,1,90,38.26432343,-109.4192483
21363,9,46,12,6,16,0,89,38.26432343,-109.4189788
21364,8,48,12,5,17,0,90,38.26432343,-109.4187093
21365,7,49,12,4,18,0,90,38.26432343,-109.4184398
21366,5,50,12,4,18,1,90,38.26432343,-109.4181703
21367,5,50,12,4,17,2,90,38.26432343,-109.4179008
21368,5,50,12,4,17,2,90,38.26432343,-109.4176313
21369,5,49,12,4,18,2,90,38.26432343,-109.4173618
21370,5,49,12,5,18,2,91,38.26432343,-109.4170923
21371,5,47,11,6,17,2,88,38.26432343,-109.4168228
21372,7,40,11,10,15,2,85,38.26432343,-109.4165533
21373,6,41,11,10,16,2,86,38.26432343,-109.4162838
21374,5,46,12,5,18,2,88,38.26432343,-109.4160143
21375,6,46,13,5,18,3,91,38.26432343,-109.4157448
21376,7,46,12,5,17,2,89,38.26432343,-109.4154753
21377,7,45,12,5,17,2,88,38.26432343,-109.4152058
21378,6,46,12,6,17,1,88,38.26432343,-109.4149364
21379,6,46,12,6,18,1,89,38.26432343,-109.4146669
21380,6,47,12,6,18,1,90,38.26432343,-109.4143974
21381,6,46,12,6,17,1,88,38.26432343,-109.4141279
21382,7,45,12,7,18,1,90,38.26432343,-109.4138584
21383,8,45,12,7,17,1,90,38.26432343,-109.4135889
21384,8,44,12,7,17,1,89,38.26432343,-109.4133194
21385,7,45,13,7,17,1,90,38.26432343,-109.4130499
21386,6,47,13,6,17,1,90,38.26432343,-109.4127804
21387,7,45,13,8,17,1,91,38.26432343,-109.4125109
21388,9,43,13,10,16,0,91,38.26432343,-109.4122414
21389,9,44,13,10,15,0,91,38.26432343,-109.4119719
21390,7,46,13,8,16,1,91,38.26432343,-109.4117024
21391,5,47,13,6,18,1,90,38.26432343,-109.4114329
21392,6,49,13,6,18,1,93,38.26432343,-109.4111634
21393,5,51,13,6,18,1,94,38.26432343,-109.4108939
21394,4,51,13,6,17,1,92,38.26432343,-109.4106244
21395,5,52,13,6,15,2,93,38.26432343,-109.4103549
21396,5,52,13,6,15,2,93,38.26432343,-109.4100855
21397,5,51,13,6,16,2,93,38.26432343,-109.409816
21398,5,51,13,6,16,2,93,38.26432343,-109.4095465
21399,5,49,13,7,17,1,92,38.26432343,-109.409277
21400,7,45,13,8,17,1,91,38.26432343,-109.4090075
21401,9,42,13,7,16,3,90,38.26432343,-109.408738
21402,7,39,12,5,14,6,83,38.26432343,-109.4084685
21403,5,41,12,6,16,4,84,38.26432343,-109.408199
21404,5,46,13,7,17,2,90,38.26432343,-109.4079295
21405,6,48,14,8,17,1,94,38.26432343,-109.40766
21406,5,49,13,7,18,1,93,38.26432343,-109.4073905
21407,4,54,12,6,15,1,92,38.26432343,-109.407121
21408,3,50,10,6,13,1,83,38.26432343,-109.4068515
21409,2,30,13,1,8,17,71,38.26432343,-109.3879869
21410,1,28,13,2,7,20,71,38.26432343,-109.3877174
21411,0,27,12,0,6,21,66,38.26432343,-109.3874479
21412,2,33,12,1,11,14,73,38.26432343,-109.3871784
21413,4,40,13,3,14,9,83,38.26432343,-109.3869089
21414,4,44,13,2,15,7,85,38.26432343,-109.3866394
21415,4,46,13,3,16,6,88,38.26432343,-109.3863699
21416,4,48,13,3,17,4,89,38.26432343,-109.3861004
21417,5,48,13,5,17,3,91,38.26432343,-109.3858309
21418,4,48,13,6,16,3,90,38.26432343,-109.3855614
21419,4,46,12,5,16,4,87,38.26432343,-109.3852919
21420,3,45,12,5,16,5,86,38.26432343,-109.3850225
21421,3,47,11,4,14,7,86,38.26432343,-109.384753
21422,2,50,10,3,13,6,84,38.26432343,-109.3844835
21423,1,52,8,3,12,6,82,38.26432343,-109.384214
21424,0,53,8,2,13,5,81,38.26432343,-109.3839445
21425,1,52,8,2,12,5,80,38.26432343,-109.383675
21426,1,44,8,2,11,7,73,38.26432343,-109.3834055
21427,2,36,9,3,9,8,67,38.26432343,-109.383136
21428,2,33,10,3,10,9,67,38.26432343,-109.3828665
21429,1,31,10,2,11,12,67,38.26432343,-109.382597
21430,2,35,13,0,12,17,79,38.26432343,-109.3823275
21431,2,36,13,0,11,16,78,38.26432343,-109.382058
21432,3,40,12,1,14,11,81,38.26432343,-109.3817885
21433,5,43,12,3,16,6,85,38.26432343,-109.381519
21434,5,43,12,6,17,3,86,38.26432343,-109.3812495
21435,11,34,13,11,14,2,85,38.26432343,-109.38098
21436,14,32,13,12,15,1,87,38.26432343,-109.3807105
21437,14,33,14,13,15,1,90,38.26432343,-109.380441
21438,12,34,14,13,15,1,89,38.26432343,-109.3801716
21439,11,34,14,14,15,1,89,38.26432343,-109.3799021
21440,17,32,14,14,14,0,91,38.26432343,-109.3796326
21441,19,31,13,15,14,0,92,38.26432343,-109.3793631
21442,21,30,13,14,14,0,92,38.26432343,-109.3790936
21443,22,29,13,15,14,0,93,38.26432343,-109.3788241
21444,21,28,12,15,13,0,89,38.26432343,-109.3785546
21445,13,30,12,11,14,1,81,38.26432343,-109.3782851
21446,9,30,11,10,13,2,75,38.26432343,-109.3780156
21447,8,25,11,13,15,1,73,38.26432343,-109.3777461
21448,12,19,11,16,14,1,73,38.26432343,-109.3774766
21449,13,15,11,20,13,1,73,38.26432343,-109.3772071
21450,16,17,11,17,13,0,74,38.26432343,-109.3769376
21451,17,21,13,12,13,1,77,38.26432343,-109.3766681
21452,14,28,13,14,14,2,85,38.26432343,-109.3763986
21453,17,27,13,15,13,1,86,38.26432343,-109.3761291
21454,25,23,13,13,11,0,85,38.26432343,-109.3758596
21455,26,22,14,12,10,0,84,38.26432343,-109.3755901
21456,25,26,13,11,10,0,85,38.26432343,-109.3753206
21457,19,32,12,12,12,0,87,38.26432343,-109.3750512
21458,19,34,13,10,14,0,90,38.26432343,-109.3747817
21459,20,32,13,10,12,1,88,38.26432343,-109.3745122
21460,19,34,12,9,12,1,87,38.26432343,-109.3742427
21461,17,35,12,9,13,1,87,38.26432343,-109.3739732
21462,15,34,12,9,13,2,85,38.26432343,-109.3737037
21463,17,35,12,10,11,2,87,38.26432343,-109.3734342
21464,16,36,12,8,12,2,86,38.26432343,-109.3731647
21465,12,37,12,6,12,3,82,38.26432343,-109.3728952
21466,7,38,11,4,11,6,77,38.26432343,-109.3726257
21467,4,31,11,5,7,11,69,38.26432343,-109.3723562
21468,2,18,14,7,5,18,64,38.26432343,-109.3720867
21469,7,12,17,7,6,23,72,38.26432343,-109.3718172
21470,4,14,18,5,8,29,78,38.26432343,-109.3715477
21471,3,20,17,2,3,29,74,38.26432343,-109.3712782
21472,3,25,14,0,3,24,69,38.26432343,-109.3710087
21473,3,26,13,0,5,20,67,38.26432343,-109.3707392
21474,4,29,13,0,6,18,70,38.26432343,-109.3704697
21475,6,32,13,1,7,17,76,38.26432343,-109.3702003
21476,9,33,14,4,8,13,81,38.26432343,-109.3699308
21477,12,34,14,8,9,7,84,38.26432343,-109.3696613
21478,14,34,14,7,9,7,85,38.26432343,-109.3693918
21479,15,32,14,7,9,8,85,38.26432343,-109.3691223
21480,17,30,14,8,8,7,84,38.26432343,-109.3688528
21481,17,29,14,8,7,9,84,38.26432343,-109.3685833
21482,18,30,14,7,8,8,85,38.26432343,-109.3683138
21483,20,29,13,9,8,6,85,38.26432343,-109.3680443
21484,19,28,14,10,9,6,86,38.26432343,-109.3677748
21485,14,30,15,7,10,12,88,38.26432343,-109.3675053
21486,8,31,15,1,8,18,81,38.26432343,-109.3672358
21487,9,34,14,5,10,11,83,38.26432343,-109.3669663
21488,5,32,13,7,10,12,79,38.26432343,-109.3666968
21489,3,31,13,6,11,14,78,38.26432343,-109.3664273
21490,1,29,12,4,14,10,70,38.26432343,-109.3661578
21491,0,22,10,7,14,9,62,38.26432343,-109.3658883
21492,2,26,10,6,19,4,67,38.26432343,-109.3656188
21493,5,26,10,2,7,9,59,38.26432343,-109.3653493
21494,2,30,8,3,9,6,58,38.26432343,-109.3650799
21495,3,30,7,3,9,5,57,38.26432343,-109.3648104
21496,3,35,8,3,8,5,62,38.26432343,-109.3645409
21497,2,36,9,3,8,7,65,38.26432343,-109.3642714
21498,2,34,10,3,8,11,68,38.26432343,-109.3640019
21499,3,33,12,1,7,15,71,38.26432343,-109.3637324
21500,4,34,12,1,9,14,74,38.26432343,-109.3634629
21501,3,33,12,1,9,14,72,38.26432343,-109.3631934
21502,3,29,12,3,6,13,66,38.26432343,-109.3629239
21503,6,29,14,5,6,9,69,38.26432343,-109.3626544
21504,12,28,17,11,8,3,79,38.26432343,-109.3623849
21505,6,21,14,9,10,16,76,38.26432343,-109.3621154
21506,3,16,13,6,6,22,66,38.26432343,-109.3618459
21507,2,16,15,3,3,26,65,38.26432343,-109.3615764
21508,3,21,15,0,3,26,68,38.26432343,-109.3613069
21509,4,24,16,1,4,26,75,38.26432343,-109.3610374
21510,4,26,16,1,5,25,77,38.26432343,-109.3607679
21511,5,27,16,1,6,24,79,38.26432343,-109.3604984
21512,5,27,16,1,6,24,79,38.26432343,-109.360229
21513,3,25,15,0,6,24,73,38.26432343,-109.3599595
21514,2,23,14,0,6,24,69,38.26432343,-109.35969
21515,3,24,14,0,4,24,69,38.26432343,-109.3594205
21516,3,22,15,1,2,25,68,38.26432343,-109.359151
21517,2,21,15,2,2,24,66,38.26432343,-109.3588815
21518,3,20,15,3,3,23,67,38.26432343,-109.358612
21519,1,22,11,0,5,17,56,38.26432343,-109.3583425
21520,11,18,8,1,8,1,47,38.26432343,-109.358073
21521,1,41,10,4,13,2,71,38.26432343,-109.3578035
21522,1,47,8,3,12,6,77,38.26432343,-109.357534
21523,1,44,8,2,10,8,73,38.26432343,-109.3572645
21524,1,43,9,1,8,10,72,38.26432343,-109.356995
21525,1,32,10,1,7,15,66,38.26432343,-109.3567255
21526,1,32,11,1,7,15,67,38.26432343,-109.356456
21527,3,34,12,1,9,12,71,38.26432343,-109.3561865
21528,1,34,10,1,10,11,67,38.26432343,-109.355917
21529,2,34,11,0,9,13,69,38.26432343,-109.3556475
21530,0,30,11,0,7,17,65,38.26432343,-109.355378
21531,0,28,11,0,7,17,63,38.26432343,-109.3551086
21532,1,33,10,1,9,12,66,38.26432343,-109.3548391
21533,2,34,11,6,7,6,66,38.26432343,-109.3545696
21534,2,32,9,6,7,6,62,38.26432343,-109.3543001
21535,1,35,9,5,6,8,64,38.26432343,-109.3540306
21536,1,31,10,3,6,12,63,38.26432343,-109.3537611
21537,3,37,12,0,9,14,75,38.26432343,-109.3534916
21538,0,36,11,0,8,17,72,38.26432343,-109.3532221
21539,1,30,13,1,10,15,70,38.26432343,-109.3529526
21540,2,28,15,4,3,19,71,38.26432343,-109.3526831
21541,1,22,14,0,5,24,66,38.26432343,-109.3524136
21542,2,31,14,1,5,21,74,38.26432343,-109.3521441
21543,1,33,12,0,10,15,71,38.26432343,-109.3518746
21544,2,35,13,3,7,16,76,38.26432343,-109.3516051
21545,2,32,14,2,7,17,74,38.26432343,-109.3513356
21546,2,29,13,2,6,19,71,38.26432343,-109.3510661
21547,2,26,13,1,8,16,66,38.26432343,-109.3507966
21548,0,28,12,1,10,14,65,38.26432343,-109.3505271
21549,2,31,11,3,13,9,69,38.26432343,-109.3502577
21550,0,32,8,0,13,8,61,38.26432343,-109.3499882
21551,1,26,9,1,8,13,58,38.26432343,-109.3497187
21552,4,27,10,8,11,8,68,38.26432343,-109.3494492
21553,1,23,11,4,12,12,63,38.26432343,-109.3491797
21554,2,23,11,6,11,10,63,38.26432343,-109.3489102
21555,6,25,11,11,8,8,69,38.26432343,-109.3486407
21556,4,20,10,9,10,8,61,38.26432343,-109.3483712
21557,2,19,11,6,13,9,60,38.26432343,-109.3481017
21558,3,20,13,3,9,16,64,38.26432343,-109.3478322
21559,3,16,15,2,3,26,65,38.26432343,-109.3475627
21560,2,15,17,1,3,30,68,38.26432343,-109.3472932
21561,2,18,18,0,1,31,70,38.26432343,-109.3470237
21562,1,20,17,0,1,29,68,38.26432343,-109.3467542
21563,1,20,17,0,1,29,68,38.26432343,-109.3464847
21564,1,20,18,0,1,30,70,38.26432343,-109.3462152
21565,0,19,17,0,1,31,68,38.26432343,-109.3459457
21566,0,20,18,0,1,31,70,38.26432343,-109.3456762
21567,1,21,18,0,3,32,75,38.26432343,-109.3454068
21568,1,24,19,0,6,33,83,38.26432343,-109.3451373
21569,1,25,20,0,8,32,86,38.26432343,-109.3448678
21570,2,27,18,2,10,28,87,38.26432343,-109.3445983
21571,5,30,16,6,12,18,87,38.26432343,-109.3443288
21572,9,33,15,10,12,10,89,38.26432343,-109.3440593
21573,14,34,14,12,11,6,91,38.26432343,-109.3437898
21574,17,34,14,14,9,4,92,38.26432343,-109.3435203
21575,16,33,14,15,10,4,92,38.26432343,-109.3432508
21576,13,32,13,15,12,5,90,38.26432343,-109.3429813
21577,10,33,13,15,13,5,89,38.26432343,-109.3427118
21578,10,34,13,17,12,4,90,38.26432343,-109.3424423
21579,13,33,13,17,10,3,89,38.26432343,-109.3421728
21580,13,32,13,17,9,4,88,38.26432343,-109.3419033
21581,11,33,14,14,11,5,88,38.26432343,-109.3416338
21582,10,34,14,12,12,6,88,38.26432343,-109.3413643
21583,9,35,14,13,13,6,90,38.26432343,-109.3410948
21584,9,35,14,12,13,5,88,38.26432343,-109.3408253
21585,9,36,14,12,13,6,90,38.26432343,-109.3405558
21586,9,35,14,12,13,7,90,38.26432343,-109.3402864
21587,8,36,14,12,12,7,89,38.26432343,-109.3400169
21588,7,38,14,11,12,7,89,38.26432343,-109.3397474
21589,8,39,15,13,10,6,91,38.26432343,-109.3394779
21590,8,40,14,12,10,6,90,38.26432343,-109.3392084
21591,7,41,14,12,10,7,91,38.26432343,-109.3389389
21592,6,39,14,13,10,7,89,38.26432343,-109.3386694
21593,7,36,14,11,11,8,87,38.26432343,-109.3383999
21594,9,35,14,14,11,7,90,38.26432343,-109.3381304
21595,8,36,14,11,12,8,89,38.26432343,-109.3378609
21596,8,35,14,9,11,11,88,38.26432343,-109.3375914
21597,8,34,14,7,9,15,87,38.26432343,-109.3373219
21598,7,33,15,4,9,19,87,38.26432343,-109.3370524
21599,5,33,15,5,10,18,86,38.26432343,-109.3367829
21600,4,30,14,3,8,19,78,38.26432343,-109.3365134
21601,3,29,14,4,9,17,76,38.26432343,-109.3362439
21602,6,31,14,7,11,12,81,38.26432343,-109.3359744
21603,7,29,15,11,13,10,85,38.26432343,-109.3357049
21604,7,28,15,12,14,10,86,38.26432343,-109.3354355
21605,7,29,15,13,15,9,88,38.26432343,-109.335166
21606,7,30,15,12,15,8,87,38.26432343,-109.3348965
21607,3,37,10,3,10,8,71,38.26405393742047,-109.4416163
21608,3,37,10,2,12,7,71,38.26405393742047,-109.4413468
21609,2,37,10,1,12,9,71,38.26405393742047,-109.4410773
21610,2,41,10,1,12,9,75,38.26405393742047,-109.4408078
21611,2,42,9,1,13,6,73,38.26405393742047,-109.4405383
21612,2,38,8,3,10,6,67,38.26405393742047,-109.4402688
21613,3,40,8,3,11,5,70,38.26405393742047,-109.4399993
21614,2,41,9,3,12,5,72,38.26405393742047,-109.4397299
21615,3,45,10,4,13,6,81,38.26405393742047,-109.4394604
21616,4,49,11,4,13,5,86,38.26405393742047,-109.4391909
21617,3,49,11,2,13,7,85,38.26405393742047,-109.4389214
21618,2,43,10,0,11,12,78,38.26405393742047,-109.4386519
21619,1,36,10,0,9,15,71,38.26405393742047,-109.4383824
21620,0,32,10,0,8,15,65,38.26405393742047,-109.4381129
21621,1,37,9,0,7,12,66,38.26405393742047,-109.4378434
21622,0,38,9,1,8,9,65,38.26405393742047,-109.4375739
21623,0,44,8,0,12,7,71,38.26405393742047,-109.4373044
21624,1,50,8,0,14,4,77,38.26405393742047,-109.4370349
21625,0,42,7,0,16,4,69,38.26405393742047,-109.4367654
21626,1,35,9,1,12,8,66,38.26405393742047,-109.4364959
21627,2,44,9,0,13,8,76,38.26405393742047,-109.4362264
21628,2,48,10,1,14,6,81,38.26405393742047,-109.4359569
21629,2,47,10,2,14,5,80,38.26405393742047,-109.4356874
21630,2,44,9,3,13,6,77,38.26405393742047,-109.4354179
21631,3,44,9,4,13,5,78,38.26405393742047,-109.4351484
21632,4,44,9,4,13,4,78,38.26405393742047,-109.434879
21633,4,39,10,2,12,7,74,38.26405393742047,-109.4346095
21634,3,38,10,1,11,9,72,38.26405393742047,-109.43434
21635,4,44,10,0,13,8,79,38.26405393742047,-109.4340705
21636,2,36,11,2,13,10,74,38.26405393742047,-109.433801
21637,4,41,11,2,14,7,79,38.26405393742047,-109.4335315
21638,5,35,11,4,13,6,74,38.26405393742047,-109.433262
21639,8,29,12,10,13,4,76,38.26405393742047,-109.4329925
21640,19,26,13,11,13,2,84,38.26405393742047,-109.432723
21641,17,25,13,13,13,1,82,38.26405393742047,-109.4324535
21642,18,25,13,13,13,1,83,38.26405393742047,-109.432184
21643,19,26,13,12,13,1,84,38.26405393742047,-109.4319145
21644,18,27,14,12,13,1,85,38.26405393742047,-109.431645
21645,16,29,14,12,13,1,85,38.26405393742047,-109.4313755
21646,14,30,14,13,13,1,85,38.26405393742047,-109.431106
21647,15,31,14,13,13,1,87,38.26405393742047,-109.4308365
21648,16,31,14,12,13,0,86,38.26405393742047,-109.430567
21649,14,32,14,12,13,1,86,38.26405393742047,-109.4302975
21650,16,31,15,12,12,1,87,38.26405393742047,-109.430028
21651,19,30,15,12,11,1,88,38.26405393742047,-109.4297586
21652,22,30,15,11,10,1,89,38.26405393742047,-109.4294891
21653,23,30,15,11,10,1,90,38.26405393742047,-109.4292196
21654,22,30,15,12,11,1,91,38.26405393742047,-109.4289501
21655,21,28,14,12,13,0,88,38.26405393742047,-109.4286806
21656,24,26,13,12,12,0,87,38.26405393742047,-109.4284111
21657,25,25,13,11,12,0,86,38.26405393742047,-109.4281416
21658,25,26,13,11,12,1,88,38.26405393742047,-109.4278721
21659,22,29,14,11,12,1,89,38.26405393742047,-109.4276026
21660,21,31,14,10,13,1,90,38.26405393742047,-109.4273331
21661,17,32,14,11,14,1,89,38.26405393742047,-109.4270636
21662,16,33,13,11,14,1,88,38.26405393742047,-109.4267941
21663,17,32,13,11,13,1,87,38.26405393742047,-109.4265246
21664,17,34,14,12,14,1,92,38.26405393742047,-109.4262551
21665,14,36,14,12,14,1,91,38.26405393742047,-109.4259856
21666,15,35,14,12,14,1,91,38.26405393742047,-109.4257161
21667,19,33,14,11,13,0,90,38.26405393742047,-109.4254466
21668,22,32,14,11,12,0,91,38.26405393742047,-109.4251771
21669,23,32,14,10,12,0,91,38.26405393742047,-109.4249077
21670,20,34,14,10,13,0,91,38.26405393742047,-109.4246382
21671,19,34,14,10,13,1,91,38.26405393742047,-109.4243687
21672,21,33,14,10,13,1,92,38.26405393742047,-109.4240992
21673,18,35,14,10,14,0,91,38.26405393742047,-109.4238297
21674,16,37,14,10,14,0,91,38.26405393742047,-109.4235602
21675,14,38,14,10,15,0,91,38.26405393742047,-109.4232907
21676,12,39,14,11,16,0,92,38.26405393742047,-109.4230212
21677,11,39,14,11,16,0,91,38.26405393742047,-109.4227517
21678,8,41,14,10,17,1,91,38.26405393742047,-109.4224822
21679,8,41,14,9,17,1,90,38.26405393742047,-109.4222127
21680,9,41,13,9,17,1,90,38.26405393742047,-109.4219432
21681,10,39,14,10,17,0,90,38.26405393742047,-109.4216737
21682,15,36,14,10,15,0,90,38.26405393742047,-109.4214042
21683,15,36,14,11,15,0,91,38.26405393742047,-109.4211347
21684,14,38,13,9,16,0,90,38.26405393742047,-109.4208652
21685,12,43,13,7,16,0,91,38.26405393742047,-109.4205957
21686,8,46,13,6,17,1,91,38.26405393742047,-109.4203262
21687,7,49,12,5,16,1,90,38.26405393742047,-109.4200568
21688,6,49,12,5,16,1,89,38.26405393742047,-109.4197873
21689,7,48,12,6,15,2,90,38.26405393742047,-109.4195178
21690,7,47,12,6,15,1,88,38.26405393742047,-109.4192483
21691,6,48,12,5,16,1,88,38.26405393742047,-109.4189788
21692,7,49,12,4,16,1,89,38.26405393742047,-109.4187093
21693,6,48,12,5,18,1,90,38.26405393742047,-109.4184398
21694,5,49,12,4,18,1,89,38.26405393742047,-109.4181703
21695,5,50,12,4,17,2,90,38.26405393742047,-109.4179008
21696,4,51,12,4,17,2,90,38.26405393742047,-109.4176313
21697,4,50,12,4,17,3,90,38.26405393742047,-109.4173618
21698,5,51,12,6,16,3,93,38.26405393742047,-109.4170923
21699,11,42,11,11,14,2,91,38.26405393742047,-109.4168228
21700,21,33,12,11,12,1,90,38.26405393742047,-109.4165533
21701,26,20,13,13,15,2,89,38.26405393742047,-109.4162838
21702,20,30,14,11,12,4,91,38.26405393742047,-109.4160143
21703,13,39,14,7,16,2,91,38.26405393742047,-109.4157448
21704,7,45,13,4,18,3,90,38.26405393742047,-109.4154753
21705,5,46,12,4,19,3,89,38.26405393742047,-109.4152058
21706,6,46,12,5,18,2,89,38.26405393742047,-109.4149364
21707,5,47,12,5,18,2,89,38.26405393742047,-109.4146669
21708,5,47,12,4,18,2,88,38.26405393742047,-109.4143974
21709,5,47,12,5,18,2,89,38.26405393742047,-109.4141279
21710,5,46,12,5,18,2,88,38.26405393742047,-109.4138584
21711,6,46,12,6,17,2,89,38.26405393742047,-109.4135889
21712,5,46,12,6,17,2,88,38.26405393742047,-109.4133194
21713,6,46,12,6,18,1,89,38.26405393742047,-109.4130499
21714,7,46,12,6,17,1,89,38.26405393742047,-109.4127804
21715,7,45,12,7,17,1,89,38.26405393742047,-109.4125109
21716,7,44,13,8,17,1,90,38.26405393742047,-109.4122414
21717,7,45,13,7,17,1,90,38.26405393742047,-109.4119719
21718,7,46,13,7,16,1,90,38.26405393742047,-109.4117024
21719,6,47,13,7,17,1,91,38.26405393742047,-109.4114329
21720,8,46,13,8,16,0,91,38.26405393742047,-109.4111634
21721,7,49,13,9,15,0,93,38.26405393742047,-109.4108939
21722,5,52,13,7,17,1,95,38.26405393742047,-109.4106244
21723,5,53,13,5,15,3,94,38.26405393742047,-109.4103549
21724,5,51,13,6,16,2,93,38.26405393742047,-109.4100855
21725,5,50,14,7,16,2,94,38.26405393742047,-109.409816
21726,5,50,13,7,16,1,92,38.26405393742047,-109.4095465
21727,5,49,13,7,17,1,92,38.26405393742047,-109.409277
21728,7,47,13,7,17,1,92,38.26405393742047,-109.4090075
21729,7,44,13,6,17,2,89,38.26405393742047,-109.408738
21730,4,43,12,4,16,4,83,38.26405393742047,-109.4084685
21731,3,47,11,4,17,3,85,38.26405393742047,-109.408199
21732,5,50,12,6,17,1,91,38.26405393742047,-109.4079295
21733,7,48,14,9,17,0,95,38.26405393742047,-109.40766
21734,7,48,14,8,16,1,94,38.26405393742047,-109.4073905
21735,4,52,11,8,12,1,88,38.26405393742047,-109.407121
21736,3,48,9,5,11,2,78,38.26405393742047,-109.4068515
21737,2,29,13,2,8,18,72,38.26405393742047,-109.3879869
21738,1,27,14,1,8,22,73,38.26405393742047,-109.3877174
21739,1,30,13,1,10,18,73,38.26405393742047,-109.3874479
21740,3,37,13,4,15,9,81,38.26405393742047,-109.3871784
21741,4,44,13,5,18,4,88,38.26405393742047,-109.3869089
21742,4,45,13,6,19,2,89,38.26405393742047,-109.3866394
21743,4,47,13,5,18,2,89,38.26405393742047,-109.3863699
21744,4,48,13,4,18,3,90,38.26405393742047,-109.3861004
21745,5,49,13,6,17,2,92,38.26405393742047,-109.3858309
21746,4,49,12,4,15,4,88,38.26405393742047,-109.3855614
21747,3,46,10,2,14,6,81,38.26405393742047,-109.3852919
21748,2,45,11,3,15,6,82,38.26405393742047,-109.3850225
21749,2,50,10,2,14,6,84,38.26405393742047,-109.384753
21750,1,54,8,2,13,5,83,38.26405393742047,-109.3844835
21751,0,55,7,0,13,5,80,38.26405393742047,-109.384214
21752,0,54,7,1,12,4,78,38.26405393742047,-109.3839445
21753,1,53,7,4,11,3,79,38.26405393742047,-109.383675
21754,1,43,8,1,11,6,70,38.26405393742047,-109.3834055
21755,2,38,10,4,11,6,71,38.26405393742047,-109.383136
21756,2,36,10,3,11,9,71,38.26405393742047,-109.3828665
21757,1,29,11,1,10,14,66,38.26405393742047,-109.382597
21758,2,32,13,1,11,16,75,38.26405393742047,-109.3823275
21759,2,34,12,0,10,16,74,38.26405393742047,-109.382058
21760,3,37,12,2,13,11,78,38.26405393742047,-109.3817885
21761,5,43,13,6,16,3,86,38.26405393742047,-109.381519
21762,5,44,13,8,17,2,89,38.26405393742047,-109.3812495
21763,10,37,13,12,17,0,89,38.26405393742047,-109.38098
21764,12,37,13,13,16,0,91,38.26405393742047,-109.3807105
21765,11,38,14,12,17,0,92,38.26405393742047,-109.380441
21766,7,40,13,10,18,1,89,38.26405393742047,-109.3801716
21767,8,37,14,12,17,1,89,38.26405393742047,-109.3799021
21768,17,32,14,14,14,0,91,38.26405393742047,-109.3796326
21769,19,29,13,15,14,0,90,38.26405393742047,-109.3793631
21770,22,28,13,13,13,0,89,38.26405393742047,-109.3790936
21771,22,29,13,12,14,0,90,38.26405393742047,-109.3788241
21772,17,33,13,10,15,0,88,38.26405393742047,-109.3785546
21773,10,40,12,8,17,0,87,38.26405393742047,-109.3782851
21774,8,40,12,8,16,1,85,38.26405393742047,-109.3780156
21775,8,33,13,10,15,1,80,38.26405393742047,-109.3777461
21776,6,23,10,14,15,2,70,38.26405393742047,-109.3774766
21777,9,21,9,13,15,1,68,38.26405393742047,-109.3772071
21778,12,22,10,13,14,0,71,38.26405393742047,-109.3769376
21779,14,22,11,13,13,0,73,38.26405393742047,-109.3766681
21780,17,24,12,12,13,1,79,38.26405393742047,-109.3763986
21781,18,25,12,12,12,1,80,38.26405393742047,-109.3761291
21782,15,25,12,11,12,1,76,38.26405393742047,-109.3758596
21783,21,28,13,9,11,1,83,38.26405393742047,-109.3755901
21784,22,31,12,10,12,0,87,38.26405393742047,-109.3753206
21785,21,32,13,11,12,0,89,38.26405393742047,-109.3750512
21786,20,33,13,9,14,0,89,38.26405393742047,-109.3747817
21787,23,30,13,10,13,0,89,38.26405393742047,-109.3745122
21788,22,29,13,11,13,0,88,38.26405393742047,-109.3742427
21789,20,30,13,11,13,1,88,38.26405393742047,-109.3739732
21790,19,33,13,10,12,1,88,38.26405393742047,-109.3737037
21791,16,35,13,10,11,2,87,38.26405393742047,-109.3734342
21792,17,37,13,9,11,1,88,38.26405393742047,-109.3731647
21793,9,39,12,7,12,4,83,38.26405393742047,-109.3728952
21794,4,35,12,5,10,9,75,38.26405393742047,-109.3726257
21795,3,24,13,8,6,15,69,38.26405393742047,-109.3723562
21796,16,12,16,7,8,20,79,38.26405393742047,-109.3720867
21797,10,13,18,5,10,29,85,38.26405393742047,-109.3718172
21798,5,17,20,3,7,30,82,38.26405393742047,-109.3715477
21799,3,23,17,2,4,28,77,38.26405393742047,-109.3712782
21800,3,27,15,0,3,25,73,38.26405393742047,-109.3710087
21801,2,26,14,0,4,23,69,38.26405393742047,-109.3707392
21802,5,28,13,2,6,17,71,38.26405393742047,-109.3704697
21803,11,33,13,5,9,9,80,38.26405393742047,-109.3702003
21804,11,34,13,7,9,7,81,38.26405393742047,-109.3699308
21805,13,34,13,9,10,5,84,38.26405393742047,-109.3696613
21806,15,33,14,7,9,6,84,38.26405393742047,-109.3693918
21807,16,31,14,7,8,8,84,38.26405393742047,-109.3691223
21808,18,29,15,7,8,9,86,38.26405393742047,-109.3688528
21809,18,28,15,7,8,10,86,38.26405393742047,-109.3685833
21810,18,30,14,8,8,8,86,38.26405393742047,-109.3683138
21811,19,28,14,9,9,6,85,38.26405393742047,-109.3680443
21812,20,27,14,9,8,7,85,38.26405393742047,-109.3677748
21813,17,29,15,6,8,11,86,38.26405393742047,-109.3675053
21814,8,29,14,2,6,18,77,38.26405393742047,-109.3672358
21815,7,38,13,4,9,10,81,38.26405393742047,-109.3669663
21816,4,40,10,1,10,9,74,38.26405393742047,-109.3666968
21817,2,32,9,1,7,10,61,38.26405393742047,-109.3664273
21818,1,22,9,4,7,9,52,38.26405393742047,-109.3661578
21819,1,19,9,5,9,10,53,38.26405393742047,-109.3658883
21820,4,21,10,6,9,6,56,38.26405393742047,-109.3656188
21821,5,32,7,3,7,6,60,38.26405393742047,-109.3653493
21822,2,29,7,2,8,6,54,38.26405393742047,-109.3650799
21823,2,28,8,3,8,7,56,38.26405393742047,-109.3648104
21824,4,29,9,3,7,8,60,38.26405393742047,-109.3645409
21825,3,29,11,4,7,11,65,38.26405393742047,-109.3642714
21826,3,27,13,2,5,17,67,38.26405393742047,-109.3640019
21827,3,28,14,0,6,19,70,38.26405393742047,-109.3637324
21828,4,32,14,2,7,16,75,38.26405393742047,-109.3634629
21829,3,32,13,1,8,16,73,38.26405393742047,-109.3631934
21830,1,26,13,3,6,15,64,38.26405393742047,-109.3629239
21831,3,23,13,3,5,14,61,38.26405393742047,-109.3626544
21832,4,26,14,5,7,12,68,38.26405393742047,-109.3623849
21833,5,25,13,10,16,10,79,38.26405393742047,-109.3621154
21834,3,22,14,7,9,20,75,38.26405393742047,-109.3618459
21835,2,22,15,2,5,25,71,38.26405393742047,-109.3615764
21836,4,26,15,0,4,25,74,38.26405393742047,-109.3613069
21837,5,27,16,2,5,24,79,38.26405393742047,-109.3610374
21838,3,26,15,0,4,25,73,38.26405393742047,-109.3607679
21839,3,25,15,0,3,25,71,38.26405393742047,-109.3604984
21840,3,25,14,0,3,23,68,38.26405393742047,-109.360229
21841,2,25,12,0,4,20,63,38.26405393742047,-109.3599595
21842,2,28,11,2,8,14,65,38.26405393742047,-109.35969
21843,2,29,11,1,7,15,65,38.26405393742047,-109.3594205
21844,2,29,11,1,6,16,65,38.26405393742047,-109.359151
21845,2,30,11,1,5,17,66,38.26405393742047,-109.3588815
21846,1,31,10,1,6,15,64,38.26405393742047,-109.358612
21847,1,30,10,2,9,11,63,38.26405393742047,-109.3583425
21848,0,38,8,3,10,8,67,38.26405393742047,-109.358073
21849,0,42,8,3,10,8,71,38.26405393742047,-109.3578035
21850,1,47,9,3,9,8,77,38.26405393742047,-109.357534
21851,2,40,10,3,9,9,73,38.26405393742047,-109.3572645
21852,2,34,11,0,7,17,71,38.26405393742047,-109.356995
21853,1,33,11,0,7,16,68,38.26405393742047,-109.3567255
21854,2,37,10,0,9,13,71,38.26405393742047,-109.356456
21855,2,40,10,0,11,11,74,38.26405393742047,-109.3561865
21856,1,33,10,1,9,14,68,38.26405393742047,-109.355917
21857,0,27,12,1,8,16,64,38.26405393742047,-109.3556475
21858,0,30,11,1,9,16,67,38.26405393742047,-109.355378
21859,0,30,11,0,8,17,66,38.26405393742047,-109.3551086
21860,0,29,11,2,6,15,63,38.26405393742047,-109.3548391
21861,1,38,12,0,5,12,68,38.26405393742047,-109.3545696
21862,6,32,13,7,7,11,76,38.26405393742047,-109.3543001
21863,2,36,12,3,7,11,71,38.26405393742047,-109.3540306
21864,5,30,12,8,6,13,74,38.26405393742047,-109.3537611
21865,2,37,12,3,6,17,77,38.26405393742047,-109.3534916
21866,1,37,13,0,9,16,76,38.26405393742047,-109.3532221
21867,3,33,14,3,7,15,75,38.26405393742047,-109.3529526
21868,3,34,14,2,6,15,74,38.26405393742047,-109.3526831
21869,2,39,12,2,6,16,77,38.26405393742047,-109.3524136
21870,3,35,13,1,5,20,77,38.26405393742047,-109.3521441
21871,1,34,11,0,9,16,71,38.26405393742047,-109.3518746
21872,1,35,11,0,10,14,71,38.26405393742047,-109.3516051
21873,1,32,11,0,11,15,70,38.26405393742047,-109.3513356
21874,2,27,13,3,10,16,71,38.26405393742047,-109.3510661
21875,3,31,11,4,12,12,73,38.26405393742047,-109.3507966
21876,4,32,13,11,5,14,79,38.26405393742047,-109.3505271
21877,3,30,11,6,12,10,72,38.26405393742047,-109.3502577
21878,5,29,11,10,10,7,72,38.26405393742047,-109.3499882
21879,7,23,12,10,13,9,74,38.26405393742047,-109.3497187
21880,3,32,11,3,8,16,73,38.26405393742047,-109.3494492
21881,0,25,11,5,15,12,68,38.26405393742047,-109.3491797
21882,0,28,10,8,19,7,72,38.26405393742047,-109.3489102
21883,2,27,11,9,21,2,72,38.26405393742047,-109.3486407
21884,2,20,11,7,21,3,64,38.26405393742047,-109.3483712
21885,1,20,12,5,19,7,64,38.26405393742047,-109.3481017
21886,1,25,15,0,9,19,69,38.26405393742047,-109.3478322
21887,2,23,17,1,5,28,76,38.26405393742047,-109.3475627
21888,0,21,18,0,3,32,74,38.26405393742047,-109.3472932
21889,1,21,18,0,3,32,75,38.26405393742047,-109.3470237
21890,1,20,17,0,2,30,70,38.26405393742047,-109.3467542
21891,1,21,17,0,2,30,71,38.26405393742047,-109.3464847
21892,0,20,17,0,2,31,70,38.26405393742047,-109.3462152
21893,0,20,17,0,2,31,70,38.26405393742047,-109.3459457
21894,0,23,18,0,3,30,74,38.26405393742047,-109.3456762
21895,1,24,18,0,5,32,80,38.26405393742047,-109.3454068
21896,2,26,18,0,6,31,83,38.26405393742047,-109.3451373
21897,3,28,18,1,8,28,86,38.26405393742047,-109.3448678
21898,5,30,17,4,10,21,87,38.26405393742047,-109.3445983
21899,9,34,15,8,13,10,89,38.26405393742047,-109.3443288
21900,11,35,14,12,14,5,91,38.26405393742047,-109.3440593
21901,15,34,14,14,11,4,92,38.26405393742047,-109.3437898
21902,17,30,13,16,10,4,90,38.26405393742047,-109.3435203
21903,15,27,12,21,11,3,89,38.26405393742047,-109.3432508
21904,13,31,13,18,11,4,90,38.26405393742047,-109.3429813
21905,11,33,13,14,12,5,88,38.26405393742047,-109.3427118
21906,10,34,13,13,13,5,88,38.26405393742047,-109.3424423
21907,10,33,13,15,10,5,86,38.26405393742047,-109.3421728
21908,10,32,13,16,10,6,87,38.26405393742047,-109.3419033
21909,11,32,13,17,10,5,88,38.26405393742047,-109.3416338
21910,11,34,14,14,12,5,90,38.26405393742047,-109.3413643
21911,10,35,14,14,12,4,89,38.26405393742047,-109.3410948
21912,9,35,14,13,11,5,87,38.26405393742047,-109.3408253
21913,9,37,14,11,12,6,89,38.26405393742047,-109.3405558
21914,10,36,14,13,10,5,88,38.26405393742047,-109.3402864
21915,11,36,14,13,10,5,89,38.26405393742047,-109.3400169
21916,9,38,14,11,11,7,90,38.26405393742047,-109.3397474
21917,8,40,14,11,12,6,91,38.26405393742047,-109.3394779
21918,7,42,14,11,12,5,91,38.26405393742047,-109.3392084
21919,8,39,14,13,10,7,91,38.26405393742047,-109.3389389
21920,9,37,14,14,9,7,90,38.26405393742047,-109.3386694
21921,9,34,14,11,10,10,88,38.26405393742047,-109.3383999
21922,9,34,14,11,11,10,89,38.26405393742047,-109.3381304
21923,8,34,14,10,11,11,88,38.26405393742047,-109.3378609
21924,7,34,14,7,12,13,87,38.26405393742047,-109.3375914
21925,5,29,15,4,11,18,82,38.26405393742047,-109.3373219
21926,3,24,17,4,7,22,77,38.26405393742047,-109.3370524
21927,4,24,16,5,6,20,75,38.26405393742047,-109.3367829
21928,2,20,15,2,4,23,66,38.26405393742047,-109.3365134
21929,2,19,14,1,3,23,62,38.26405393742047,-109.3362439
21930,2,20,14,2,3,22,63,38.26405393742047,-109.3359744
21931,2,17,15,3,4,22,63,38.26405393742047,-109.3357049
21932,3,20,16,3,5,24,71,38.26405393742047,-109.3354355
21933,3,25,17,3,8,23,79,38.26405393742047,-109.335166
21934,4,29,16,5,10,19,83,38.26405393742047,-109.3348965
21935,2,39,9,3,9,7,69,38.26378444283523,-109.4418858
21936,2,39,9,2,9,8,69,38.26378444283523,-109.4416163
21937,2,35,9,3,10,7,66,38.26378444283523,-109.4413468
21938,2,31,9,3,9,9,63,38.26378444283523,-109.4410773
21939,2,32,8,3,8,8,61,38.26378444283523,-109.4408078
21940,1,34,8,2,9,6,60,38.26378444283523,-109.4405383
21941,1,37,7,2,9,5,61,38.26378444283523,-109.4402688
21942,3,36,7,3,9,4,62,38.26378444283523,-109.4399993
21943,2,36,8,3,10,6,65,38.26378444283523,-109.4397299
21944,2,39,10,2,11,10,74,38.26378444283523,-109.4394604
21945,2,47,11,2,13,9,84,38.26378444283523,-109.4391909
21946,2,49,10,3,12,9,85,38.26378444283523,-109.4389214
21947,2,43,10,0,10,14,79,38.26378444283523,-109.4386519
21948,1,35,9,0,7,17,69,38.26378444283523,-109.4383824
21949,0,33,9,0,8,13,63,38.26378444283523,-109.4381129
21950,2,37,9,3,8,7,66,38.26378444283523,-109.4378434
21951,2,36,8,4,9,6,65,38.26378444283523,-109.4375739
21952,0,41,8,1,11,7,68,38.26378444283523,-109.4373044
21953,0,53,7,0,13,4,77,38.26378444283523,-109.4370349
21954,0,60,7,0,14,2,83,38.26378444283523,-109.4367654
21955,0,61,7,0,14,3,85,38.26378444283523,-109.4364959
21956,0,53,7,0,15,5,80,38.26378444283523,-109.4362264
21957,1,46,8,0,13,7,75,38.26378444283523,-109.4359569
21958,1,45,8,1,13,7,75,38.26378444283523,-109.4356874
21959,1,45,9,1,13,7,76,38.26378444283523,-109.4354179
21960,2,44,9,3,13,5,76,38.26378444283523,-109.4351484
21961,3,44,9,4,13,4,77,38.26378444283523,-109.434879
21962,3,43,10,4,14,4,78,38.26378444283523,-109.4346095
21963,3,41,10,3,14,5,76,38.26378444283523,-109.43434
21964,4,41,11,3,15,5,79,38.26378444283523,-109.4340705
21965,2,37,10,1,12,11,73,38.26378444283523,-109.433801
21966,4,41,11,2,13,7,78,38.26378444283523,-109.4335315
21967,6,38,11,5,14,5,79,38.26378444283523,-109.433262
21968,10,33,12,9,13,3,80,38.26378444283523,-109.4329925
21969,18,29,13,12,13,1,86,38.26378444283523,-109.432723
21970,18,28,13,13,13,1,86,38.26378444283523,-109.4324535
21971,18,29,13,12,13,0,85,38.26378444283523,-109.432184
21972,17,30,14,12,14,0,87,38.26378444283523,-109.4319145
21973,13,30,14,13,14,1,85,38.26378444283523,-109.431645
21974,10,31,15,13,14,1,84,38.26378444283523,-109.4313755
21975,10,31,15,14,14,1,85,38.26378444283523,-109.431106
21976,15,32,15,13,13,1,89,38.26378444283523,-109.4308365
21977,20,32,14,11,13,0,90,38.26378444283523,-109.430567
21978,19,32,14,11,13,0,89,38.26378444283523,-109.4302975
21979,15,33,15,12,13,0,88,38.26378444283523,-109.430028
21980,13,32,15,14,13,1,88,38.26378444283523,-109.4297586
21981,14,32,15,13,13,1,88,38.26378444283523,-109.4294891
21982,13,32,15,13,13,1,87,38.26378444283523,-109.4292196
21983,14,32,15,12,13,1,87,38.26378444283523,-109.4289501
21984,18,31,14,12,13,0,88,38.26378444283523,-109.4286806
21985,22,30,14,12,13,0,91,38.26378444283523,-109.4284111
21986,24,29,14,12,13,0,92,38.26378444283523,-109.4281416
21987,25,29,14,11,12,0,91,38.26378444283523,-109.4278721
21988,18,30,14,12,12,1,87,38.26378444283523,-109.4276026
21989,19,32,15,11,12,1,90,38.26378444283523,-109.4273331
21990,16,33,14,12,13,1,89,38.26378444283523,-109.4270636
21991,14,36,14,11,13,0,88,38.26378444283523,-109.4267941
21992,14,36,14,11,13,0,88,38.26378444283523,-109.4265246
21993,12,37,14,11,14,1,89,38.26378444283523,-109.4262551
21994,11,37,14,12,14,1,89,38.26378444283523,-109.4259856
21995,11,36,14,12,14,1,88,38.26378444283523,-109.4257161
21996,13,34,14,12,14,1,88,38.26378444283523,-109.4254466
21997,16,33,13,11,14,0,87,38.26378444283523,-109.4251771
21998,17,33,13,11,13,0,87,38.26378444283523,-109.4249077
21999,14,34,13,10,14,1,86,38.26378444283523,-109.4246382
22000,14,34,13,10,14,1,86,38.26378444283523,-109.4243687
22001,16,34,14,10,14,1,89,38.26378444283523,-109.4240992
22002,17,33,14,11,14,1,90,38.26378444283523,-109.4238297
22003,18,33,14,10,14,0,89,38.26378444283523,-109.4235602
22004,22,32,14,9,14,0,91,38.26378444283523,-109.4232907
22005,22,31,13,9,14,0,89,38.26378444283523,-109.4230212
22006,20,33,13,10,14,0,90,38.26378444283523,-109.4227517
22007,12,39,14,11,16,0,92,38.26378444283523,-109.4224822
22008,8,43,14,9,18,1,93,38.26378444283523,-109.4222127
22009,8,44,13,8,17,1,91,38.26378444283523,-109.4219432
22010,10,42,13,9,17,0,91,38.26378444283523,-109.4216737
22011,13,39,13,10,16,0,91,38.26378444283523,-109.4214042
22012,13,39,13,10,16,0,91,38.26378444283523,-109.4211347
22013,9,44,13,8,17,0,91,38.26378444283523,-109.4208652
22014,7,49,12,6,17,1,92,38.26378444283523,-109.4205957
22015,5,51,12,5,17,1,91,38.26378444283523,-109.4203262
22016,5,50,12,6,17,1,91,38.26378444283523,-109.4200568
22017,5,48,12,6,17,2,90,38.26378444283523,-109.4197873
22018,6,48,13,7,16,2,92,38.26378444283523,-109.4195178
22019,7,47,13,7,15,2,91,38.26378444283523,-109.4192483
22020,6,48,13,5,15,2,89,38.26378444283523,-109.4189788
22021,6,48,12,4,16,2,88,38.26378444283523,-109.4187093
22022,6,47,12,5,17,2,89,38.26378444283523,-109.4184398
22023,5,49,12,5,18,2,91,38.26378444283523,-109.4181703
22024,5,50,12,4,17,2,90,38.26378444283523,-109.4179008
22025,5,51,12,4,17,3,92,38.26378444283523,-109.4176313
22026,5,51,12,4,17,2,91,38.26378444283523,-109.4173618
22027,6,51,11,7,15,1,91,38.26378444283523,-109.4170923
22028,14,40,12,11,14,2,93,38.26378444283523,-109.4168228
22029,27,24,12,8,12,1,84,38.26378444283523,-109.4165533
22030,44,11,11,13,13,2,94,38.26378444283523,-109.4162838
22031,47,13,13,13,7,2,95,38.26378444283523,-109.4160143
22032,33,27,15,8,10,1,94,38.26378444283523,-109.4157448
22033,13,40,13,6,16,1,89,38.26378444283523,-109.4154753
22034,7,46,12,4,17,3,89,38.26378444283523,-109.4152058
22035,6,46,12,4,17,3,88,38.26378444283523,-109.4149364
22036,5,47,12,4,18,3,89,38.26378444283523,-109.4146669
22037,6,47,12,5,18,2,90,38.26378444283523,-109.4143974
22038,7,46,12,5,17,1,88,38.26378444283523,-109.4141279
22039,7,46,12,5,18,1,89,38.26378444283523,-109.4138584
22040,7,45,12,5,18,1,88,38.26378444283523,-109.4135889
22041,7,46,12,5,18,1,89,38.26378444283523,-109.4133194
22042,7,46,12,5,18,1,89,38.26378444283523,-109.4130499
22043,6,47,12,5,18,1,89,38.26378444283523,-109.4127804
22044,5,48,12,6,18,1,90,38.26378444283523,-109.4125109
22045,5,49,12,6,18,1,91,38.26378444283523,-109.4122414
22046,6,48,13,6,18,1,92,38.26378444283523,-109.4119719
22047,6,48,13,7,17,1,92,38.26378444283523,-109.4117024
22048,6,49,13,7,16,1,92,38.26378444283523,-109.4114329
22049,9,45,13,11,14,0,92,38.26378444283523,-109.4111634
22050,8,46,13,11,14,1,93,38.26378444283523,-109.4108939
22051,7,48,13,9,15,1,93,38.26378444283523,-109.4106244
22052,5,51,13,7,17,1,94,38.26378444283523,-109.4103549
22053,5,52,13,5,16,2,93,38.26378444283523,-109.4100855
22054,5,50,13,6,17,1,92,38.26378444283523,-109.409816
22055,5,51,13,6,17,1,93,38.26378444283523,-109.4095465
22056,6,49,13,6,17,1,92,38.26378444283523,-109.409277
22057,6,47,13,7,17,1,91,38.26378444283523,-109.4090075
22058,5,46,13,6,17,2,89,38.26378444283523,-109.408738
22059,3,49,11,4,16,2,85,38.26378444283523,-109.4084685
22060,3,53,10,2,16,3,87,38.26378444283523,-109.408199
22061,4,53,11,4,16,2,90,38.26378444283523,-109.4079295
22062,5,49,13,8,17,1,93,38.26378444283523,-109.40766
22063,6,48,14,10,15,1,94,38.26378444283523,-109.4073905
22064,4,47,11,8,11,1,82,38.26378444283523,-109.407121
22065,2,44,9,5,11,2,73,38.26378444283523,-109.4068515
22066,2,31,12,1,8,16,70,38.26378444283523,-109.3879869
22067,0,26,12,0,6,19,63,38.26378444283523,-109.3877174
22068,2,32,13,2,12,12,73,38.26378444283523,-109.3874479
22069,3,41,13,5,17,5,84,38.26378444283523,-109.3871784
22070,5,45,14,8,19,1,92,38.26378444283523,-109.3869089
22071,5,46,14,8,19,0,92,38.26378444283523,-109.3866394
22072,5,47,13,6,18,1,90,38.26378444283523,-109.3863699
22073,5,48,13,5,17,2,90,38.26378444283523,-109.3861004
22074,5,49,13,5,17,2,91,38.26378444283523,-109.3858309
22075,4,49,11,3,15,3,85,38.26378444283523,-109.3855614
22076,3,47,11,4,16,3,84,38.26378444283523,-109.3852919
22077,2,47,10,2,15,5,81,38.26378444283523,-109.3850225
22078,1,53,9,1,15,5,84,38.26378444283523,-109.384753
22079,0,56,7,1,14,4,82,38.26378444283523,-109.3844835
22080,0,57,6,2,11,3,79,38.26378444283523,-109.384214
22081,0,55,7,3,11,2,78,38.26378444283523,-109.3839445
22082,1,49,8,5,10,2,75,38.26378444283523,-109.383675
22083,1,35,9,2,9,8,64,38.26378444283523,-109.3834055
22084,3,35,10,5,10,6,69,38.26378444283523,-109.383136
22085,1,36,11,2,12,10,72,38.26378444283523,-109.3828665
22086,0,32,12,0,12,13,69,38.26378444283523,-109.382597
22087,2,30,11,1,12,11,67,38.26378444283523,-109.3823275
22088,1,27,11,1,7,16,63,38.26378444283523,-109.382058
22089,3,38,11,2,13,9,76,38.26378444283523,-109.3817885
22090,4,44,13,5,17,4,87,38.26378444283523,-109.381519
22091,5,44,13,8,17,2,89,38.26378444283523,-109.3812495
22092,6,38,12,11,17,2,86,38.26378444283523,-109.38098
22093,6,38,13,13,17,1,88,38.26378444283523,-109.3807105
22094,5,39,12,11,19,1,87,38.26378444283523,-109.380441
22095,6,41,13,8,18,1,87,38.26378444283523,-109.3801716
22096,7,39,13,10,17,1,87,38.26378444283523,-109.3799021
22097,12,34,13,12,16,0,87,38.26378444283523,-109.3796326
22098,17,28,13,15,14,1,88,38.26378444283523,-109.3793631
22099,21,27,13,15,14,0,90,38.26378444283523,-109.3790936
22100,17,32,13,13,15,0,90,38.26378444283523,-109.3788241
22101,8,40,14,10,17,0,89,38.26378444283523,-109.3785546
22102,5,45,13,7,19,0,89,38.26378444283523,-109.3782851
22103,6,43,12,8,18,1,88,38.26378444283523,-109.3780156
22104,6,37,13,12,16,1,85,38.26378444283523,-109.3777461
22105,8,25,12,12,14,2,73,38.26378444283523,-109.3774766
22106,11,23,10,12,14,0,70,38.26378444283523,-109.3772071
22107,10,25,12,11,14,2,74,38.26378444283523,-109.3769376
22108,14,28,13,10,13,1,79,38.26378444283523,-109.3766681
22109,22,28,13,9,12,1,85,38.26378444283523,-109.3763986
22110,24,30,12,8,11,0,85,38.26378444283523,-109.3761291
22111,16,37,12,9,14,0,88,38.26378444283523,-109.3758596
22112,14,39,13,9,15,0,90,38.26378444283523,-109.3755901
22113,19,33,13,11,13,0,89,38.26378444283523,-109.3753206
22114,26,28,13,11,12,0,90,38.26378444283523,-109.3750512
22115,30,27,12,10,11,0,90,38.26378444283523,-109.3747817
22116,33,24,12,10,11,0,90,38.26378444283523,-109.3745122
22117,29,26,12,11,12,0,90,38.26378444283523,-109.3742427
22118,25,29,13,12,12,0,91,38.26378444283523,-109.3739732
22119,20,32,13,12,13,0,90,38.26378444283523,-109.3737037
22120,18,34,13,11,11,1,88,38.26378444283523,-109.3734342
22121,18,35,13,11,11,1,89,38.26378444283523,-109.3731647
22122,11,36,12,6,11,5,81,38.26378444283523,-109.3728952
22123,7,26,13,6,6,14,72,38.26378444283523,-109.3726257
22124,10,12,17,7,5,22,73,38.26378444283523,-109.3723562
22125,24,8,14,8,15,24,93,38.26378444283523,-109.3720867
22126,10,15,19,3,9,31,87,38.26378444283523,-109.3718172
22127,3,20,18,1,3,32,77,38.26378444283523,-109.3715477
22128,1,21,16,0,2,29,69,38.26378444283523,-109.3712782
22129,4,25,15,0,4,23,71,38.26378444283523,-109.3710087
22130,3,25,13,0,4,21,66,38.26378444283523,-109.3707392
22131,5,32,12,3,9,13,74,38.26378444283523,-109.3704697
22132,11,35,13,8,10,4,81,38.26378444283523,-109.3702003
22133,11,34,13,9,9,5,81,38.26378444283523,-109.3699308
22134,12,32,13,8,9,6,80,38.26378444283523,-109.3696613
22135,16,31,14,7,9,7,84,38.26378444283523,-109.3693918
22136,17,30,14,5,8,9,83,38.26378444283523,-109.3691223
22137,16,29,14,5,7,11,82,38.26378444283523,-109.3688528
22138,16,29,14,5,8,10,82,38.26378444283523,-109.3685833
22139,16,30,13,7,9,7,82,38.26378444283523,-109.3683138
22140,16,29,13,7,9,7,81,38.26378444283523,-109.3680443
22141,19,28,14,6,8,9,84,38.26378444283523,-109.3677748
22142,15,30,15,5,8,11,84,38.26378444283523,-109.3675053
22143,5,35,13,3,8,14,78,38.26378444283523,-109.3672358
22144,3,45,10,2,11,8,79,38.26378444283523,-109.3669663
22145,1,43,8,1,12,7,72,38.26378444283523,-109.3666968
22146,1,46,7,1,11,4,70,38.26378444283523,-109.3664273
22147,1,46,7,2,10,4,70,38.26378444283523,-109.3661578
22148,2,42,6,3,10,5,68,38.26378444283523,-109.3658883
22149,2,38,7,4,8,5,64,38.26378444283523,-109.3656188
22150,2,34,7,2,9,5,59,38.26378444283523,-109.3653493
22151,2,32,7,1,9,6,57,38.26378444283523,-109.3650799
22152,2,30,7,2,8,7,56,38.26378444283523,-109.3648104
22153,2,26,10,2,5,13,58,38.26378444283523,-109.3645409
22154,3,23,13,1,2,20,62,38.26378444283523,-109.3642714
22155,3,24,14,0,3,22,66,38.26378444283523,-109.3640019
22156,4,27,14,1,4,20,70,38.26378444283523,-109.3637324
22157,4,28,13,1,5,18,69,38.26378444283523,-109.3634629
22158,5,36,13,4,9,10,77,38.26378444283523,-109.3631934
22159,2,23,11,4,5,12,57,38.26378444283523,-109.3629239
22160,4,18,13,5,6,12,58,38.26378444283523,-109.3626544
22161,6,22,13,8,10,12,71,38.26378444283523,-109.3623849
22162,7,23,13,10,17,7,77,38.26378444283523,-109.3621154
22163,3,25,14,4,10,20,76,38.26378444283523,-109.3618459
22164,3,27,15,0,6,23,74,38.26378444283523,-109.3615764
22165,3,27,13,0,5,22,70,38.26378444283523,-109.3613069
22166,3,27,13,0,5,20,68,38.26378444283523,-109.3610374
22167,2,27,13,1,4,20,67,38.26378444283523,-109.3607679
22168,1,28,12,1,5,18,65,38.26378444283523,-109.3604984
22169,2,31,11,1,7,15,67,38.26378444283523,-109.360229
22170,2,35,11,0,9,13,70,38.26378444283523,-109.3599595
22171,2,35,11,0,10,12,70,38.26378444283523,-109.35969
22172,1,32,10,0,8,14,65,38.26378444283523,-109.3594205
22173,1,33,10,0,8,14,66,38.26378444283523,-109.359151
22174,1,35,10,0,9,12,67,38.26378444283523,-109.3588815
22175,1,36,10,0,10,11,68,38.26378444283523,-109.358612
22176,1,35,10,0,10,12,68,38.26378444283523,-109.3583425
22177,0,31,10,2,12,10,65,38.26378444283523,-109.358073
22178,0,33,10,2,10,10,65,38.26378444283523,-109.3578035
22179,1,37,11,2,11,9,71,38.26378444283523,-109.357534
22180,3,37,11,1,10,11,73,38.26378444283523,-109.3572645
22181,2,35,11,1,9,14,72,38.26378444283523,-109.356995
22182,1,34,11,0,6,17,69,38.26378444283523,-109.3567255
22183,1,34,11,0,7,16,69,38.26378444283523,-109.356456
22184,1,34,11,1,8,15,70,38.26378444283523,-109.3561865
22185,1,30,11,1,7,17,67,38.26378444283523,-109.355917
22186,1,27,12,1,6,19,66,38.26378444283523,-109.3556475
22187,1,28,12,1,7,17,66,38.26378444283523,-109.355378
22188,2,32,15,7,3,18,77,38.26378444283523,-109.3551086
22189,1,32,14,0,9,17,73,38.26378444283523,-109.3548391
22190,2,35,13,4,6,17,77,38.26378444283523,-109.3545696
22191,4,32,15,2,7,18,78,38.26378444283523,-109.3543001
22192,3,36,13,4,5,19,80,38.26378444283523,-109.3540306
22193,3,31,15,11,4,16,80,38.26378444283523,-109.3537611
22194,4,31,14,8,7,14,78,38.26378444283523,-109.3534916
22195,2,31,16,2,7,19,77,38.26378444283523,-109.3532221
22196,3,30,14,6,6,16,75,38.26378444283523,-109.3529526
22197,3,32,12,8,5,14,74,38.26378444283523,-109.3526831
22198,2,31,11,6,7,13,70,38.26378444283523,-109.3524136
22199,1,35,11,2,9,16,74,38.26378444283523,-109.3521441
22200,2,32,11,11,10,11,77,38.26378444283523,-109.3518746
22201,2,33,10,13,9,9,76,38.26378444283523,-109.3516051
22202,2,30,11,10,10,11,74,38.26378444283523,-109.3513356
22203,4,29,12,9,14,10,78,38.26378444283523,-109.3510661
22204,9,31,11,15,11,5,82,38.26378444283523,-109.3507966
22205,9,28,11,15,16,3,82,38.26378444283523,-109.3505271
22206,5,25,12,17,13,6,78,38.26378444283523,-109.3502577
22207,5,29,11,12,11,9,77,38.26378444283523,-109.3499882
22208,6,26,12,14,13,9,80,38.26378444283523,-109.3497187
22209,3,30,13,9,11,13,79,38.26378444283523,-109.3494492
22210,1,26,13,12,18,9,79,38.26378444283523,-109.3491797
22211,0,25,13,13,21,5,77,38.26378444283523,-109.3489102
22212,0,20,12,9,16,9,66,38.26378444283523,-109.3486407
22213,2,22,14,7,13,16,74,38.26378444283523,-109.3483712
22214,0,18,14,2,15,18,67,38.26378444283523,-109.3481017
22215,3,22,17,0,9,24,75,38.26378444283523,-109.3478322
22216,1,22,19,1,5,30,78,38.26378444283523,-109.3475627
22217,0,23,20,0,4,33,80,38.26378444283523,-109.3472932
22218,0,23,20,0,4,33,80,38.26378444283523,-109.3470237
22219,1,20,17,0,2,31,71,38.26378444283523,-109.3467542
22220,1,20,16,0,2,30,69,38.26378444283523,-109.3464847
22221,0,20,17,0,1,30,68,38.26378444283523,-109.3462152
22222,0,20,18,0,2,32,72,38.26378444283523,-109.3459457
22223,1,23,19,0,5,33,81,38.26378444283523,-109.3456762
22224,1,26,19,0,7,32,85,38.26378444283523,-109.3454068
22225,3,29,17,3,9,24,85,38.26378444283523,-109.3451373
22226,7,31,15,7,11,14,85,38.26378444283523,-109.3448678
22227,8,34,14,9,13,9,87,38.26378444283523,-109.3445983
22228,10,36,14,11,13,5,89,38.26378444283523,-109.3443288
22229,12,34,14,13,12,5,90,38.26378444283523,-109.3440593
22230,13,32,13,15,11,5,89,38.26378444283523,-109.3437898
22231,12,31,13,19,11,4,90,38.26378444283523,-109.3435203
22232,12,30,13,18,12,4,89,38.26378444283523,-109.3432508
22233,11,33,13,17,11,4,89,38.26378444283523,-109.3429813
22234,9,35,13,14,12,5,88,38.26378444283523,-109.3427118
22235,7,35,13,13,14,5,87,38.26378444283523,-109.3424423
22236,7,35,13,13,13,6,87,38.26378444283523,-109.3421728
22237,7,34,13,14,12,6,86,38.26378444283523,-109.3419033
22238,9,34,13,15,12,4,87,38.26378444283523,-109.3416338
22239,10,34,13,14,11,4,86,38.26378444283523,-109.3413643
22240,9,34,13,15,11,5,87,38.26378444283523,-109.3410948
22241,9,34,13,14,10,6,86,38.26378444283523,-109.3408253
22242,8,36,14,12,11,6,87,38.26378444283523,-109.3405558
22243,9,35,14,12,10,6,86,38.26378444283523,-109.3402864
22244,8,36,14,10,11,9,88,38.26378444283523,-109.3400169
22245,6,38,14,10,11,10,89,38.26378444283523,-109.3397474
22246,6,40,14,10,12,7,89,38.26378444283523,-109.3394779
22247,5,42,14,10,12,6,89,38.26378444283523,-109.3392084
22248,5,42,14,11,11,6,89,38.26378444283523,-109.3389389
22249,6,40,14,12,10,7,89,38.26378444283523,-109.3386694
22250,7,37,14,11,10,10,89,38.26378444283523,-109.3383999
22251,7,34,14,12,10,10,87,38.26378444283523,-109.3381304
22252,6,33,14,9,11,13,86,38.26378444283523,-109.3378609
22253,3,28,15,5,8,18,77,38.26378444283523,-109.3375914
22254,3,19,14,3,4,22,65,38.26378444283523,-109.3373219
22255,3,14,14,3,4,21,59,38.26378444283523,-109.3370524
22256,3,18,12,4,5,15,57,38.26378444283523,-109.3367829
22257,2,20,12,3,4,19,60,38.26378444283523,-109.3365134
22258,2,18,14,3,3,24,64,38.26378444283523,-109.3362439
22259,1,15,16,1,2,27,62,38.26378444283523,-109.3359744
22260,1,16,16,0,1,28,62,38.26378444283523,-109.3357049
22261,1,19,13,2,3,21,59,38.26378444283523,-109.3354355
22262,2,24,12,3,5,18,64,38.26378444283523,-109.335166
22263,2,29,12,2,7,17,69,38.26378444283523,-109.3348965
22264,2,40,9,3,10,7,71,38.26351495,-109.4418858
22265,2,39,9,1,10,10,71,38.26351495,-109.4416163
22266,1,37,9,0,9,11,67,38.26351495,-109.4413468
22267,1,35,9,1,9,10,65,38.26351495,-109.4410773
22268,1,35,9,2,9,8,64,38.26351495,-109.4408078
22269,1,35,8,2,10,6,62,38.26351495,-109.4405383
22270,2,37,8,3,10,5,65,38.26351495,-109.4402688
22271,2,38,8,2,9,6,65,38.26351495,-109.4399993
22272,2,37,9,1,8,11,68,38.26351495,-109.4397299
22273,2,41,9,0,10,11,73,38.26351495,-109.4394604
22274,2,46,10,1,12,10,81,38.26351495,-109.4391909
22275,1,49,10,1,12,10,83,38.26351495,-109.4389214
22276,1,38,10,0,8,16,73,38.26351495,-109.4386519
22277,0,36,9,0,7,15,67,38.26351495,-109.4383824
22278,0,37,9,0,9,11,66,38.26351495,-109.4381129
22279,1,36,9,0,7,9,62,38.26351495,-109.4378434
22280,3,41,7,3,7,5,66,38.26351495,-109.4375739
22281,1,38,8,2,9,7,65,38.26351495,-109.4373044
22282,0,44,8,0,12,6,70,38.26351495,-109.4370349
22283,0,55,8,0,15,4,82,38.26351495,-109.4367654
22284,0,61,7,1,14,2,85,38.26351495,-109.4364959
22285,1,64,7,2,14,2,90,38.26351495,-109.4362264
22286,1,61,7,1,14,3,87,38.26351495,-109.4359569
22287,1,58,8,0,15,4,86,38.26351495,-109.4356874
22288,1,54,8,0,16,4,83,38.26351495,-109.4354179
22289,2,48,9,2,15,4,80,38.26351495,-109.4351484
22290,2,44,10,4,15,3,78,38.26351495,-109.434879
22291,2,41,10,4,14,5,76,38.26351495,-109.4346095
22292,2,39,10,3,13,7,74,38.26351495,-109.43434
22293,4,42,10,3,14,6,79,38.26351495,-109.4340705
22294,4,39,11,3,13,9,79,38.26351495,-109.433801
22295,6,42,12,3,13,8,84,38.26351495,-109.4335315
22296,6,38,11,4,14,7,80,38.26351495,-109.433262
22297,7,34,12,7,14,5,79,38.26351495,-109.4329925
22298,16,32,13,9,14,2,86,38.26351495,-109.432723
22299,20,29,14,11,13,1,88,38.26351495,-109.4324535
22300,21,31,14,12,13,0,91,38.26351495,-109.432184
22301,19,33,15,11,13,0,91,38.26351495,-109.4319145
22302,16,34,15,12,13,0,90,38.26351495,-109.431645
22303,11,34,15,13,13,1,87,38.26351495,-109.4313755
22304,12,35,15,13,13,1,89,38.26351495,-109.431106
22305,16,34,15,11,13,1,90,38.26351495,-109.4308365
22306,19,33,14,11,13,0,90,38.26351495,-109.430567
22307,20,34,14,11,13,0,92,38.26351495,-109.4302975
22308,16,35,15,12,13,0,91,38.26351495,-109.430028
22309,11,34,15,13,13,1,87,38.26351495,-109.4297586
22310,8,35,15,13,14,1,86,38.26351495,-109.4294891
22311,7,36,15,12,13,2,85,38.26351495,-109.4292196
22312,7,36,14,12,13,2,84,38.26351495,-109.4289501
22313,14,35,14,12,14,0,89,38.26351495,-109.4286806
22314,21,33,14,11,13,0,92,38.26351495,-109.4284111
22315,23,31,14,11,13,0,92,38.26351495,-109.4281416
22316,22,31,14,11,12,0,90,38.26351495,-109.4278721
22317,19,31,15,12,12,0,89,38.26351495,-109.4276026
22318,18,33,15,12,12,0,90,38.26351495,-109.4273331
22319,14,34,15,12,13,0,88,38.26351495,-109.4270636
22320,11,36,14,12,14,1,88,38.26351495,-109.4267941
22321,10,37,14,12,13,1,87,38.26351495,-109.4265246
22322,10,37,14,13,13,1,88,38.26351495,-109.4262551
22323,10,36,14,12,13,1,86,38.26351495,-109.4259856
22324,12,35,14,12,13,1,87,38.26351495,-109.4257161
22325,13,34,14,12,13,1,87,38.26351495,-109.4254466
22326,12,34,14,12,13,1,86,38.26351495,-109.4251771
22327,11,35,14,12,14,1,87,38.26351495,-109.4249077
22328,10,35,14,12,14,1,86,38.26351495,-109.4246382
22329,11,35,14,13,14,0,87,38.26351495,-109.4243687
22330,12,35,14,13,14,0,88,38.26351495,-109.4240992
22331,12,36,14,12,15,0,89,38.26351495,-109.4238297
22332,14,35,14,12,15,0,90,38.26351495,-109.4235602
22333,18,32,14,11,14,1,90,38.26351495,-109.4232907
22334,22,30,13,10,14,0,89,38.26351495,-109.4230212
22335,24,31,13,9,13,0,90,38.26351495,-109.4227517
22336,27,31,13,9,13,0,93,38.26351495,-109.4224822
22337,18,36,14,10,14,0,92,38.26351495,-109.4222127
22338,14,40,13,10,15,0,92,38.26351495,-109.4219432
22339,11,41,13,9,16,1,91,38.26351495,-109.4216737
22340,9,43,13,8,17,1,91,38.26351495,-109.4214042
22341,7,46,13,7,17,1,91,38.26351495,-109.4211347
22342,6,49,12,6,17,1,91,38.26351495,-109.4208652
22343,5,51,12,6,17,1,92,38.26351495,-109.4205957
22344,5,50,12,6,17,2,92,38.26351495,-109.4203262
22345,6,49,12,6,17,1,91,38.26351495,-109.4200568
22346,5,48,12,6,17,2,90,38.26351495,-109.4197873
22347,6,48,13,6,17,2,92,38.26351495,-109.4195178
22348,6,47,13,6,17,2,91,38.26351495,-109.4192483
22349,6,47,13,6,17,2,91,38.26351495,-109.4189788
22350,7,47,13,5,17,2,91,38.26351495,-109.4187093
22351,6,49,13,5,17,2,92,38.26351495,-109.4184398
22352,5,50,13,5,18,2,93,38.26351495,-109.4181703
22353,6,51,13,4,18,2,94,38.26351495,-109.4179008
22354,5,52,12,4,17,2,92,38.26351495,-109.4176313
22355,5,55,11,4,16,1,92,38.26351495,-109.4173618
22356,6,53,11,7,15,1,93,38.26351495,-109.4170923
22357,13,42,12,10,14,2,93,38.26351495,-109.4168228
22358,30,28,13,9,12,1,93,38.26351495,-109.4165533
22359,41,16,12,8,11,1,89,38.26351495,-109.4162838
22360,41,18,13,12,8,1,93,38.26351495,-109.4160143
22361,30,28,14,9,11,0,92,38.26351495,-109.4157448
22362,16,39,13,7,14,1,90,38.26351495,-109.4154753
22363,9,44,12,6,16,1,88,38.26351495,-109.4152058
22364,6,46,12,4,18,2,88,38.26351495,-109.4149364
22365,5,47,12,4,18,3,89,38.26351495,-109.4146669
22366,5,47,12,4,18,2,88,38.26351495,-109.4143974
22367,6,47,12,5,18,2,90,38.26351495,-109.4141279
22368,7,45,12,6,18,1,89,38.26351495,-109.4138584
22369,6,46,12,5,18,1,88,38.26351495,-109.4135889
22370,7,47,12,4,17,1,88,38.26351495,-109.4133194
22371,7,47,12,4,17,1,88,38.26351495,-109.4130499
22372,6,49,12,4,17,1,89,38.26351495,-109.4127804
22373,5,51,12,5,17,1,91,38.26351495,-109.4125109
22374,5,53,12,5,17,1,93,38.26351495,-109.4122414
22375,6,53,12,6,16,1,94,38.26351495,-109.4119719
22376,6,52,12,7,15,1,93,38.26351495,-109.4117024
22377,6,50,12,8,15,1,92,38.26351495,-109.4114329
22378,7,48,13,10,14,1,93,38.26351495,-109.4111634
22379,6,50,13,8,16,1,94,38.26351495,-109.4108939
22380,6,53,13,6,16,0,94,38.26351495,-109.4106244
22381,5,53,13,6,17,1,95,38.26351495,-109.4103549
22382,5,53,13,5,17,1,94,38.26351495,-109.4100855
22383,5,52,13,6,17,1,94,38.26351495,-109.409816
22384,5,50,13,6,17,1,92,38.26351495,-109.4095465
22385,6,49,13,6,17,1,92,38.26351495,-109.409277
22386,5,48,13,6,17,2,91,38.26351495,-109.4090075
22387,4,46,13,5,17,3,88,38.26351495,-109.408738
22388,4,48,11,4,16,2,85,38.26351495,-109.4084685
22389,3,50,10,3,15,3,84,38.26351495,-109.408199
22390,4,49,11,4,15,3,86,38.26351495,-109.4079295
22391,6,47,13,7,16,2,91,38.26351495,-109.40766
22392,5,48,12,8,14,1,88,38.26351495,-109.4073905
22393,4,46,10,8,11,2,81,38.26351495,-109.407121
22394,2,42,10,5,11,3,73,38.26351495,-109.4068515
22395,1,32,11,0,8,17,69,38.26351495,-109.3879869
22396,1,30,11,0,8,16,66,38.26351495,-109.3877174
22397,2,36,10,0,13,10,71,38.26351495,-109.3874479
22398,4,42,11,1,16,6,80,38.26351495,-109.3871784
22399,4,45,13,3,18,4,87,38.26351495,-109.3869089
22400,4,47,13,4,18,3,89,38.26351495,-109.3866394
22401,4,48,13,5,18,2,90,38.26351495,-109.3863699
22402,5,48,13,5,17,2,90,38.26351495,-109.3861004
22403,5,47,13,5,16,3,89,38.26351495,-109.3858309
22404,5,48,13,4,16,4,90,38.26351495,-109.3855614
22405,3,48,11,3,15,4,84,38.26351495,-109.3852919
22406,2,47,10,2,15,5,81,38.26351495,-109.3850225
22407,1,53,9,2,15,3,83,38.26351495,-109.384753
22408,0,56,7,2,13,2,80,38.26351495,-109.3844835
22409,0,51,7,2,11,3,74,38.26351495,-109.384214
22410,1,43,8,3,11,4,70,38.26351495,-109.3839445
22411,2,40,10,5,12,4,73,38.26351495,-109.383675
22412,1,33,10,2,9,10,65,38.26351495,-109.3834055
22413,2,33,11,3,11,11,71,38.26351495,-109.383136
22414,1,32,11,0,11,14,69,38.26351495,-109.3828665
22415,0,31,11,0,10,15,67,38.26351495,-109.382597
22416,1,34,10,1,13,8,67,38.26351495,-109.3823275
22417,2,35,10,3,13,7,70,38.26351495,-109.382058
22418,2,32,10,3,12,9,68,38.26351495,-109.3817885
22419,3,36,12,4,15,7,77,38.26351495,-109.381519
22420,5,43,13,7,17,3,88,38.26351495,-109.3812495
22421,6,41,13,9,19,1,89,38.26351495,-109.38098
22422,4,42,13,8,19,2,88,38.26351495,-109.3807105
22423,5,43,12,7,19,2,88,38.26351495,-109.380441
22424,5,44,12,6,19,1,87,38.26351495,-109.3801716
22425,6,42,13,9,18,1,89,38.26351495,-109.3799021
22426,8,36,13,13,17,1,88,38.26351495,-109.3796326
22427,12,31,13,17,14,1,88,38.26351495,-109.3793631
22428,14,31,13,17,14,0,89,38.26351495,-109.3790936
22429,10,38,13,13,17,0,91,38.26351495,-109.3788241
22430,5,44,13,8,18,1,89,38.26351495,-109.3785546
22431,4,46,12,6,18,1,87,38.26351495,-109.3782851
22432,5,41,12,8,17,2,85,38.26351495,-109.3780156
22433,8,29,13,12,14,1,77,38.26351495,-109.3777461
22434,7,20,11,14,13,2,67,38.26351495,-109.3774766
22435,10,23,11,11,14,1,70,38.26351495,-109.3772071
22436,9,35,13,10,16,1,84,38.26351495,-109.3769376
22437,12,38,12,8,16,1,87,38.26351495,-109.3766681
22438,16,37,13,8,15,0,89,38.26351495,-109.3763986
22439,19,35,13,9,13,0,89,38.26351495,-109.3761291
22440,17,37,13,9,14,0,90,38.26351495,-109.3758596
22441,17,35,14,12,13,0,91,38.26351495,-109.3755901
22442,20,31,13,12,12,0,88,38.26351495,-109.3753206
22443,27,28,12,11,11,0,89,38.26351495,-109.3750512
22444,36,26,12,8,9,0,91,38.26351495,-109.3747817
22445,35,23,12,10,10,0,90,38.26351495,-109.3745122
22446,33,24,12,11,11,0,91,38.26351495,-109.3742427
22447,27,28,13,12,11,0,91,38.26351495,-109.3739732
22448,22,31,13,13,11,0,90,38.26351495,-109.3737037
22449,21,32,13,13,11,0,90,38.26351495,-109.3734342
22450,14,38,13,9,12,2,88,38.26351495,-109.3731647
22451,8,36,12,6,10,7,79,38.26351495,-109.3728952
22452,10,21,14,8,5,16,74,38.26351495,-109.3726257
22453,32,9,16,5,10,19,91,38.26351495,-109.3723562
22454,28,9,14,7,13,22,93,38.26351495,-109.3720867
22455,9,19,18,3,7,29,85,38.26351495,-109.3718172
22456,3,23,19,0,4,31,80,38.26351495,-109.3715477
22457,2,23,17,0,3,28,73,38.26351495,-109.3712782
22458,4,24,14,0,4,22,68,38.26351495,-109.3710087
22459,5,31,13,2,7,15,73,38.26351495,-109.3707392
22460,9,35,12,5,9,8,78,38.26351495,-109.3704697
22461,13,34,13,7,9,5,81,38.26351495,-109.3702003
22462,13,32,13,6,7,8,79,38.26351495,-109.3699308
22463,13,31,13,6,7,10,80,38.26351495,-109.3696613
22464,11,32,13,4,8,10,78,38.26351495,-109.3693918
22465,9,33,13,4,8,10,77,38.26351495,-109.3691223
22466,8,35,13,4,8,9,77,38.26351495,-109.3688528
22467,7,37,12,3,10,8,77,38.26351495,-109.3685833
22468,7,39,11,4,11,7,79,38.26351495,-109.3683138
22469,6,38,12,4,12,5,77,38.26351495,-109.3680443
22470,8,34,12,6,11,6,77,38.26351495,-109.3677748
22471,8,37,12,5,12,6,80,38.26351495,-109.3675053
22472,3,45,10,1,11,9,79,38.26351495,-109.3672358
22473,1,44,8,2,10,8,73,38.26351495,-109.3669663
22474,0,44,7,1,10,7,69,38.26351495,-109.3666968
22475,0,47,6,0,10,5,68,38.26351495,-109.3664273
22476,0,50,6,0,9,5,70,38.26351495,-109.3661578
22477,1,50,7,3,9,4,74,38.26351495,-109.3658883
22478,1,39,6,2,9,6,63,38.26351495,-109.3656188
22479,2,37,7,2,9,5,62,38.26351495,-109.3653493
22480,2,34,7,2,9,5,59,38.26351495,-109.3650799
22481,1,35,8,2,9,7,62,38.26351495,-109.3648104
22482,2,32,11,1,6,15,67,38.26351495,-109.3645409
22483,3,28,14,1,4,19,69,38.26351495,-109.3642714
22484,3,26,15,0,4,21,69,38.26351495,-109.3640019
22485,4,25,15,0,4,20,68,38.26351495,-109.3637324
22486,4,26,13,1,5,16,65,38.26351495,-109.3634629
22487,11,29,11,7,9,4,71,38.26351495,-109.3631934
22488,3,20,11,4,6,11,55,38.26351495,-109.3629239
22489,3,23,13,12,9,10,70,38.26351495,-109.3626544
22490,2,24,13,5,16,15,75,38.26351495,-109.3623849
22491,7,21,14,11,14,8,75,38.26351495,-109.3621154
22492,2,27,15,1,10,19,74,38.26351495,-109.3618459
22493,2,25,14,0,6,22,69,38.26351495,-109.3615764
22494,2,26,13,0,6,20,67,38.26351495,-109.3613069
22495,2,29,13,1,8,16,69,38.26351495,-109.3610374
22496,1,30,12,1,7,16,67,38.26351495,-109.3607679
22497,1,32,11,0,8,16,68,38.26351495,-109.3604984
22498,1,35,10,0,9,15,70,38.26351495,-109.360229
22499,1,37,10,0,10,13,71,38.26351495,-109.3599595
22500,1,36,10,0,11,12,70,38.26351495,-109.35969
22501,1,35,10,0,8,13,67,38.26351495,-109.3594205
22502,1,33,10,0,8,13,65,38.26351495,-109.359151
22503,1,37,10,0,10,11,69,38.26351495,-109.3588815
22504,1,38,10,1,13,8,71,38.26351495,-109.358612
22505,1,36,10,1,12,10,70,38.26351495,-109.3583425
22506,2,40,10,0,11,11,74,38.26351495,-109.358073
22507,1,37,10,0,10,13,71,38.26351495,-109.3578035
22508,1,35,10,0,8,14,68,38.26351495,-109.357534
22509,2,32,11,2,6,15,68,38.26351495,-109.3572645
22510,1,29,12,1,5,19,67,38.26351495,-109.356995
22511,1,31,12,1,5,18,68,38.26351495,-109.3567255
22512,1,29,12,2,5,15,64,38.26351495,-109.356456
22513,1,28,12,2,5,15,63,38.26351495,-109.3561865
22514,2,28,13,1,5,16,65,38.26351495,-109.355917
22515,1,28,12,2,7,15,65,38.26351495,-109.3556475
22516,2,26,12,2,7,14,63,38.26351495,-109.355378
22517,5,32,16,7,3,17,80,38.26351495,-109.3551086
22518,3,34,14,0,6,21,78,38.26351495,-109.3548391
22519,2,29,15,0,6,24,76,38.26351495,-109.3545696
22520,1,34,13,2,8,17,75,38.26351495,-109.3543001
22521,2,29,14,0,10,18,73,38.26351495,-109.3540306
22522,1,29,15,0,6,25,76,38.26351495,-109.3537611
22523,1,30,15,0,6,24,76,38.26351495,-109.3534916
22524,0,28,13,0,8,21,70,38.26351495,-109.3532221
22525,2,31,14,9,6,17,79,38.26351495,-109.3529526
22526,3,32,13,12,9,12,81,38.26351495,-109.3526831
22527,5,28,12,14,11,10,80,38.26351495,-109.3524136
22528,4,28,13,11,9,13,78,38.26351495,-109.3521441
22529,4,27,13,11,14,9,78,38.26351495,-109.3518746
22530,9,28,14,12,15,7,85,38.26351495,-109.3516051
22531,14,27,13,11,16,4,85,38.26351495,-109.3513356
22532,19,27,12,14,15,1,88,38.26351495,-109.3510661
22533,20,26,12,17,15,1,91,38.26351495,-109.3507966
22534,13,27,11,19,17,1,88,38.26351495,-109.3505271
22535,4,23,14,19,17,6,83,38.26351495,-109.3502577
22536,3,22,13,17,20,6,81,38.26351495,-109.3499882
22537,4,24,13,14,15,13,83,38.26351495,-109.3497187
22538,5,19,13,14,21,9,81,38.26351495,-109.3494492
22539,4,20,13,16,24,5,82,38.26351495,-109.3491797
22540,4,20,11,14,21,5,75,38.26351495,-109.3489102
22541,1,12,12,12,14,12,63,38.26351495,-109.3486407
22542,0,14,12,8,10,13,57,38.26351495,-109.3483712
22543,1,19,14,2,11,20,67,38.26351495,-109.3481017
22544,1,21,17,0,9,25,73,38.26351495,-109.3478322
22545,0,22,19,1,4,32,78,38.26351495,-109.3475627
22546,0,22,19,0,3,34,78,38.26351495,-109.3472932
22547,0,23,19,0,4,32,78,38.26351495,-109.3470237
22548,0,20,18,0,3,31,72,38.26351495,-109.3467542
22549,1,21,17,0,2,30,71,38.26351495,-109.3464847
22550,1,22,17,0,2,30,72,38.26351495,-109.3462152
22551,1,21,18,0,3,31,74,38.26351495,-109.3459457
22552,0,22,19,0,5,32,78,38.26351495,-109.3456762
22553,2,25,19,1,7,29,83,38.26351495,-109.3454068
22554,6,30,16,6,9,19,86,38.26351495,-109.3451373
22555,9,33,14,10,13,10,89,38.26351495,-109.3448678
22556,9,34,14,11,13,7,88,38.26351495,-109.3445983
22557,9,33,14,12,13,7,88,38.26351495,-109.3443288
22558,8,32,14,13,13,8,88,38.26351495,-109.3440593
22559,9,32,14,15,12,7,89,38.26351495,-109.3437898
22560,9,33,14,15,13,5,89,38.26351495,-109.3435203
22561,9,34,13,13,14,5,88,38.26351495,-109.3432508
22562,7,36,13,12,15,5,88,38.26351495,-109.3429813
22563,6,38,13,11,15,5,88,38.26351495,-109.3427118
22564,6,40,13,10,15,5,89,38.26351495,-109.3424423
22565,5,41,13,8,14,5,86,38.26351495,-109.3421728
22566,5,40,13,8,16,5,87,38.26351495,-109.3419033
22567,6,37,13,10,16,5,87,38.26351495,-109.3416338
22568,6,36,13,10,15,6,86,38.26351495,-109.3413643
22569,7,35,13,10,15,6,86,38.26351495,-109.3410948
22570,8,35,13,9,13,8,86,38.26351495,-109.3408253
22571,7,35,14,7,14,10,87,38.26351495,-109.3405558
22572,6,34,15,5,12,14,86,38.26351495,-109.3402864
22573,5,32,15,5,10,16,83,38.26351495,-109.3400169
22574,5,34,15,5,10,14,83,38.26351495,-109.3397474
22575,6,38,15,8,12,9,88,38.26351495,-109.3394779
22576,5,42,14,9,13,6,89,38.26351495,-109.3392084
22577,5,43,14,10,12,5,89,38.26351495,-109.3389389
22578,5,43,13,9,12,6,88,38.26351495,-109.3386694
22579,4,38,13,9,11,9,84,38.26351495,-109.3383999
22580,5,34,14,8,11,12,84,38.26351495,-109.3381304
22581,3,28,14,4,9,17,75,38.26351495,-109.3378609
22582,2,21,14,2,4,23,66,38.26351495,-109.3375914
22583,2,17,13,2,3,22,59,38.26351495,-109.3373219
22584,2,19,12,3,5,16,57,38.26351495,-109.3370524
22585,2,21,12,5,7,14,61,38.26351495,-109.3367829
22586,2,22,13,3,5,20,65,38.26351495,-109.3365134
22587,1,21,14,3,3,23,65,38.26351495,-109.3362439
22588,1,24,12,2,3,22,64,38.26351495,-109.3359744
22589,0,29,10,1,6,15,61,38.26351495,-109.3357049
22590,0,33,8,0,8,12,61,38.26351495,-109.3354355
22591,0,42,7,0,10,6,65,38.26351495,-109.335166
22592,0,44,7,1,11,5,68,38.26351495,-109.3348965
22593,1,39,8,2,12,7,69,38.26351495,-109.334627
22594,2,41,9,3,11,7,73,38.26324545366476,-109.4418858
22595,1,41,10,2,12,9,75,38.26324545366476,-109.4416163
22596,2,45,10,1,11,11,80,38.26324545366476,-109.4413468
22597,1,42,10,0,11,11,75,38.26324545366476,-109.4410773
22598,1,40,9,1,12,8,71,38.26324545366476,-109.4408078
22599,1,39,8,2,11,6,67,38.26324545366476,-109.4405383
22600,2,44,8,3,12,4,73,38.26324545366476,-109.4402688
22601,2,43,9,4,12,4,74,38.26324545366476,-109.4399993
22602,1,41,9,2,11,7,71,38.26324545366476,-109.4397299
22603,1,42,10,1,12,8,74,38.26324545366476,-109.4394604
22604,1,46,10,1,14,8,80,38.26324545366476,-109.4391909
22605,2,51,10,1,14,8,86,38.26324545366476,-109.4389214
22606,0,40,10,0,10,13,73,38.26324545366476,-109.4386519
22607,0,41,9,0,10,14,74,38.26324545366476,-109.4383824
22608,1,40,9,0,12,11,73,38.26324545366476,-109.4381129
22609,1,36,9,1,9,9,65,38.26324545366476,-109.4378434
22610,3,38,8,2,9,6,66,38.26324545366476,-109.4375739
22611,2,33,8,2,9,7,61,38.26324545366476,-109.4373044
22612,1,34,8,2,9,7,61,38.26324545366476,-109.4370349
22613,1,39,8,2,10,6,66,38.26324545366476,-109.4367654
22614,1,46,8,2,13,4,74,38.26324545366476,-109.4364959
22615,1,53,8,1,14,3,80,38.26324545366476,-109.4362264
22616,2,48,9,1,15,5,80,38.26324545366476,-109.4359569
22617,2,47,9,1,14,6,79,38.26324545366476,-109.4356874
22618,2,50,9,1,14,5,81,38.26324545366476,-109.4354179
22619,1,52,8,0,16,4,81,38.26324545366476,-109.4351484
22620,1,48,9,1,16,4,79,38.26324545366476,-109.434879
22621,2,42,9,2,14,6,75,38.26324545366476,-109.4346095
22622,2,40,9,2,13,7,73,38.26324545366476,-109.43434
22623,4,46,11,2,15,6,84,38.26324545366476,-109.4340705
22624,3,47,10,3,14,8,85,38.26324545366476,-109.433801
22625,3,48,10,2,13,8,84,38.26324545366476,-109.4335315
22626,3,46,11,2,14,7,83,38.26324545366476,-109.433262
22627,3,41,11,4,15,5,79,38.26324545366476,-109.4329925
22628,11,37,13,9,15,2,87,38.26324545366476,-109.432723
22629,18,33,14,11,14,0,90,38.26324545366476,-109.4324535
22630,20,33,14,11,13,0,91,38.26324545366476,-109.432184
22631,17,35,15,12,13,0,92,38.26324545366476,-109.4319145
22632,12,35,15,13,13,1,89,38.26324545366476,-109.431645
22633,8,36,15,13,13,1,86,38.26324545366476,-109.4313755
22634,9,38,15,13,13,1,89,38.26324545366476,-109.431106
22635,10,38,15,13,13,1,90,38.26324545366476,-109.4308365
22636,13,37,15,11,13,1,90,38.26324545366476,-109.430567
22637,16,36,15,11,14,0,92,38.26324545366476,-109.4302975
22638,15,35,15,13,14,0,92,38.26324545366476,-109.430028
22639,12,36,15,13,14,1,91,38.26324545366476,-109.4297586
22640,9,38,15,12,14,1,89,38.26324545366476,-109.4294891
22641,8,40,15,12,14,1,90,38.26324545366476,-109.4292196
22642,7,39,14,12,14,1,87,38.26324545366476,-109.4289501
22643,14,37,14,12,14,0,91,38.26324545366476,-109.4286806
22644,23,33,14,10,12,0,92,38.26324545366476,-109.4284111
22645,24,32,14,10,12,0,92,38.26324545366476,-109.4281416
22646,22,32,14,11,12,0,91,38.26324545366476,-109.4278721
22647,21,31,15,12,12,0,91,38.26324545366476,-109.4276026
22648,17,34,15,13,13,0,92,38.26324545366476,-109.4273331
22649,12,36,15,13,13,0,89,38.26324545366476,-109.4270636
22650,9,37,14,13,14,1,88,38.26324545366476,-109.4267941
22651,8,37,14,13,14,1,87,38.26324545366476,-109.4265246
22652,8,38,14,13,13,1,87,38.26324545366476,-109.4262551
22653,9,37,14,13,14,1,88,38.26324545366476,-109.4259856
22654,11,35,14,13,14,1,88,38.26324545366476,-109.4257161
22655,11,35,15,13,14,1,89,38.26324545366476,-109.4254466
22656,10,35,15,13,14,1,88,38.26324545366476,-109.4251771
22657,7,37,15,11,15,1,86,38.26324545366476,-109.4249077
22658,8,37,15,13,15,1,89,38.26324545366476,-109.4246382
22659,9,37,15,13,15,1,90,38.26324545366476,-109.4243687
22660,10,37,14,13,15,0,89,38.26324545366476,-109.4240992
22661,10,39,14,13,15,1,92,38.26324545366476,-109.4238297
22662,10,39,14,12,16,0,91,38.26324545366476,-109.4235602
22663,13,37,14,12,15,0,91,38.26324545366476,-109.4232907
22664,14,36,14,12,15,0,91,38.26324545366476,-109.4230212
22665,18,33,13,10,14,0,88,38.26324545366476,-109.4227517
22666,27,30,13,8,13,0,91,38.26324545366476,-109.4224822
22667,32,28,13,7,12,0,92,38.26324545366476,-109.4222127
22668,28,30,13,9,12,0,92,38.26324545366476,-109.4219432
22669,19,35,13,9,13,0,89,38.26324545366476,-109.4216737
22670,9,43,13,9,17,1,92,38.26324545366476,-109.4214042
22671,6,49,12,6,17,1,91,38.26324545366476,-109.4211347
22672,6,51,12,6,17,1,93,38.26324545366476,-109.4208652
22673,6,51,12,6,16,1,92,38.26324545366476,-109.4205957
22674,6,50,12,6,17,1,92,38.26324545366476,-109.4203262
22675,6,48,13,6,17,1,91,38.26324545366476,-109.4200568
22676,7,48,13,7,17,1,93,38.26324545366476,-109.4197873
22677,7,47,13,7,17,1,92,38.26324545366476,-109.4195178
22678,6,47,13,7,17,1,91,38.26324545366476,-109.4192483
22679,6,47,13,6,17,1,90,38.26324545366476,-109.4189788
22680,6,48,13,5,17,2,91,38.26324545366476,-109.4187093
22681,6,50,13,5,17,2,93,38.26324545366476,-109.4184398
22682,5,52,13,5,17,2,94,38.26324545366476,-109.4181703
22683,4,53,12,4,17,2,92,38.26324545366476,-109.4179008
22684,5,54,12,5,16,1,93,38.26324545366476,-109.4176313
22685,4,55,10,6,15,1,91,38.26324545366476,-109.4173618
22686,5,53,11,6,16,1,92,38.26324545366476,-109.4170923
22687,9,44,12,8,17,1,91,38.26324545366476,-109.4168228
22688,14,38,13,9,15,3,92,38.26324545366476,-109.4165533
22689,19,35,13,8,14,3,92,38.26324545366476,-109.4162838
22690,16,37,13,8,14,2,90,38.26324545366476,-109.4160143
22691,12,41,13,6,16,2,90,38.26324545366476,-109.4157448
22692,7,46,12,5,17,2,89,38.26324545366476,-109.4154753
22693,6,47,12,5,18,2,90,38.26324545366476,-109.4152058
22694,6,46,12,5,18,2,89,38.26324545366476,-109.4149364
22695,6,47,12,4,18,2,89,38.26324545366476,-109.4146669
22696,5,48,12,4,18,2,89,38.26324545366476,-109.4143974
22697,6,48,12,4,17,2,89,38.26324545366476,-109.4141279
22698,7,46,12,5,17,2,89,38.26324545366476,-109.4138584
22699,7,46,12,5,17,2,89,38.26324545366476,-109.4135889
22700,7,46,12,5,17,1,88,38.26324545366476,-109.4133194
22701,7,47,12,5,17,1,89,38.26324545366476,-109.4130499
22702,6,48,12,5,17,1,89,38.26324545366476,-109.4127804
22703,5,51,12,5,17,1,91,38.26324545366476,-109.4125109
22704,5,52,13,5,16,1,92,38.26324545366476,-109.4122414
22705,6,53,12,6,15,1,93,38.26324545366476,-109.4119719
22706,6,52,12,8,14,1,93,38.26324545366476,-109.4117024
22707,6,51,12,8,14,1,92,38.26324545366476,-109.4114329
22708,6,50,12,8,14,1,91,38.26324545366476,-109.4111634
22709,5,52,13,6,15,1,92,38.26324545366476,-109.4108939
22710,5,54,13,5,15,1,93,38.26324545366476,-109.4106244
22711,5,54,12,5,16,1,93,38.26324545366476,-109.4103549
22712,5,53,12,5,16,1,92,38.26324545366476,-109.4100855
22713,5,53,12,6,16,1,93,38.26324545366476,-109.409816
22714,5,51,13,6,16,1,92,38.26324545366476,-109.4095465
22715,5,50,13,6,16,2,92,38.26324545366476,-109.409277
22716,5,48,13,5,17,3,91,38.26324545366476,-109.4090075
22717,5,47,13,4,17,4,90,38.26324545366476,-109.408738
22718,4,46,11,3,16,5,85,38.26324545366476,-109.4084685
22719,4,44,11,3,16,5,83,38.26324545366476,-109.408199
22720,5,44,11,4,16,4,84,38.26324545366476,-109.4079295
22721,6,45,12,7,15,2,87,38.26324545366476,-109.40766
22722,4,45,11,8,13,2,83,38.26324545366476,-109.4073905
22723,3,45,10,7,11,2,78,38.26324545366476,-109.407121
22724,2,40,9,4,10,5,70,38.26324545366476,-109.4068515
22725,2,37,11,0,11,14,75,38.26324545366476,-109.3879869
22726,2,35,11,0,11,13,72,38.26324545366476,-109.3877174
22727,3,39,11,0,14,8,75,38.26324545366476,-109.3874479
22728,5,43,12,2,16,5,83,38.26324545366476,-109.3871784
22729,4,43,12,1,16,7,83,38.26324545366476,-109.3869089
22730,4,46,13,3,17,4,87,38.26324545366476,-109.3866394
22731,5,47,13,4,17,2,88,38.26324545366476,-109.3863699
22732,5,47,13,5,17,2,89,38.26324545366476,-109.3861004
22733,5,48,13,4,17,4,91,38.26324545366476,-109.3858309
22734,4,48,12,2,15,7,88,38.26324545366476,-109.3855614
22735,3,49,11,1,14,7,85,38.26324545366476,-109.3852919
22736,1,51,9,1,14,5,81,38.26324545366476,-109.3850225
22737,0,58,8,1,13,3,83,38.26324545366476,-109.384753
22738,1,52,7,2,11,3,76,38.26324545366476,-109.3844835
22739,1,41,8,2,10,5,67,38.26324545366476,-109.384214
22740,1,35,9,3,10,7,65,38.26324545366476,-109.3839445
22741,2,35,11,3,13,9,73,38.26324545366476,-109.383675
22742,1,32,11,0,9,14,67,38.26324545366476,-109.3834055
22743,2,37,12,0,12,13,76,38.26324545366476,-109.383136
22744,2,36,12,0,14,13,77,38.26324545366476,-109.3828665
22745,1,34,11,0,12,13,71,38.26324545366476,-109.382597
22746,2,37,11,2,14,7,73,38.26324545366476,-109.3823275
22747,2,38,10,1,14,7,72,38.26324545366476,-109.382058
22748,1,32,10,0,11,10,64,38.26324545366476,-109.3817885
22749,3,34,11,3,14,7,72,38.26324545366476,-109.381519
22750,4,39,12,5,17,4,81,38.26324545366476,-109.3812495
22751,5,44,13,7,19,2,90,38.26324545366476,-109.38098
22752,5,45,13,7,19,1,90,38.26324545366476,-109.3807105
22753,5,46,13,6,19,1,90,38.26324545366476,-109.380441
22754,5,44,12,6,18,1,86,38.26324545366476,-109.3801716
22755,7,38,13,10,18,1,87,38.26324545366476,-109.3799021
22756,10,30,13,18,14,1,86,38.26324545366476,-109.3796326
22757,11,32,13,16,15,1,88,38.26324545366476,-109.3793631
22758,11,34,13,14,16,0,88,38.26324545366476,-109.3790936
22759,8,38,13,11,18,0,88,38.26324545366476,-109.3788241
22760,6,42,12,8,18,1,87,38.26324545366476,-109.3785546
22761,4,42,12,8,19,1,86,38.26324545366476,-109.3782851
22762,4,39,12,7,17,3,82,38.26324545366476,-109.3780156
22763,5,27,11,11,14,2,70,38.26324545366476,-109.3777461
22764,4,20,10,14,12,2,62,38.26324545366476,-109.3774766
22765,5,27,11,12,15,1,71,38.26324545366476,-109.3772071
22766,7,36,12,8,15,4,82,38.26324545366476,-109.3769376
22767,13,36,12,9,15,1,86,38.26324545366476,-109.3766681
22768,16,34,13,11,14,0,88,38.26324545366476,-109.3763986
22769,17,32,13,12,12,0,86,38.26324545366476,-109.3761291
22770,18,33,13,11,12,1,88,38.26324545366476,-109.3758596
22771,17,33,13,13,13,0,89,38.26324545366476,-109.3755901
22772,19,32,13,12,12,0,88,38.26324545366476,-109.3753206
22773,24,30,12,11,11,0,88,38.26324545366476,-109.3750512
22774,32,26,12,9,9,0,88,38.26324545366476,-109.3747817
22775,35,24,12,11,10,0,92,38.26324545366476,-109.3745122
22776,34,24,11,12,10,0,91,38.26324545366476,-109.3742427
22777,27,27,12,13,11,0,90,38.26324545366476,-109.3739732
22778,24,30,12,12,11,0,89,38.26324545366476,-109.3737037
22779,21,33,13,11,12,0,90,38.26324545366476,-109.3734342
22780,12,41,13,8,12,2,88,38.26324545366476,-109.3731647
22781,13,34,13,9,10,6,85,38.26324545366476,-109.3728952
22782,21,20,16,7,5,16,85,38.26324545366476,-109.3726257
22783,28,9,16,4,10,24,91,38.26324545366476,-109.3723562
22784,17,17,18,5,6,24,87,38.26324545366476,-109.3720867
22785,8,25,17,2,5,27,84,38.26324545366476,-109.3718172
22786,4,23,16,1,3,27,74,38.26324545366476,-109.3715477
22787,4,23,15,1,3,24,70,38.26324545366476,-109.3712782
22788,7,32,13,4,9,13,78,38.26324545366476,-109.3710087
22789,9,37,13,7,12,6,84,38.26324545366476,-109.3707392
22790,13,36,13,8,11,4,85,38.26324545366476,-109.3704697
22791,13,35,13,7,10,6,84,38.26324545366476,-109.3702003
22792,10,34,12,4,9,9,78,38.26324545366476,-109.3699308
22793,7,33,12,4,8,10,74,38.26324545366476,-109.3696613
22794,5,36,12,2,7,12,74,38.26324545366476,-109.3693918
22795,4,35,11,2,8,11,71,38.26324545366476,-109.3691223
22796,4,34,11,2,8,11,70,38.26324545366476,-109.3688528
22797,4,35,11,2,8,11,71,38.26324545366476,-109.3685833
22798,3,37,11,1,9,10,71,38.26324545366476,-109.3683138
22799,3,35,11,2,10,9,70,38.26324545366476,-109.3680443
22800,2,35,10,3,11,8,69,38.26324545366476,-109.3677748
22801,2,39,10,2,12,7,72,38.26324545366476,-109.3675053
22802,1,41,10,2,9,8,71,38.26324545366476,-109.3672358
22803,1,45,8,3,10,6,73,38.26324545366476,-109.3669663
22804,1,45,7,3,10,4,70,38.26324545366476,-109.3666968
22805,1,45,7,3,9,5,70,38.26324545366476,-109.3664273
22806,0,46,6,0,9,5,66,38.26324545366476,-109.3661578
22807,1,50,7,2,9,3,72,38.26324545366476,-109.3658883
22808,0,43,6,1,8,6,64,38.26324545366476,-109.3656188
22809,1,45,7,2,10,5,70,38.26324545366476,-109.3653493
22810,1,37,8,2,9,5,62,38.26324545366476,-109.3650799
22811,2,36,9,3,9,7,66,38.26324545366476,-109.3648104
22812,2,33,11,0,7,15,68,38.26324545366476,-109.3645409
22813,3,31,12,1,7,16,70,38.26324545366476,-109.3642714
22814,2,25,13,0,3,19,62,38.26324545366476,-109.3640019
22815,3,21,12,2,4,17,59,38.26324545366476,-109.3637324
22816,5,21,10,4,5,10,55,38.26324545366476,-109.3634629
22817,10,23,11,9,8,4,65,38.26324545366476,-109.3631934
22818,1,22,12,11,9,10,65,38.26324545366476,-109.3629239
22819,2,25,13,12,15,10,77,38.26324545366476,-109.3626544
22820,3,25,12,5,17,12,74,38.26324545366476,-109.3623849
22821,2,25,13,4,9,16,69,38.26324545366476,-109.3621154
22822,2,25,12,1,7,17,64,38.26324545366476,-109.3618459
22823,2,26,12,1,6,16,63,38.26324545366476,-109.3615764
22824,1,27,12,2,7,16,65,38.26324545366476,-109.3613069
22825,1,27,13,2,7,17,67,38.26324545366476,-109.3610374
22826,0,28,12,2,7,17,66,38.26324545366476,-109.3607679
22827,0,31,10,1,8,15,65,38.26324545366476,-109.3604984
22828,1,34,10,0,10,13,68,38.26324545366476,-109.360229
22829,1,36,10,0,13,11,71,38.26324545366476,-109.3599595
22830,2,36,10,0,11,12,71,38.26324545366476,-109.35969
22831,1,34,10,0,9,14,68,38.26324545366476,-109.3594205
22832,0,32,11,0,9,14,66,38.26324545366476,-109.359151
22833,1,34,10,0,9,13,67,38.26324545366476,-109.3588815
22834,1,36,10,0,11,11,69,38.26324545366476,-109.358612
22835,1,34,10,0,11,12,68,38.26324545366476,-109.3583425
22836,1,36,10,0,9,14,70,38.26324545366476,-109.358073
22837,1,33,11,0,7,16,68,38.26324545366476,-109.3578035
22838,2,28,12,2,6,15,65,38.26324545366476,-109.357534
22839,4,24,14,4,5,13,64,38.26324545366476,-109.3572645
22840,4,32,13,5,8,10,72,38.26324545366476,-109.356995
22841,2,25,11,3,7,11,59,38.26324545366476,-109.3567255
22842,3,26,12,5,8,9,63,38.26324545366476,-109.356456
22843,2,26,13,6,8,10,65,38.26324545366476,-109.3561865
22844,1,23,12,5,7,14,62,38.26324545366476,-109.355917
22845,1,23,13,0,3,22,62,38.26324545366476,-109.3556475
22846,2,25,13,0,6,20,66,38.26324545366476,-109.355378
22847,2,25,14,0,6,23,70,38.26324545366476,-109.3551086
22848,1,26,14,0,7,23,71,38.26324545366476,-109.3548391
22849,0,28,11,0,9,18,66,38.26324545366476,-109.3545696
22850,0,27,12,0,9,17,65,38.26324545366476,-109.3543001
22851,1,25,14,0,8,20,68,38.26324545366476,-109.3540306
22852,2,29,16,0,6,27,80,38.26324545366476,-109.3537611
22853,1,28,16,0,7,24,76,38.26324545366476,-109.3534916
22854,0,28,14,0,10,19,71,38.26324545366476,-109.3532221
22855,2,37,13,10,8,13,83,38.26324545366476,-109.3529526
22856,7,37,12,12,13,6,87,38.26324545366476,-109.3526831
22857,11,36,11,15,15,1,89,38.26324545366476,-109.3524136
22858,10,33,12,15,11,5,86,38.26324545366476,-109.3521441
22859,8,25,14,16,16,5,84,38.26324545366476,-109.3518746
22860,8,23,15,12,17,11,86,38.26324545366476,-109.3516051
22861,13,23,14,16,18,5,89,38.26324545366476,-109.3513356
22862,19,26,12,19,16,0,92,38.26324545366476,-109.3510661
22863,21,28,12,17,13,1,92,38.26324545366476,-109.3507966
22864,8,26,14,14,19,6,87,38.26324545366476,-109.3505271
22865,4,22,14,15,17,7,79,38.26324545366476,-109.3502577
22866,4,20,14,16,17,9,80,38.26324545366476,-109.3499882
22867,5,21,13,18,22,4,83,38.26324545366476,-109.3497187
22868,4,18,12,16,22,2,74,38.26324545366476,-109.3494492
22869,9,14,10,20,21,1,75,38.26324545366476,-109.3491797
22870,6,11,9,19,17,1,63,38.26324545366476,-109.3489102
22871,0,9,13,15,13,12,62,38.26324545366476,-109.3486407
22872,0,13,15,9,16,15,68,38.26324545366476,-109.3483712
22873,2,21,16,3,10,23,75,38.26324545366476,-109.3481017
22874,1,21,19,1,8,29,79,38.26324545366476,-109.3478322
22875,1,22,20,0,4,35,82,38.26324545366476,-109.3475627
22876,1,21,19,0,4,34,79,38.26324545366476,-109.3472932
22877,0,22,18,0,4,33,77,38.26324545366476,-109.3470237
22878,0,20,19,0,3,33,75,38.26324545366476,-109.3467542
22879,1,21,19,0,3,32,76,38.26324545366476,-109.3464847
22880,2,24,18,1,4,29,78,38.26324545366476,-109.3462152
22881,1,23,18,1,4,30,77,38.26324545366476,-109.3459457
22882,1,20,20,0,5,33,79,38.26324545366476,-109.3456762
22883,2,23,19,1,5,31,81,38.26324545366476,-109.3454068
22884,5,28,18,4,6,24,85,38.26324545366476,-109.3451373
22885,6,29,16,7,9,19,86,38.26324545366476,-109.3448678
22886,6,30,16,7,10,18,87,38.26324545366476,-109.3445983
22887,5,31,16,7,11,17,87,38.26324545366476,-109.3443288
22888,5,29,16,8,11,17,86,38.26324545366476,-109.3440593
22889,7,29,15,12,11,12,86,38.26324545366476,-109.3437898
22890,10,31,14,16,12,5,88,38.26324545366476,-109.3435203
22891,8,34,13,15,13,4,87,38.26324545366476,-109.3432508
22892,7,36,13,14,13,4,87,38.26324545366476,-109.3429813
22893,6,39,13,11,14,4,87,38.26324545366476,-109.3427118
22894,6,41,13,8,15,5,88,38.26324545366476,-109.3424423
22895,6,42,13,8,15,4,88,38.26324545366476,-109.3421728
22896,6,43,13,7,17,3,89,38.26324545366476,-109.3419033
22897,6,41,13,7,17,4,88,38.26324545366476,-109.3416338
22898,6,39,13,6,16,6,86,38.26324545366476,-109.3413643
22899,6,38,13,6,14,7,84,38.26324545366476,-109.3410948
22900,5,34,14,3,10,16,82,38.26324545366476,-109.3408253
22901,2,25,17,1,5,26,76,38.26324545366476,-109.3405558
22902,1,21,18,1,3,30,74,38.26324545366476,-109.3402864
22903,2,22,18,0,3,30,75,38.26324545366476,-109.3400169
22904,2,25,17,1,4,26,75,38.26324545366476,-109.3397474
22905,4,34,15,3,9,17,82,38.26324545366476,-109.3394779
22906,5,39,14,4,12,12,86,38.26324545366476,-109.3392084
22907,4,39,13,3,12,12,83,38.26324545366476,-109.3389389
22908,4,37,14,3,12,13,83,38.26324545366476,-109.3386694
22909,4,36,14,3,12,14,83,38.26324545366476,-109.3383999
22910,4,29,15,6,11,16,81,38.26324545366476,-109.3381304
22911,2,20,15,0,3,25,65,38.26324545366476,-109.3378609
22912,2,17,14,1,3,24,61,38.26324545366476,-109.3375914
22913,1,16,13,2,3,22,57,38.26324545366476,-109.3373219
22914,1,18,13,2,3,22,59,38.26324545366476,-109.3370524
22915,1,18,16,1,3,25,64,38.26324545366476,-109.3367829
22916,1,18,14,2,3,24,62,38.26324545366476,-109.3365134
22917,1,26,11,2,6,17,63,38.26324545366476,-109.3362439
22918,1,30,9,2,8,12,62,38.26324545366476,-109.3359744
22919,0,40,7,0,10,8,65,38.26324545366476,-109.3357049
22920,0,45,7,1,11,6,70,38.26324545366476,-109.3354355
22921,0,49,7,1,11,4,72,38.26324545366476,-109.335166
22922,0,50,7,1,11,4,73,38.26324545366476,-109.3348965
22923,0,48,7,1,11,5,72,38.26324545366476,-109.334627
22924,2,39,8,3,10,7,69,38.262975959079526,-109.4421553
22925,1,39,9,3,10,9,71,38.262975959079526,-109.4418858
22926,1,40,10,2,12,10,75,38.262975959079526,-109.4416163
22927,2,49,10,2,12,8,83,38.262975959079526,-109.4413468
22928,2,44,10,0,11,10,77,38.262975959079526,-109.4410773
22929,1,37,9,1,9,11,68,38.262975959079526,-109.4408078
22930,1,35,8,2,9,9,64,38.262975959079526,-109.4405383
22931,2,41,8,3,11,5,70,38.262975959079526,-109.4402688
22932,1,39,8,3,10,6,67,38.262975959079526,-109.4399993
22933,2,38,8,4,10,6,68,38.262975959079526,-109.4397299
22934,2,39,9,3,12,6,71,38.262975959079526,-109.4394604
22935,1,42,9,1,13,8,74,38.262975959079526,-109.4391909
22936,1,45,10,1,14,8,79,38.262975959079526,-109.4389214
22937,1,40,9,0,12,9,71,38.262975959079526,-109.4386519
22938,0,45,9,0,14,8,76,38.262975959079526,-109.4383824
22939,1,46,9,0,14,9,79,38.262975959079526,-109.4381129
22940,1,43,10,0,14,9,77,38.262975959079526,-109.4378434
22941,2,42,9,3,14,6,76,38.262975959079526,-109.4375739
22942,2,40,9,3,14,6,74,38.262975959079526,-109.4373044
22943,2,38,9,3,10,7,69,38.262975959079526,-109.4370349
22944,1,37,9,2,10,7,66,38.262975959079526,-109.4367654
22945,1,42,8,2,10,5,68,38.262975959079526,-109.4364959
22946,1,44,8,1,12,5,71,38.262975959079526,-109.4362264
22947,2,44,10,4,14,5,79,38.262975959079526,-109.4359569
22948,4,48,10,5,14,3,84,38.262975959079526,-109.4356874
22949,3,53,10,5,14,2,87,38.262975959079526,-109.4354179
22950,1,57,8,2,15,2,85,38.262975959079526,-109.4351484
22951,1,56,8,1,14,3,83,38.262975959079526,-109.434879
22952,2,49,9,1,14,5,80,38.262975959079526,-109.4346095
22953,3,42,9,1,12,8,75,38.262975959079526,-109.43434
22954,3,43,10,2,14,7,79,38.262975959079526,-109.4340705
22955,2,45,10,2,13,9,81,38.262975959079526,-109.433801
22956,2,45,11,2,13,9,82,38.262975959079526,-109.4335315
22957,3,43,11,3,15,6,81,38.262975959079526,-109.433262
22958,5,42,11,5,15,4,82,38.262975959079526,-109.4329925
22959,11,40,13,9,15,2,90,38.262975959079526,-109.432723
22960,18,35,14,11,14,0,92,38.262975959079526,-109.4324535
22961,20,35,14,11,13,0,93,38.262975959079526,-109.432184
22962,15,38,15,12,13,0,93,38.262975959079526,-109.4319145
22963,10,38,15,13,13,1,90,38.262975959079526,-109.431645
22964,8,38,15,12,12,2,87,38.262975959079526,-109.4313755
22965,7,42,14,11,12,2,88,38.262975959079526,-109.431106
22966,7,43,14,11,12,2,89,38.262975959079526,-109.4308365
22967,8,40,14,12,13,1,88,38.262975959079526,-109.430567
22968,10,37,15,13,14,1,90,38.262975959079526,-109.4302975
22969,14,36,15,13,14,0,92,38.262975959079526,-109.430028
22970,10,38,14,13,14,1,90,38.262975959079526,-109.4297586
22971,9,41,14,12,14,1,91,38.262975959079526,-109.4294891
22972,8,42,14,11,14,1,90,38.262975959079526,-109.4292196
22973,9,41,14,12,14,1,91,38.262975959079526,-109.4289501
22974,19,36,14,10,12,0,91,38.262975959079526,-109.4286806
22975,22,34,14,10,11,0,91,38.262975959079526,-109.4284111
22976,19,35,14,11,12,0,91,38.262975959079526,-109.4281416
22977,16,36,15,11,13,0,91,38.262975959079526,-109.4278721
22978,16,34,15,13,13,0,91,38.262975959079526,-109.4276026
22979,15,35,15,13,13,0,91,38.262975959079526,-109.4273331
22980,12,36,15,13,13,0,89,38.262975959079526,-109.4270636
22981,10,37,15,13,14,0,89,38.262975959079526,-109.4267941
22982,9,38,14,13,13,1,88,38.262975959079526,-109.4265246
22983,10,39,14,12,13,1,89,38.262975959079526,-109.4262551
22984,10,38,14,11,14,1,88,38.262975959079526,-109.4259856
22985,11,36,14,12,14,1,88,38.262975959079526,-109.4257161
22986,11,36,15,12,14,1,89,38.262975959079526,-109.4254466
22987,10,36,15,13,14,1,89,38.262975959079526,-109.4251771
22988,6,38,15,11,15,1,86,38.262975959079526,-109.4249077
22989,6,38,15,12,15,1,87,38.262975959079526,-109.4246382
22990,7,39,15,13,15,1,90,38.262975959079526,-109.4243687
22991,9,40,15,13,16,0,93,38.262975959079526,-109.4240992
22992,9,41,14,12,16,0,92,38.262975959079526,-109.4238297
22993,9,40,14,11,17,0,91,38.262975959079526,-109.4235602
22994,12,38,14,12,16,0,92,38.262975959079526,-109.4232907
22995,13,36,14,13,15,0,91,38.262975959079526,-109.4230212
22996,12,34,13,12,15,0,86,38.262975959079526,-109.4227517
22997,14,31,12,10,15,1,83,38.262975959079526,-109.4224822
22998,22,29,12,10,13,0,86,38.262975959079526,-109.4222127
22999,23,29,13,10,13,0,88,38.262975959079526,-109.4219432
23000,20,31,13,10,14,0,88,38.262975959079526,-109.4216737
23001,16,35,14,10,14,1,90,38.262975959079526,-109.4214042
23002,13,40,13,10,15,0,91,38.262975959079526,-109.4211347
23003,13,41,13,9,14,1,91,38.262975959079526,-109.4208652
23004,10,46,13,8,14,1,92,38.262975959079526,-109.4205957
23005,7,48,13,8,15,1,92,38.262975959079526,-109.4203262
23006,8,45,13,8,16,1,91,38.262975959079526,-109.4200568
23007,9,44,13,10,16,0,92,38.262975959079526,-109.4197873
23008,10,43,13,9,16,0,91,38.262975959079526,-109.4195178
23009,9,44,13,8,16,0,90,38.262975959079526,-109.4192483
23010,8,46,13,8,16,1,92,38.262975959079526,-109.4189788
23011,9,46,13,8,16,0,92,38.262975959079526,-109.4187093
23012,7,48,13,8,16,1,93,38.262975959079526,-109.4184398
23013,8,51,12,7,15,1,94,38.262975959079526,-109.4181703
23014,6,54,11,7,14,1,93,38.262975959079526,-109.4179008
23015,5,56,10,6,14,0,91,38.262975959079526,-109.4176313
23016,7,53,10,9,13,0,92,38.262975959079526,-109.4173618
23017,7,53,11,6,16,0,93,38.262975959079526,-109.4170923
23018,6,50,13,6,17,1,93,38.262975959079526,-109.4168228
23019,5,49,13,5,17,2,91,38.262975959079526,-109.4165533
23020,6,48,12,5,18,2,91,38.262975959079526,-109.4162838
23021,6,46,12,6,17,2,89,38.262975959079526,-109.4160143
23022,6,46,12,6,17,3,90,38.262975959079526,-109.4157448
23023,6,46,12,6,16,3,89,38.262975959079526,-109.4154753
23024,6,47,12,5,16,3,89,38.262975959079526,-109.4152058
23025,5,44,12,5,17,4,87,38.262975959079526,-109.4149364
23026,5,47,12,5,17,2,88,38.262975959079526,-109.4146669
23027,5,48,12,4,17,3,89,38.262975959079526,-109.4143974
23028,5,48,12,4,18,3,90,38.262975959079526,-109.4141279
23029,6,46,12,5,19,2,90,38.262975959079526,-109.4138584
23030,6,46,12,5,17,2,88,38.262975959079526,-109.4135889
23031,7,46,12,6,17,1,89,38.262975959079526,-109.4133194
23032,7,46,12,5,17,1,88,38.262975959079526,-109.4130499
23033,6,50,12,4,17,1,90,38.262975959079526,-109.4127804
23034,5,53,12,4,16,2,92,38.262975959079526,-109.4125109
23035,5,51,12,6,15,2,91,38.262975959079526,-109.4122414
23036,6,52,13,7,15,1,94,38.262975959079526,-109.4119719
23037,6,53,12,6,15,1,93,38.262975959079526,-109.4117024
23038,5,53,12,6,15,1,92,38.262975959079526,-109.4114329
23039,5,52,12,5,15,2,91,38.262975959079526,-109.4111634
23040,5,54,12,5,15,2,93,38.262975959079526,-109.4108939
23041,5,54,12,5,15,1,92,38.262975959079526,-109.4106244
23042,5,54,12,5,16,1,93,38.262975959079526,-109.4103549
23043,6,54,12,5,16,1,94,38.262975959079526,-109.4100855
23044,7,51,12,6,16,1,93,38.262975959079526,-109.409816
23045,6,52,13,6,17,1,95,38.262975959079526,-109.4095465
23046,5,51,13,6,16,2,93,38.262975959079526,-109.409277
23047,5,50,13,5,16,2,91,38.262975959079526,-109.4090075
23048,5,49,13,5,17,3,92,38.262975959079526,-109.408738
23049,5,47,12,3,16,4,87,38.262975959079526,-109.4084685
23050,5,46,12,4,15,4,86,38.262975959079526,-109.408199
23051,6,45,12,4,15,4,86,38.262975959079526,-109.4079295
23052,6,46,12,6,15,2,87,38.262975959079526,-109.40766
23053,4,44,10,10,11,2,81,38.262975959079526,-109.4073905
23054,2,45,9,7,9,2,74,38.262975959079526,-109.407121
23055,1,41,9,5,10,4,70,38.262975959079526,-109.4068515
23056,2,38,12,0,13,12,77,38.262975959079526,-109.3879869
23057,2,33,11,0,10,14,70,38.262975959079526,-109.3877174
23058,2,34,11,0,11,13,71,38.262975959079526,-109.3874479
23059,4,41,13,2,15,7,82,38.262975959079526,-109.3871784
23060,4,43,13,3,16,7,86,38.262975959079526,-109.3869089
23061,5,46,13,4,17,3,88,38.262975959079526,-109.3866394
23062,6,47,13,5,17,2,90,38.262975959079526,-109.3863699
23063,6,48,13,5,16,2,90,38.262975959079526,-109.3861004
23064,5,50,13,4,16,4,92,38.262975959079526,-109.3858309
23065,4,51,12,2,13,6,88,38.262975959079526,-109.3855614
23066,2,51,10,1,13,7,84,38.262975959079526,-109.3852919
23067,1,54,9,0,14,5,83,38.262975959079526,-109.3850225
23068,0,58,8,0,15,3,84,38.262975959079526,-109.384753
23069,1,45,9,3,13,3,74,38.262975959079526,-109.3844835
23070,1,36,9,2,10,7,65,38.262975959079526,-109.384214
23071,1,33,11,3,10,10,68,38.262975959079526,-109.3839445
23072,2,35,13,1,11,14,76,38.262975959079526,-109.383675
23073,2,38,12,1,12,13,78,38.262975959079526,-109.3834055
23074,3,41,12,1,14,11,82,38.262975959079526,-109.383136
23075,3,42,12,1,15,10,83,38.262975959079526,-109.3828665
23076,2,40,12,1,15,10,80,38.262975959079526,-109.382597
23077,2,38,12,2,15,9,78,38.262975959079526,-109.3823275
23078,1,34,11,0,12,13,71,38.262975959079526,-109.382058
23079,1,32,11,1,12,11,68,38.262975959079526,-109.3817885
23080,2,32,11,1,12,10,68,38.262975959079526,-109.381519
23081,2,36,11,3,14,7,73,38.262975959079526,-109.3812495
23082,4,44,12,4,18,3,85,38.262975959079526,-109.38098
23083,4,47,12,5,19,1,88,38.262975959079526,-109.3807105
23084,4,46,12,4,18,2,86,38.262975959079526,-109.380441
23085,5,41,12,7,17,2,84,38.262975959079526,-109.3801716
23086,6,34,12,13,17,2,84,38.262975959079526,-109.3799021
23087,8,29,12,21,15,1,86,38.262975959079526,-109.3796326
23088,8,36,13,13,18,0,88,38.262975959079526,-109.3793631
23089,6,40,13,11,19,0,89,38.262975959079526,-109.3790936
23090,5,42,12,9,19,1,88,38.262975959079526,-109.3788241
23091,6,42,12,8,18,1,87,38.262975959079526,-109.3785546
23092,4,40,12,7,18,2,83,38.262975959079526,-109.3782851
23093,6,35,11,6,15,2,75,38.262975959079526,-109.3780156
23094,7,25,10,8,12,2,64,38.262975959079526,-109.3777461
23095,6,22,10,8,12,2,60,38.262975959079526,-109.3774766
23096,12,32,11,8,13,2,78,38.262975959079526,-109.3772071
23097,10,34,12,12,15,1,84,38.262975959079526,-109.3769376
23098,9,38,12,11,15,1,86,38.262975959079526,-109.3766681
23099,10,38,12,10,15,1,86,38.262975959079526,-109.3763986
23100,18,35,12,11,13,0,89,38.262975959079526,-109.3761291
23101,21,32,13,11,12,0,89,38.262975959079526,-109.3758596
23102,18,32,12,13,13,0,88,38.262975959079526,-109.3755901
23103,19,29,12,17,12,0,89,38.262975959079526,-109.3753206
23104,22,26,12,20,11,0,91,38.262975959079526,-109.3750512
23105,25,25,13,20,10,0,93,38.262975959079526,-109.3747817
23106,26,24,13,21,9,0,93,38.262975959079526,-109.3745122
23107,26,27,12,15,10,0,90,38.262975959079526,-109.3742427
23108,22,29,12,14,12,0,89,38.262975959079526,-109.3739732
23109,18,32,12,11,13,2,88,38.262975959079526,-109.3737037
23110,13,35,13,6,12,5,84,38.262975959079526,-109.3734342
23111,8,39,12,7,11,7,84,38.262975959079526,-109.3731647
23112,12,31,13,9,11,7,83,38.262975959079526,-109.3728952
23113,19,17,15,9,8,14,82,38.262975959079526,-109.3726257
23114,11,15,19,5,6,28,84,38.262975959079526,-109.3723562
23115,8,22,18,4,1,27,80,38.262975959079526,-109.3720867
23116,5,24,16,2,2,25,74,38.262975959079526,-109.3718172
23117,3,31,14,1,6,20,75,38.262975959079526,-109.3715477
23118,4,36,13,2,10,14,79,38.262975959079526,-109.3712782
23119,6,40,13,4,12,9,84,38.262975959079526,-109.3710087
23120,9,41,13,8,13,3,87,38.262975959079526,-109.3707392
23121,12,40,13,9,13,2,89,38.262975959079526,-109.3704697
23122,12,38,13,8,13,3,87,38.262975959079526,-109.3702003
23123,7,36,12,6,11,7,79,38.262975959079526,-109.3699308
23124,4,30,12,4,9,13,72,38.262975959079526,-109.3696613
23125,3,27,13,2,4,18,67,38.262975959079526,-109.3693918
23126,3,25,13,2,5,18,66,38.262975959079526,-109.3691223
23127,3,23,13,2,5,19,65,38.262975959079526,-109.3688528
23128,2,22,14,1,3,22,64,38.262975959079526,-109.3685833
23129,2,24,14,1,4,21,66,38.262975959079526,-109.3683138
23130,0,26,11,0,6,18,61,38.262975959079526,-109.3680443
23131,1,35,10,0,10,10,66,38.262975959079526,-109.3677748
23132,1,44,8,3,10,6,72,38.262975959079526,-109.3675053
23133,2,53,7,5,11,3,81,38.262975959079526,-109.3672358
23134,2,49,7,5,10,4,77,38.262975959079526,-109.3669663
23135,1,48,7,4,10,3,73,38.262975959079526,-109.3666968
23136,1,48,7,3,9,4,72,38.262975959079526,-109.3664273
23137,0,46,6,0,8,4,64,38.262975959079526,-109.3661578
23138,0,44,7,1,9,4,65,38.262975959079526,-109.3658883
23139,1,45,7,1,9,4,67,38.262975959079526,-109.3656188
23140,1,43,8,2,10,4,68,38.262975959079526,-109.3653493
23141,2,36,9,3,11,5,66,38.262975959079526,-109.3650799
23142,4,35,10,3,8,8,68,38.262975959079526,-109.3648104
23143,1,32,11,0,6,15,65,38.262975959079526,-109.3645409
23144,2,38,10,0,9,12,71,38.262975959079526,-109.3642714
23145,2,25,10,2,5,13,57,38.262975959079526,-109.3640019
23146,3,18,10,5,6,10,52,38.262975959079526,-109.3637324
23147,7,20,12,7,7,6,59,38.262975959079526,-109.3634629
23148,3,23,13,10,9,10,68,38.262975959079526,-109.3631934
23149,2,24,13,7,11,12,69,38.262975959079526,-109.3629239
23150,3,26,12,8,14,8,71,38.262975959079526,-109.3626544
23151,3,20,12,6,10,11,62,38.262975959079526,-109.3623849
23152,5,24,11,5,10,9,64,38.262975959079526,-109.3621154
23153,3,26,11,3,9,11,63,38.262975959079526,-109.3618459
23154,2,30,11,2,8,12,65,38.262975959079526,-109.3615764
23155,2,30,11,1,6,13,63,38.262975959079526,-109.3613069
23156,1,29,11,1,6,13,61,38.262975959079526,-109.3610374
23157,2,33,11,1,6,12,65,38.262975959079526,-109.3607679
23158,3,31,10,2,6,10,62,38.262975959079526,-109.3604984
23159,4,30,10,1,7,10,62,38.262975959079526,-109.360229
23160,3,31,11,0,9,13,67,38.262975959079526,-109.3599595
23161,2,35,12,0,8,16,73,38.262975959079526,-109.35969
23162,2,37,11,0,8,15,73,38.262975959079526,-109.3594205
23163,1,32,11,1,9,15,69,38.262975959079526,-109.359151
23164,1,30,11,0,7,17,66,38.262975959079526,-109.3588815
23165,1,29,12,0,7,17,66,38.262975959079526,-109.358612
23166,0,29,11,0,7,17,64,38.262975959079526,-109.3583425
23167,1,30,11,0,5,19,66,38.262975959079526,-109.358073
23168,0,28,13,1,5,18,65,38.262975959079526,-109.3578035
23169,1,24,14,2,5,19,65,38.262975959079526,-109.357534
23170,2,21,14,1,5,21,64,38.262975959079526,-109.3572645
23171,1,22,14,1,5,22,65,38.262975959079526,-109.356995
23172,1,23,14,1,5,23,67,38.262975959079526,-109.3567255
23173,0,25,14,0,5,24,68,38.262975959079526,-109.356456
23174,1,28,14,0,6,22,71,38.262975959079526,-109.3561865
23175,3,30,14,0,7,19,73,38.262975959079526,-109.355917
23176,2,27,13,0,5,21,68,38.262975959079526,-109.3556475
23177,2,29,12,0,8,20,71,38.262975959079526,-109.355378
23178,1,28,13,0,8,22,72,38.262975959079526,-109.3551086
23179,1,27,13,0,8,23,72,38.262975959079526,-109.3548391
23180,1,26,14,3,12,18,74,38.262975959079526,-109.3545696
23181,1,26,14,0,11,20,72,38.262975959079526,-109.3543001
23182,1,26,14,0,10,21,72,38.262975959079526,-109.3540306
23183,1,23,15,0,8,23,70,38.262975959079526,-109.3537611
23184,1,23,16,1,8,24,73,38.262975959079526,-109.3534916
23185,1,23,16,6,11,19,76,38.262975959079526,-109.3532221
23186,6,25,15,13,14,13,86,38.262975959079526,-109.3529526
23187,6,25,15,15,15,10,86,38.262975959079526,-109.3526831
23188,7,24,14,18,17,7,87,38.262975959079526,-109.3524136
23189,14,26,11,21,14,0,86,38.262975959079526,-109.3521441
23190,6,23,13,15,22,7,86,38.262975959079526,-109.3518746
23191,2,16,15,18,20,11,82,38.262975959079526,-109.3516051
23192,9,20,13,15,25,7,89,38.262975959079526,-109.3513356
23193,14,23,12,19,19,2,89,38.262975959079526,-109.3510661
23194,19,27,12,17,16,0,91,38.262975959079526,-109.3507966
23195,5,27,13,18,14,4,81,38.262975959079526,-109.3505271
23196,5,29,12,19,13,2,80,38.262975959079526,-109.3502577
23197,4,26,13,16,19,2,80,38.262975959079526,-109.3499882
23198,6,20,12,15,24,2,79,38.262975959079526,-109.3497187
23199,4,14,11,18,16,2,65,38.262975959079526,-109.3494492
23200,5,8,10,16,16,2,57,38.262975959079526,-109.3491797
23201,3,9,12,18,18,7,67,38.262975959079526,-109.3489102
23202,0,17,16,7,13,18,71,38.262975959079526,-109.3486407
23203,2,24,16,3,11,22,78,38.262975959079526,-109.3483712
23204,1,23,18,2,7,28,79,38.262975959079526,-109.3481017
23205,1,23,19,0,5,33,81,38.262975959079526,-109.3478322
23206,1,23,19,0,4,33,80,38.262975959079526,-109.3475627
23207,2,22,19,0,4,32,79,38.262975959079526,-109.3472932
23208,1,20,19,0,3,32,75,38.262975959079526,-109.3470237
23209,2,21,19,1,4,31,78,38.262975959079526,-109.3467542
23210,3,24,18,2,5,30,82,38.262975959079526,-109.3464847
23211,3,26,18,1,5,28,81,38.262975959079526,-109.3462152
23212,2,23,18,1,3,29,76,38.262975959079526,-109.3459457
23213,1,20,19,1,4,31,76,38.262975959079526,-109.3456762
23214,2,21,21,1,5,33,83,38.262975959079526,-109.3454068
23215,1,23,20,1,6,32,83,38.262975959079526,-109.3451373
23216,1,24,19,1,8,31,84,38.262975959079526,-109.3448678
23217,2,25,19,2,9,28,85,38.262975959079526,-109.3445983
23218,5,26,19,5,10,24,89,38.262975959079526,-109.3443288
23219,3,26,19,4,11,24,87,38.262975959079526,-109.3440593
23220,5,28,17,8,11,18,87,38.262975959079526,-109.3437898
23221,8,30,14,16,11,8,87,38.262975959079526,-109.3435203
23222,8,34,13,15,12,5,87,38.262975959079526,-109.3432508
23223,7,36,13,13,13,5,87,38.262975959079526,-109.3429813
23224,7,38,13,11,13,5,87,38.262975959079526,-109.3427118
23225,6,40,13,9,14,5,87,38.262975959079526,-109.3424423
23226,6,41,13,7,14,5,86,38.262975959079526,-109.3421728
23227,6,43,13,6,15,5,88,38.262975959079526,-109.3419033
23228,6,42,13,6,16,4,87,38.262975959079526,-109.3416338
23229,6,38,13,5,15,8,85,38.262975959079526,-109.3413643
23230,4,29,14,2,8,19,76,38.262975959079526,-109.3410948
23231,2,19,17,0,1,31,70,38.262975959079526,-109.3408253
23232,1,14,18,0,1,32,66,38.262975959079526,-109.3405558
23233,1,17,18,0,1,32,69,38.262975959079526,-109.3402864
23234,1,20,19,0,2,32,74,38.262975959079526,-109.3400169
23235,1,22,19,0,4,31,77,38.262975959079526,-109.3397474
23236,1,23,19,0,3,30,76,38.262975959079526,-109.3394779
23237,2,28,16,1,5,24,76,38.262975959079526,-109.3392084
23238,2,28,16,0,5,25,76,38.262975959079526,-109.3389389
23239,2,27,16,1,6,23,75,38.262975959079526,-109.3386694
23240,3,28,15,1,7,21,75,38.262975959079526,-109.3383999
23241,3,22,15,3,5,23,71,38.262975959079526,-109.3381304
23242,2,14,14,1,3,25,59,38.262975959079526,-109.3378609
23243,1,14,14,0,2,25,56,38.262975959079526,-109.3375914
23244,1,14,15,1,2,24,57,38.262975959079526,-109.3373219
23245,1,15,16,1,2,28,63,38.262975959079526,-109.3370524
23246,1,18,17,0,2,30,68,38.262975959079526,-109.3367829
23247,1,19,15,0,3,26,64,38.262975959079526,-109.3365134
23248,1,21,14,0,4,23,63,38.262975959079526,-109.3362439
23249,1,20,14,3,4,21,63,38.262975959079526,-109.3359744
23250,1,19,14,3,4,21,62,38.262975959079526,-109.3357049
23251,1,22,13,4,7,16,63,38.262975959079526,-109.3354355
23252,1,23,12,3,6,16,61,38.262975959079526,-109.335166
23253,1,31,10,2,11,11,66,38.262975959079526,-109.3348965
23254,1,41,8,3,11,5,69,38.262975959079526,-109.334627
23255,1,46,7,2,11,4,71,38.262975959079526,-109.3343575
23256,2,43,10,1,12,10,78,38.262706464494286,-109.4421553
23257,2,40,11,2,13,10,78,38.262706464494286,-109.4418858
23258,3,41,12,5,15,7,83,38.262706464494286,-109.4416163
23259,2,49,10,3,13,8,85,38.262706464494286,-109.4413468
23260,2,42,10,1,12,10,77,38.262706464494286,-109.4410773
23261,1,41,10,2,12,10,76,38.262706464494286,-109.4408078
23262,1,42,9,1,12,8,73,38.262706464494286,-109.4405383
23263,2,39,9,3,11,8,72,38.262706464494286,-109.4402688
23264,1,39,9,3,11,7,70,38.262706464494286,-109.4399993
23265,2,37,9,3,11,8,70,38.262706464494286,-109.4397299
23266,1,36,9,2,11,9,68,38.262706464494286,-109.4394604
23267,1,39,9,0,13,9,71,38.262706464494286,-109.4391909
23268,0,40,9,0,12,9,70,38.262706464494286,-109.4389214
23269,1,39,8,1,9,9,67,38.262706464494286,-109.4386519
23270,1,40,8,2,11,7,69,38.262706464494286,-109.4383824
23271,1,45,8,1,12,6,73,38.262706464494286,-109.4381129
23272,1,51,8,0,12,5,77,38.262706464494286,-109.4378434
23273,2,54,9,1,14,4,84,38.262706464494286,-109.4375739
23274,2,48,9,0,11,9,79,38.262706464494286,-109.4373044
23275,1,38,9,0,10,12,70,38.262706464494286,-109.4370349
23276,0,35,9,1,9,12,66,38.262706464494286,-109.4367654
23277,1,38,8,1,10,8,66,38.262706464494286,-109.4364959
23278,1,41,9,1,13,7,72,38.262706464494286,-109.4362264
23279,2,43,10,3,14,5,77,38.262706464494286,-109.4359569
23280,2,43,10,4,14,5,78,38.262706464494286,-109.4356874
23281,3,45,11,5,16,3,83,38.262706464494286,-109.4354179
23282,7,49,11,6,16,1,90,38.262706464494286,-109.4351484
23283,10,46,11,7,16,0,90,38.262706464494286,-109.434879
23284,9,45,11,6,16,1,88,38.262706464494286,-109.4346095
23285,5,44,10,3,16,4,82,38.262706464494286,-109.43434
23286,3,46,10,2,15,5,81,38.262706464494286,-109.4340705
23287,2,46,10,1,13,9,81,38.262706464494286,-109.433801
23288,2,41,10,2,13,9,77,38.262706464494286,-109.4335315
23289,3,43,10,3,14,6,79,38.262706464494286,-109.433262
23290,5,45,11,5,16,2,84,38.262706464494286,-109.4329925
23291,11,40,13,10,15,0,89,38.262706464494286,-109.432723
23292,18,35,14,12,14,0,93,38.262706464494286,-109.4324535
23293,17,36,14,12,14,0,93,38.262706464494286,-109.432184
23294,12,40,14,12,14,1,93,38.262706464494286,-109.4319145
23295,9,40,14,13,13,1,90,38.262706464494286,-109.431645
23296,10,39,15,13,12,2,91,38.262706464494286,-109.4313755
23297,9,39,15,14,12,1,90,38.262706464494286,-109.431106
23298,8,43,14,13,13,1,92,38.262706464494286,-109.4308365
23299,9,43,14,12,13,1,92,38.262706464494286,-109.430567
23300,10,40,14,12,14,1,91,38.262706464494286,-109.4302975
23301,14,39,14,12,14,0,93,38.262706464494286,-109.430028
23302,10,40,14,12,14,1,91,38.262706464494286,-109.4297586
23303,8,42,14,12,14,1,91,38.262706464494286,-109.4294891
23304,8,42,14,11,13,1,89,38.262706464494286,-109.4292196
23305,10,42,14,10,13,1,90,38.262706464494286,-109.4289501
23306,17,35,13,7,10,0,82,38.262706464494286,-109.4286806
23307,15,37,14,10,12,1,89,38.262706464494286,-109.4284111
23308,13,40,14,11,13,1,92,38.262706464494286,-109.4281416
23309,11,40,14,12,13,1,91,38.262706464494286,-109.4278721
23310,11,39,15,13,12,1,91,38.262706464494286,-109.4276026
23311,12,37,15,13,13,1,91,38.262706464494286,-109.4273331
23312,14,37,15,13,13,0,92,38.262706464494286,-109.4270636
23313,12,38,15,13,14,0,92,38.262706464494286,-109.4267941
23314,10,39,14,12,13,1,89,38.262706464494286,-109.4265246
23315,11,40,14,11,12,0,88,38.262706464494286,-109.4262551
23316,13,40,14,11,13,0,91,38.262706464494286,-109.4259856
23317,12,38,14,12,14,0,90,38.262706464494286,-109.4257161
23318,11,38,14,12,14,1,90,38.262706464494286,-109.4254466
23319,9,39,14,12,14,1,89,38.262706464494286,-109.4251771
23320,6,39,15,11,15,1,87,38.262706464494286,-109.4249077
23321,5,40,14,11,15,1,86,38.262706464494286,-109.4246382
23322,6,41,14,11,16,1,89,38.262706464494286,-109.4243687
23323,7,41,14,12,16,0,90,38.262706464494286,-109.4240992
23324,7,41,14,12,16,1,91,38.262706464494286,-109.4238297
23325,7,39,14,11,16,1,88,38.262706464494286,-109.4235602
23326,11,38,14,12,16,0,91,38.262706464494286,-109.4232907
23327,11,36,14,13,15,0,89,38.262706464494286,-109.4230212
23328,10,35,14,12,14,1,86,38.262706464494286,-109.4227517
23329,10,31,13,11,14,1,80,38.262706464494286,-109.4224822
23330,12,30,12,9,13,1,77,38.262706464494286,-109.4222127
23331,13,27,12,11,13,1,77,38.262706464494286,-109.4219432
23332,14,26,13,12,13,1,79,38.262706464494286,-109.4216737
23333,15,30,13,11,14,1,84,38.262706464494286,-109.4214042
23334,16,33,13,11,14,0,87,38.262706464494286,-109.4211347
23335,20,35,13,10,13,0,91,38.262706464494286,-109.4208652
23336,14,40,14,10,14,0,92,38.262706464494286,-109.4205957
23337,9,44,13,10,15,1,92,38.262706464494286,-109.4203262
23338,9,42,13,11,14,1,90,38.262706464494286,-109.4200568
23339,13,41,14,11,13,0,92,38.262706464494286,-109.4197873
23340,10,40,14,10,15,0,89,38.262706464494286,-109.4195178
23341,8,41,13,10,16,1,89,38.262706464494286,-109.4192483
23342,8,44,13,11,16,0,92,38.262706464494286,-109.4189788
23343,11,44,13,10,14,0,92,38.262706464494286,-109.4187093
23344,10,46,13,9,13,1,92,38.262706464494286,-109.4184398
23345,9,50,11,9,13,1,93,38.262706464494286,-109.4181703
23346,6,53,11,10,12,0,92,38.262706464494286,-109.4179008
23347,6,54,10,10,12,0,92,38.262706464494286,-109.4176313
23348,11,49,11,9,14,0,94,38.262706464494286,-109.4173618
23349,11,45,12,8,15,0,91,38.262706464494286,-109.4170923
23350,6,47,12,7,17,1,90,38.262706464494286,-109.4168228
23351,5,49,12,5,18,2,91,38.262706464494286,-109.4165533
23352,5,48,12,5,18,3,91,38.262706464494286,-109.4162838
23353,6,46,13,5,17,3,90,38.262706464494286,-109.4160143
23354,6,46,12,6,17,2,89,38.262706464494286,-109.4157448
23355,6,46,12,6,17,2,89,38.262706464494286,-109.4154753
23356,7,46,12,6,16,2,89,38.262706464494286,-109.4152058
23357,7,46,12,5,17,2,89,38.262706464494286,-109.4149364
23358,6,45,12,6,17,2,88,38.262706464494286,-109.4146669
23359,5,46,12,5,18,2,88,38.262706464494286,-109.4143974
23360,5,46,12,5,17,3,88,38.262706464494286,-109.4141279
23361,5,46,12,5,17,2,87,38.262706464494286,-109.4138584
23362,6,46,12,6,17,2,89,38.262706464494286,-109.4135889
23363,6,47,12,6,16,2,89,38.262706464494286,-109.4133194
23364,5,48,12,5,17,2,89,38.262706464494286,-109.4130499
23365,4,52,12,5,17,2,92,38.262706464494286,-109.4127804
23366,4,53,12,5,15,2,91,38.262706464494286,-109.4125109
23367,5,52,12,5,14,2,90,38.262706464494286,-109.4122414
23368,5,51,13,6,15,2,92,38.262706464494286,-109.4119719
23369,6,52,13,6,15,2,94,38.262706464494286,-109.4117024
23370,5,54,12,5,15,2,93,38.262706464494286,-109.4114329
23371,5,54,12,5,15,1,92,38.262706464494286,-109.4111634
23372,5,53,12,6,15,1,92,38.262706464494286,-109.4108939
23373,5,54,12,5,15,1,92,38.262706464494286,-109.4106244
23374,5,53,12,5,15,2,92,38.262706464494286,-109.4103549
23375,6,53,12,6,15,2,94,38.262706464494286,-109.4100855
23376,7,50,12,6,17,0,92,38.262706464494286,-109.409816
23377,7,51,12,6,16,0,92,38.262706464494286,-109.4095465
23378,5,51,13,7,16,1,93,38.262706464494286,-109.409277
23379,5,51,13,6,16,1,92,38.262706464494286,-109.4090075
23380,5,51,13,5,17,2,93,38.262706464494286,-109.408738
23381,4,48,12,4,16,3,87,38.262706464494286,-109.4084685
23382,4,47,12,4,16,4,87,38.262706464494286,-109.408199
23383,5,46,12,4,15,4,86,38.262706464494286,-109.4079295
23384,4,47,11,4,15,3,84,38.262706464494286,-109.40766
23385,3,46,10,7,11,2,79,38.262706464494286,-109.4073905
23386,2,42,9,6,10,2,71,38.262706464494286,-109.407121
23387,1,42,9,4,10,4,70,38.262706464494286,-109.4068515
23388,2,36,12,0,12,13,75,38.262706464494286,-109.3879869
23389,3,31,12,0,9,15,70,38.262706464494286,-109.3877174
23390,3,35,12,0,12,13,75,38.262706464494286,-109.3874479
23391,4,42,13,2,15,7,83,38.262706464494286,-109.3871784
23392,4,44,13,4,16,6,87,38.262706464494286,-109.3869089
23393,5,46,13,5,17,3,89,38.262706464494286,-109.3866394
23394,6,47,13,5,17,2,90,38.262706464494286,-109.3863699
23395,5,48,13,4,16,3,89,38.262706464494286,-109.3861004
23396,5,51,13,4,15,3,91,38.262706464494286,-109.3858309
23397,4,50,11,3,14,4,86,38.262706464494286,-109.3855614
23398,2,52,10,2,13,5,84,38.262706464494286,-109.3852919
23399,1,53,9,0,14,5,82,38.262706464494286,-109.3850225
23400,1,50,10,0,15,6,82,38.262706464494286,-109.384753
23401,2,39,11,2,14,6,74,38.262706464494286,-109.3844835
23402,2,37,10,1,10,8,68,38.262706464494286,-109.384214
23403,3,39,10,1,12,7,72,38.262706464494286,-109.3839445
23404,4,40,12,2,15,7,80,38.262706464494286,-109.383675
23405,4,44,13,2,15,8,86,38.262706464494286,-109.3834055
23406,3,41,13,0,15,10,82,38.262706464494286,-109.383136
23407,3,40,12,0,14,10,79,38.262706464494286,-109.3828665
23408,3,40,12,0,14,10,79,38.262706464494286,-109.382597
23409,3,39,11,0,14,12,79,38.262706464494286,-109.3823275
23410,3,37,12,1,13,12,78,38.262706464494286,-109.382058
23411,2,36,12,0,13,12,75,38.262706464494286,-109.3817885
23412,2,34,11,0,11,13,71,38.262706464494286,-109.381519
23413,2,34,11,0,11,12,70,38.262706464494286,-109.3812495
23414,3,37,11,5,14,5,75,38.262706464494286,-109.38098
23415,4,42,12,5,18,2,83,38.262706464494286,-109.3807105
23416,4,42,12,6,19,3,86,38.262706464494286,-109.380441
23417,3,39,12,7,18,4,83,38.262706464494286,-109.3801716
23418,4,36,13,12,18,3,86,38.262706464494286,-109.3799021
23419,6,35,13,14,17,1,86,38.262706464494286,-109.3796326
23420,5,42,13,9,20,0,89,38.262706464494286,-109.3793631
23421,5,44,13,8,20,0,90,38.262706464494286,-109.3790936
23422,5,44,13,7,20,1,90,38.262706464494286,-109.3788241
23423,5,42,13,7,18,2,87,38.262706464494286,-109.3785546
23424,6,38,11,5,16,3,79,38.262706464494286,-109.3782851
23425,9,28,9,4,11,4,65,38.262706464494286,-109.3780156
23426,7,25,10,7,11,3,63,38.262706464494286,-109.3777461
23427,4,27,10,6,13,3,63,38.262706464494286,-109.3774766
23428,6,40,11,6,15,3,81,38.262706464494286,-109.3772071
23429,5,40,11,6,16,3,81,38.262706464494286,-109.3769376
23430,6,40,11,6,15,3,81,38.262706464494286,-109.3766681
23431,12,39,12,6,14,3,86,38.262706464494286,-109.3763986
23432,19,36,13,8,12,1,89,38.262706464494286,-109.3761291
23433,19,35,12,9,13,0,88,38.262706464494286,-109.3758596
23434,21,32,12,12,13,0,90,38.262706464494286,-109.3755901
23435,22,28,12,16,12,0,90,38.262706464494286,-109.3753206
23436,22,27,12,18,11,0,90,38.262706464494286,-109.3750512
23437,23,26,13,18,11,0,91,38.262706464494286,-109.3747817
23438,22,26,14,19,11,0,92,38.262706464494286,-109.3745122
23439,21,28,12,15,12,0,88,38.262706464494286,-109.3742427
23440,19,32,13,9,12,2,87,38.262706464494286,-109.3739732
23441,13,37,13,6,13,4,86,38.262706464494286,-109.3737037
23442,8,36,12,6,11,8,81,38.262706464494286,-109.3734342
23443,6,31,12,7,9,11,76,38.262706464494286,-109.3731647
23444,13,18,12,9,16,9,77,38.262706464494286,-109.3728952
23445,22,10,13,14,18,7,84,38.262706464494286,-109.3726257
23446,22,11,13,10,11,14,81,38.262706464494286,-109.3723562
23447,7,20,16,3,1,25,72,38.262706464494286,-109.3720867
23448,4,24,15,2,1,24,70,38.262706464494286,-109.3718172
23449,2,29,13,0,5,21,70,38.262706464494286,-109.3715477
23450,3,35,12,1,9,16,76,38.262706464494286,-109.3712782
23451,6,40,13,2,11,11,83,38.262706464494286,-109.3710087
23452,8,42,12,5,12,5,84,38.262706464494286,-109.3707392
23453,7,43,12,5,13,4,84,38.262706464494286,-109.3704697
23454,5,43,12,4,13,7,84,38.262706464494286,-109.3702003
23455,5,37,12,4,10,11,79,38.262706464494286,-109.3699308
23456,4,25,14,3,5,19,70,38.262706464494286,-109.3696613
23457,3,21,15,1,2,26,68,38.262706464494286,-109.3693918
23458,2,26,14,0,6,21,69,38.262706464494286,-109.3691223
23459,7,23,12,8,7,18,75,38.262706464494286,-109.3688528
23460,6,22,12,7,7,20,74,38.262706464494286,-109.3685833
23461,2,28,15,0,8,23,76,38.262706464494286,-109.3683138
23462,1,32,11,1,10,12,67,38.262706464494286,-109.3680443
23463,1,42,8,3,9,7,70,38.262706464494286,-109.3677748
23464,2,48,7,5,10,4,76,38.262706464494286,-109.3675053
23465,3,47,8,6,10,4,78,38.262706464494286,-109.3672358
23466,2,52,8,4,12,3,81,38.262706464494286,-109.3669663
23467,1,46,8,4,11,5,75,38.262706464494286,-109.3666968
23468,2,45,8,4,11,4,74,38.262706464494286,-109.3664273
23469,1,44,8,1,10,4,68,38.262706464494286,-109.3661578
23470,1,41,8,2,10,4,66,38.262706464494286,-109.3658883
23471,1,40,8,2,10,4,65,38.262706464494286,-109.3656188
23472,2,39,8,3,11,5,68,38.262706464494286,-109.3653493
23473,3,38,10,4,11,5,71,38.262706464494286,-109.3650799
23474,4,39,11,1,10,9,74,38.262706464494286,-109.3648104
23475,2,36,11,0,8,13,70,38.262706464494286,-109.3645409
23476,1,28,10,2,6,13,60,38.262706464494286,-109.3642714
23477,3,23,10,4,7,9,56,38.262706464494286,-109.3640019
23478,6,18,12,6,6,8,56,38.262706464494286,-109.3637324
23479,8,27,13,9,10,7,74,38.262706464494286,-109.3634629
23480,1,20,13,4,7,18,63,38.262706464494286,-109.3631934
23481,2,26,11,4,9,12,64,38.262706464494286,-109.3629239
23482,4,23,11,4,8,9,59,38.262706464494286,-109.3626544
23483,3,21,10,3,7,9,53,38.262706464494286,-109.3623849
23484,4,21,11,4,7,8,55,38.262706464494286,-109.3621154
23485,5,26,10,5,7,6,59,38.262706464494286,-109.3618459
23486,5,32,11,3,7,7,65,38.262706464494286,-109.3615764
23487,3,29,11,3,6,9,61,38.262706464494286,-109.3613069
23488,2,26,11,3,6,10,58,38.262706464494286,-109.3610374
23489,4,27,12,2,6,11,62,38.262706464494286,-109.3607679
23490,4,23,11,3,6,11,58,38.262706464494286,-109.3604984
23491,3,23,11,2,7,12,58,38.262706464494286,-109.360229
23492,2,24,11,2,6,14,59,38.262706464494286,-109.3599595
23493,2,31,11,0,7,14,65,38.262706464494286,-109.35969
23494,0,34,11,1,8,13,67,38.262706464494286,-109.3594205
23495,1,33,10,2,7,12,65,38.262706464494286,-109.359151
23496,2,29,10,2,6,14,63,38.262706464494286,-109.3588815
23497,2,26,12,2,6,15,63,38.262706464494286,-109.358612
23498,1,25,13,1,5,17,62,38.262706464494286,-109.3583425
23499,2,26,12,1,4,15,60,38.262706464494286,-109.358073
23500,2,26,12,2,7,13,62,38.262706464494286,-109.3578035
23501,2,24,12,0,6,17,61,38.262706464494286,-109.357534
23502,3,29,14,0,5,21,72,38.262706464494286,-109.3572645
23503,2,26,14,0,3,24,69,38.262706464494286,-109.356995
23504,2,24,14,0,4,23,67,38.262706464494286,-109.3567255
23505,3,26,13,0,4,22,68,38.262706464494286,-109.356456
23506,2,27,13,0,4,21,67,38.262706464494286,-109.3561865
23507,1,28,12,0,5,19,65,38.262706464494286,-109.355917
23508,1,26,13,0,6,21,67,38.262706464494286,-109.3556475
23509,0,25,13,0,8,22,68,38.262706464494286,-109.355378
23510,1,27,14,0,8,23,73,38.262706464494286,-109.3551086
23511,1,24,14,0,8,24,71,38.262706464494286,-109.3548391
23512,1,20,15,1,6,26,69,38.262706464494286,-109.3545696
23513,2,22,15,2,7,23,71,38.262706464494286,-109.3543001
23514,1,23,14,3,10,18,69,38.262706464494286,-109.3540306
23515,2,26,14,6,13,12,73,38.262706464494286,-109.3537611
23516,3,25,15,8,14,11,76,38.262706464494286,-109.3534916
23517,6,24,16,14,16,10,86,38.262706464494286,-109.3532221
23518,6,20,14,20,17,6,83,38.262706464494286,-109.3529526
23519,5,20,15,18,15,10,83,38.262706464494286,-109.3526831
23520,5,20,15,18,15,10,83,38.262706464494286,-109.3524136
23521,8,19,12,23,17,5,84,38.262706464494286,-109.3521441
23522,5,14,12,16,18,11,76,38.262706464494286,-109.3518746
23523,5,12,12,14,17,14,74,38.262706464494286,-109.3516051
23524,5,16,12,13,17,14,77,38.262706464494286,-109.3513356
23525,5,18,12,16,18,9,78,38.262706464494286,-109.3510661
23526,7,18,10,20,18,5,78,38.262706464494286,-109.3507966
23527,3,18,14,23,17,3,78,38.262706464494286,-109.3505271
23528,5,18,14,20,18,3,78,38.262706464494286,-109.3502577
23529,5,14,13,19,19,3,73,38.262706464494286,-109.3499882
23530,3,11,15,24,14,8,75,38.262706464494286,-109.3497187
23531,0,13,17,15,10,17,72,38.262706464494286,-109.3494492
23532,0,16,17,4,11,24,72,38.262706464494286,-109.3491797
23533,0,20,19,1,10,27,77,38.262706464494286,-109.3489102
23534,1,23,19,0,8,28,79,38.262706464494286,-109.3486407
23535,0,23,19,0,5,31,78,38.262706464494286,-109.3483712
23536,0,23,19,0,5,31,78,38.262706464494286,-109.3481017
23537,0,22,17,0,4,31,74,38.262706464494286,-109.3478322
23538,1,23,17,0,4,31,76,38.262706464494286,-109.3475627
23539,1,22,18,1,4,30,76,38.262706464494286,-109.3472932
23540,1,21,18,1,4,30,75,38.262706464494286,-109.3470237
23541,2,24,18,2,5,28,79,38.262706464494286,-109.3467542
23542,3,26,18,2,6,27,82,38.262706464494286,-109.3464847
23543,3,25,17,1,5,28,79,38.262706464494286,-109.3462152
23544,2,21,18,0,3,30,74,38.262706464494286,-109.3459457
23545,2,22,19,1,4,31,79,38.262706464494286,-109.3456762
23546,1,22,20,1,6,32,82,38.262706464494286,-109.3454068
23547,1,21,20,1,6,34,83,38.262706464494286,-109.3451373
23548,1,20,20,1,6,34,82,38.262706464494286,-109.3448678
23549,1,21,20,2,7,33,84,38.262706464494286,-109.3445983
23550,1,20,20,2,8,32,83,38.262706464494286,-109.3443288
23551,2,25,20,2,9,29,87,38.262706464494286,-109.3440593
23552,6,29,16,8,10,19,88,38.262706464494286,-109.3437898
23553,7,32,14,13,11,9,86,38.262706464494286,-109.3435203
23554,6,34,14,9,14,9,86,38.262706464494286,-109.3432508
23555,6,35,14,8,16,9,88,38.262706464494286,-109.3429813
23556,7,37,13,9,16,5,87,38.262706464494286,-109.3427118
23557,8,37,13,10,15,4,87,38.262706464494286,-109.3424423
23558,7,38,14,9,15,5,88,38.262706464494286,-109.3421728
23559,6,40,13,6,15,5,85,38.262706464494286,-109.3419033
23560,5,40,13,5,15,7,85,38.262706464494286,-109.3416338
23561,4,33,14,3,11,15,80,38.262706464494286,-109.3413643
23562,3,22,16,1,4,26,72,38.262706464494286,-109.3410948
23563,2,13,18,0,0,33,66,38.262706464494286,-109.3408253
23564,1,13,17,0,0,33,64,38.262706464494286,-109.3405558
23565,1,18,18,0,0,32,69,38.262706464494286,-109.3402864
23566,1,22,18,0,2,31,74,38.262706464494286,-109.3400169
23567,1,25,18,0,4,30,78,38.262706464494286,-109.3397474
23568,2,25,19,1,5,29,81,38.262706464494286,-109.3394779
23569,3,29,16,2,8,23,81,38.262706464494286,-109.3392084
23570,3,28,16,1,6,24,78,38.262706464494286,-109.3389389
23571,3,23,16,1,4,26,73,38.262706464494286,-109.3386694
23572,3,20,16,1,3,25,68,38.262706464494286,-109.3383999
23573,2,17,14,1,2,25,61,38.262706464494286,-109.3381304
23574,1,19,12,2,3,19,56,38.262706464494286,-109.3378609
23575,1,13,14,2,3,22,55,38.262706464494286,-109.3375914
23576,1,14,17,1,3,27,63,38.262706464494286,-109.3373219
23577,1,17,18,0,2,30,68,38.262706464494286,-109.3370524
23578,0,19,15,0,2,26,62,38.262706464494286,-109.3367829
23579,1,19,16,1,4,26,67,38.262706464494286,-109.3365134
23580,1,20,17,1,4,28,71,38.262706464494286,-109.3362439
23581,1,22,18,1,5,29,76,38.262706464494286,-109.3359744
23582,0,23,18,0,5,29,75,38.262706464494286,-109.3357049
23583,1,24,17,0,8,24,74,38.262706464494286,-109.3354355
23584,0,23,16,2,7,24,72,38.262706464494286,-109.335166
23585,1,22,15,3,8,20,69,38.262706464494286,-109.3348965
23586,2,20,14,6,7,17,66,38.262706464494286,-109.334627
23587,6,22,15,9,8,14,74,38.262706464494286,-109.3343575
23588,3,48,11,4,15,4,85,38.262436969909054,-109.4424248
23589,2,47,10,1,13,8,81,38.262436969909054,-109.4421553
23590,2,48,11,2,15,7,85,38.262436969909054,-109.4418858
23591,3,50,10,5,14,4,86,38.262436969909054,-109.4416163
23592,2,47,10,2,12,8,81,38.262436969909054,-109.4413468
23593,2,43,10,2,12,9,78,38.262436969909054,-109.4410773
23594,2,47,9,1,13,7,79,38.262436969909054,-109.4408078
23595,2,48,9,1,14,6,80,38.262436969909054,-109.4405383
23596,1,43,9,1,13,8,75,38.262436969909054,-109.4402688
23597,1,45,9,0,12,9,76,38.262436969909054,-109.4399993
23598,1,40,9,0,11,10,71,38.262436969909054,-109.4397299
23599,1,39,9,0,12,10,71,38.262436969909054,-109.4394604
23600,1,39,9,0,12,9,70,38.262436969909054,-109.4391909
23601,1,38,8,1,10,9,67,38.262436969909054,-109.4389214
23602,1,40,9,1,9,9,69,38.262436969909054,-109.4386519
23603,1,39,9,1,11,9,70,38.262436969909054,-109.4383824
23604,1,40,8,0,11,8,68,38.262436969909054,-109.4381129
23605,1,43,7,1,10,6,68,38.262436969909054,-109.4378434
23606,2,45,8,4,12,4,75,38.262436969909054,-109.4375739
23607,2,49,8,0,12,5,76,38.262436969909054,-109.4373044
23608,1,44,9,0,13,7,74,38.262436969909054,-109.4370349
23609,2,41,9,2,12,8,74,38.262436969909054,-109.4367654
23610,2,38,9,2,12,8,71,38.262436969909054,-109.4364959
23611,2,43,9,2,11,7,74,38.262436969909054,-109.4362264
23612,2,45,9,3,12,5,76,38.262436969909054,-109.4359569
23613,2,47,9,2,14,5,79,38.262436969909054,-109.4356874
23614,2,47,10,3,16,4,82,38.262436969909054,-109.4354179
23615,6,43,11,4,16,4,84,38.262436969909054,-109.4351484
23616,10,45,12,8,17,1,93,38.262436969909054,-109.434879
23617,8,44,12,6,15,4,89,38.262436969909054,-109.4346095
23618,3,46,11,3,14,6,83,38.262436969909054,-109.43434
23619,2,49,10,1,14,6,82,38.262436969909054,-109.4340705
23620,1,51,9,2,14,5,82,38.262436969909054,-109.433801
23621,2,46,10,3,14,5,80,38.262436969909054,-109.4335315
23622,2,44,10,3,15,4,78,38.262436969909054,-109.433262
23623,5,44,11,5,16,3,84,38.262436969909054,-109.4329925
23624,13,37,13,11,15,1,90,38.262436969909054,-109.432723
23625,17,34,13,12,14,0,90,38.262436969909054,-109.4324535
23626,16,36,14,12,14,0,92,38.262436969909054,-109.432184
23627,12,40,14,12,14,1,93,38.262436969909054,-109.4319145
23628,11,39,14,13,13,1,91,38.262436969909054,-109.431645
23629,12,35,15,14,12,2,90,38.262436969909054,-109.4313755
23630,13,36,16,15,12,1,93,38.262436969909054,-109.431106
23631,9,40,15,14,12,1,91,38.262436969909054,-109.4308365
23632,8,42,14,12,14,1,91,38.262436969909054,-109.430567
23633,11,42,14,12,14,0,93,38.262436969909054,-109.4302975
23634,15,39,14,11,14,0,93,38.262436969909054,-109.430028
23635,10,43,14,12,15,1,95,38.262436969909054,-109.4297586
23636,8,43,14,11,14,1,91,38.262436969909054,-109.4294891
23637,8,44,14,12,14,1,93,38.262436969909054,-109.4292196
23638,11,42,14,11,13,1,92,38.262436969909054,-109.4289501
23639,18,35,14,9,11,0,87,38.262436969909054,-109.4286806
23640,15,39,14,11,13,0,92,38.262436969909054,-109.4284111
23641,13,41,14,12,13,0,93,38.262436969909054,-109.4281416
23642,10,41,15,13,12,1,92,38.262436969909054,-109.4278721
23643,9,38,14,14,12,1,88,38.262436969909054,-109.4276026
23644,13,38,16,13,12,1,93,38.262436969909054,-109.4273331
23645,15,37,15,13,13,0,93,38.262436969909054,-109.4270636
23646,13,38,15,13,14,0,93,38.262436969909054,-109.4267941
23647,10,39,14,12,13,1,89,38.262436969909054,-109.4265246
23648,10,40,14,11,13,1,89,38.262436969909054,-109.4262551
23649,13,42,14,11,13,0,93,38.262436969909054,-109.4259856
23650,12,40,14,11,13,0,90,38.262436969909054,-109.4257161
23651,11,40,14,12,14,1,92,38.262436969909054,-109.4254466
23652,8,41,14,11,14,1,89,38.262436969909054,-109.4251771
23653,7,43,14,12,16,1,93,38.262436969909054,-109.4249077
23654,6,44,14,12,16,0,92,38.262436969909054,-109.4246382
23655,6,45,14,11,16,0,92,38.262436969909054,-109.4243687
23656,6,43,14,10,16,1,90,38.262436969909054,-109.4240992
23657,6,42,14,10,16,1,89,38.262436969909054,-109.4238297
23658,8,40,14,12,16,0,90,38.262436969909054,-109.4235602
23659,9,39,14,12,16,0,90,38.262436969909054,-109.4232907
23660,9,38,15,12,15,0,89,38.262436969909054,-109.4230212
23661,9,37,14,12,14,1,87,38.262436969909054,-109.4227517
23662,9,34,13,12,13,1,82,38.262436969909054,-109.4224822
23663,10,33,13,11,13,1,81,38.262436969909054,-109.4222127
23664,12,30,14,12,13,1,82,38.262436969909054,-109.4219432
23665,13,29,14,12,13,1,82,38.262436969909054,-109.4216737
23666,12,31,14,12,13,1,83,38.262436969909054,-109.4214042
23667,13,34,14,12,14,0,87,38.262436969909054,-109.4211347
23668,15,34,13,11,14,0,87,38.262436969909054,-109.4208652
23669,12,37,13,11,14,0,87,38.262436969909054,-109.4205957
23670,10,40,14,12,14,0,90,38.262436969909054,-109.4203262
23671,11,38,15,12,14,0,90,38.262436969909054,-109.4200568
23672,13,37,15,12,13,0,90,38.262436969909054,-109.4197873
23673,9,39,14,12,15,1,90,38.262436969909054,-109.4195178
23674,7,41,14,11,16,1,90,38.262436969909054,-109.4192483
23675,8,43,14,11,15,1,92,38.262436969909054,-109.4189788
23676,10,44,13,11,14,0,92,38.262436969909054,-109.4187093
23677,8,50,13,9,13,1,94,38.262436969909054,-109.4184398
23678,5,57,11,6,14,1,94,38.262436969909054,-109.4181703
23679,4,59,10,6,14,1,94,38.262436969909054,-109.4179008
23680,5,55,10,7,14,0,91,38.262436969909054,-109.4176313
23681,7,49,13,8,16,0,93,38.262436969909054,-109.4173618
23682,10,45,13,9,15,0,92,38.262436969909054,-109.4170923
23683,9,45,13,8,17,0,92,38.262436969909054,-109.4168228
23684,7,47,12,7,17,0,90,38.262436969909054,-109.4165533
23685,6,48,12,6,17,1,90,38.262436969909054,-109.4162838
23686,6,45,13,6,17,3,90,38.262436969909054,-109.4160143
23687,6,45,12,6,17,2,88,38.262436969909054,-109.4157448
23688,7,45,12,6,17,2,89,38.262436969909054,-109.4154753
23689,7,45,12,6,16,2,88,38.262436969909054,-109.4152058
23690,7,45,12,7,17,2,90,38.262436969909054,-109.4149364
23691,6,45,12,6,16,2,87,38.262436969909054,-109.4146669
23692,6,45,12,5,17,3,88,38.262436969909054,-109.4143974
23693,6,46,12,5,17,2,88,38.262436969909054,-109.4141279
23694,6,47,12,6,17,2,90,38.262436969909054,-109.4138584
23695,7,47,12,6,16,2,90,38.262436969909054,-109.4135889
23696,5,48,12,5,17,2,89,38.262436969909054,-109.4133194
23697,5,49,12,5,17,1,89,38.262436969909054,-109.4130499
23698,5,52,12,5,17,1,92,38.262436969909054,-109.4127804
23699,5,53,12,5,16,2,93,38.262436969909054,-109.4125109
23700,5,50,13,5,16,3,92,38.262436969909054,-109.4122414
23701,5,49,13,6,16,3,92,38.262436969909054,-109.4119719
23702,5,50,13,6,15,2,91,38.262436969909054,-109.4117024
23703,5,52,12,6,15,2,92,38.262436969909054,-109.4114329
23704,4,53,12,6,16,2,93,38.262436969909054,-109.4111634
23705,5,52,12,6,15,2,92,38.262436969909054,-109.4108939
23706,5,53,12,6,15,2,93,38.262436969909054,-109.4106244
23707,5,53,12,6,15,2,93,38.262436969909054,-109.4103549
23708,6,52,12,6,15,2,93,38.262436969909054,-109.4100855
23709,7,51,12,6,16,1,93,38.262436969909054,-109.409816
23710,5,51,12,6,17,1,92,38.262436969909054,-109.4095465
23711,5,52,12,5,17,1,92,38.262436969909054,-109.409277
23712,4,52,12,5,17,2,92,38.262436969909054,-109.4090075
23713,5,52,12,4,17,1,91,38.262436969909054,-109.408738
23714,4,50,11,3,16,2,86,38.262436969909054,-109.4084685
23715,4,47,11,3,16,4,85,38.262436969909054,-109.408199
23716,4,47,11,3,15,5,85,38.262436969909054,-109.4079295
23717,4,49,10,2,15,4,84,38.262436969909054,-109.40766
23718,2,49,10,1,14,3,79,38.262436969909054,-109.4073905
23719,2,41,10,3,12,4,72,38.262436969909054,-109.407121
23720,1,39,10,2,11,7,70,38.262436969909054,-109.4068515
23721,2,34,11,0,11,13,71,38.262436969909054,-109.3879869
23722,2,33,11,0,10,14,70,38.262436969909054,-109.3877174
23723,4,38,12,0,14,10,78,38.262436969909054,-109.3874479
23724,6,45,13,4,17,3,88,38.262436969909054,-109.3871784
23725,5,45,13,4,16,4,87,38.262436969909054,-109.3869089
23726,5,46,13,5,16,3,88,38.262436969909054,-109.3866394
23727,5,47,13,4,16,3,88,38.262436969909054,-109.3863699
23728,4,49,13,3,16,5,90,38.262436969909054,-109.3861004
23729,4,50,12,4,15,3,88,38.262436969909054,-109.3858309
23730,2,48,10,3,14,5,82,38.262436969909054,-109.3855614
23731,2,48,10,2,14,5,81,38.262436969909054,-109.3852919
23732,1,46,10,0,14,7,78,38.262436969909054,-109.3850225
23733,1,41,10,0,12,11,75,38.262436969909054,-109.384753
23734,1,36,11,2,11,10,71,38.262436969909054,-109.3844835
23735,4,41,10,2,11,5,73,38.262436969909054,-109.384214
23736,5,40,10,2,11,4,72,38.262436969909054,-109.3839445
23737,2,39,10,1,13,8,73,38.262436969909054,-109.383675
23738,3,40,11,0,13,9,76,38.262436969909054,-109.3834055
23739,2,36,11,0,12,12,73,38.262436969909054,-109.383136
23740,2,37,11,0,13,11,74,38.262436969909054,-109.3828665
23741,2,37,11,0,14,10,74,38.262436969909054,-109.382597
23742,4,38,11,0,13,11,77,38.262436969909054,-109.3823275
23743,6,40,12,4,15,7,84,38.262436969909054,-109.382058
23744,5,42,12,3,17,5,84,38.262436969909054,-109.3817885
23745,5,42,12,3,17,6,85,38.262436969909054,-109.381519
23746,4,41,13,4,16,6,84,38.262436969909054,-109.3812495
23747,3,41,13,8,16,4,85,38.262436969909054,-109.38098
23748,4,43,12,5,18,3,85,38.262436969909054,-109.3807105
23749,5,42,12,5,17,3,84,38.262436969909054,-109.380441
23750,5,40,12,7,18,3,85,38.262436969909054,-109.3801716
23751,4,38,12,9,17,3,83,38.262436969909054,-109.3799021
23752,4,42,13,6,19,2,86,38.262436969909054,-109.3796326
23753,4,46,13,5,19,2,89,38.262436969909054,-109.3793631
23754,4,46,13,6,19,1,89,38.262436969909054,-109.3790936
23755,5,44,13,7,18,1,88,38.262436969909054,-109.3788241
23756,6,42,13,8,17,2,88,38.262436969909054,-109.3785546
23757,4,38,11,7,16,2,78,38.262436969909054,-109.3782851
23758,7,34,9,7,10,2,69,38.262436969909054,-109.3780156
23759,6,29,10,7,13,2,67,38.262436969909054,-109.3777461
23760,4,38,10,5,14,4,75,38.262436969909054,-109.3774766
23761,4,45,11,3,15,5,83,38.262436969909054,-109.3772071
23762,4,41,11,6,17,3,82,38.262436969909054,-109.3769376
23763,9,39,12,10,15,1,86,38.262436969909054,-109.3766681
23764,14,38,13,10,14,1,90,38.262436969909054,-109.3763986
23765,16,38,13,9,13,1,90,38.262436969909054,-109.3761291
23766,15,37,13,11,14,0,90,38.262436969909054,-109.3758596
23767,21,33,12,10,13,0,89,38.262436969909054,-109.3755901
23768,23,27,12,11,12,1,86,38.262436969909054,-109.3753206
23769,21,25,13,11,11,4,85,38.262436969909054,-109.3750512
23770,20,26,13,12,11,4,86,38.262436969909054,-109.3747817
23771,21,27,13,13,12,2,88,38.262436969909054,-109.3745122
23772,12,27,12,10,13,4,78,38.262436969909054,-109.3742427
23773,4,35,11,6,14,5,75,38.262436969909054,-109.3739732
23774,2,39,10,2,12,9,74,38.262436969909054,-109.3737037
23775,3,34,11,1,8,14,71,38.262436969909054,-109.3734342
23776,8,27,12,6,8,14,75,38.262436969909054,-109.3731647
23777,19,19,14,7,9,13,81,38.262436969909054,-109.3728952
23778,23,14,12,11,15,8,83,38.262436969909054,-109.3726257
23779,19,16,12,11,10,10,78,38.262436969909054,-109.3723562
23780,5,22,13,3,5,20,68,38.262436969909054,-109.3720867
23781,3,25,13,0,4,21,66,38.262436969909054,-109.3718172
23782,2,28,12,1,6,18,67,38.262436969909054,-109.3715477
23783,3,34,12,2,10,14,75,38.262436969909054,-109.3712782
23784,4,39,12,3,12,10,80,38.262436969909054,-109.3710087
23785,4,42,12,3,13,8,82,38.262436969909054,-109.3707392
23786,4,39,12,3,12,10,80,38.262436969909054,-109.3704697
23787,3,32,13,2,7,17,74,38.262436969909054,-109.3702003
23788,2,25,14,2,3,23,69,38.262436969909054,-109.3699308
23789,2,24,14,1,2,24,67,38.262436969909054,-109.3696613
23790,1,30,13,0,6,21,71,38.262436969909054,-109.3693918
23791,5,27,12,10,7,16,77,38.262436969909054,-109.3691223
23792,10,25,10,12,10,6,73,38.262436969909054,-109.3688528
23793,10,24,10,13,10,6,73,38.262436969909054,-109.3685833
23794,1,34,7,4,10,5,61,38.262436969909054,-109.3683138
23795,1,57,8,4,12,2,84,38.262436969909054,-109.3680443
23796,2,50,8,6,11,2,79,38.262436969909054,-109.3677748
23797,3,39,8,6,10,6,72,38.262436969909054,-109.3675053
23798,2,39,8,4,10,8,71,38.262436969909054,-109.3672358
23799,3,38,10,5,9,6,71,38.262436969909054,-109.3669663
23800,3,41,10,2,11,7,74,38.262436969909054,-109.3666968
23801,2,39,10,2,10,9,72,38.262436969909054,-109.3664273
23802,3,38,10,2,10,8,71,38.262436969909054,-109.3661578
23803,3,38,10,3,11,7,72,38.262436969909054,-109.3658883
23804,2,37,10,1,10,10,70,38.262436969909054,-109.3656188
23805,3,38,11,2,10,9,73,38.262436969909054,-109.3653493
23806,3,39,11,1,10,9,73,38.262436969909054,-109.3650799
23807,3,42,11,1,10,9,76,38.262436969909054,-109.3648104
23808,4,42,11,1,10,10,78,38.262436969909054,-109.3645409
23809,3,25,10,4,6,10,58,38.262436969909054,-109.3642714
23810,5,22,11,6,7,8,59,38.262436969909054,-109.3640019
23811,4,18,12,6,8,10,58,38.262436969909054,-109.3637324
23812,4,22,12,7,9,12,66,38.262436969909054,-109.3634629
23813,2,26,11,5,9,9,62,38.262436969909054,-109.3631934
23814,3,26,11,4,7,8,59,38.262436969909054,-109.3629239
23815,2,23,11,4,8,8,56,38.262436969909054,-109.3626544
23816,2,20,11,5,8,9,55,38.262436969909054,-109.3623849
23817,3,18,11,6,8,9,55,38.262436969909054,-109.3621154
23818,3,20,11,6,9,8,57,38.262436969909054,-109.3618459
23819,3,22,11,5,9,8,58,38.262436969909054,-109.3615764
23820,3,20,11,6,10,9,59,38.262436969909054,-109.3613069
23821,3,19,12,10,10,10,64,38.262436969909054,-109.3610374
23822,1,19,13,5,6,19,63,38.262436969909054,-109.3607679
23823,1,23,13,2,6,20,65,38.262436969909054,-109.3604984
23824,2,27,12,6,9,13,69,38.262436969909054,-109.360229
23825,2,25,11,7,9,10,64,38.262436969909054,-109.3599595
23826,3,27,11,4,8,9,62,38.262436969909054,-109.35969
23827,3,33,10,3,6,8,63,38.262436969909054,-109.3594205
23828,2,31,11,2,5,9,60,38.262436969909054,-109.359151
23829,3,28,11,1,7,11,61,38.262436969909054,-109.3588815
23830,3,25,12,3,8,12,63,38.262436969909054,-109.358612
23831,1,22,13,2,6,19,63,38.262436969909054,-109.3583425
23832,0,23,14,0,4,23,64,38.262436969909054,-109.358073
23833,1,26,15,0,5,24,71,38.262436969909054,-109.3578035
23834,1,27,15,0,4,26,73,38.262436969909054,-109.357534
23835,1,27,15,0,3,26,72,38.262436969909054,-109.3572645
23836,2,28,13,0,4,24,71,38.262436969909054,-109.356995
23837,3,33,13,0,11,17,77,38.262436969909054,-109.3567255
23838,1,28,13,0,8,21,71,38.262436969909054,-109.356456
23839,1,25,14,0,5,25,70,38.262436969909054,-109.3561865
23840,2,24,14,0,4,25,69,38.262436969909054,-109.355917
23841,1,24,14,0,4,25,68,38.262436969909054,-109.3556475
23842,0,23,14,0,4,26,67,38.262436969909054,-109.355378
23843,0,24,14,0,5,26,69,38.262436969909054,-109.3551086
23844,1,24,14,0,7,24,70,38.262436969909054,-109.3548391
23845,1,23,14,3,9,18,68,38.262436969909054,-109.3545696
23846,5,24,16,5,10,18,78,38.262436969909054,-109.3543001
23847,2,24,15,3,11,17,72,38.262436969909054,-109.3540306
23848,3,27,14,6,14,10,74,38.262436969909054,-109.3537611
23849,5,26,13,16,16,5,81,38.262436969909054,-109.3534916
23850,7,21,15,20,18,6,87,38.262436969909054,-109.3532221
23851,8,16,13,24,19,5,85,38.262436969909054,-109.3529526
23852,5,17,13,20,16,9,80,38.262436969909054,-109.3526831
23853,5,19,13,17,18,10,82,38.262436969909054,-109.3524136
23854,6,17,11,20,19,7,80,38.262436969909054,-109.3521441
23855,6,17,12,16,14,9,74,38.262436969909054,-109.3518746
23856,5,19,12,15,17,7,75,38.262436969909054,-109.3516051
23857,5,17,11,14,15,7,69,38.262436969909054,-109.3513356
23858,5,13,9,12,12,7,58,38.262436969909054,-109.3510661
23859,5,8,7,10,10,5,45,38.262436969909054,-109.3507966
23860,5,8,7,11,9,5,45,38.262436969909054,-109.3505271
23861,4,12,11,12,13,10,62,38.262436969909054,-109.3502577
23862,1,15,14,10,11,20,71,38.262436969909054,-109.3499882
23863,1,17,16,7,10,23,74,38.262436969909054,-109.3497187
23864,1,20,17,4,7,27,76,38.262436969909054,-109.3494492
23865,0,25,18,1,7,29,80,38.262436969909054,-109.3491797
23866,1,25,18,0,6,30,80,38.262436969909054,-109.3489102
23867,0,23,18,0,4,31,76,38.262436969909054,-109.3486407
23868,0,22,18,0,4,32,76,38.262436969909054,-109.3483712
23869,0,22,17,0,3,30,72,38.262436969909054,-109.3481017
23870,0,21,17,0,3,31,72,38.262436969909054,-109.3478322
23871,1,21,17,0,3,31,73,38.262436969909054,-109.3475627
23872,1,22,18,1,4,31,77,38.262436969909054,-109.3472932
23873,1,22,18,1,4,31,77,38.262436969909054,-109.3470237
23874,2,28,17,2,8,26,83,38.262436969909054,-109.3467542
23875,3,28,17,2,10,25,85,38.262436969909054,-109.3464847
23876,3,27,18,2,8,28,86,38.262436969909054,-109.3462152
23877,2,23,19,1,6,31,82,38.262436969909054,-109.3459457
23878,1,23,19,1,6,32,82,38.262436969909054,-109.3456762
23879,1,24,20,2,6,30,83,38.262436969909054,-109.3454068
23880,2,23,20,3,6,30,84,38.262436969909054,-109.3451373
23881,2,22,20,3,6,31,84,38.262436969909054,-109.3448678
23882,1,22,20,2,7,30,82,38.262436969909054,-109.3445983
23883,1,20,21,3,8,30,83,38.262436969909054,-109.3443288
23884,1,21,21,1,8,32,84,38.262436969909054,-109.3440593
23885,5,26,18,4,10,24,87,38.262436969909054,-109.3437898
23886,5,29,17,6,9,20,86,38.262436969909054,-109.3435203
23887,5,31,16,5,13,19,89,38.262436969909054,-109.3432508
23888,5,32,15,6,15,14,87,38.262436969909054,-109.3429813
23889,7,35,14,8,14,9,87,38.262436969909054,-109.3427118
23890,7,37,13,9,16,5,87,38.262436969909054,-109.3424423
23891,7,37,13,8,16,5,86,38.262436969909054,-109.3421728
23892,4,39,13,5,14,8,83,38.262436969909054,-109.3419033
23893,4,37,13,2,12,13,81,38.262436969909054,-109.3416338
23894,3,31,14,1,9,19,77,38.262436969909054,-109.3413643
23895,3,24,17,1,3,26,74,38.262436969909054,-109.3410948
23896,3,15,19,2,2,31,72,38.262436969909054,-109.3408253
23897,2,14,19,0,0,33,68,38.262436969909054,-109.3405558
23898,1,18,18,0,1,32,70,38.262436969909054,-109.3402864
23899,1,21,18,0,3,30,73,38.262436969909054,-109.3400169
23900,2,24,18,1,5,27,77,38.262436969909054,-109.3397474
23901,3,28,17,2,8,22,80,38.262436969909054,-109.3394779
23902,3,30,15,1,8,20,77,38.262436969909054,-109.3392084
23903,2,24,16,0,4,25,71,38.262436969909054,-109.3389389
23904,2,16,17,0,2,28,65,38.262436969909054,-109.3386694
23905,2,12,16,1,2,28,61,38.262436969909054,-109.3383999
23906,2,15,14,1,2,24,58,38.262436969909054,-109.3381304
23907,2,20,13,2,6,18,61,38.262436969909054,-109.3378609
23908,2,14,15,3,4,22,60,38.262436969909054,-109.3375914
23909,1,16,18,0,3,30,68,38.262436969909054,-109.3373219
23910,0,19,19,0,4,31,73,38.262436969909054,-109.3370524
23911,2,23,18,1,6,27,77,38.262436969909054,-109.3367829
23912,2,26,19,2,7,29,85,38.262436969909054,-109.3365134
23913,1,26,19,2,6,30,84,38.262436969909054,-109.3362439
23914,3,25,18,2,6,26,80,38.262436969909054,-109.3359744
23915,2,27,16,2,5,22,74,38.262436969909054,-109.3357049
23916,1,25,14,3,6,20,69,38.262436969909054,-109.3354355
23917,1,24,15,1,5,23,69,38.262436969909054,-109.335166
23918,1,22,16,1,5,25,70,38.262436969909054,-109.3348965
23919,1,19,17,2,5,26,70,38.262436969909054,-109.334627
23920,1,17,18,4,7,27,74,38.262436969909054,-109.3343575
23921,10,16,14,10,19,19,88,38.262436969909054,-109.334088
23922,3,44,11,4,15,4,81,38.26216747532382,-109.4424248
23923,2,51,10,1,13,6,83,38.26216747532382,-109.4421553
23924,2,52,10,4,14,5,87,38.26216747532382,-109.4418858
23925,2,50,10,4,14,5,85,38.26216747532382,-109.4416163
23926,3,42,10,2,9,11,77,38.26216747532382,-109.4413468
23927,2,40,10,3,13,7,75,38.26216747532382,-109.4410773
23928,2,47,10,2,15,4,80,38.26216747532382,-109.4408078
23929,2,49,9,2,15,5,82,38.26216747532382,-109.4405383
23930,2,44,9,1,14,7,77,38.26216747532382,-109.4402688
23931,1,42,9,0,11,9,72,38.26216747532382,-109.4399993
23932,1,41,9,0,12,9,72,38.26216747532382,-109.4397299
23933,1,40,9,0,11,10,71,38.26216747532382,-109.4394604
23934,1,43,9,0,11,10,74,38.26216747532382,-109.4391909
23935,2,44,9,0,11,9,75,38.26216747532382,-109.4389214
23936,1,41,9,0,10,12,73,38.26216747532382,-109.4386519
23937,1,41,9,0,12,9,72,38.26216747532382,-109.4383824
23938,1,41,9,1,14,7,73,38.26216747532382,-109.4381129
23939,1,40,8,1,12,7,69,38.26216747532382,-109.4378434
23940,2,40,7,1,8,7,65,38.26216747532382,-109.4375739
23941,1,40,7,1,9,6,64,38.26216747532382,-109.4373044
23942,1,40,8,2,10,7,68,38.26216747532382,-109.4370349
23943,1,40,8,0,13,8,70,38.26216747532382,-109.4367654
23944,0,42,9,0,13,10,74,38.26216747532382,-109.4364959
23945,1,45,9,0,12,7,74,38.26216747532382,-109.4362264
23946,2,46,9,4,12,3,76,38.26216747532382,-109.4359569
23947,1,47,9,3,14,4,78,38.26216747532382,-109.4356874
23948,2,48,10,2,14,6,82,38.26216747532382,-109.4354179
23949,3,48,11,3,15,6,86,38.26216747532382,-109.4351484
23950,6,49,12,6,15,4,92,38.26216747532382,-109.434879
23951,4,48,11,5,15,4,87,38.26216747532382,-109.4346095
23952,3,47,10,4,14,6,84,38.26216747532382,-109.43434
23953,2,49,10,3,14,6,84,38.26216747532382,-109.4340705
23954,3,54,9,3,15,3,87,38.26216747532382,-109.433801
23955,3,47,10,4,16,2,82,38.26216747532382,-109.4335315
23956,4,43,10,4,16,4,81,38.26216747532382,-109.433262
23957,5,43,11,4,17,3,83,38.26216747532382,-109.4329925
23958,9,42,12,9,16,1,89,38.26216747532382,-109.432723
23959,12,38,13,11,15,1,90,38.26216747532382,-109.4324535
23960,15,38,14,12,14,0,93,38.26216747532382,-109.432184
23961,12,39,14,13,14,0,92,38.26216747532382,-109.4319145
23962,11,38,15,14,14,1,93,38.26216747532382,-109.431645
23963,13,34,15,14,12,2,90,38.26216747532382,-109.4313755
23964,14,36,16,14,12,1,93,38.26216747532382,-109.431106
23965,9,39,15,14,12,1,90,38.26216747532382,-109.4308365
23966,8,42,14,13,13,1,91,38.26216747532382,-109.430567
23967,10,42,14,12,14,1,93,38.26216747532382,-109.4302975
23968,14,39,14,12,13,0,92,38.26216747532382,-109.430028
23969,8,44,14,11,15,1,93,38.26216747532382,-109.4297586
23970,7,45,14,11,14,1,92,38.26216747532382,-109.4294891
23971,8,44,14,12,14,1,93,38.26216747532382,-109.4292196
23972,12,40,14,12,14,1,93,38.26216747532382,-109.4289501
23973,25,32,14,10,12,0,93,38.26216747532382,-109.4286806
23974,19,35,14,11,13,0,92,38.26216747532382,-109.4284111
23975,12,40,14,12,13,0,91,38.26216747532382,-109.4281416
23976,9,41,14,13,12,1,90,38.26216747532382,-109.4278721
23977,8,42,14,13,12,1,90,38.26216747532382,-109.4276026
23978,12,40,15,13,12,1,93,38.26216747532382,-109.4273331
23979,13,38,15,13,13,1,93,38.26216747532382,-109.4270636
23980,12,40,14,13,14,0,93,38.26216747532382,-109.4267941
23981,10,42,14,12,14,1,93,38.26216747532382,-109.4265246
23982,8,40,14,11,13,2,88,38.26216747532382,-109.4262551
23983,10,43,14,11,13,1,92,38.26216747532382,-109.4259856
23984,11,41,14,11,13,1,91,38.26216747532382,-109.4257161
23985,10,41,14,12,14,1,92,38.26216747532382,-109.4254466
23986,9,42,15,13,15,0,94,38.26216747532382,-109.4251771
23987,8,43,14,12,16,0,93,38.26216747532382,-109.4249077
23988,8,44,14,12,16,0,94,38.26216747532382,-109.4246382
23989,7,44,14,12,17,0,94,38.26216747532382,-109.4243687
23990,6,44,14,11,17,1,93,38.26216747532382,-109.4240992
23991,7,44,14,10,16,1,92,38.26216747532382,-109.4238297
23992,8,42,14,11,16,1,92,38.26216747532382,-109.4235602
23993,8,41,14,12,15,1,91,38.26216747532382,-109.4232907
23994,8,41,14,12,14,1,90,38.26216747532382,-109.4230212
23995,8,39,14,12,14,1,88,38.26216747532382,-109.4227517
23996,8,36,14,13,14,1,86,38.26216747532382,-109.4224822
23997,11,35,14,12,13,1,86,38.26216747532382,-109.4222127
23998,11,33,14,12,13,1,84,38.26216747532382,-109.4219432
23999,10,33,15,13,14,1,86,38.26216747532382,-109.4216737
24000,9,34,15,14,14,1,87,38.26216747532382,-109.4214042
24001,10,35,14,13,14,0,86,38.26216747532382,-109.4211347
24002,11,35,13,10,14,1,84,38.26216747532382,-109.4208652
24003,10,36,13,10,13,1,83,38.26216747532382,-109.4205957
24004,9,36,13,11,13,1,83,38.26216747532382,-109.4203262
24005,11,36,15,13,13,1,89,38.26216747532382,-109.4200568
24006,14,32,15,13,13,1,88,38.26216747532382,-109.4197873
24007,11,36,15,13,14,0,89,38.26216747532382,-109.4195178
24008,9,40,14,12,15,1,91,38.26216747532382,-109.4192483
24009,8,44,14,11,15,1,93,38.26216747532382,-109.4189788
24010,8,47,14,11,14,1,95,38.26216747532382,-109.4187093
24011,5,53,12,8,14,1,93,38.26216747532382,-109.4184398
24012,3,59,10,6,14,1,93,38.26216747532382,-109.4181703
24013,3,59,10,6,15,1,94,38.26216747532382,-109.4179008
24014,5,52,12,8,17,0,94,38.26216747532382,-109.4176313
24015,8,45,13,10,16,0,92,38.26216747532382,-109.4173618
24016,8,43,13,11,16,0,91,38.26216747532382,-109.4170923
24017,8,43,13,11,15,0,90,38.26216747532382,-109.4168228
24018,8,44,12,9,16,0,89,38.26216747532382,-109.4165533
24019,6,46,12,7,17,1,89,38.26216747532382,-109.4162838
24020,8,45,12,7,15,1,88,38.26216747532382,-109.4160143
24021,8,45,12,7,16,1,89,38.26216747532382,-109.4157448
24022,8,45,12,7,16,2,90,38.26216747532382,-109.4154753
24023,8,45,12,7,15,2,89,38.26216747532382,-109.4152058
24024,8,46,12,7,15,1,89,38.26216747532382,-109.4149364
24025,7,46,12,7,16,1,89,38.26216747532382,-109.4146669
24026,7,45,13,7,17,1,90,38.26216747532382,-109.4143974
24027,6,46,12,7,17,1,89,38.26216747532382,-109.4141279
24028,6,48,12,6,17,1,90,38.26216747532382,-109.4138584
24029,5,49,12,5,17,2,90,38.26216747532382,-109.4135889
24030,5,50,12,5,17,1,90,38.26216747532382,-109.4133194
24031,5,50,12,5,17,1,90,38.26216747532382,-109.4130499
24032,5,51,12,6,17,0,91,38.26216747532382,-109.4127804
24033,5,51,13,6,17,1,93,38.26216747532382,-109.4125109
24034,5,51,12,5,15,2,90,38.26216747532382,-109.4122414
24035,5,47,13,5,15,3,88,38.26216747532382,-109.4119719
24036,5,49,13,6,15,2,90,38.26216747532382,-109.4117024
24037,5,51,13,6,15,3,93,38.26216747532382,-109.4114329
24038,5,52,13,6,15,3,94,38.26216747532382,-109.4111634
24039,5,53,13,5,15,3,94,38.26216747532382,-109.4108939
24040,4,53,12,5,16,2,92,38.26216747532382,-109.4106244
24041,5,53,12,5,16,1,92,38.26216747532382,-109.4103549
24042,6,51,13,6,16,1,93,38.26216747532382,-109.4100855
24043,7,49,13,6,16,0,91,38.26216747532382,-109.409816
24044,6,48,12,6,17,1,90,38.26216747532382,-109.4095465
24045,5,47,12,6,18,1,89,38.26216747532382,-109.409277
24046,4,46,12,6,18,1,87,38.26216747532382,-109.4090075
24047,4,46,12,6,17,2,87,38.26216747532382,-109.408738
24048,4,46,11,5,17,3,86,38.26216747532382,-109.4084685
24049,4,45,11,2,16,4,82,38.26216747532382,-109.408199
24050,3,48,11,1,15,4,82,38.26216747532382,-109.4079295
24051,2,54,10,0,16,4,86,38.26216747532382,-109.40766
24052,2,52,9,0,15,5,83,38.26216747532382,-109.4073905
24053,1,47,10,0,13,5,76,38.26216747532382,-109.407121
24054,1,39,10,2,11,8,71,38.26216747532382,-109.4068515
24055,2,35,11,0,11,13,72,38.26216747532382,-109.3879869
24056,2,36,11,0,12,13,74,38.26216747532382,-109.3877174
24057,4,39,12,1,14,9,79,38.26216747532382,-109.3874479
24058,5,45,12,4,17,3,86,38.26216747532382,-109.3871784
24059,5,45,13,4,17,4,88,38.26216747532382,-109.3869089
24060,5,46,13,4,16,3,87,38.26216747532382,-109.3866394
24061,5,47,13,3,16,4,88,38.26216747532382,-109.3863699
24062,3,49,12,2,16,6,88,38.26216747532382,-109.3861004
24063,2,50,10,1,13,7,83,38.26216747532382,-109.3858309
24064,2,49,10,1,15,5,82,38.26216747532382,-109.3855614
24065,1,46,10,1,15,5,78,38.26216747532382,-109.3852919
24066,1,42,10,1,13,7,74,38.26216747532382,-109.3850225
24067,3,38,10,3,12,5,71,38.26216747532382,-109.384753
24068,3,44,11,3,13,4,78,38.26216747532382,-109.3844835
24069,3,39,10,3,11,5,71,38.26216747532382,-109.384214
24070,2,35,10,2,9,9,67,38.26216747532382,-109.3839445
24071,2,28,11,2,9,11,63,38.26216747532382,-109.383675
24072,2,29,12,1,11,12,67,38.26216747532382,-109.3834055
24073,0,29,11,0,7,17,64,38.26216747532382,-109.383136
24074,1,32,10,0,10,14,67,38.26216747532382,-109.3828665
24075,1,32,11,0,11,14,69,38.26216747532382,-109.382597
24076,2,32,12,0,11,16,73,38.26216747532382,-109.3823275
24077,5,39,12,3,16,5,80,38.26216747532382,-109.382058
24078,5,44,13,6,19,1,88,38.26216747532382,-109.3817885
24079,6,44,13,7,19,1,90,38.26216747532382,-109.381519
24080,7,42,12,8,17,1,87,38.26216747532382,-109.3812495
24081,6,40,12,8,17,2,85,38.26216747532382,-109.38098
24082,5,42,12,6,17,3,85,38.26216747532382,-109.3807105
24083,6,42,12,6,17,2,85,38.26216747532382,-109.380441
24084,6,41,12,7,18,2,86,38.26216747532382,-109.3801716
24085,6,42,12,8,18,1,87,38.26216747532382,-109.3799021
24086,5,47,13,4,19,1,89,38.26216747532382,-109.3796326
24087,5,48,13,5,20,0,91,38.26216747532382,-109.3793631
24088,5,48,13,5,19,0,90,38.26216747532382,-109.3790936
24089,8,44,13,8,18,0,91,38.26216747532382,-109.3788241
24090,15,36,14,9,15,1,90,38.26216747532382,-109.3785546
24091,12,32,12,10,13,1,80,38.26216747532382,-109.3782851
24092,10,29,11,8,11,1,70,38.26216747532382,-109.3780156
24093,5,32,11,6,15,3,72,38.26216747532382,-109.3777461
24094,3,41,11,3,16,5,79,38.26216747532382,-109.3774766
24095,4,47,11,3,14,5,84,38.26216747532382,-109.3772071
24096,5,40,12,4,15,6,82,38.26216747532382,-109.3769376
24097,10,40,13,9,14,2,88,38.26216747532382,-109.3766681
24098,12,40,13,8,14,2,89,38.26216747532382,-109.3763986
24099,10,39,13,7,15,3,87,38.26216747532382,-109.3761291
24100,11,38,13,8,15,2,87,38.26216747532382,-109.3758596
24101,14,33,13,7,14,3,84,38.26216747532382,-109.3755901
24102,9,30,13,4,10,12,78,38.26216747532382,-109.3753206
24103,5,28,13,1,8,17,72,38.26216747532382,-109.3750512
24104,3,29,11,0,8,15,66,38.26216747532382,-109.3747817
24105,3,36,10,4,12,7,72,38.26216747532382,-109.3745122
24106,1,38,10,4,11,6,70,38.26216747532382,-109.3742427
24107,1,40,9,3,11,6,70,38.26216747532382,-109.3739732
24108,2,40,9,4,11,6,72,38.26216747532382,-109.3737037
24109,3,35,11,5,12,9,75,38.26216747532382,-109.3734342
24110,8,29,12,5,9,12,75,38.26216747532382,-109.3731647
24111,11,26,13,4,7,15,76,38.26216747532382,-109.3728952
24112,6,22,14,4,6,20,72,38.26216747532382,-109.3726257
24113,3,22,14,1,6,23,69,38.26216747532382,-109.3723562
24114,3,27,14,0,5,22,71,38.26216747532382,-109.3720867
24115,2,27,13,0,4,23,69,38.26216747532382,-109.3718172
24116,3,32,12,1,9,17,74,38.26216747532382,-109.3715477
24117,4,38,12,2,12,12,80,38.26216747532382,-109.3712782
24118,3,40,12,2,12,10,79,38.26216747532382,-109.3710087
24119,2,38,12,2,10,14,78,38.26216747532382,-109.3707392
24120,2,27,14,3,4,22,72,38.26216747532382,-109.3704697
24121,1,22,14,2,2,25,66,38.26216747532382,-109.3702003
24122,1,25,13,0,3,24,66,38.26216747532382,-109.3699308
24123,1,30,11,0,7,19,68,38.26216747532382,-109.3696613
24124,0,31,9,0,12,10,62,38.26216747532382,-109.3693918
24125,1,33,10,2,14,5,65,38.26216747532382,-109.3691223
24126,1,43,8,4,12,1,69,38.26216747532382,-109.3688528
24127,0,52,8,4,11,2,77,38.26216747532382,-109.3685833
24128,2,63,7,5,12,1,90,38.26216747532382,-109.3683138
24129,2,60,7,5,11,2,87,38.26216747532382,-109.3680443
24130,3,45,8,6,11,4,77,38.26216747532382,-109.3677748
24131,1,41,8,4,11,7,72,38.26216747532382,-109.3675053
24132,1,36,10,0,7,15,69,38.26216747532382,-109.3672358
24133,3,37,11,2,8,11,72,38.26216747532382,-109.3669663
24134,3,38,10,1,9,11,72,38.26216747532382,-109.3666968
24135,3,33,11,1,7,13,68,38.26216747532382,-109.3664273
24136,3,32,11,1,7,13,67,38.26216747532382,-109.3661578
24137,3,37,11,1,8,11,71,38.26216747532382,-109.3658883
24138,3,38,11,0,10,12,74,38.26216747532382,-109.3656188
24139,3,38,11,0,7,13,72,38.26216747532382,-109.3653493
24140,2,39,11,0,8,12,72,38.26216747532382,-109.3650799
24141,3,43,11,0,11,9,77,38.26216747532382,-109.3648104
24142,3,42,11,1,11,10,78,38.26216747532382,-109.3645409
24143,4,27,10,4,6,8,59,38.26216747532382,-109.3642714
24144,5,24,12,6,6,9,62,38.26216747532382,-109.3640019
24145,6,22,12,5,8,9,62,38.26216747532382,-109.3637324
24146,5,25,11,6,8,7,62,38.26216747532382,-109.3634629
24147,3,26,11,5,8,7,60,38.26216747532382,-109.3631934
24148,4,23,11,9,10,6,63,38.26216747532382,-109.3629239
24149,1,21,12,12,10,9,65,38.26216747532382,-109.3626544
24150,1,22,13,9,9,14,68,38.26216747532382,-109.3623849
24151,1,24,14,7,11,16,73,38.26216747532382,-109.3621154
24152,1,19,15,5,7,21,68,38.26216747532382,-109.3618459
24153,1,22,14,7,9,16,69,38.26216747532382,-109.3615764
24154,0,24,14,6,10,18,72,38.26216747532382,-109.3613069
24155,0,27,16,3,10,23,79,38.26216747532382,-109.3610374
24156,1,28,17,2,9,24,81,38.26216747532382,-109.3607679
24157,0,29,17,0,8,24,78,38.26216747532382,-109.3604984
24158,0,28,14,0,4,23,69,38.26216747532382,-109.360229
24159,1,26,13,0,4,19,63,38.26216747532382,-109.3599595
24160,2,27,11,3,6,13,62,38.26216747532382,-109.35969
24161,5,31,12,4,8,6,66,38.26216747532382,-109.3594205
24162,3,25,11,4,8,9,60,38.26216747532382,-109.359151
24163,3,24,13,3,10,13,66,38.26216747532382,-109.3588815
24164,1,28,15,0,6,25,75,38.26216747532382,-109.358612
24165,1,26,16,0,4,27,74,38.26216747532382,-109.3583425
24166,2,28,18,0,6,27,81,38.26216747532382,-109.358073
24167,2,25,17,0,5,27,76,38.26216747532382,-109.3578035
24168,2,26,15,0,6,24,73,38.26216747532382,-109.357534
24169,3,29,14,0,7,20,73,38.26216747532382,-109.3572645
24170,2,31,13,0,8,20,74,38.26216747532382,-109.356995
24171,2,27,13,0,6,22,70,38.26216747532382,-109.3567255
24172,2,26,13,0,6,21,68,38.26216747532382,-109.356456
24173,2,25,13,0,6,22,68,38.26216747532382,-109.3561865
24174,2,26,14,0,6,23,71,38.26216747532382,-109.355917
24175,2,26,14,0,4,24,70,38.26216747532382,-109.3556475
24176,0,21,13,0,4,24,62,38.26216747532382,-109.355378
24177,0,21,13,0,5,23,62,38.26216747532382,-109.3551086
24178,0,22,12,2,8,19,63,38.26216747532382,-109.3548391
24179,1,23,12,5,11,14,66,38.26216747532382,-109.3545696
24180,3,22,15,10,10,13,73,38.26216747532382,-109.3543001
24181,3,22,16,8,9,17,75,38.26216747532382,-109.3540306
24182,3,25,16,10,13,12,79,38.26216747532382,-109.3537611
24183,4,23,14,18,17,5,81,38.26216747532382,-109.3534916
24184,4,17,14,19,18,9,81,38.26216747532382,-109.3532221
24185,7,15,11,21,18,8,80,38.26216747532382,-109.3529526
24186,6,15,11,18,16,10,76,38.26216747532382,-109.3526831
24187,6,15,11,18,15,10,75,38.26216747532382,-109.3524136
24188,7,14,11,19,14,8,73,38.26216747532382,-109.3521441
24189,9,12,9,20,12,6,68,38.26216747532382,-109.3518746
24190,7,13,9,19,12,4,64,38.26216747532382,-109.3516051
24191,7,11,8,17,12,4,59,38.26216747532382,-109.3513356
24192,6,8,8,13,11,5,51,38.26216747532382,-109.3510661
24193,5,8,9,11,11,8,52,38.26216747532382,-109.3507966
24194,5,12,11,13,12,11,64,38.26216747532382,-109.3505271
24195,1,21,16,5,10,21,74,38.26216747532382,-109.3502577
24196,0,24,17,1,7,28,77,38.26216747532382,-109.3499882
24197,0,24,18,0,5,32,79,38.26216747532382,-109.3497187
24198,0,22,18,0,3,34,77,38.26216747532382,-109.3494492
24199,1,21,17,0,2,31,72,38.26216747532382,-109.3491797
24200,1,21,16,0,2,30,70,38.26216747532382,-109.3489102
24201,1,20,16,0,2,30,69,38.26216747532382,-109.3486407
24202,1,20,17,0,2,31,71,38.26216747532382,-109.3483712
24203,1,20,16,0,1,30,68,38.26216747532382,-109.3481017
24204,1,19,16,0,2,30,68,38.26216747532382,-109.3478322
24205,1,19,18,0,2,32,72,38.26216747532382,-109.3475627
24206,1,21,19,1,3,33,78,38.26216747532382,-109.3472932
24207,1,23,19,1,5,32,81,38.26216747532382,-109.3470237
24208,2,29,16,3,10,25,85,38.26216747532382,-109.3467542
24209,5,29,16,4,12,22,88,38.26216747532382,-109.3464847
24210,4,28,16,3,11,24,86,38.26216747532382,-109.3462152
24211,2,27,17,2,9,28,85,38.26216747532382,-109.3459457
24212,1,26,19,0,7,31,84,38.26216747532382,-109.3456762
24213,2,24,20,3,6,30,85,38.26216747532382,-109.3454068
24214,2,23,20,2,5,32,84,38.26216747532382,-109.3451373
24215,1,22,21,2,5,33,84,38.26216747532382,-109.3448678
24216,1,22,21,1,6,32,83,38.26216747532382,-109.3445983
24217,1,21,20,0,5,31,78,38.26216747532382,-109.3443288
24218,1,19,21,0,4,35,80,38.26216747532382,-109.3440593
24219,1,21,20,1,7,33,83,38.26216747532382,-109.3437898
24220,2,25,19,1,8,30,85,38.26216747532382,-109.3435203
24221,3,28,18,1,9,28,87,38.26216747532382,-109.3432508
24222,4,32,16,3,13,18,86,38.26216747532382,-109.3429813
24223,5,34,14,6,14,12,85,38.26216747532382,-109.3427118
24224,7,35,14,8,15,8,87,38.26216747532382,-109.3424423
24225,7,36,13,9,15,7,87,38.26216747532382,-109.3421728
24226,6,36,13,7,15,8,85,38.26216747532382,-109.3419033
24227,4,35,14,2,11,17,83,38.26216747532382,-109.3416338
24228,2,29,16,0,7,24,78,38.26216747532382,-109.3413643
24229,1,22,18,0,3,29,73,38.26216747532382,-109.3410948
24230,2,19,19,0,2,32,74,38.26216747532382,-109.3408253
24231,3,20,19,2,3,30,77,38.26216747532382,-109.3405558
24232,1,18,19,1,3,32,74,38.26216747532382,-109.3402864
24233,1,19,20,0,4,33,77,38.26216747532382,-109.3400169
24234,1,21,20,0,4,33,79,38.26216747532382,-109.3397474
24235,1,24,19,0,4,32,80,38.26216747532382,-109.3394779
24236,0,23,17,0,3,30,73,38.26216747532382,-109.3392084
24237,1,20,18,0,3,30,72,38.26216747532382,-109.3389389
24238,2,18,18,1,3,30,72,38.26216747532382,-109.3386694
24239,1,18,18,2,5,30,74,38.26216747532382,-109.3383999
24240,1,21,19,1,6,32,80,38.26216747532382,-109.3381304
24241,2,22,18,7,8,25,82,38.26216747532382,-109.3378609
24242,0,19,18,2,6,29,74,38.26216747532382,-109.3375914
24243,0,20,20,0,5,33,78,38.26216747532382,-109.3373219
24244,0,22,18,0,5,32,77,38.26216747532382,-109.3370524
24245,3,28,18,4,7,24,84,38.26216747532382,-109.3367829
24246,3,25,19,3,5,26,81,38.26216747532382,-109.3365134
24247,1,21,18,1,3,28,72,38.26216747532382,-109.3362439
24248,1,20,14,2,3,23,63,38.26216747532382,-109.3359744
24249,1,26,12,3,9,16,67,38.26216747532382,-109.3357049
24250,1,31,11,3,11,13,70,38.26216747532382,-109.3354355
24251,1,24,13,4,5,19,66,38.26216747532382,-109.335166
24252,0,22,15,1,3,25,66,38.26216747532382,-109.3348965
24253,1,21,16,0,3,26,67,38.26216747532382,-109.334627
24254,1,17,18,1,3,29,69,38.26216747532382,-109.3343575
24255,3,13,18,5,8,28,75,38.26216747532382,-109.334088
24256,3,44,11,3,15,5,81,38.26189798073858,-109.4426943
24257,4,41,11,6,15,4,81,38.26189798073858,-109.4424248
24258,3,48,10,2,14,7,84,38.26189798073858,-109.4421553
24259,2,50,10,3,14,6,85,38.26189798073858,-109.4418858
24260,2,46,11,3,14,6,82,38.26189798073858,-109.4416163
24261,3,36,10,1,6,15,71,38.26189798073858,-109.4413468
24262,2,38,9,1,10,11,71,38.26189798073858,-109.4410773
24263,2,45,10,1,14,7,79,38.26189798073858,-109.4408078
24264,2,48,10,1,14,7,82,38.26189798073858,-109.4405383
24265,2,44,10,1,13,9,79,38.26189798073858,-109.4402688
24266,2,41,9,1,10,10,73,38.26189798073858,-109.4399993
24267,1,43,9,1,14,7,75,38.26189798073858,-109.4397299
24268,2,44,10,2,14,6,78,38.26189798073858,-109.4394604
24269,2,46,9,2,13,5,77,38.26189798073858,-109.4391909
24270,2,51,8,0,13,6,80,38.26189798073858,-109.4389214
24271,2,45,10,0,12,10,79,38.26189798073858,-109.4386519
24272,2,45,10,1,14,8,80,38.26189798073858,-109.4383824
24273,1,46,10,0,15,7,79,38.26189798073858,-109.4381129
24274,1,44,9,1,13,7,75,38.26189798073858,-109.4378434
24275,2,38,8,2,8,9,67,38.26189798073858,-109.4375739
24276,1,37,8,2,10,8,66,38.26189798073858,-109.4373044
24277,1,33,9,3,11,9,66,38.26189798073858,-109.4370349
24278,1,32,10,2,12,9,66,38.26189798073858,-109.4367654
24279,1,38,10,0,12,11,72,38.26189798073858,-109.4364959
24280,1,47,8,0,12,10,78,38.26189798073858,-109.4362264
24281,1,48,8,0,13,7,77,38.26189798073858,-109.4359569
24282,2,48,10,1,14,6,81,38.26189798073858,-109.4356874
24283,3,48,11,4,14,5,85,38.26189798073858,-109.4354179
24284,5,48,11,6,14,4,88,38.26189798073858,-109.4351484
24285,5,50,11,7,15,2,90,38.26189798073858,-109.434879
24286,3,53,10,3,15,4,88,38.26189798073858,-109.4346095
24287,3,52,10,3,15,5,88,38.26189798073858,-109.43434
24288,5,52,10,4,15,3,89,38.26189798073858,-109.4340705
24289,8,51,11,5,16,1,92,38.26189798073858,-109.433801
24290,10,46,11,7,16,1,91,38.26189798073858,-109.4335315
24291,8,45,11,6,16,2,88,38.26189798073858,-109.433262
24292,8,45,12,7,16,1,89,38.26189798073858,-109.4329925
24293,12,42,13,11,14,1,93,38.26189798073858,-109.432723
24294,20,35,13,12,13,0,93,38.26189798073858,-109.4324535
24295,17,37,14,12,14,0,94,38.26189798073858,-109.432184
24296,13,39,14,13,14,1,94,38.26189798073858,-109.4319145
24297,11,40,15,14,14,1,95,38.26189798073858,-109.431645
24298,12,38,15,14,13,1,93,38.26189798073858,-109.4313755
24299,14,36,15,14,12,1,92,38.26189798073858,-109.431106
24300,10,39,15,14,13,1,92,38.26189798073858,-109.4308365
24301,10,43,14,13,14,1,95,38.26189798073858,-109.430567
24302,11,43,14,12,14,1,95,38.26189798073858,-109.4302975
24303,12,41,14,12,13,0,92,38.26189798073858,-109.430028
24304,8,44,14,12,14,1,93,38.26189798073858,-109.4297586
24305,7,44,14,12,15,1,93,38.26189798073858,-109.4294891
24306,8,44,14,11,15,1,93,38.26189798073858,-109.4292196
24307,10,41,14,12,15,1,93,38.26189798073858,-109.4289501
24308,19,34,14,12,13,0,92,38.26189798073858,-109.4286806
24309,14,37,14,12,14,0,91,38.26189798073858,-109.4284111
24310,11,40,14,13,13,1,92,38.26189798073858,-109.4281416
24311,8,42,14,13,12,1,90,38.26189798073858,-109.4278721
24312,8,43,14,13,11,1,90,38.26189798073858,-109.4276026
24313,9,43,14,12,12,1,91,38.26189798073858,-109.4273331
24314,9,42,14,12,13,1,91,38.26189798073858,-109.4270636
24315,10,42,14,12,14,1,93,38.26189798073858,-109.4267941
24316,9,42,14,12,14,1,92,38.26189798073858,-109.4265246
24317,7,42,14,11,13,1,88,38.26189798073858,-109.4262551
24318,8,41,14,11,14,1,89,38.26189798073858,-109.4259856
24319,10,41,15,12,15,0,93,38.26189798073858,-109.4257161
24320,11,41,15,12,15,0,94,38.26189798073858,-109.4254466
24321,10,42,14,12,15,0,93,38.26189798073858,-109.4251771
24322,7,43,14,11,16,1,92,38.26189798073858,-109.4249077
24323,8,45,14,11,17,0,95,38.26189798073858,-109.4246382
24324,7,44,14,11,16,0,92,38.26189798073858,-109.4243687
24325,7,44,14,10,16,1,92,38.26189798073858,-109.4240992
24326,8,45,13,9,15,1,91,38.26189798073858,-109.4238297
24327,8,44,13,9,15,1,90,38.26189798073858,-109.4235602
24328,7,42,14,11,14,2,90,38.26189798073858,-109.4232907
24329,8,41,14,11,14,1,89,38.26189798073858,-109.4230212
24330,8,40,14,12,14,1,89,38.26189798073858,-109.4227517
24331,10,37,15,14,15,1,92,38.26189798073858,-109.4224822
24332,9,36,15,13,14,1,88,38.26189798073858,-109.4222127
24333,9,35,15,13,14,1,87,38.26189798073858,-109.4219432
24334,8,35,15,13,14,1,86,38.26189798073858,-109.4216737
24335,8,36,15,13,14,1,87,38.26189798073858,-109.4214042
24336,8,36,14,13,14,1,86,38.26189798073858,-109.4211347
24337,8,35,14,12,14,1,84,38.26189798073858,-109.4208652
24338,8,35,13,11,13,1,81,38.26189798073858,-109.4205957
24339,9,36,14,12,13,1,85,38.26189798073858,-109.4203262
24340,13,35,15,13,13,0,89,38.26189798073858,-109.4200568
24341,14,36,15,12,13,1,91,38.26189798073858,-109.4197873
24342,12,37,15,14,14,0,92,38.26189798073858,-109.4195178
24343,9,39,14,13,14,0,89,38.26189798073858,-109.4192483
24344,6,44,14,11,14,1,90,38.26189798073858,-109.4189788
24345,6,50,13,9,14,1,93,38.26189798073858,-109.4187093
24346,3,54,10,6,13,2,88,38.26189798073858,-109.4184398
24347,3,57,10,6,14,1,91,38.26189798073858,-109.4181703
24348,4,53,12,8,16,0,93,38.26189798073858,-109.4179008
24349,8,44,13,11,16,0,92,38.26189798073858,-109.4176313
24350,10,42,13,10,15,0,90,38.26189798073858,-109.4173618
24351,9,43,13,9,16,0,90,38.26189798073858,-109.4170923
24352,9,43,13,10,16,0,91,38.26189798073858,-109.4168228
24353,8,44,12,9,16,0,89,38.26189798073858,-109.4165533
24354,7,44,12,7,17,1,88,38.26189798073858,-109.4162838
24355,6,46,12,7,17,2,90,38.26189798073858,-109.4160143
24356,7,45,13,8,17,1,91,38.26189798073858,-109.4157448
24357,10,43,13,10,16,0,92,38.26189798073858,-109.4154753
24358,12,41,14,11,14,0,92,38.26189798073858,-109.4152058
24359,12,39,14,13,13,0,91,38.26189798073858,-109.4149364
24360,11,42,14,12,13,0,92,38.26189798073858,-109.4146669
24361,7,45,13,10,16,0,91,38.26189798073858,-109.4143974
24362,6,47,13,7,17,1,91,38.26189798073858,-109.4141279
24363,6,48,13,7,16,1,91,38.26189798073858,-109.4138584
24364,5,50,13,7,17,1,93,38.26189798073858,-109.4135889
24365,5,50,13,7,18,0,93,38.26189798073858,-109.4133194
24366,5,51,13,7,17,0,93,38.26189798073858,-109.4130499
24367,6,51,12,7,16,0,92,38.26189798073858,-109.4127804
24368,6,46,12,8,15,0,87,38.26189798073858,-109.4125109
24369,9,38,12,9,13,2,83,38.26189798073858,-109.4122414
24370,10,36,13,10,12,2,83,38.26189798073858,-109.4119719
24371,7,44,13,9,13,2,88,38.26189798073858,-109.4117024
24372,5,52,13,6,15,2,93,38.26189798073858,-109.4114329
24373,5,52,13,5,16,2,93,38.26189798073858,-109.4111634
24374,4,53,13,5,15,3,93,38.26189798073858,-109.4108939
24375,4,55,12,5,15,2,93,38.26189798073858,-109.4106244
24376,5,53,13,5,16,1,93,38.26189798073858,-109.4103549
24377,7,48,13,6,17,0,91,38.26189798073858,-109.4100855
24378,8,47,13,7,16,0,91,38.26189798073858,-109.409816
24379,8,46,13,8,17,0,92,38.26189798073858,-109.4095465
24380,6,45,12,8,18,0,89,38.26189798073858,-109.409277
24381,6,45,12,8,18,1,90,38.26189798073858,-109.4090075
24382,5,45,12,7,18,2,89,38.26189798073858,-109.408738
24383,5,46,12,6,18,2,89,38.26189798073858,-109.4084685
24384,5,44,12,5,17,2,85,38.26189798073858,-109.408199
24385,3,45,11,2,17,4,82,38.26189798073858,-109.4079295
24386,2,48,10,0,16,6,82,38.26189798073858,-109.40766
24387,2,48,10,0,15,7,82,38.26189798073858,-109.4073905
24388,2,48,10,1,15,4,80,38.26189798073858,-109.407121
24389,2,41,10,2,13,6,74,38.26189798073858,-109.4068515
24390,2,37,11,0,12,12,74,38.26189798073858,-109.3879869
24391,2,38,11,0,13,11,75,38.26189798073858,-109.3877174
24392,3,41,12,1,15,8,80,38.26189798073858,-109.3874479
24393,5,46,13,3,16,4,87,38.26189798073858,-109.3871784
24394,5,45,13,5,17,3,88,38.26189798073858,-109.3869089
24395,6,46,13,5,17,2,89,38.26189798073858,-109.3866394
24396,5,48,13,4,17,2,89,38.26189798073858,-109.3863699
24397,3,51,12,2,16,5,89,38.26189798073858,-109.3861004
24398,2,52,9,0,14,6,83,38.26189798073858,-109.3858309
24399,1,50,10,1,15,5,82,38.26189798073858,-109.3855614
24400,1,42,9,1,13,6,72,38.26189798073858,-109.3852919
24401,2,35,9,3,9,7,65,38.26189798073858,-109.3850225
24402,2,34,9,4,8,6,63,38.26189798073858,-109.384753
24403,3,42,10,4,12,5,76,38.26189798073858,-109.3844835
24404,2,38,10,4,11,6,71,38.26189798073858,-109.384214
24405,1,30,11,3,10,11,66,38.26189798073858,-109.3839445
24406,1,28,12,0,8,17,66,38.26189798073858,-109.383675
24407,1,32,13,0,9,19,74,38.26189798073858,-109.3834055
24408,0,31,11,0,10,15,67,38.26189798073858,-109.383136
24409,1,31,11,0,10,16,69,38.26189798073858,-109.3828665
24410,2,32,13,0,9,18,74,38.26189798073858,-109.382597
24411,2,35,12,0,11,15,75,38.26189798073858,-109.3823275
24412,3,43,13,2,17,6,84,38.26189798073858,-109.382058
24413,5,44,13,6,18,2,88,38.26189798073858,-109.3817885
24414,6,43,13,9,18,0,89,38.26189798073858,-109.381519
24415,8,39,13,11,17,0,88,38.26189798073858,-109.3812495
24416,9,38,13,12,17,0,89,38.26189798073858,-109.38098
24417,7,40,13,10,18,0,88,38.26189798073858,-109.3807105
24418,8,39,12,9,19,0,87,38.26189798073858,-109.380441
24419,8,40,12,9,18,0,87,38.26189798073858,-109.3801716
24420,7,43,12,7,18,0,87,38.26189798073858,-109.3799021
24421,5,48,13,5,20,0,91,38.26189798073858,-109.3796326
24422,6,50,13,5,19,0,93,38.26189798073858,-109.3793631
24423,6,50,13,5,18,0,92,38.26189798073858,-109.3790936
24424,7,49,13,5,17,0,91,38.26189798073858,-109.3788241
24425,9,44,12,6,15,0,86,38.26189798073858,-109.3785546
24426,11,29,10,7,11,2,70,38.26189798073858,-109.3782851
24427,12,28,10,4,11,3,68,38.26189798073858,-109.3780156
24428,8,36,11,5,14,3,77,38.26189798073858,-109.3777461
24429,6,43,11,3,15,4,82,38.26189798073858,-109.3774766
24430,9,40,12,6,12,4,83,38.26189798073858,-109.3772071
24431,11,40,12,6,14,3,86,38.26189798073858,-109.3769376
24432,15,39,12,6,12,2,86,38.26189798073858,-109.3766681
24433,16,38,12,7,13,2,88,38.26189798073858,-109.3763986
24434,16,36,13,8,14,2,89,38.26189798073858,-109.3761291
24435,18,32,13,8,13,3,87,38.26189798073858,-109.3758596
24436,6,27,13,3,8,16,73,38.26189798073858,-109.3755901
24437,2,28,12,1,7,17,67,38.26189798073858,-109.3753206
24438,1,34,10,1,11,11,68,38.26189798073858,-109.3750512
24439,2,42,9,2,11,7,73,38.26189798073858,-109.3747817
24440,1,39,9,3,10,7,69,38.26189798073858,-109.3745122
24441,3,36,11,5,11,8,74,38.26189798073858,-109.3742427
24442,2,38,11,1,12,10,74,38.26189798073858,-109.3739732
24443,2,39,10,0,11,12,74,38.26189798073858,-109.3737037
24444,2,35,10,1,9,15,72,38.26189798073858,-109.3734342
24445,5,25,14,3,6,20,73,38.26189798073858,-109.3731647
24446,4,25,14,3,5,22,73,38.26189798073858,-109.3728952
24447,5,26,15,3,5,22,76,38.26189798073858,-109.3726257
24448,6,28,15,2,6,21,78,38.26189798073858,-109.3723562
24449,4,30,13,0,7,19,73,38.26189798073858,-109.3720867
24450,4,31,12,2,10,15,74,38.26189798073858,-109.3718172
24451,4,35,12,3,11,12,77,38.26189798073858,-109.3715477
24452,4,38,13,3,12,11,81,38.26189798073858,-109.3712782
24453,3,37,12,2,11,14,79,38.26189798073858,-109.3710087
24454,2,30,14,3,5,22,76,38.26189798073858,-109.3707392
24455,1,22,15,2,2,26,68,38.26189798073858,-109.3704697
24456,1,24,13,0,2,24,64,38.26189798073858,-109.3702003
24457,0,31,10,0,5,19,65,38.26189798073858,-109.3699308
24458,0,36,10,0,13,8,67,38.26189798073858,-109.3696613
24459,0,47,10,1,15,3,76,38.26189798073858,-109.3693918
24460,1,55,9,5,11,1,82,38.26189798073858,-109.3691223
24461,1,54,8,4,11,3,81,38.26189798073858,-109.3688528
24462,1,52,8,4,11,4,80,38.26189798073858,-109.3685833
24463,2,52,9,5,10,5,83,38.26189798073858,-109.3683138
24464,2,46,9,5,11,5,78,38.26189798073858,-109.3680443
24465,1,45,8,4,11,6,75,38.26189798073858,-109.3677748
24466,2,37,10,1,10,12,72,38.26189798073858,-109.3675053
24467,1,31,11,1,6,17,67,38.26189798073858,-109.3672358
24468,2,31,11,2,7,15,68,38.26189798073858,-109.3669663
24469,2,35,11,1,8,14,71,38.26189798073858,-109.3666968
24470,2,33,11,1,7,13,67,38.26189798073858,-109.3664273
24471,2,34,11,1,8,12,68,38.26189798073858,-109.3661578
24472,2,40,10,1,10,10,73,38.26189798073858,-109.3658883
24473,2,40,10,0,10,11,73,38.26189798073858,-109.3656188
24474,2,37,11,0,8,13,71,38.26189798073858,-109.3653493
24475,2,36,11,1,8,12,70,38.26189798073858,-109.3650799
24476,2,38,11,1,10,10,72,38.26189798073858,-109.3648104
24477,3,38,11,2,10,9,73,38.26189798073858,-109.3645409
24478,6,32,11,6,7,5,67,38.26189798073858,-109.3642714
24479,5,27,12,6,7,8,65,38.26189798073858,-109.3640019
24480,4,25,12,5,9,9,64,38.26189798073858,-109.3637324
24481,2,28,12,5,9,9,65,38.26189798073858,-109.3634629
24482,2,23,11,7,8,11,62,38.26189798073858,-109.3631934
24483,0,26,12,5,11,14,68,38.26189798073858,-109.3629239
24484,0,27,14,4,11,19,75,38.26189798073858,-109.3626544
24485,0,27,15,3,9,21,75,38.26189798073858,-109.3623849
24486,1,28,16,4,7,20,76,38.26189798073858,-109.3621154
24487,0,25,16,3,8,21,73,38.26189798073858,-109.3618459
24488,0,25,14,3,9,19,70,38.26189798073858,-109.3615764
24489,0,27,14,4,11,17,73,38.26189798073858,-109.3613069
24490,0,28,15,2,9,20,74,38.26189798073858,-109.3610374
24491,0,27,16,0,6,26,75,38.26189798073858,-109.3607679
24492,2,27,16,0,5,25,75,38.26189798073858,-109.3604984
24493,0,26,16,0,4,27,73,38.26189798073858,-109.360229
24494,0,25,16,0,3,27,71,38.26189798073858,-109.3599595
24495,0,25,15,0,4,24,68,38.26189798073858,-109.35969
24496,1,26,13,3,7,17,67,38.26189798073858,-109.3594205
24497,0,26,14,2,8,20,70,38.26189798073858,-109.359151
24498,1,25,15,0,7,24,72,38.26189798073858,-109.3588815
24499,1,26,15,0,6,25,73,38.26189798073858,-109.358612
24500,0,24,14,0,6,24,68,38.26189798073858,-109.3583425
24501,1,27,15,0,5,25,73,38.26189798073858,-109.358073
24502,1,29,15,0,8,23,76,38.26189798073858,-109.3578035
24503,2,29,15,0,8,21,75,38.26189798073858,-109.357534
24504,3,27,16,0,7,21,74,38.26189798073858,-109.3572645
24505,3,26,17,0,5,26,77,38.26189798073858,-109.356995
24506,2,25,15,0,5,25,72,38.26189798073858,-109.3567255
24507,3,25,14,1,4,22,69,38.26189798073858,-109.356456
24508,4,25,13,1,4,21,68,38.26189798073858,-109.3561865
24509,3,23,13,0,3,22,64,38.26189798073858,-109.355917
24510,2,21,13,0,3,23,62,38.26189798073858,-109.3556475
24511,0,18,13,1,3,22,57,38.26189798073858,-109.355378
24512,1,24,13,3,8,18,67,38.26189798073858,-109.3551086
24513,2,27,13,4,12,15,73,38.26189798073858,-109.3548391
24514,3,24,13,9,13,11,73,38.26189798073858,-109.3545696
24515,4,29,14,10,14,11,82,38.26189798073858,-109.3543001
24516,4,26,14,13,16,6,79,38.26189798073858,-109.3540306
24517,5,27,13,18,18,3,84,38.26189798073858,-109.3537611
24518,6,27,12,19,19,1,84,38.26189798073858,-109.3534916
24519,6,22,14,18,16,5,81,38.26189798073858,-109.3532221
24520,3,21,13,12,15,11,75,38.26189798073858,-109.3529526
24521,5,16,11,11,14,11,68,38.26189798073858,-109.3526831
24522,5,13,10,14,14,9,65,38.26189798073858,-109.3524136
24523,6,11,10,15,12,7,61,38.26189798073858,-109.3521441
24524,6,7,8,12,10,6,49,38.26189798073858,-109.3518746
24525,6,7,7,15,10,8,53,38.26189798073858,-109.3516051
24526,6,8,11,15,10,14,64,38.26189798073858,-109.3513356
24527,4,14,14,9,11,19,71,38.26189798073858,-109.3510661
24528,0,20,16,4,8,24,72,38.26189798073858,-109.3507966
24529,0,23,17,2,8,27,77,38.26189798073858,-109.3505271
24530,1,23,18,0,4,32,78,38.26189798073858,-109.3502577
24531,2,20,17,0,2,33,74,38.26189798073858,-109.3499882
24532,2,18,17,0,1,32,70,38.26189798073858,-109.3497187
24533,1,17,17,0,1,34,70,38.26189798073858,-109.3494492
24534,1,19,17,0,1,32,70,38.26189798073858,-109.3491797
24535,1,19,17,0,1,32,70,38.26189798073858,-109.3489102
24536,2,19,17,0,0,31,69,38.26189798073858,-109.3486407
24537,2,18,16,0,0,30,66,38.26189798073858,-109.3483712
24538,1,20,14,0,1,25,61,38.26189798073858,-109.3481017
24539,1,21,15,0,2,28,67,38.26189798073858,-109.3478322
24540,1,20,18,0,2,32,73,38.26189798073858,-109.3475627
24541,1,21,20,0,4,35,81,38.26189798073858,-109.3472932
24542,1,22,20,0,6,35,84,38.26189798073858,-109.3470237
24543,2,25,18,2,8,31,86,38.26189798073858,-109.3467542
24544,3,28,17,2,11,26,87,38.26189798073858,-109.3464847
24545,4,28,16,3,11,24,86,38.26189798073858,-109.3462152
24546,3,28,17,3,11,25,87,38.26189798073858,-109.3459457
24547,2,27,18,2,10,27,86,38.26189798073858,-109.3456762
24548,3,26,18,1,7,29,84,38.26189798073858,-109.3454068
24549,2,24,19,1,6,31,83,38.26189798073858,-109.3451373
24550,1,23,20,1,6,33,84,38.26189798073858,-109.3448678
24551,0,23,20,0,5,34,82,38.26189798073858,-109.3445983
24552,1,19,19,0,2,32,73,38.26189798073858,-109.3443288
24553,1,18,19,0,2,33,73,38.26189798073858,-109.3440593
24554,1,19,19,0,4,33,76,38.26189798073858,-109.3437898
24555,2,24,18,1,6,31,82,38.26189798073858,-109.3435203
24556,3,28,18,1,9,28,87,38.26189798073858,-109.3432508
24557,5,32,15,4,12,18,86,38.26189798073858,-109.3429813
24558,5,34,14,5,14,14,86,38.26189798073858,-109.3427118
24559,5,34,14,6,14,14,87,38.26189798073858,-109.3424423
24560,5,33,15,7,12,15,87,38.26189798073858,-109.3421728
24561,4,32,15,5,11,17,84,38.26189798073858,-109.3419033
24562,2,29,17,2,9,24,83,38.26189798073858,-109.3416338
24563,1,26,19,1,6,31,84,38.26189798073858,-109.3413643
24564,1,22,21,0,5,35,84,38.26189798073858,-109.3410948
24565,1,21,20,0,4,35,81,38.26189798073858,-109.3408253
24566,0,20,19,0,3,33,75,38.26189798073858,-109.3405558
24567,0,21,20,0,3,34,78,38.26189798073858,-109.3402864
24568,1,20,21,0,5,36,83,38.26189798073858,-109.3400169
24569,1,18,21,0,5,38,83,38.26189798073858,-109.3397474
24570,1,19,21,0,5,38,84,38.26189798073858,-109.3394779
24571,0,20,21,0,4,38,83,38.26189798073858,-109.3392084
24572,1,21,20,2,6,34,84,38.26189798073858,-109.3389389
24573,0,22,21,2,6,34,85,38.26189798073858,-109.3386694
24574,0,22,21,0,6,36,85,38.26189798073858,-109.3383999
24575,1,18,19,0,4,33,75,38.26189798073858,-109.3381304
24576,1,17,17,4,6,24,69,38.26189798073858,-109.3378609
24577,1,17,18,2,4,29,71,38.26189798073858,-109.3375914
24578,1,17,17,1,3,28,67,38.26189798073858,-109.3373219
24579,1,20,14,3,4,22,64,38.26189798073858,-109.3370524
24580,2,25,13,3,6,18,67,38.26189798073858,-109.3367829
24581,2,22,14,3,4,21,66,38.26189798073858,-109.3365134
24582,1,20,15,3,3,23,65,38.26189798073858,-109.3362439
24583,1,24,12,2,4,20,63,38.26189798073858,-109.3359744
24584,1,34,9,1,9,11,65,38.26189798073858,-109.3357049
24585,1,36,9,2,9,8,65,38.26189798073858,-109.3354355
24586,1,38,10,2,12,10,73,38.26189798073858,-109.335166
24587,1,31,11,2,9,15,69,38.26189798073858,-109.3348965
24588,1,24,13,2,4,22,66,38.26189798073858,-109.334627
24589,1,19,17,1,3,27,68,38.26189798073858,-109.3343575
24590,1,16,18,1,3,30,69,38.26189798073858,-109.334088
24591,1,13,16,4,3,25,62,38.26189798073858,-109.3338185
24592,2,44,11,2,14,8,81,38.26162848615334,-109.4426943
24593,4,46,12,5,16,4,87,38.26162848615334,-109.4424248
24594,3,51,10,3,13,5,85,38.26162848615334,-109.4421553
24595,2,51,10,2,13,6,84,38.26162848615334,-109.4418858
24596,2,47,11,2,15,7,84,38.26162848615334,-109.4416163
24597,3,36,11,0,7,15,72,38.26162848615334,-109.4413468
24598,1,41,10,0,12,12,76,38.26162848615334,-109.4410773
24599,2,45,11,1,14,8,81,38.26162848615334,-109.4408078
24600,2,49,10,1,13,9,84,38.26162848615334,-109.4405383
24601,2,47,10,0,11,10,80,38.26162848615334,-109.4402688
24602,2,41,10,0,11,12,76,38.26162848615334,-109.4399993
24603,1,40,9,0,10,11,71,38.26162848615334,-109.4397299
24604,2,44,10,1,13,7,77,38.26162848615334,-109.4394604
24605,2,47,10,1,15,5,80,38.26162848615334,-109.4391909
24606,2,50,9,0,14,6,81,38.26162848615334,-109.4389214
24607,2,47,10,0,15,8,82,38.26162848615334,-109.4386519
24608,2,51,10,2,17,5,87,38.26162848615334,-109.4383824
24609,3,52,10,4,15,4,88,38.26162848615334,-109.4381129
24610,3,51,9,3,14,4,84,38.26162848615334,-109.4378434
24611,2,50,9,0,13,7,81,38.26162848615334,-109.4375739
24612,1,44,8,0,10,10,73,38.26162848615334,-109.4373044
24613,2,40,9,0,10,10,71,38.26162848615334,-109.4370349
24614,2,39,9,0,11,12,73,38.26162848615334,-109.4367654
24615,1,43,10,0,13,13,80,38.26162848615334,-109.4364959
24616,2,50,10,0,16,6,84,38.26162848615334,-109.4362264
24617,2,51,10,2,15,3,83,38.26162848615334,-109.4359569
24618,3,50,11,4,16,3,87,38.26162848615334,-109.4356874
24619,5,49,12,6,15,3,90,38.26162848615334,-109.4354179
24620,6,48,12,8,15,2,91,38.26162848615334,-109.4351484
24621,6,48,11,8,15,2,90,38.26162848615334,-109.434879
24622,5,51,11,6,16,2,91,38.26162848615334,-109.4346095
24623,5,50,11,5,16,3,90,38.26162848615334,-109.43434
24624,7,47,11,6,16,2,89,38.26162848615334,-109.4340705
24625,10,45,12,8,15,1,91,38.26162848615334,-109.433801
24626,11,44,12,10,16,0,93,38.26162848615334,-109.4335315
24627,11,43,12,11,15,0,92,38.26162848615334,-109.433262
24628,15,41,13,11,14,0,94,38.26162848615334,-109.4329925
24629,22,35,13,10,12,0,92,38.26162848615334,-109.432723
24630,28,29,12,11,11,0,91,38.26162848615334,-109.4324535
24631,18,37,14,11,13,0,93,38.26162848615334,-109.432184
24632,13,41,14,13,13,1,95,38.26162848615334,-109.4319145
24633,11,41,15,13,14,1,95,38.26162848615334,-109.431645
24634,12,39,15,14,13,1,94,38.26162848615334,-109.4313755
24635,12,38,15,15,12,1,93,38.26162848615334,-109.431106
24636,13,38,15,14,13,1,94,38.26162848615334,-109.4308365
24637,11,41,14,13,13,1,93,38.26162848615334,-109.430567
24638,10,43,14,13,14,1,95,38.26162848615334,-109.4302975
24639,9,43,14,13,14,1,94,38.26162848615334,-109.430028
24640,8,44,14,13,14,1,94,38.26162848615334,-109.4297586
24641,8,45,14,12,14,1,94,38.26162848615334,-109.4294891
24642,9,45,13,11,14,1,93,38.26162848615334,-109.4292196
24643,9,43,14,12,15,1,94,38.26162848615334,-109.4289501
24644,12,39,14,13,15,0,93,38.26162848615334,-109.4286806
24645,11,41,13,12,14,1,92,38.26162848615334,-109.4284111
24646,9,43,14,12,14,1,93,38.26162848615334,-109.4281416
24647,8,43,14,12,13,1,91,38.26162848615334,-109.4278721
24648,7,45,14,12,13,1,92,38.26162848615334,-109.4276026
24649,9,43,14,12,13,1,92,38.26162848615334,-109.4273331
24650,9,43,14,12,14,1,93,38.26162848615334,-109.4270636
24651,9,42,14,12,14,1,92,38.26162848615334,-109.4267941
24652,8,42,14,11,14,1,90,38.26162848615334,-109.4265246
24653,6,41,14,11,14,2,88,38.26162848615334,-109.4262551
24654,8,41,14,12,15,1,91,38.26162848615334,-109.4259856
24655,12,39,14,13,15,0,93,38.26162848615334,-109.4257161
24656,13,39,14,13,14,0,93,38.26162848615334,-109.4254466
24657,10,41,14,13,15,0,93,38.26162848615334,-109.4251771
24658,7,44,14,11,16,1,93,38.26162848615334,-109.4249077
24659,8,43,14,11,16,1,93,38.26162848615334,-109.4246382
24660,9,43,14,11,16,1,94,38.26162848615334,-109.4243687
24661,8,44,13,10,15,1,91,38.26162848615334,-109.4240992
24662,7,45,13,9,16,1,91,38.26162848615334,-109.4238297
24663,8,45,13,10,15,1,92,38.26162848615334,-109.4235602
24664,7,43,14,11,15,1,91,38.26162848615334,-109.4232907
24665,8,41,14,12,15,1,91,38.26162848615334,-109.4230212
24666,9,40,14,12,15,1,91,38.26162848615334,-109.4227517
24667,11,37,15,13,15,1,92,38.26162848615334,-109.4224822
24668,11,37,15,14,15,0,92,38.26162848615334,-109.4222127
24669,10,37,15,14,15,1,92,38.26162848615334,-109.4219432
24670,8,36,15,13,15,1,88,38.26162848615334,-109.4216737
24671,8,36,14,13,14,1,86,38.26162848615334,-109.4214042
24672,8,36,14,13,14,2,87,38.26162848615334,-109.4211347
24673,11,35,14,12,14,1,87,38.26162848615334,-109.4208652
24674,12,35,15,12,13,1,88,38.26162848615334,-109.4205957
24675,13,37,15,13,13,1,92,38.26162848615334,-109.4203262
24676,14,37,15,14,13,0,93,38.26162848615334,-109.4200568
24677,15,37,15,13,13,0,93,38.26162848615334,-109.4197873
24678,14,37,15,13,14,0,93,38.26162848615334,-109.4195178
24679,10,40,14,13,15,0,92,38.26162848615334,-109.4192483
24680,6,44,14,10,15,1,90,38.26162848615334,-109.4189788
24681,5,50,13,8,14,1,91,38.26162848615334,-109.4187093
24682,3,56,10,5,14,1,89,38.26162848615334,-109.4184398
24683,4,52,11,7,15,1,90,38.26162848615334,-109.4181703
24684,8,46,13,10,16,0,93,38.26162848615334,-109.4179008
24685,11,41,13,11,15,0,91,38.26162848615334,-109.4176313
24686,9,42,13,9,16,0,89,38.26162848615334,-109.4173618
24687,9,42,13,10,16,0,90,38.26162848615334,-109.4170923
24688,7,46,13,8,18,0,92,38.26162848615334,-109.4168228
24689,6,47,12,6,17,1,89,38.26162848615334,-109.4165533
24690,7,46,12,6,15,2,88,38.26162848615334,-109.4162838
24691,6,46,13,7,15,3,90,38.26162848615334,-109.4160143
24692,8,45,13,8,16,1,91,38.26162848615334,-109.4157448
24693,9,43,14,11,15,0,92,38.26162848615334,-109.4154753
24694,12,39,15,14,13,0,93,38.26162848615334,-109.4152058
24695,15,37,16,15,13,0,96,38.26162848615334,-109.4149364
24696,17,37,16,13,12,0,95,38.26162848615334,-109.4146669
24697,11,42,15,13,13,0,94,38.26162848615334,-109.4143974
24698,8,47,14,10,14,0,93,38.26162848615334,-109.4141279
24699,6,48,14,10,16,0,94,38.26162848615334,-109.4138584
24700,6,47,13,9,16,0,91,38.26162848615334,-109.4135889
24701,7,46,13,10,16,0,92,38.26162848615334,-109.4133194
24702,8,45,13,10,15,0,91,38.26162848615334,-109.4130499
24703,9,43,13,10,13,1,89,38.26162848615334,-109.4127804
24704,10,38,13,10,12,1,84,38.26162848615334,-109.4125109
24705,11,38,13,9,12,1,84,38.26162848615334,-109.4122414
24706,9,40,14,10,12,2,87,38.26162848615334,-109.4119719
24707,6,44,14,8,13,2,87,38.26162848615334,-109.4117024
24708,5,49,13,7,14,2,90,38.26162848615334,-109.4114329
24709,4,53,12,5,15,2,91,38.26162848615334,-109.4111634
24710,4,54,12,5,15,2,92,38.26162848615334,-109.4108939
24711,4,55,12,5,15,2,93,38.26162848615334,-109.4106244
24712,5,53,13,6,16,1,94,38.26162848615334,-109.4103549
24713,8,47,13,7,16,0,91,38.26162848615334,-109.4100855
24714,8,47,13,8,16,0,92,38.26162848615334,-109.409816
24715,8,45,13,8,17,0,91,38.26162848615334,-109.4095465
24716,8,45,13,8,17,0,91,38.26162848615334,-109.409277
24717,6,45,13,8,18,0,90,38.26162848615334,-109.4090075
24718,6,47,12,6,19,1,91,38.26162848615334,-109.408738
24719,5,47,12,6,19,1,90,38.26162848615334,-109.4084685
24720,5,47,12,6,19,1,90,38.26162848615334,-109.408199
24721,4,46,12,4,18,3,87,38.26162848615334,-109.4079295
24722,3,46,11,2,16,5,83,38.26162848615334,-109.40766
24723,3,44,11,1,15,6,80,38.26162848615334,-109.4073905
24724,3,46,11,2,16,4,82,38.26162848615334,-109.407121
24725,3,43,11,2,15,5,79,38.26162848615334,-109.4068515
24726,1,36,11,0,13,12,73,38.26162848615334,-109.3879869
24727,2,38,11,0,13,11,75,38.26162848615334,-109.3877174
24728,3,41,12,1,15,8,80,38.26162848615334,-109.3874479
24729,4,46,13,3,17,4,87,38.26162848615334,-109.3871784
24730,5,46,13,5,17,2,88,38.26162848615334,-109.3869089
24731,5,47,13,5,17,1,88,38.26162848615334,-109.3866394
24732,5,51,13,4,17,1,91,38.26162848615334,-109.3863699
24733,3,50,11,4,16,2,86,38.26162848615334,-109.3861004
24734,1,49,9,1,14,5,79,38.26162848615334,-109.3858309
24735,2,47,10,1,15,6,81,38.26162848615334,-109.3855614
24736,2,40,10,5,12,3,72,38.26162848615334,-109.3852919
24737,4,36,8,5,9,4,66,38.26162848615334,-109.3850225
24738,2,36,8,3,7,6,62,38.26162848615334,-109.384753
24739,4,39,10,5,11,6,75,38.26162848615334,-109.3844835
24740,2,36,10,3,13,9,73,38.26162848615334,-109.384214
24741,1,30,11,1,10,14,67,38.26162848615334,-109.3839445
24742,0,31,12,0,11,17,71,38.26162848615334,-109.383675
24743,0,32,12,0,11,17,72,38.26162848615334,-109.3834055
24744,0,30,9,0,11,13,63,38.26162848615334,-109.383136
24745,1,31,11,0,10,15,68,38.26162848615334,-109.3828665
24746,2,35,12,0,11,14,74,38.26162848615334,-109.382597
24747,3,39,12,0,14,10,78,38.26162848615334,-109.3823275
24748,4,45,13,4,18,3,87,38.26162848615334,-109.382058
24749,5,43,12,6,18,2,86,38.26162848615334,-109.3817885
24750,7,39,12,9,18,1,86,38.26162848615334,-109.381519
24751,9,37,13,11,18,0,88,38.26162848615334,-109.3812495
24752,9,37,13,12,18,0,89,38.26162848615334,-109.38098
24753,13,36,13,11,16,0,89,38.26162848615334,-109.3807105
24754,14,34,13,12,16,0,89,38.26162848615334,-109.380441
24755,12,38,12,10,17,0,89,38.26162848615334,-109.3801716
24756,8,45,12,7,17,0,89,38.26162848615334,-109.3799021
24757,5,49,13,6,19,0,92,38.26162848615334,-109.3796326
24758,5,50,13,6,19,0,93,38.26162848615334,-109.3793631
24759,5,49,13,6,18,0,91,38.26162848615334,-109.3790936
24760,5,47,12,5,17,1,87,38.26162848615334,-109.3788241
24761,7,39,10,5,14,2,77,38.26162848615334,-109.3785546
24762,10,27,10,9,10,2,68,38.26162848615334,-109.3782851
24763,8,36,9,4,12,3,72,38.26162848615334,-109.3780156
24764,5,40,10,3,13,5,76,38.26162848615334,-109.3777461
24765,6,41,11,3,14,5,80,38.26162848615334,-109.3774766
24766,11,37,12,6,10,6,82,38.26162848615334,-109.3772071
24767,10,37,12,5,13,6,83,38.26162848615334,-109.3769376
24768,13,40,12,6,13,3,87,38.26162848615334,-109.3766681
24769,16,39,12,6,13,2,88,38.26162848615334,-109.3763986
24770,18,36,13,7,13,2,89,38.26162848615334,-109.3761291
24771,16,33,13,6,11,6,85,38.26162848615334,-109.3758596
24772,3,27,12,1,7,17,67,38.26162848615334,-109.3755901
24773,2,32,11,4,12,9,70,38.26162848615334,-109.3753206
24774,3,38,10,3,12,6,72,38.26162848615334,-109.3750512
24775,7,40,11,5,11,5,79,38.26162848615334,-109.3747817
24776,6,29,11,7,11,7,71,38.26162848615334,-109.3745122
24777,5,35,11,2,10,11,74,38.26162848615334,-109.3742427
24778,3,37,11,0,9,14,74,38.26162848615334,-109.3739732
24779,2,36,11,0,8,15,72,38.26162848615334,-109.3737037
24780,3,33,11,1,7,17,72,38.26162848615334,-109.3734342
24781,4,33,14,2,7,19,79,38.26162848615334,-109.3731647
24782,2,26,14,2,4,25,73,38.26162848615334,-109.3728952
24783,2,24,15,2,2,28,73,38.26162848615334,-109.3726257
24784,3,26,14,1,3,25,72,38.26162848615334,-109.3723562
24785,3,34,12,1,10,13,73,38.26162848615334,-109.3720867
24786,5,38,12,4,12,9,80,38.26162848615334,-109.3718172
24787,5,39,13,3,12,10,82,38.26162848615334,-109.3715477
24788,3,37,13,2,11,14,80,38.26162848615334,-109.3712782
24789,2,32,14,2,8,19,77,38.26162848615334,-109.3710087
24790,2,25,14,3,2,25,71,38.26162848615334,-109.3707392
24791,1,23,14,1,2,25,66,38.26162848615334,-109.3704697
24792,2,29,12,0,4,21,68,38.26162848615334,-109.3702003
24793,1,35,10,0,7,17,70,38.26162848615334,-109.3699308
24794,1,40,10,2,12,7,72,38.26162848615334,-109.3696613
24795,0,46,9,2,12,5,74,38.26162848615334,-109.3693918
24796,1,49,8,4,11,4,77,38.26162848615334,-109.3691223
24797,1,43,9,4,11,6,74,38.26162848615334,-109.3688528
24798,1,37,10,3,9,9,69,38.26162848615334,-109.3685833
24799,2,35,12,5,8,10,72,38.26162848615334,-109.3683138
24800,1,36,11,4,9,11,72,38.26162848615334,-109.3680443
24801,2,35,10,1,9,13,70,38.26162848615334,-109.3677748
24802,2,35,10,0,8,15,70,38.26162848615334,-109.3675053
24803,1,34,11,1,7,16,70,38.26162848615334,-109.3672358
24804,1,35,11,1,8,14,70,38.26162848615334,-109.3669663
24805,2,34,11,1,8,15,71,38.26162848615334,-109.3666968
24806,2,31,11,1,7,15,67,38.26162848615334,-109.3664273
24807,2,32,11,0,7,15,67,38.26162848615334,-109.3661578
24808,2,36,10,1,8,13,70,38.26162848615334,-109.3658883
24809,2,37,10,0,8,13,70,38.26162848615334,-109.3656188
24810,2,33,10,1,7,13,66,38.26162848615334,-109.3653493
24811,2,29,10,3,8,11,63,38.26162848615334,-109.3650799
24812,4,26,9,4,7,10,60,38.26162848615334,-109.3648104
24813,4,23,10,5,6,10,58,38.26162848615334,-109.3645409
24814,6,30,12,8,7,5,68,38.26162848615334,-109.3642714
24815,5,23,13,8,10,7,66,38.26162848615334,-109.3640019
24816,2,24,12,7,11,11,67,38.26162848615334,-109.3637324
24817,1,31,12,4,13,13,74,38.26162848615334,-109.3634629
24818,2,24,12,6,10,13,67,38.26162848615334,-109.3631934
24819,1,24,12,5,9,12,63,38.26162848615334,-109.3629239
24820,1,22,12,4,7,14,60,38.26162848615334,-109.3626544
24821,2,17,12,5,6,16,58,38.26162848615334,-109.3623849
24822,2,16,13,7,6,15,59,38.26162848615334,-109.3621154
24823,2,16,13,6,6,16,59,38.26162848615334,-109.3618459
24824,2,20,13,5,6,15,61,38.26162848615334,-109.3615764
24825,1,19,12,3,5,18,58,38.26162848615334,-109.3613069
24826,0,18,13,0,3,22,56,38.26162848615334,-109.3610374
24827,1,22,14,0,3,24,64,38.26162848615334,-109.3607679
24828,1,24,14,0,3,24,66,38.26162848615334,-109.3604984
24829,1,24,15,0,2,26,68,38.26162848615334,-109.360229
24830,0,23,16,0,2,29,70,38.26162848615334,-109.3599595
24831,0,24,17,0,3,30,74,38.26162848615334,-109.35969
24832,0,25,17,0,5,28,75,38.26162848615334,-109.3594205
24833,0,26,15,0,7,25,73,38.26162848615334,-109.359151
24834,1,26,16,0,7,26,76,38.26162848615334,-109.3588815
24835,2,26,16,0,6,25,75,38.26162848615334,-109.358612
24836,2,26,14,0,6,22,70,38.26162848615334,-109.3583425
24837,2,24,14,0,5,23,68,38.26162848615334,-109.358073
24838,2,25,14,0,4,22,67,38.26162848615334,-109.3578035
24839,2,25,13,0,4,22,66,38.26162848615334,-109.357534
24840,1,25,13,0,4,22,65,38.26162848615334,-109.3572645
24841,0,24,13,0,3,24,64,38.26162848615334,-109.356995
24842,1,24,14,0,4,25,68,38.26162848615334,-109.3567255
24843,1,24,14,0,3,26,68,38.26162848615334,-109.356456
24844,1,22,14,0,3,25,65,38.26162848615334,-109.3561865
24845,1,21,13,1,4,23,63,38.26162848615334,-109.355917
24846,3,22,14,6,8,15,68,38.26162848615334,-109.3556475
24847,1,22,13,2,7,18,63,38.26162848615334,-109.355378
24848,1,32,11,1,15,9,69,38.26162848615334,-109.3551086
24849,7,33,11,4,15,6,76,38.26162848615334,-109.3548391
24850,4,39,12,6,12,7,80,38.26162848615334,-109.3545696
24851,2,31,11,13,17,1,75,38.26162848615334,-109.3543001
24852,1,34,8,11,15,1,70,38.26162848615334,-109.3540306
24853,2,34,9,9,17,1,72,38.26162848615334,-109.3537611
24854,2,32,10,7,20,2,73,38.26162848615334,-109.3534916
24855,2,31,11,8,21,5,78,38.26162848615334,-109.3532221
24856,2,24,12,8,13,12,71,38.26162848615334,-109.3529526
24857,3,18,12,12,16,11,72,38.26162848615334,-109.3526831
24858,3,15,11,14,18,7,68,38.26162848615334,-109.3524136
24859,4,13,11,15,17,7,67,38.26162848615334,-109.3521441
24860,3,13,13,11,11,14,65,38.26162848615334,-109.3518746
24861,1,19,15,5,9,21,70,38.26162848615334,-109.3516051
24862,0,23,16,2,8,25,74,38.26162848615334,-109.3513356
24863,1,25,17,0,6,27,76,38.26162848615334,-109.3510661
24864,2,23,17,0,4,28,74,38.26162848615334,-109.3507966
24865,2,19,17,0,2,33,73,38.26162848615334,-109.3505271
24866,2,17,18,0,1,34,72,38.26162848615334,-109.3502577
24867,2,17,18,0,1,33,71,38.26162848615334,-109.3499882
24868,2,18,18,0,1,33,72,38.26162848615334,-109.3497187
24869,2,19,17,0,1,33,72,38.26162848615334,-109.3494492
24870,1,19,17,0,1,31,69,38.26162848615334,-109.3491797
24871,2,19,16,0,1,30,68,38.26162848615334,-109.3489102
24872,2,18,16,0,0,29,65,38.26162848615334,-109.3486407
24873,2,17,16,0,0,29,64,38.26162848615334,-109.3483712
24874,2,20,15,0,0,28,65,38.26162848615334,-109.3481017
24875,2,22,17,0,2,31,74,38.26162848615334,-109.3478322
24876,1,22,19,0,4,35,81,38.26162848615334,-109.3475627
24877,1,21,20,0,5,37,84,38.26162848615334,-109.3472932
24878,1,20,20,0,5,38,84,38.26162848615334,-109.3470237
24879,1,20,21,1,6,36,85,38.26162848615334,-109.3467542
24880,1,22,20,1,5,36,85,38.26162848615334,-109.3464847
24881,1,24,19,0,6,34,84,38.26162848615334,-109.3462152
24882,1,26,18,0,7,31,83,38.26162848615334,-109.3459457
24883,1,27,18,0,8,31,85,38.26162848615334,-109.3456762
24884,3,28,18,0,7,30,86,38.26162848615334,-109.3454068
24885,2,28,17,0,8,28,83,38.26162848615334,-109.3451373
24886,2,26,18,1,7,31,85,38.26162848615334,-109.3448678
24887,1,23,19,0,5,33,81,38.26162848615334,-109.3445983
24888,1,21,19,0,1,32,74,38.26162848615334,-109.3443288
24889,1,20,17,0,1,30,69,38.26162848615334,-109.3440593
24890,2,22,17,0,3,28,72,38.26162848615334,-109.3437898
24891,3,26,17,0,6,26,78,38.26162848615334,-109.3435203
24892,3,30,17,0,9,25,84,38.26162848615334,-109.3432508
24893,4,31,16,3,11,20,85,38.26162848615334,-109.3429813
24894,5,32,15,4,12,17,85,38.26162848615334,-109.3427118
24895,3,31,16,2,10,23,85,38.26162848615334,-109.3424423
24896,2,29,17,1,9,28,86,38.26162848615334,-109.3421728
24897,1,25,19,1,7,30,83,38.26162848615334,-109.3419033
24898,1,24,20,1,7,32,85,38.26162848615334,-109.3416338
24899,1,20,21,0,6,36,84,38.26162848615334,-109.3413643
24900,1,18,21,0,6,37,83,38.26162848615334,-109.3410948
24901,1,18,22,0,6,36,83,38.26162848615334,-109.3408253
24902,0,20,21,1,6,35,83,38.26162848615334,-109.3405558
24903,2,25,19,1,7,31,85,38.26162848615334,-109.3402864
24904,1,22,20,1,7,34,85,38.26162848615334,-109.3400169
24905,1,18,21,0,6,39,85,38.26162848615334,-109.3397474
24906,1,17,21,0,6,40,85,38.26162848615334,-109.3394779
24907,1,20,21,1,6,37,86,38.26162848615334,-109.3392084
24908,0,20,21,0,5,37,83,38.26162848615334,-109.3389389
24909,1,20,21,0,4,35,81,38.26162848615334,-109.3386694
24910,2,17,19,0,3,33,74,38.26162848615334,-109.3383999
24911,2,17,19,0,2,33,73,38.26162848615334,-109.3381304
24912,2,19,19,0,1,31,72,38.26162848615334,-109.3378609
24913,1,18,17,0,2,28,66,38.26162848615334,-109.3375914
24914,2,19,15,3,3,23,65,38.26162848615334,-109.3373219
24915,2,24,13,4,5,18,66,38.26162848615334,-109.3370524
24916,2,24,12,3,5,18,64,38.26162848615334,-109.3367829
24917,2,21,14,4,4,21,66,38.26162848615334,-109.3365134
24918,2,22,14,2,4,22,66,38.26162848615334,-109.3362439
24919,2,30,11,1,5,16,65,38.26162848615334,-109.3359744
24920,1,36,9,1,7,10,64,38.26162848615334,-109.3357049
24921,1,38,9,2,10,9,69,38.26162848615334,-109.3354355
24922,0,48,9,3,13,5,78,38.26162848615334,-109.335166
24923,0,48,9,1,14,6,78,38.26162848615334,-109.3348965
24924,1,42,10,1,13,9,76,38.26162848615334,-109.334627
24925,1,30,11,2,8,16,68,38.26162848615334,-109.3343575
24926,1,16,17,1,2,28,65,38.26162848615334,-109.334088
24927,1,18,15,1,2,25,62,38.26162848615334,-109.3338185
24928,3,49,10,2,13,8,85,38.26135899156811,-109.4426943
24929,3,51,11,5,14,4,88,38.26135899156811,-109.4424248
24930,2,52,9,3,12,6,84,38.26135899156811,-109.4421553
24931,2,50,10,2,13,6,83,38.26135899156811,-109.4418858
24932,2,47,11,2,17,6,85,38.26135899156811,-109.4416163
24933,3,47,11,2,15,7,85,38.26135899156811,-109.4413468
24934,2,49,10,1,15,7,84,38.26135899156811,-109.4410773
24935,2,50,10,2,15,7,86,38.26135899156811,-109.4408078
24936,2,52,10,2,13,7,86,38.26135899156811,-109.4405383
24937,2,52,9,2,13,7,85,38.26135899156811,-109.4402688
24938,2,50,10,1,12,9,84,38.26135899156811,-109.4399993
24939,2,45,10,0,10,11,78,38.26135899156811,-109.4397299
24940,2,45,10,1,12,9,79,38.26135899156811,-109.4394604
24941,2,45,10,1,14,7,79,38.26135899156811,-109.4391909
24942,2,44,10,1,13,9,79,38.26135899156811,-109.4389214
24943,2,45,10,1,14,9,81,38.26135899156811,-109.4386519
24944,3,53,10,5,15,3,89,38.26135899156811,-109.4383824
24945,3,56,9,6,13,3,90,38.26135899156811,-109.4381129
24946,2,53,10,3,14,4,86,38.26135899156811,-109.4378434
24947,1,38,10,0,9,14,72,38.26135899156811,-109.4375739
24948,0,27,11,1,7,17,63,38.26135899156811,-109.4373044
24949,1,27,10,3,9,12,62,38.26135899156811,-109.4370349
24950,1,30,10,2,10,12,65,38.26135899156811,-109.4367654
24951,2,39,10,0,11,12,74,38.26135899156811,-109.4364959
24952,3,54,10,0,14,8,89,38.26135899156811,-109.4362264
24953,5,50,11,5,16,3,90,38.26135899156811,-109.4359569
24954,6,49,12,7,15,2,91,38.26135899156811,-109.4356874
24955,6,49,12,7,15,2,91,38.26135899156811,-109.4354179
24956,4,50,12,8,15,2,91,38.26135899156811,-109.4351484
24957,3,49,10,5,14,2,83,38.26135899156811,-109.434879
24958,3,52,10,3,15,3,86,38.26135899156811,-109.4346095
24959,4,51,11,4,16,3,89,38.26135899156811,-109.43434
24960,6,48,12,7,16,1,90,38.26135899156811,-109.4340705
24961,8,45,13,13,13,1,93,38.26135899156811,-109.433801
24962,9,43,14,12,13,1,92,38.26135899156811,-109.4335315
24963,10,44,13,12,14,1,94,38.26135899156811,-109.433262
24964,12,42,13,12,14,0,93,38.26135899156811,-109.4329925
24965,16,39,13,11,14,0,93,38.26135899156811,-109.432723
24966,22,35,13,11,12,0,93,38.26135899156811,-109.4324535
24967,14,39,14,12,13,0,92,38.26135899156811,-109.432184
24968,11,40,15,14,13,1,94,38.26135899156811,-109.4319145
24969,10,40,15,14,13,1,93,38.26135899156811,-109.431645
24970,10,42,14,13,13,1,93,38.26135899156811,-109.4313755
24971,10,42,14,13,14,1,94,38.26135899156811,-109.431106
24972,12,41,14,12,14,1,94,38.26135899156811,-109.4308365
24973,11,42,14,13,14,1,95,38.26135899156811,-109.430567
24974,10,43,14,13,14,1,95,38.26135899156811,-109.4302975
24975,8,46,14,13,13,1,95,38.26135899156811,-109.430028
24976,8,46,14,13,14,1,96,38.26135899156811,-109.4297586
24977,9,45,14,12,14,0,94,38.26135899156811,-109.4294891
24978,10,44,14,12,14,0,94,38.26135899156811,-109.4292196
24979,11,42,14,12,15,0,94,38.26135899156811,-109.4289501
24980,13,40,14,12,14,0,93,38.26135899156811,-109.4286806
24981,11,42,14,12,14,0,93,38.26135899156811,-109.4284111
24982,12,41,14,12,14,0,93,38.26135899156811,-109.4281416
24983,12,41,14,12,14,0,93,38.26135899156811,-109.4278721
24984,12,42,14,11,14,0,93,38.26135899156811,-109.4276026
24985,10,43,14,12,14,0,93,38.26135899156811,-109.4273331
24986,10,44,14,12,14,0,94,38.26135899156811,-109.4270636
24987,9,43,14,13,14,0,93,38.26135899156811,-109.4267941
24988,8,42,14,12,15,1,92,38.26135899156811,-109.4265246
24989,7,42,14,11,15,1,90,38.26135899156811,-109.4262551
24990,9,42,14,12,15,1,93,38.26135899156811,-109.4259856
24991,11,40,14,13,15,0,93,38.26135899156811,-109.4257161
24992,11,40,14,13,14,0,92,38.26135899156811,-109.4254466
24993,9,42,14,13,14,1,93,38.26135899156811,-109.4251771
24994,8,44,14,12,15,1,94,38.26135899156811,-109.4249077
24995,9,42,14,13,15,1,94,38.26135899156811,-109.4246382
24996,9,42,14,13,14,1,93,38.26135899156811,-109.4243687
24997,8,43,14,13,14,1,93,38.26135899156811,-109.4240992
24998,7,45,13,11,14,1,91,38.26135899156811,-109.4238297
24999,8,44,13,11,15,1,92,38.26135899156811,-109.4235602
25000,9,42,13,12,14,1,91,38.26135899156811,-109.4232907
25001,10,41,13,12,15,1,92,38.26135899156811,-109.4230212
25002,10,39,14,12,16,1,92,38.26135899156811,-109.4227517
25003,10,39,15,13,16,1,94,38.26135899156811,-109.4224822
25004,9,38,15,13,15,1,91,38.26135899156811,-109.4222127
25005,11,37,15,13,15,1,92,38.26135899156811,-109.4219432
25006,12,37,15,13,15,0,92,38.26135899156811,-109.4216737
25007,10,38,15,14,15,1,93,38.26135899156811,-109.4214042
25008,12,37,15,14,15,1,94,38.26135899156811,-109.4211347
25009,13,36,15,13,15,0,92,38.26135899156811,-109.4208652
25010,14,37,15,13,14,0,93,38.26135899156811,-109.4205957
25011,14,37,15,14,13,0,93,38.26135899156811,-109.4203262
25012,13,37,15,15,13,0,93,38.26135899156811,-109.4200568
25013,13,38,15,15,13,0,94,38.26135899156811,-109.4197873
25014,14,37,15,14,13,0,93,38.26135899156811,-109.4195178
25015,11,40,15,13,14,0,93,38.26135899156811,-109.4192483
25016,5,45,13,9,16,1,89,38.26135899156811,-109.4189788
25017,4,52,11,5,15,1,88,38.26135899156811,-109.4187093
25018,3,56,10,5,14,1,89,38.26135899156811,-109.4184398
25019,5,50,11,7,16,1,90,38.26135899156811,-109.4181703
25020,9,44,13,10,16,0,92,38.26135899156811,-109.4179008
25021,11,41,13,11,15,0,91,38.26135899156811,-109.4176313
25022,9,45,13,10,15,0,92,38.26135899156811,-109.4173618
25023,9,45,13,9,15,0,91,38.26135899156811,-109.4170923
25024,8,46,13,9,16,0,92,38.26135899156811,-109.4168228
25025,9,45,12,8,15,0,89,38.26135899156811,-109.4165533
25026,13,41,12,9,13,1,89,38.26135899156811,-109.4162838
25027,14,38,12,11,13,0,88,38.26135899156811,-109.4160143
25028,10,43,13,11,14,0,91,38.26135899156811,-109.4157448
25029,8,44,14,11,13,0,90,38.26135899156811,-109.4154753
25030,10,41,14,12,14,0,91,38.26135899156811,-109.4152058
25031,13,38,15,13,14,0,93,38.26135899156811,-109.4149364
25032,13,37,15,13,14,0,92,38.26135899156811,-109.4146669
25033,13,39,14,13,13,0,92,38.26135899156811,-109.4143974
25034,10,43,14,12,13,0,92,38.26135899156811,-109.4141279
25035,7,44,14,12,13,0,90,38.26135899156811,-109.4138584
25036,8,43,13,10,13,1,88,38.26135899156811,-109.4135889
25037,10,39,13,11,13,1,87,38.26135899156811,-109.4133194
25038,10,37,13,11,12,1,84,38.26135899156811,-109.4130499
25039,10,37,13,10,12,1,83,38.26135899156811,-109.4127804
25040,10,38,13,10,12,1,84,38.26135899156811,-109.4125109
25041,8,42,14,11,12,1,88,38.26135899156811,-109.4122414
25042,7,42,14,11,12,1,87,38.26135899156811,-109.4119719
25043,6,43,14,11,12,1,87,38.26135899156811,-109.4117024
25044,5,46,13,11,13,1,89,38.26135899156811,-109.4114329
25045,4,51,13,8,15,1,92,38.26135899156811,-109.4111634
25046,4,54,12,6,16,1,93,38.26135899156811,-109.4108939
25047,5,54,13,6,16,1,95,38.26135899156811,-109.4106244
25048,6,51,13,7,16,0,93,38.26135899156811,-109.4103549
25049,8,47,13,8,16,0,92,38.26135899156811,-109.4100855
25050,9,46,13,7,16,0,91,38.26135899156811,-109.409816
25051,8,45,13,9,17,0,92,38.26135899156811,-109.4095465
25052,7,46,13,8,17,0,91,38.26135899156811,-109.409277
25053,6,46,13,7,18,0,90,38.26135899156811,-109.4090075
25054,5,47,12,6,19,1,90,38.26135899156811,-109.408738
25055,5,48,12,6,19,1,91,38.26135899156811,-109.4084685
25056,5,47,12,5,19,1,89,38.26135899156811,-109.408199
25057,5,47,12,5,18,1,88,38.26135899156811,-109.4079295
25058,4,47,12,4,18,3,88,38.26135899156811,-109.40766
25059,4,46,12,3,17,4,86,38.26135899156811,-109.4073905
25060,4,46,12,3,17,4,86,38.26135899156811,-109.407121
25061,4,45,12,4,17,4,86,38.26135899156811,-109.4068515
25062,1,34,11,0,13,13,72,38.26135899156811,-109.3879869
25063,2,37,11,0,14,11,75,38.26135899156811,-109.3877174
25064,3,42,12,1,16,7,81,38.26135899156811,-109.3874479
25065,5,45,13,3,17,3,86,38.26135899156811,-109.3871784
25066,5,46,13,5,18,2,89,38.26135899156811,-109.3869089
25067,5,49,13,5,18,1,91,38.26135899156811,-109.3866394
25068,4,50,12,4,17,2,89,38.26135899156811,-109.3863699
25069,3,48,10,4,14,3,82,38.26135899156811,-109.3861004
25070,2,47,9,3,14,5,80,38.26135899156811,-109.3858309
25071,1,43,9,1,12,8,74,38.26135899156811,-109.3855614
25072,2,35,9,5,11,4,66,38.26135899156811,-109.3852919
25073,4,36,8,6,8,3,65,38.26135899156811,-109.3850225
25074,2,34,9,3,7,7,62,38.26135899156811,-109.384753
25075,4,32,12,7,11,8,74,38.26135899156811,-109.3844835
25076,3,33,11,3,14,7,71,38.26135899156811,-109.384214
25077,2,32,11,1,12,9,67,38.26135899156811,-109.3839445
25078,0,30,12,1,11,13,67,38.26135899156811,-109.383675
25079,0,34,10,0,13,13,70,38.26135899156811,-109.3834055
25080,0,28,10,0,10,15,63,38.26135899156811,-109.383136
25081,1,31,11,0,10,15,68,38.26135899156811,-109.3828665
25082,3,36,12,0,14,11,76,38.26135899156811,-109.382597
25083,3,43,13,2,17,6,84,38.26135899156811,-109.3823275
25084,4,49,13,4,19,1,90,38.26135899156811,-109.382058
25085,7,43,13,7,19,0,89,38.26135899156811,-109.3817885
25086,10,38,13,9,18,0,88,38.26135899156811,-109.381519
25087,10,37,13,11,18,0,89,38.26135899156811,-109.3812495
25088,8,39,13,10,18,0,88,38.26135899156811,-109.38098
25089,17,34,13,11,15,0,90,38.26135899156811,-109.3807105
25090,16,33,13,13,15,0,90,38.26135899156811,-109.380441
25091,12,38,13,11,16,0,90,38.26135899156811,-109.3801716
25092,7,45,13,9,17,0,91,38.26135899156811,-109.3799021
25093,6,48,13,6,18,0,91,38.26135899156811,-109.3796326
25094,5,48,13,6,18,0,90,38.26135899156811,-109.3793631
25095,5,46,13,6,18,1,89,38.26135899156811,-109.3790936
25096,6,41,11,6,16,2,82,38.26135899156811,-109.3788241
25097,8,31,9,7,11,2,68,38.26135899156811,-109.3785546
25098,3,22,9,8,8,4,54,38.26135899156811,-109.3782851
25099,6,33,9,4,12,4,68,38.26135899156811,-109.3780156
25100,5,33,10,4,11,7,70,38.26135899156811,-109.3777461
25101,7,31,11,3,11,8,71,38.26135899156811,-109.3774766
25102,8,35,12,3,12,7,77,38.26135899156811,-109.3772071
25103,8,37,11,3,13,7,79,38.26135899156811,-109.3769376
25104,8,41,11,4,14,5,83,38.26135899156811,-109.3766681
25105,8,39,11,5,14,5,82,38.26135899156811,-109.3763986
25106,9,36,11,6,13,5,80,38.26135899156811,-109.3761291
25107,11,36,12,5,13,5,82,38.26135899156811,-109.3758596
25108,4,32,11,3,11,10,71,38.26135899156811,-109.3755901
25109,2,35,11,3,12,9,72,38.26135899156811,-109.3753206
25110,3,35,11,3,12,8,72,38.26135899156811,-109.3750512
25111,6,37,12,3,13,7,78,38.26135899156811,-109.3747817
25112,5,37,11,2,12,9,76,38.26135899156811,-109.3745122
25113,5,42,11,0,11,9,78,38.26135899156811,-109.3742427
25114,3,41,10,0,10,12,76,38.26135899156811,-109.3739732
25115,2,40,11,0,10,12,75,38.26135899156811,-109.3737037
25116,4,39,11,1,10,12,77,38.26135899156811,-109.3734342
25117,3,33,12,1,8,16,73,38.26135899156811,-109.3731647
25118,4,27,15,1,4,22,73,38.26135899156811,-109.3728952
25119,3,24,15,1,3,24,70,38.26135899156811,-109.3726257
25120,3,26,14,0,5,23,71,38.26135899156811,-109.3723562
25121,5,37,12,2,12,12,80,38.26135899156811,-109.3720867
25122,4,34,12,2,10,13,75,38.26135899156811,-109.3718172
25123,4,36,12,1,10,14,77,38.26135899156811,-109.3715477
25124,3,35,12,1,8,17,76,38.26135899156811,-109.3712782
25125,2,30,12,1,5,20,70,38.26135899156811,-109.3710087
25126,1,27,13,1,3,22,67,38.26135899156811,-109.3707392
25127,1,27,12,0,3,21,64,38.26135899156811,-109.3704697
25128,1,29,12,0,5,20,67,38.26135899156811,-109.3702003
25129,1,31,11,0,6,18,67,38.26135899156811,-109.3699308
25130,1,34,11,0,8,15,69,38.26135899156811,-109.3696613
25131,1,37,10,1,10,11,70,38.26135899156811,-109.3693918
25132,1,37,9,1,10,11,69,38.26135899156811,-109.3691223
25133,2,34,10,0,8,15,69,38.26135899156811,-109.3688528
25134,3,28,12,1,6,17,67,38.26135899156811,-109.3685833
25135,3,29,13,1,6,18,70,38.26135899156811,-109.3683138
25136,2,33,12,0,7,17,71,38.26135899156811,-109.3680443
25137,2,37,11,0,9,14,73,38.26135899156811,-109.3677748
25138,2,37,10,0,9,13,71,38.26135899156811,-109.3675053
25139,1,37,10,0,9,13,70,38.26135899156811,-109.3672358
25140,2,38,10,0,10,12,72,38.26135899156811,-109.3669663
25141,2,32,11,1,9,14,69,38.26135899156811,-109.3666968
25142,2,28,12,2,8,15,67,38.26135899156811,-109.3664273
25143,2,29,11,1,7,16,66,38.26135899156811,-109.3661578
25144,3,32,10,1,6,15,67,38.26135899156811,-109.3658883
25145,4,33,10,3,7,10,67,38.26135899156811,-109.3656188
25146,2,26,9,3,6,9,55,38.26135899156811,-109.3653493
25147,4,24,8,5,7,8,56,38.26135899156811,-109.3650799
25148,4,21,8,5,7,8,53,38.26135899156811,-109.3648104
25149,7,19,9,6,6,10,57,38.26135899156811,-109.3645409
25150,9,21,13,7,6,8,64,38.26135899156811,-109.3642714
25151,3,21,12,12,11,10,69,38.26135899156811,-109.3640019
25152,1,22,13,4,7,19,66,38.26135899156811,-109.3637324
25153,1,23,13,2,6,19,64,38.26135899156811,-109.3634629
25154,3,29,12,3,8,12,67,38.26135899156811,-109.3631934
25155,5,31,11,3,8,7,65,38.26135899156811,-109.3629239
25156,5,26,11,2,8,9,61,38.26135899156811,-109.3626544
25157,4,19,11,2,6,12,54,38.26135899156811,-109.3623849
25158,3,15,11,3,5,14,51,38.26135899156811,-109.3621154
25159,4,15,11,4,6,12,52,38.26135899156811,-109.3618459
25160,4,17,11,5,7,11,55,38.26135899156811,-109.3615764
25161,3,21,10,5,7,10,56,38.26135899156811,-109.3613069
25162,2,23,10,5,7,12,59,38.26135899156811,-109.3610374
25163,2,24,11,4,5,16,62,38.26135899156811,-109.3607679
25164,2,22,12,1,2,19,58,38.26135899156811,-109.3604984
25165,2,24,12,0,3,20,61,38.26135899156811,-109.360229
25166,1,22,12,0,2,22,59,38.26135899156811,-109.3599595
25167,0,20,12,0,2,23,57,38.26135899156811,-109.35969
25168,1,20,12,0,2,23,58,38.26135899156811,-109.3594205
25169,1,26,11,0,4,19,61,38.26135899156811,-109.359151
25170,1,24,12,0,4,20,61,38.26135899156811,-109.3588815
25171,1,23,12,0,4,21,61,38.26135899156811,-109.358612
25172,2,26,12,0,5,19,64,38.26135899156811,-109.3583425
25173,2,26,12,0,5,19,64,38.26135899156811,-109.358073
25174,2,29,12,0,5,17,65,38.26135899156811,-109.3578035
25175,2,31,11,0,5,17,66,38.26135899156811,-109.357534
25176,1,33,11,0,5,17,67,38.26135899156811,-109.3572645
25177,2,35,11,1,3,17,69,38.26135899156811,-109.356995
25178,2,30,12,0,3,21,68,38.26135899156811,-109.3567255
25179,2,23,13,0,2,24,64,38.26135899156811,-109.356456
25180,1,21,14,0,1,27,64,38.26135899156811,-109.3561865
25181,1,21,14,0,3,26,65,38.26135899156811,-109.355917
25182,1,23,14,1,7,21,67,38.26135899156811,-109.3556475
25183,0,29,12,0,10,18,69,38.26135899156811,-109.355378
25184,1,34,10,0,16,7,68,38.26135899156811,-109.3551086
25185,5,37,9,9,15,0,75,38.26135899156811,-109.3548391
25186,6,42,8,7,10,3,76,38.26135899156811,-109.3545696
25187,3,42,9,6,10,4,74,38.26135899156811,-109.3543001
25188,1,41,8,4,10,4,68,38.26135899156811,-109.3540306
25189,0,33,9,4,5,8,59,38.26135899156811,-109.3537611
25190,2,22,10,2,5,12,53,38.26135899156811,-109.3534916
25191,9,17,12,3,8,9,58,38.26135899156811,-109.3532221
25192,8,13,12,3,6,13,55,38.26135899156811,-109.3529526
25193,1,9,10,7,9,13,49,38.26135899156811,-109.3526831
25194,2,11,10,11,12,9,55,38.26135899156811,-109.3524136
25195,5,15,10,15,14,5,64,38.26135899156811,-109.3521441
25196,3,17,12,12,9,15,68,38.26135899156811,-109.3518746
25197,1,19,15,1,4,27,67,38.26135899156811,-109.3516051
25198,2,23,16,0,3,29,73,38.26135899156811,-109.3513356
25199,3,21,17,1,2,29,73,38.26135899156811,-109.3510661
25200,3,18,17,2,2,30,72,38.26135899156811,-109.3507966
25201,2,16,18,0,2,35,73,38.26135899156811,-109.3505271
25202,2,17,18,0,1,35,73,38.26135899156811,-109.3502577
25203,2,18,18,0,1,35,74,38.26135899156811,-109.3499882
25204,2,19,18,0,1,33,73,38.26135899156811,-109.3497187
25205,2,22,17,0,1,31,73,38.26135899156811,-109.3494492
25206,1,20,16,0,1,29,67,38.26135899156811,-109.3491797
25207,2,19,16,0,0,28,65,38.26135899156811,-109.3489102
25208,1,19,16,0,0,29,65,38.26135899156811,-109.3486407
25209,1,19,16,0,0,30,66,38.26135899156811,-109.3483712
25210,2,22,18,0,2,32,76,38.26135899156811,-109.3481017
25211,2,22,19,1,4,34,82,38.26135899156811,-109.3478322
25212,1,20,20,0,5,36,82,38.26135899156811,-109.3475627
25213,1,19,20,0,5,37,82,38.26135899156811,-109.3472932
25214,2,20,20,0,4,37,83,38.26135899156811,-109.3470237
25215,1,21,21,0,5,36,84,38.26135899156811,-109.3467542
25216,1,21,21,0,4,37,84,38.26135899156811,-109.3464847
25217,1,21,20,0,4,36,82,38.26135899156811,-109.3462152
25218,1,23,19,1,4,34,82,38.26135899156811,-109.3459457
25219,0,24,19,0,5,34,82,38.26135899156811,-109.3456762
25220,1,25,18,0,6,33,83,38.26135899156811,-109.3454068
25221,2,28,17,0,8,30,85,38.26135899156811,-109.3451373
25222,3,26,18,1,7,30,85,38.26135899156811,-109.3448678
25223,2,24,18,1,4,31,80,38.26135899156811,-109.3445983
25224,3,26,17,0,2,25,73,38.26135899156811,-109.3443288
25225,1,21,15,0,3,23,63,38.26135899156811,-109.3440593
25226,1,22,15,0,3,23,64,38.26135899156811,-109.3437898
25227,2,25,16,0,3,24,70,38.26135899156811,-109.3435203
25228,3,26,17,0,5,26,77,38.26135899156811,-109.3432508
25229,4,25,18,1,5,27,80,38.26135899156811,-109.3429813
25230,3,25,18,0,6,30,82,38.26135899156811,-109.3427118
25231,1,25,19,0,7,32,84,38.26135899156811,-109.3424423
25232,1,23,19,1,8,32,84,38.26135899156811,-109.3421728
25233,1,21,20,2,8,33,85,38.26135899156811,-109.3419033
25234,1,25,19,2,9,29,85,38.26135899156811,-109.3416338
25235,1,25,19,2,9,30,86,38.26135899156811,-109.3413643
25236,1,25,19,1,7,31,84,38.26135899156811,-109.3410948
25237,2,26,19,2,6,31,86,38.26135899156811,-109.3408253
25238,2,26,19,2,6,30,85,38.26135899156811,-109.3405558
25239,1,27,18,2,6,29,83,38.26135899156811,-109.3402864
25240,0,23,20,0,5,34,82,38.26135899156811,-109.3400169
25241,0,20,22,0,5,38,85,38.26135899156811,-109.3397474
25242,1,18,22,0,5,39,85,38.26135899156811,-109.3394779
25243,0,19,21,0,4,38,82,38.26135899156811,-109.3392084
25244,1,18,21,0,3,37,80,38.26135899156811,-109.3389389
25245,1,20,21,0,4,36,82,38.26135899156811,-109.3386694
25246,1,22,20,1,5,34,83,38.26135899156811,-109.3383999
25247,2,23,19,3,5,32,84,38.26135899156811,-109.3381304
25248,2,24,18,2,3,27,76,38.26135899156811,-109.3378609
25249,2,17,15,2,3,24,63,38.26135899156811,-109.3375914
25250,2,16,15,2,4,23,62,38.26135899156811,-109.3373219
25251,2,17,16,3,4,23,65,38.26135899156811,-109.3370524
25252,2,16,16,2,3,25,64,38.26135899156811,-109.3367829
25253,3,21,15,2,3,21,65,38.26135899156811,-109.3365134
25254,1,27,10,3,8,13,62,38.26135899156811,-109.3362439
25255,1,35,9,3,10,7,65,38.26135899156811,-109.3359744
25256,1,43,8,3,10,5,70,38.26135899156811,-109.3357049
25257,1,40,10,3,11,9,74,38.26135899156811,-109.3354355
25258,0,45,9,1,14,5,74,38.26135899156811,-109.335166
25259,0,50,8,2,12,4,76,38.26135899156811,-109.3348965
25260,0,49,8,2,11,5,75,38.26135899156811,-109.334627
25261,1,45,10,1,13,8,78,38.26135899156811,-109.3343575
25262,1,17,15,1,2,25,61,38.26135899156811,-109.334088
25263,0,17,15,0,1,27,60,38.26135899156811,-109.3338185
25264,3,48,10,3,13,6,83,38.261089496982876,-109.4429638
25265,3,47,9,3,11,6,79,38.261089496982876,-109.4426943
25266,3,49,10,5,13,3,83,38.261089496982876,-109.4424248
25267,3,47,9,3,13,5,80,38.261089496982876,-109.4421553
25268,3,48,10,3,14,5,83,38.261089496982876,-109.4418858
25269,3,49,10,4,15,3,84,38.261089496982876,-109.4416163
25270,3,49,10,4,15,3,84,38.261089496982876,-109.4413468
25271,3,51,10,4,14,4,86,38.261089496982876,-109.4410773
25272,2,50,10,3,14,5,84,38.261089496982876,-109.4408078
25273,2,50,10,2,13,6,83,38.261089496982876,-109.4405383
25274,2,51,9,2,13,6,83,38.261089496982876,-109.4402688
25275,2,49,10,1,13,7,82,38.261089496982876,-109.4399993
25276,2,45,10,1,12,9,79,38.261089496982876,-109.4397299
25277,2,43,10,0,13,9,77,38.261089496982876,-109.4394604
25278,2,44,10,1,14,7,78,38.261089496982876,-109.4391909
25279,3,46,11,3,15,6,84,38.261089496982876,-109.4389214
25280,2,49,10,2,14,6,83,38.261089496982876,-109.4386519
25281,2,50,9,3,14,4,82,38.261089496982876,-109.4383824
25282,3,50,9,2,14,4,82,38.261089496982876,-109.4381129
25283,2,49,9,0,14,6,80,38.261089496982876,-109.4378434
25284,4,46,10,0,10,9,79,38.261089496982876,-109.4375739
25285,2,43,10,0,11,11,77,38.261089496982876,-109.4373044
25286,2,41,10,0,11,11,75,38.261089496982876,-109.4370349
25287,1,37,10,0,11,12,71,38.261089496982876,-109.4367654
25288,1,43,10,0,14,9,77,38.261089496982876,-109.4364959
25289,3,52,10,2,14,6,87,38.261089496982876,-109.4362264
25290,5,50,12,4,15,4,90,38.261089496982876,-109.4359569
25291,4,49,12,4,16,4,89,38.261089496982876,-109.4356874
25292,4,48,12,5,17,3,89,38.261089496982876,-109.4354179
25293,7,46,13,7,16,2,91,38.261089496982876,-109.4351484
25294,5,46,11,6,16,2,86,38.261089496982876,-109.434879
25295,6,48,12,7,17,1,91,38.261089496982876,-109.4346095
25296,6,49,12,8,16,1,92,38.261089496982876,-109.43434
25297,6,48,12,9,15,1,91,38.261089496982876,-109.4340705
25298,7,45,13,13,13,1,92,38.261089496982876,-109.433801
25299,8,43,14,13,14,1,93,38.261089496982876,-109.4335315
25300,9,44,13,12,15,1,94,38.261089496982876,-109.433262
25301,10,44,13,11,15,1,94,38.261089496982876,-109.4329925
25302,12,42,13,11,14,0,92,38.261089496982876,-109.432723
25303,11,42,14,13,14,0,94,38.261089496982876,-109.4324535
25304,9,40,14,13,12,1,89,38.261089496982876,-109.432184
25305,9,40,14,14,13,1,91,38.261089496982876,-109.4319145
25306,9,41,14,14,13,1,92,38.261089496982876,-109.431645
25307,9,43,15,12,14,1,94,38.261089496982876,-109.4313755
25308,8,45,14,12,15,1,95,38.261089496982876,-109.431106
25309,9,43,14,13,14,1,94,38.261089496982876,-109.4308365
25310,10,42,14,13,14,1,94,38.261089496982876,-109.430567
25311,9,44,14,13,13,1,94,38.261089496982876,-109.4302975
25312,7,47,14,12,13,1,94,38.261089496982876,-109.430028
25313,8,45,14,13,14,1,95,38.261089496982876,-109.4297586
25314,10,44,14,12,14,1,95,38.261089496982876,-109.4294891
25315,12,42,14,12,14,0,94,38.261089496982876,-109.4292196
25316,12,41,14,12,15,0,94,38.261089496982876,-109.4289501
25317,14,40,14,12,14,0,94,38.261089496982876,-109.4286806
25318,11,43,14,11,14,1,94,38.261089496982876,-109.4284111
25319,11,42,14,11,15,1,94,38.261089496982876,-109.4281416
25320,13,40,14,12,14,0,93,38.261089496982876,-109.4278721
25321,15,39,14,11,14,0,93,38.261089496982876,-109.4276026
25322,11,43,14,12,14,0,94,38.261089496982876,-109.4273331
25323,11,43,14,12,14,0,94,38.261089496982876,-109.4270636
25324,11,42,14,13,14,0,94,38.261089496982876,-109.4267941
25325,10,42,14,13,14,1,94,38.261089496982876,-109.4265246
25326,10,41,14,12,15,1,93,38.261089496982876,-109.4262551
25327,10,41,14,13,15,1,94,38.261089496982876,-109.4259856
25328,10,41,14,13,14,0,92,38.261089496982876,-109.4257161
25329,10,41,14,14,14,0,93,38.261089496982876,-109.4254466
25330,10,41,14,13,14,1,93,38.261089496982876,-109.4251771
25331,10,41,14,13,14,1,93,38.261089496982876,-109.4249077
25332,10,41,15,14,14,1,95,38.261089496982876,-109.4246382
25333,8,43,14,14,13,1,93,38.261089496982876,-109.4243687
25334,7,45,14,13,13,1,93,38.261089496982876,-109.4240992
25335,7,44,14,13,14,1,93,38.261089496982876,-109.4238297
25336,9,44,13,11,14,1,92,38.261089496982876,-109.4235602
25337,9,43,13,11,14,1,91,38.261089496982876,-109.4232907
25338,9,42,13,11,15,1,91,38.261089496982876,-109.4230212
25339,8,42,13,11,16,1,91,38.261089496982876,-109.4227517
25340,8,42,14,11,16,1,92,38.261089496982876,-109.4224822
25341,8,41,14,12,15,1,91,38.261089496982876,-109.4222127
25342,11,38,14,13,15,1,92,38.261089496982876,-109.4219432
25343,12,37,14,13,15,1,92,38.261089496982876,-109.4216737
25344,11,38,14,13,15,1,92,38.261089496982876,-109.4214042
25345,13,37,14,13,15,0,92,38.261089496982876,-109.4211347
25346,14,36,14,14,14,0,92,38.261089496982876,-109.4208652
25347,14,36,14,14,13,1,92,38.261089496982876,-109.4205957
25348,14,37,14,14,13,0,92,38.261089496982876,-109.4203262
25349,12,39,14,13,13,0,91,38.261089496982876,-109.4200568
25350,11,40,14,13,14,0,92,38.261089496982876,-109.4197873
25351,12,39,15,14,13,0,93,38.261089496982876,-109.4195178
25352,12,40,14,13,14,0,93,38.261089496982876,-109.4192483
25353,8,45,13,10,16,0,92,38.261089496982876,-109.4189788
25354,5,52,11,7,15,1,91,38.261089496982876,-109.4187093
25355,4,50,10,7,15,1,87,38.261089496982876,-109.4184398
25356,10,45,12,9,16,0,92,38.261089496982876,-109.4181703
25357,13,40,13,11,14,0,91,38.261089496982876,-109.4179008
25358,12,40,13,11,14,0,90,38.261089496982876,-109.4176313
25359,11,41,14,13,14,0,93,38.261089496982876,-109.4173618
25360,11,40,14,13,13,0,91,38.261089496982876,-109.4170923
25361,11,39,14,13,13,0,90,38.261089496982876,-109.4168228
25362,11,36,12,11,13,1,84,38.261089496982876,-109.4165533
25363,11,34,11,9,13,1,79,38.261089496982876,-109.4162838
25364,12,32,11,7,11,2,75,38.261089496982876,-109.4160143
25365,11,34,11,8,11,1,76,38.261089496982876,-109.4157448
25366,13,37,13,9,10,1,83,38.261089496982876,-109.4154753
25367,14,36,13,10,10,1,84,38.261089496982876,-109.4152058
25368,13,33,13,11,10,1,81,38.261089496982876,-109.4149364
25369,12,36,13,11,11,1,84,38.261089496982876,-109.4146669
25370,12,37,14,12,12,1,88,38.261089496982876,-109.4143974
25371,11,39,14,12,12,0,88,38.261089496982876,-109.4141279
25372,10,41,14,11,12,1,89,38.261089496982876,-109.4138584
25373,9,37,13,10,12,1,82,38.261089496982876,-109.4135889
25374,11,35,13,11,11,1,82,38.261089496982876,-109.4133194
25375,12,37,13,11,11,1,85,38.261089496982876,-109.4130499
25376,11,41,13,10,11,1,87,38.261089496982876,-109.4127804
25377,7,46,14,10,12,1,90,38.261089496982876,-109.4125109
25378,6,48,14,9,15,1,93,38.261089496982876,-109.4122414
25379,5,47,14,11,15,1,93,38.261089496982876,-109.4119719
25380,5,45,14,11,14,1,90,38.261089496982876,-109.4117024
25381,5,46,14,11,13,1,90,38.261089496982876,-109.4114329
25382,5,49,14,10,15,0,93,38.261089496982876,-109.4111634
25383,4,53,13,7,16,1,94,38.261089496982876,-109.4108939
25384,5,53,13,7,16,1,95,38.261089496982876,-109.4106244
25385,5,50,13,8,17,0,93,38.261089496982876,-109.4103549
25386,7,48,13,7,16,0,91,38.261089496982876,-109.4100855
25387,8,47,13,9,16,0,93,38.261089496982876,-109.409816
25388,8,45,14,11,17,0,95,38.261089496982876,-109.4095465
25389,7,45,13,10,17,0,92,38.261089496982876,-109.409277
25390,5,44,13,9,18,0,89,38.261089496982876,-109.4090075
25391,5,45,12,7,19,0,88,38.261089496982876,-109.408738
25392,4,46,13,8,20,0,91,38.261089496982876,-109.4084685
25393,5,46,12,7,19,0,89,38.261089496982876,-109.408199
25394,6,47,13,7,18,0,91,38.261089496982876,-109.4079295
25395,5,47,13,6,18,1,90,38.261089496982876,-109.40766
25396,4,46,12,4,18,3,87,38.261089496982876,-109.4073905
25397,4,44,12,2,16,6,84,38.261089496982876,-109.407121
25398,4,46,12,3,16,6,87,38.261089496982876,-109.4068515
25399,1,32,11,0,11,15,70,38.261089496982876,-109.3879869
25400,2,35,11,0,13,13,74,38.261089496982876,-109.3877174
25401,3,41,12,1,16,7,80,38.261089496982876,-109.3874479
25402,5,44,13,3,18,5,88,38.261089496982876,-109.3871784
25403,5,46,13,5,18,2,89,38.261089496982876,-109.3869089
25404,4,48,12,5,18,2,89,38.261089496982876,-109.3866394
25405,3,50,11,3,16,3,86,38.261089496982876,-109.3863699
25406,2,48,9,3,13,5,80,38.261089496982876,-109.3861004
25407,2,44,10,4,13,6,79,38.261089496982876,-109.3858309
25408,1,38,10,2,9,10,70,38.261089496982876,-109.3855614
25409,2,32,9,5,9,5,62,38.261089496982876,-109.3852919
25410,3,35,9,6,8,4,65,38.261089496982876,-109.3850225
25411,2,30,10,3,7,9,61,38.261089496982876,-109.384753
25412,2,29,13,4,9,12,69,38.261089496982876,-109.3844835
25413,3,32,10,5,11,7,68,38.261089496982876,-109.384214
25414,1,30,10,1,11,9,62,38.261089496982876,-109.3839445
25415,1,31,11,0,12,13,68,38.261089496982876,-109.383675
25416,1,32,11,0,13,15,72,38.261089496982876,-109.3834055
25417,1,27,11,0,7,21,67,38.261089496982876,-109.383136
25418,2,35,12,0,12,15,76,38.261089496982876,-109.3828665
25419,4,42,13,1,16,9,85,38.261089496982876,-109.382597
25420,4,47,13,3,19,3,89,38.261089496982876,-109.3823275
25421,4,51,13,5,19,1,93,38.261089496982876,-109.382058
25422,7,43,14,8,19,0,91,38.261089496982876,-109.3817885
25423,13,37,13,10,17,0,90,38.261089496982876,-109.381519
25424,14,37,13,10,17,0,91,38.261089496982876,-109.3812495
25425,9,40,14,10,19,0,92,38.261089496982876,-109.38098
25426,13,36,13,12,17,0,91,38.261089496982876,-109.3807105
25427,14,34,13,12,15,0,88,38.261089496982876,-109.380441
25428,10,38,14,12,16,0,90,38.261089496982876,-109.3801716
25429,7,44,13,10,17,0,91,38.261089496982876,-109.3799021
25430,6,47,13,7,18,0,91,38.261089496982876,-109.3796326
25431,6,47,13,7,18,0,91,38.261089496982876,-109.3793631
25432,5,44,12,7,18,1,87,38.261089496982876,-109.3790936
25433,5,33,10,7,15,3,73,38.261089496982876,-109.3788241
25434,4,22,9,7,11,4,57,38.261089496982876,-109.3785546
25435,6,25,10,6,12,4,63,38.261089496982876,-109.3782851
25436,4,30,10,4,10,8,66,38.261089496982876,-109.3780156
25437,3,28,10,2,9,11,63,38.261089496982876,-109.3777461
25438,3,28,10,3,13,7,64,38.261089496982876,-109.3774766
25439,6,34,11,4,14,4,73,38.261089496982876,-109.3772071
25440,5,42,11,5,16,2,81,38.261089496982876,-109.3769376
25441,4,44,10,3,16,3,80,38.261089496982876,-109.3766681
25442,5,41,10,4,15,4,79,38.261089496982876,-109.3763986
25443,6,39,11,4,14,4,78,38.261089496982876,-109.3761291
25444,4,41,10,2,14,5,76,38.261089496982876,-109.3758596
25445,2,37,10,2,12,8,71,38.261089496982876,-109.3755901
25446,2,38,10,2,12,8,72,38.261089496982876,-109.3753206
25447,3,40,10,1,13,8,75,38.261089496982876,-109.3750512
25448,2,41,10,0,13,9,75,38.261089496982876,-109.3747817
25449,1,41,9,0,11,11,73,38.261089496982876,-109.3745122
25450,2,41,10,0,11,11,75,38.261089496982876,-109.3742427
25451,2,36,10,0,10,12,70,38.261089496982876,-109.3739732
25452,3,33,11,2,7,13,69,38.261089496982876,-109.3737037
25453,10,37,13,3,8,9,80,38.261089496982876,-109.3734342
25454,1,28,12,0,6,20,67,38.261089496982876,-109.3731647
25455,2,29,13,0,7,21,72,38.261089496982876,-109.3728952
25456,2,25,14,0,4,25,70,38.261089496982876,-109.3726257
25457,2,26,14,1,4,24,71,38.261089496982876,-109.3723562
25458,6,38,13,3,8,14,82,38.261089496982876,-109.3720867
25459,3,33,12,0,6,18,72,38.261089496982876,-109.3718172
25460,2,37,12,0,8,16,75,38.261089496982876,-109.3715477
25461,2,37,11,0,7,16,73,38.261089496982876,-109.3712782
25462,2,31,11,0,6,18,68,38.261089496982876,-109.3710087
25463,2,27,12,0,5,18,64,38.261089496982876,-109.3707392
25464,2,28,11,0,5,18,64,38.261089496982876,-109.3704697
25465,2,32,11,0,7,17,69,38.261089496982876,-109.3702003
25466,1,34,11,0,9,15,70,38.261089496982876,-109.3699308
25467,2,37,10,0,10,14,73,38.261089496982876,-109.3696613
25468,1,37,10,0,9,14,71,38.261089496982876,-109.3693918
25469,1,37,10,0,9,13,70,38.261089496982876,-109.3691223
25470,1,34,10,0,8,14,67,38.261089496982876,-109.3688528
25471,1,33,10,0,7,15,66,38.261089496982876,-109.3685833
25472,2,35,11,0,8,14,70,38.261089496982876,-109.3683138
25473,2,36,11,0,10,13,72,38.261089496982876,-109.3680443
25474,2,38,10,0,10,13,73,38.261089496982876,-109.3677748
25475,2,38,10,0,10,13,73,38.261089496982876,-109.3675053
25476,2,36,10,0,9,13,70,38.261089496982876,-109.3672358
25477,1,33,10,0,9,13,66,38.261089496982876,-109.3669663
25478,2,28,11,2,8,14,65,38.261089496982876,-109.3666968
25479,2,26,12,3,6,15,64,38.261089496982876,-109.3664273
25480,2,27,12,3,6,14,64,38.261089496982876,-109.3661578
25481,7,26,11,3,3,13,63,38.261089496982876,-109.3658883
25482,6,25,9,4,5,11,60,38.261089496982876,-109.3656188
25483,5,27,8,4,6,9,59,38.261089496982876,-109.3653493
25484,4,22,9,6,6,8,55,38.261089496982876,-109.3650799
25485,4,20,10,5,5,10,54,38.261089496982876,-109.3648104
25486,6,21,11,7,9,9,63,38.261089496982876,-109.3645409
25487,3,24,12,3,11,10,63,38.261089496982876,-109.3642714
25488,1,25,11,6,11,11,65,38.261089496982876,-109.3640019
25489,1,27,11,3,8,14,64,38.261089496982876,-109.3637324
25490,2,29,11,1,7,15,65,38.261089496982876,-109.3634629
25491,2,27,12,1,3,18,63,38.261089496982876,-109.3631934
25492,4,24,13,2,5,14,62,38.261089496982876,-109.3629239
25493,3,21,12,2,4,18,60,38.261089496982876,-109.3626544
25494,2,20,12,2,4,19,59,38.261089496982876,-109.3623849
25495,3,22,13,3,4,17,62,38.261089496982876,-109.3621154
25496,5,26,14,6,6,13,70,38.261089496982876,-109.3618459
25497,5,22,12,5,6,14,64,38.261089496982876,-109.3615764
25498,5,19,12,3,6,14,59,38.261089496982876,-109.3613069
25499,4,23,11,3,6,12,59,38.261089496982876,-109.3610374
25500,1,27,11,3,8,13,63,38.261089496982876,-109.3607679
25501,0,29,10,2,7,13,61,38.261089496982876,-109.3604984
25502,0,31,10,1,7,13,62,38.261089496982876,-109.360229
25503,0,35,9,0,8,12,64,38.261089496982876,-109.3599595
25504,0,37,9,0,9,12,67,38.261089496982876,-109.35969
25505,0,38,10,0,10,11,69,38.261089496982876,-109.3594205
25506,1,36,9,0,8,12,66,38.261089496982876,-109.359151
25507,1,33,10,0,7,13,64,38.261089496982876,-109.3588815
25508,1,33,11,0,7,14,66,38.261089496982876,-109.358612
25509,1,33,10,1,8,13,66,38.261089496982876,-109.3583425
25510,1,35,10,1,10,11,68,38.261089496982876,-109.358073
25511,2,35,10,0,9,12,68,38.261089496982876,-109.3578035
25512,1,27,11,0,5,19,63,38.261089496982876,-109.357534
25513,1,25,12,0,2,22,62,38.261089496982876,-109.3572645
25514,3,31,10,1,4,16,65,38.261089496982876,-109.356995
25515,1,31,11,0,6,16,65,38.261089496982876,-109.3567255
25516,1,29,11,0,6,18,65,38.261089496982876,-109.356456
25517,2,28,11,0,5,19,65,38.261089496982876,-109.3561865
25518,2,31,12,1,6,19,71,38.261089496982876,-109.355917
25519,1,29,12,0,4,23,69,38.261089496982876,-109.3556475
25520,1,30,11,0,6,20,68,38.261089496982876,-109.355378
25521,1,20,6,3,13,2,45,38.261089496982876,-109.3551086
25522,0,20,5,5,10,1,41,38.261089496982876,-109.3548391
25523,2,51,8,5,9,1,76,38.261089496982876,-109.3545696
25524,1,59,7,5,10,1,83,38.261089496982876,-109.3543001
25525,0,53,6,2,9,3,73,38.261089496982876,-109.3540306
25526,2,52,6,5,9,3,77,38.261089496982876,-109.3537611
25527,1,47,6,4,9,4,71,38.261089496982876,-109.3534916
25528,2,39,7,4,8,6,66,38.261089496982876,-109.3532221
25529,2,30,8,4,6,10,60,38.261089496982876,-109.3529526
25530,2,23,8,5,5,11,54,38.261089496982876,-109.3526831
25531,2,20,8,6,5,11,52,38.261089496982876,-109.3524136
25532,3,17,10,7,8,9,54,38.261089496982876,-109.3521441
25533,3,10,11,7,6,12,49,38.261089496982876,-109.3518746
25534,6,8,12,8,6,13,53,38.261089496982876,-109.3516051
25535,4,13,15,2,2,23,59,38.261089496982876,-109.3513356
25536,3,18,18,2,2,31,74,38.261089496982876,-109.3510661
25537,1,18,19,0,2,35,75,38.261089496982876,-109.3507966
25538,2,18,19,1,3,35,78,38.261089496982876,-109.3505271
25539,2,17,19,0,1,36,75,38.261089496982876,-109.3502577
25540,2,17,19,0,0,35,73,38.261089496982876,-109.3499882
25541,3,17,19,0,0,33,72,38.261089496982876,-109.3497187
25542,4,20,17,0,1,27,69,38.261089496982876,-109.3494492
25543,2,20,16,0,1,26,65,38.261089496982876,-109.3491797
25544,2,19,16,0,0,28,65,38.261089496982876,-109.3489102
25545,1,20,16,0,0,31,68,38.261089496982876,-109.3486407
25546,1,21,17,0,1,32,72,38.261089496982876,-109.3483712
25547,2,23,18,0,3,30,76,38.261089496982876,-109.3481017
25548,1,21,18,0,2,33,75,38.261089496982876,-109.3478322
25549,2,20,19,0,2,35,78,38.261089496982876,-109.3475627
25550,2,20,19,0,2,35,78,38.261089496982876,-109.3472932
25551,2,22,19,0,2,34,79,38.261089496982876,-109.3470237
25552,1,22,19,0,3,34,79,38.261089496982876,-109.3467542
25553,1,22,19,0,4,35,81,38.261089496982876,-109.3464847
25554,1,21,20,1,5,35,83,38.261089496982876,-109.3462152
25555,1,23,19,1,5,34,83,38.261089496982876,-109.3459457
25556,1,26,18,1,5,32,83,38.261089496982876,-109.3456762
25557,1,26,18,0,5,32,82,38.261089496982876,-109.3454068
25558,2,26,18,1,6,31,84,38.261089496982876,-109.3451373
25559,2,25,18,1,5,31,82,38.261089496982876,-109.3448678
25560,2,23,17,0,2,29,73,38.261089496982876,-109.3445983
25561,3,25,17,0,2,24,71,38.261089496982876,-109.3443288
25562,1,22,17,0,1,27,68,38.261089496982876,-109.3440593
25563,1,24,17,0,2,26,70,38.261089496982876,-109.3437898
25564,1,25,16,0,2,26,70,38.261089496982876,-109.3435203
25565,1,24,16,0,2,27,70,38.261089496982876,-109.3432508
25566,0,22,16,0,3,29,70,38.261089496982876,-109.3429813
25567,1,24,20,0,6,32,83,38.261089496982876,-109.3427118
25568,1,21,20,1,8,33,84,38.261089496982876,-109.3424423
25569,1,21,20,3,9,31,85,38.261089496982876,-109.3421728
25570,2,24,18,5,12,26,87,38.261089496982876,-109.3419033
25571,4,27,16,7,14,18,86,38.261089496982876,-109.3416338
25572,4,30,16,7,13,17,87,38.261089496982876,-109.3413643
25573,3,31,16,4,11,22,87,38.261089496982876,-109.3410948
25574,2,28,18,2,7,28,85,38.261089496982876,-109.3408253
25575,1,25,20,2,5,33,86,38.261089496982876,-109.3405558
25576,0,22,21,0,4,37,84,38.261089496982876,-109.3402864
25577,0,21,22,0,5,39,87,38.261089496982876,-109.3400169
25578,1,18,23,0,5,39,86,38.261089496982876,-109.3397474
25579,0,17,22,0,5,40,84,38.261089496982876,-109.3394779
25580,0,19,21,0,5,40,85,38.261089496982876,-109.3392084
25581,1,19,21,0,6,38,85,38.261089496982876,-109.3389389
25582,1,21,21,0,6,36,85,38.261089496982876,-109.3386694
25583,1,23,20,0,6,35,85,38.261089496982876,-109.3383999
25584,1,26,19,1,6,31,84,38.261089496982876,-109.3381304
25585,2,23,18,0,4,29,76,38.261089496982876,-109.3378609
25586,2,19,16,1,3,25,66,38.261089496982876,-109.3375914
25587,2,19,16,1,4,25,67,38.261089496982876,-109.3373219
25588,1,21,18,0,5,29,74,38.261089496982876,-109.3370524
25589,3,24,18,3,5,27,80,38.261089496982876,-109.3367829
25590,2,29,12,4,6,15,68,38.261089496982876,-109.3365134
25591,2,35,9,4,11,6,67,38.261089496982876,-109.3362439
25592,1,39,9,2,11,6,68,38.261089496982876,-109.3359744
25593,1,40,9,1,9,10,70,38.261089496982876,-109.3357049
25594,1,32,13,2,9,15,72,38.261089496982876,-109.3354355
25595,1,43,10,4,14,5,77,38.261089496982876,-109.335166
25596,1,46,9,3,11,5,75,38.261089496982876,-109.3348965
25597,1,44,9,1,12,8,75,38.261089496982876,-109.334627
25598,1,34,11,1,9,14,70,38.261089496982876,-109.3343575
25599,1,18,15,0,2,25,61,38.261089496982876,-109.334088
25600,1,18,15,0,1,27,62,38.261089496982876,-109.3338185
25601,0,22,13,0,3,22,60,38.261089496982876,-109.333549
25602,4,39,9,3,10,6,71,38.26082000239764,-109.4429638
25603,5,37,9,3,9,6,69,38.26082000239764,-109.4426943
25604,6,36,9,4,11,4,70,38.26082000239764,-109.4424248
25605,4,35,8,3,9,7,66,38.26082000239764,-109.4421553
25606,5,38,8,3,9,6,69,38.26082000239764,-109.4418858
25607,4,40,8,4,11,4,71,38.26082000239764,-109.4416163
25608,2,39,9,3,11,6,70,38.26082000239764,-109.4413468
25609,6,42,9,3,13,4,77,38.26082000239764,-109.4410773
25610,2,43,9,1,13,6,74,38.26082000239764,-109.4408078
25611,2,47,9,1,13,6,78,38.26082000239764,-109.4405383
25612,3,49,9,3,15,3,82,38.26082000239764,-109.4402688
25613,2,45,10,2,13,6,78,38.26082000239764,-109.4399993
25614,1,43,10,1,14,7,76,38.26082000239764,-109.4397299
25615,2,44,10,1,15,7,79,38.26082000239764,-109.4394604
25616,3,48,11,3,16,5,86,38.26082000239764,-109.4391909
25617,4,52,10,5,14,3,88,38.26082000239764,-109.4389214
25618,3,55,10,6,13,3,90,38.26082000239764,-109.4386519
25619,3,48,10,3,14,4,82,38.26082000239764,-109.4383824
25620,2,41,10,1,12,8,74,38.26082000239764,-109.4381129
25621,2,36,9,1,10,11,69,38.26082000239764,-109.4378434
25622,4,34,10,1,10,9,68,38.26082000239764,-109.4375739
25623,2,41,9,3,15,6,76,38.26082000239764,-109.4373044
25624,1,43,9,0,14,7,74,38.26082000239764,-109.4370349
25625,2,40,10,1,14,7,74,38.26082000239764,-109.4367654
25626,2,42,10,3,15,5,77,38.26082000239764,-109.4364959
25627,3,49,10,0,15,6,83,38.26082000239764,-109.4362264
25628,3,47,11,2,15,7,85,38.26082000239764,-109.4359569
25629,4,47,12,4,16,4,87,38.26082000239764,-109.4356874
25630,7,46,12,7,15,2,89,38.26082000239764,-109.4354179
25631,11,43,13,10,14,1,92,38.26082000239764,-109.4351484
25632,9,45,13,10,15,1,93,38.26082000239764,-109.434879
25633,7,45,13,10,15,1,91,38.26082000239764,-109.4346095
25634,5,47,13,10,15,1,91,38.26082000239764,-109.43434
25635,5,48,13,10,15,1,92,38.26082000239764,-109.4340705
25636,5,46,13,12,15,1,92,38.26082000239764,-109.433801
25637,5,44,13,13,14,1,90,38.26082000239764,-109.4335315
25638,7,45,14,12,15,1,94,38.26082000239764,-109.433262
25639,10,43,14,12,14,1,94,38.26082000239764,-109.4329925
25640,11,42,14,12,14,1,94,38.26082000239764,-109.432723
25641,9,42,14,12,13,1,91,38.26082000239764,-109.4324535
25642,9,42,14,12,12,1,90,38.26082000239764,-109.432184
25643,9,42,14,12,13,1,91,38.26082000239764,-109.4319145
25644,10,42,14,13,14,1,94,38.26082000239764,-109.431645
25645,11,42,14,12,14,1,94,38.26082000239764,-109.4313755
25646,10,43,14,11,15,1,94,38.26082000239764,-109.431106
25647,9,44,14,12,15,1,95,38.26082000239764,-109.4308365
25648,9,44,14,12,14,1,94,38.26082000239764,-109.430567
25649,8,45,14,12,14,1,94,38.26082000239764,-109.4302975
25650,7,47,13,11,14,1,93,38.26082000239764,-109.430028
25651,8,46,14,12,14,1,95,38.26082000239764,-109.4297586
25652,10,44,14,12,15,0,95,38.26082000239764,-109.4294891
25653,12,41,14,12,15,0,94,38.26082000239764,-109.4292196
25654,13,41,14,11,15,0,94,38.26082000239764,-109.4289501
25655,11,43,14,11,15,0,94,38.26082000239764,-109.4286806
25656,9,45,14,11,15,1,95,38.26082000239764,-109.4284111
25657,9,44,14,11,15,1,94,38.26082000239764,-109.4281416
25658,10,42,14,12,15,1,94,38.26082000239764,-109.4278721
25659,12,40,14,12,15,1,94,38.26082000239764,-109.4276026
25660,13,42,14,11,14,0,94,38.26082000239764,-109.4273331
25661,13,41,14,11,14,0,93,38.26082000239764,-109.4270636
25662,13,42,14,12,14,0,95,38.26082000239764,-109.4267941
25663,11,43,14,12,14,0,94,38.26082000239764,-109.4265246
25664,11,42,14,12,15,0,94,38.26082000239764,-109.4262551
25665,8,43,14,13,15,1,94,38.26082000239764,-109.4259856
25666,9,43,14,13,14,1,94,38.26082000239764,-109.4257161
25667,9,43,14,13,14,1,94,38.26082000239764,-109.4254466
25668,9,43,14,12,15,1,94,38.26082000239764,-109.4251771
25669,9,42,14,13,15,1,94,38.26082000239764,-109.4249077
25670,10,41,15,14,14,1,95,38.26082000239764,-109.4246382
25671,9,43,15,14,13,1,95,38.26082000239764,-109.4243687
25672,9,43,14,14,13,1,94,38.26082000239764,-109.4240992
25673,10,42,14,14,14,1,95,38.26082000239764,-109.4238297
25674,11,42,14,13,14,0,94,38.26082000239764,-109.4235602
25675,10,43,13,11,14,1,92,38.26082000239764,-109.4232907
25676,8,44,13,10,15,1,91,38.26082000239764,-109.4230212
25677,7,44,13,10,16,1,91,38.26082000239764,-109.4227517
25678,6,45,13,10,15,1,90,38.26082000239764,-109.4224822
25679,7,44,14,12,15,1,93,38.26082000239764,-109.4222127
25680,9,42,14,13,15,1,94,38.26082000239764,-109.4219432
25681,10,41,14,12,16,1,94,38.26082000239764,-109.4216737
25682,9,41,14,12,16,1,93,38.26082000239764,-109.4214042
25683,9,40,14,13,15,1,92,38.26082000239764,-109.4211347
25684,12,38,14,14,14,1,93,38.26082000239764,-109.4208652
25685,13,36,14,13,14,1,91,38.26082000239764,-109.4205957
25686,14,35,14,13,13,1,90,38.26082000239764,-109.4203262
25687,15,35,14,13,13,0,90,38.26082000239764,-109.4200568
25688,12,38,14,13,14,1,92,38.26082000239764,-109.4197873
25689,13,36,14,13,14,1,91,38.26082000239764,-109.4195178
25690,12,39,13,11,14,1,90,38.26082000239764,-109.4192483
25691,7,46,12,9,15,1,90,38.26082000239764,-109.4189788
25692,5,51,10,8,14,1,89,38.26082000239764,-109.4187093
25693,6,47,12,9,15,1,90,38.26082000239764,-109.4184398
25694,12,41,13,11,15,0,92,38.26082000239764,-109.4181703
25695,14,38,14,12,14,0,92,38.26082000239764,-109.4179008
25696,13,38,14,13,14,0,92,38.26082000239764,-109.4176313
25697,12,38,14,13,14,0,91,38.26082000239764,-109.4173618
25698,11,40,13,13,13,0,90,38.26082000239764,-109.4170923
25699,11,36,12,11,13,1,84,38.26082000239764,-109.4168228
25700,11,35,12,10,12,1,81,38.26082000239764,-109.4165533
25701,10,35,12,10,12,1,80,38.26082000239764,-109.4162838
25702,10,32,11,9,11,1,74,38.26082000239764,-109.4160143
25703,14,31,12,9,10,1,77,38.26082000239764,-109.4157448
25704,14,34,13,11,10,1,83,38.26082000239764,-109.4154753
25705,12,37,14,12,11,1,87,38.26082000239764,-109.4152058
25706,12,35,14,13,10,1,85,38.26082000239764,-109.4149364
25707,9,39,13,10,10,1,82,38.26082000239764,-109.4146669
25708,9,38,13,11,10,1,82,38.26082000239764,-109.4143974
25709,9,39,13,11,10,1,83,38.26082000239764,-109.4141279
25710,9,43,13,10,10,1,86,38.26082000239764,-109.4138584
25711,8,45,13,9,10,2,87,38.26082000239764,-109.4135889
25712,9,44,13,10,11,1,88,38.26082000239764,-109.4133194
25713,11,44,14,10,11,1,91,38.26082000239764,-109.4130499
25714,9,46,14,10,12,1,92,38.26082000239764,-109.4127804
25715,6,49,14,10,14,1,94,38.26082000239764,-109.4125109
25716,5,52,13,7,16,1,94,38.26082000239764,-109.4122414
25717,5,49,14,9,16,1,94,38.26082000239764,-109.4119719
25718,5,46,14,10,14,2,91,38.26082000239764,-109.4117024
25719,5,45,14,10,14,2,90,38.26082000239764,-109.4114329
25720,5,47,14,11,16,1,94,38.26082000239764,-109.4111634
25721,5,51,13,8,16,1,94,38.26082000239764,-109.4108939
25722,4,51,13,7,16,1,92,38.26082000239764,-109.4106244
25723,5,50,13,7,17,1,93,38.26082000239764,-109.4103549
25724,6,47,13,8,17,0,91,38.26082000239764,-109.4100855
25725,7,46,13,10,17,0,93,38.26082000239764,-109.409816
25726,8,45,14,11,16,0,94,38.26082000239764,-109.4095465
25727,7,45,13,10,16,0,91,38.26082000239764,-109.409277
25728,7,44,13,9,17,0,90,38.26082000239764,-109.4090075
25729,6,44,13,8,19,0,90,38.26082000239764,-109.408738
25730,5,45,13,8,19,0,90,38.26082000239764,-109.4084685
25731,5,46,13,7,18,0,89,38.26082000239764,-109.408199
25732,5,47,13,7,18,0,90,38.26082000239764,-109.4079295
25733,5,47,13,7,18,1,91,38.26082000239764,-109.40766
25734,4,46,13,5,19,2,89,38.26082000239764,-109.4073905
25735,3,43,12,2,16,6,82,38.26082000239764,-109.407121
25736,2,46,11,0,15,7,81,38.26082000239764,-109.4068515
25737,0,29,10,0,9,16,64,38.26082000239764,-109.3879869
25738,1,34,11,0,12,12,70,38.26082000239764,-109.3877174
25739,3,41,12,2,16,8,82,38.26082000239764,-109.3874479
25740,5,45,13,3,17,5,88,38.26082000239764,-109.3871784
25741,5,48,13,5,18,2,91,38.26082000239764,-109.3869089
25742,3,46,11,4,17,3,84,38.26082000239764,-109.3866394
25743,2,46,10,4,15,4,81,38.26082000239764,-109.3863699
25744,2,47,10,2,14,5,80,38.26082000239764,-109.3861004
25745,2,41,11,3,15,6,78,38.26082000239764,-109.3858309
25746,1,33,10,3,10,7,64,38.26082000239764,-109.3855614
25747,2,32,8,6,7,5,60,38.26082000239764,-109.3852919
25748,3,35,8,7,8,4,65,38.26082000239764,-109.3850225
25749,7,34,12,6,10,3,72,38.26082000239764,-109.384753
25750,4,28,11,7,9,6,65,38.26082000239764,-109.3844835
25751,2,29,10,7,10,6,64,38.26082000239764,-109.384214
25752,0,29,11,0,11,13,64,38.26082000239764,-109.3839445
25753,0,31,11,0,10,18,70,38.26082000239764,-109.383675
25754,1,30,11,0,10,17,69,38.26082000239764,-109.3834055
25755,1,30,12,0,8,19,70,38.26082000239764,-109.383136
25756,3,39,12,0,12,13,79,38.26082000239764,-109.3828665
25757,4,44,13,1,16,7,85,38.26082000239764,-109.382597
25758,4,47,13,3,19,3,89,38.26082000239764,-109.3823275
25759,4,48,13,5,19,1,90,38.26082000239764,-109.382058
25760,7,44,14,8,19,0,92,38.26082000239764,-109.3817885
25761,11,39,14,11,18,0,93,38.26082000239764,-109.381519
25762,14,36,14,13,16,0,93,38.26082000239764,-109.3812495
25763,14,36,14,14,16,0,94,38.26082000239764,-109.38098
25764,18,32,13,13,14,0,90,38.26082000239764,-109.3807105
25765,17,31,13,14,14,0,89,38.26082000239764,-109.380441
25766,11,36,14,14,16,0,91,38.26082000239764,-109.3801716
25767,7,42,14,12,18,0,93,38.26082000239764,-109.3799021
25768,8,45,13,8,17,0,91,38.26082000239764,-109.3796326
25769,6,46,13,6,17,1,89,38.26082000239764,-109.3793631
25770,4,39,11,6,15,3,78,38.26082000239764,-109.3790936
25771,5,25,10,6,10,6,62,38.26082000239764,-109.3788241
25772,6,19,10,9,12,4,60,38.26082000239764,-109.3785546
25773,10,25,12,10,11,5,73,38.26082000239764,-109.3782851
25774,7,34,11,5,14,5,76,38.26082000239764,-109.3780156
25775,5,37,10,3,15,4,74,38.26082000239764,-109.3777461
25776,4,40,10,2,16,3,75,38.26082000239764,-109.3774766
25777,3,44,10,3,18,2,80,38.26082000239764,-109.3772071
25778,3,43,10,4,16,3,79,38.26082000239764,-109.3769376
25779,8,40,11,5,16,2,82,38.26082000239764,-109.3766681
25780,15,37,12,8,15,1,88,38.26082000239764,-109.3763986
25781,11,36,12,8,15,2,84,38.26082000239764,-109.3761291
25782,3,35,11,2,12,9,72,38.26082000239764,-109.3758596
25783,2,41,10,0,12,9,74,38.26082000239764,-109.3755901
25784,2,41,10,0,11,10,74,38.26082000239764,-109.3753206
25785,2,40,10,0,11,10,73,38.26082000239764,-109.3750512
25786,1,37,9,0,10,10,67,38.26082000239764,-109.3747817
25787,1,36,9,0,7,13,66,38.26082000239764,-109.3745122
25788,3,33,9,2,9,8,64,38.26082000239764,-109.3742427
25789,3,30,11,2,7,9,62,38.26082000239764,-109.3739732
25790,4,28,11,3,8,9,63,38.26082000239764,-109.3737037
25791,4,31,12,1,11,12,71,38.26082000239764,-109.3734342
25792,1,28,12,0,8,21,70,38.26082000239764,-109.3731647
25793,3,29,12,0,9,18,71,38.26082000239764,-109.3728952
25794,2,26,13,0,5,21,67,38.26082000239764,-109.3726257
25795,2,26,13,1,4,21,67,38.26082000239764,-109.3723562
25796,3,34,12,1,6,17,73,38.26082000239764,-109.3720867
25797,2,34,11,0,8,15,70,38.26082000239764,-109.3718172
25798,2,38,11,0,9,14,74,38.26082000239764,-109.3715477
25799,2,41,10,0,11,12,76,38.26082000239764,-109.3712782
25800,2,38,10,0,11,12,73,38.26082000239764,-109.3710087
25801,1,30,11,0,7,16,65,38.26082000239764,-109.3707392
25802,2,32,10,0,7,16,67,38.26082000239764,-109.3704697
25803,2,36,10,0,8,14,70,38.26082000239764,-109.3702003
25804,2,39,10,0,11,12,74,38.26082000239764,-109.3699308
25805,2,39,10,0,11,11,73,38.26082000239764,-109.3696613
25806,2,35,10,0,9,13,69,38.26082000239764,-109.3693918
25807,2,32,11,0,8,15,68,38.26082000239764,-109.3691223
25808,1,28,10,0,6,17,62,38.26082000239764,-109.3688528
25809,1,31,10,0,6,16,64,38.26082000239764,-109.3685833
25810,1,37,10,0,9,13,70,38.26082000239764,-109.3683138
25811,1,38,10,0,10,12,71,38.26082000239764,-109.3680443
25812,1,39,10,0,10,12,72,38.26082000239764,-109.3677748
25813,1,37,10,0,10,13,71,38.26082000239764,-109.3675053
25814,1,32,11,2,9,12,67,38.26082000239764,-109.3672358
25815,4,29,11,4,7,9,64,38.26082000239764,-109.3669663
25816,2,22,10,3,5,13,55,38.26082000239764,-109.3666968
25817,2,24,11,3,5,13,58,38.26082000239764,-109.3664273
25818,2,24,11,4,5,11,57,38.26082000239764,-109.3661578
25819,6,22,10,3,3,15,59,38.26082000239764,-109.3658883
25820,5,23,9,5,4,13,59,38.26082000239764,-109.3656188
25821,4,27,10,6,7,12,66,38.26082000239764,-109.3653493
25822,1,25,13,8,10,9,66,38.26082000239764,-109.3650799
25823,0,26,12,6,9,12,65,38.26082000239764,-109.3648104
25824,1,28,11,6,11,11,68,38.26082000239764,-109.3645409
25825,1,28,12,1,9,16,67,38.26082000239764,-109.3642714
25826,0,27,12,0,8,17,64,38.26082000239764,-109.3640019
25827,0,28,11,0,9,16,64,38.26082000239764,-109.3637324
25828,1,28,12,1,7,17,66,38.26082000239764,-109.3634629
25829,1,30,11,0,6,17,65,38.26082000239764,-109.3631934
25830,2,31,12,2,8,14,69,38.26082000239764,-109.3629239
25831,1,25,12,0,6,19,63,38.26082000239764,-109.3626544
25832,1,25,12,0,4,20,62,38.26082000239764,-109.3623849
25833,1,25,12,0,5,19,62,38.26082000239764,-109.3621154
25834,3,25,13,0,5,20,66,38.26082000239764,-109.3618459
25835,2,25,13,0,5,22,67,38.26082000239764,-109.3615764
25836,1,23,13,0,4,23,64,38.26082000239764,-109.3613069
25837,2,22,13,1,4,22,64,38.26082000239764,-109.3610374
25838,1,23,13,2,4,19,62,38.26082000239764,-109.3607679
25839,3,27,10,2,6,12,60,38.26082000239764,-109.3604984
25840,2,29,10,1,6,14,62,38.26082000239764,-109.360229
25841,1,30,11,1,8,15,66,38.26082000239764,-109.3599595
25842,1,32,11,0,9,14,67,38.26082000239764,-109.35969
25843,1,30,10,0,6,16,63,38.26082000239764,-109.3594205
25844,0,29,10,0,7,15,61,38.26082000239764,-109.359151
25845,0,31,10,0,9,12,62,38.26082000239764,-109.3588815
25846,0,33,10,1,10,11,65,38.26082000239764,-109.358612
25847,1,36,9,0,8,12,66,38.26082000239764,-109.3583425
25848,1,34,10,0,9,12,66,38.26082000239764,-109.358073
25849,1,31,10,0,7,14,63,38.26082000239764,-109.3578035
25850,1,26,10,1,6,15,59,38.26082000239764,-109.357534
25851,1,24,11,0,4,18,58,38.26082000239764,-109.3572645
25852,3,27,12,0,6,19,67,38.26082000239764,-109.356995
25853,3,21,11,3,3,18,59,38.26082000239764,-109.3567255
25854,2,26,9,2,6,15,60,38.26082000239764,-109.356456
25855,1,31,11,0,10,19,72,38.26082000239764,-109.3561865
25856,2,31,13,1,7,20,74,38.26082000239764,-109.355917
25857,0,37,11,0,8,17,73,38.26082000239764,-109.3556475
25858,0,27,8,0,11,9,55,38.26082000239764,-109.355378
25859,0,42,8,3,12,3,68,38.26082000239764,-109.3551086
25860,1,51,7,4,10,3,76,38.26082000239764,-109.3548391
25861,2,55,7,6,10,2,82,38.26082000239764,-109.3545696
25862,2,59,7,5,10,2,85,38.26082000239764,-109.3543001
25863,2,60,7,5,10,2,86,38.26082000239764,-109.3540306
25864,0,56,6,2,8,4,76,38.26082000239764,-109.3537611
25865,2,58,6,5,9,2,82,38.26082000239764,-109.3534916
25866,1,55,6,4,9,2,77,38.26082000239764,-109.3532221
25867,2,45,7,4,8,5,71,38.26082000239764,-109.3529526
25868,2,32,8,4,9,7,62,38.26082000239764,-109.3526831
25869,3,34,8,5,8,7,65,38.26082000239764,-109.3524136
25870,3,36,8,5,8,7,67,38.26082000239764,-109.3521441
25871,4,35,8,5,8,6,66,38.26082000239764,-109.3518746
25872,4,19,9,5,9,7,53,38.26082000239764,-109.3516051
25873,4,8,13,5,4,18,52,38.26082000239764,-109.3513356
25874,3,17,17,0,3,28,68,38.26082000239764,-109.3510661
25875,1,16,18,0,1,34,70,38.26082000239764,-109.3507966
25876,1,17,18,0,2,34,72,38.26082000239764,-109.3505271
25877,2,17,18,0,1,34,72,38.26082000239764,-109.3502577
25878,2,15,18,0,0,32,67,38.26082000239764,-109.3499882
25879,2,15,17,0,0,30,64,38.26082000239764,-109.3497187
25880,3,18,15,0,1,25,62,38.26082000239764,-109.3494492
25881,1,17,15,0,2,26,61,38.26082000239764,-109.3491797
25882,1,18,16,0,1,30,66,38.26082000239764,-109.3489102
25883,1,19,17,0,1,33,71,38.26082000239764,-109.3486407
25884,2,19,18,0,1,32,72,38.26082000239764,-109.3483712
25885,2,20,18,0,1,32,73,38.26082000239764,-109.3481017
25886,1,18,17,0,1,32,69,38.26082000239764,-109.3478322
25887,1,18,18,0,1,32,70,38.26082000239764,-109.3475627
25888,1,19,18,0,1,33,72,38.26082000239764,-109.3472932
25889,1,22,17,0,1,33,74,38.26082000239764,-109.3470237
25890,2,25,17,0,3,30,77,38.26082000239764,-109.3467542
25891,1,22,18,0,3,32,76,38.26082000239764,-109.3464847
25892,1,22,19,0,4,34,80,38.26082000239764,-109.3462152
25893,2,22,19,1,4,34,82,38.26082000239764,-109.3459457
25894,3,23,18,2,4,31,81,38.26082000239764,-109.3456762
25895,2,25,17,0,3,31,78,38.26082000239764,-109.3454068
25896,2,24,18,1,3,31,79,38.26082000239764,-109.3451373
25897,1,21,18,0,2,32,74,38.26082000239764,-109.3448678
25898,1,20,18,0,1,31,71,38.26082000239764,-109.3445983
25899,2,21,18,0,1,29,71,38.26082000239764,-109.3443288
25900,1,21,18,0,0,30,70,38.26082000239764,-109.3440593
25901,2,23,18,0,1,28,72,38.26082000239764,-109.3437898
25902,1,24,18,0,1,29,73,38.26082000239764,-109.3435203
25903,1,23,17,0,2,30,73,38.26082000239764,-109.3432508
25904,1,24,20,0,6,33,84,38.26082000239764,-109.3429813
25905,1,26,20,0,6,32,85,38.26082000239764,-109.3427118
25906,2,25,19,1,8,30,85,38.26082000239764,-109.3424423
25907,2,26,18,4,10,25,85,38.26082000239764,-109.3421728
25908,5,27,17,9,12,17,87,38.26082000239764,-109.3419033
25909,7,28,16,11,14,10,86,38.26082000239764,-109.3416338
25910,4,30,16,8,14,14,86,38.26082000239764,-109.3413643
25911,2,30,17,3,9,23,84,38.26082000239764,-109.3410948
25912,1,26,19,1,5,32,84,38.26082000239764,-109.3408253
25913,1,21,21,0,4,37,84,38.26082000239764,-109.3405558
25914,1,19,21,0,5,39,85,38.26082000239764,-109.3402864
25915,1,17,22,0,5,40,85,38.26082000239764,-109.3400169
25916,1,15,22,1,5,42,86,38.26082000239764,-109.3397474
25917,1,15,22,1,5,42,86,38.26082000239764,-109.3394779
25918,0,15,22,0,5,44,86,38.26082000239764,-109.3392084
25919,1,18,22,0,5,40,86,38.26082000239764,-109.3389389
25920,1,22,21,0,7,36,87,38.26082000239764,-109.3386694
25921,1,24,20,2,7,32,86,38.26082000239764,-109.3383999
25922,1,22,21,3,8,30,85,38.26082000239764,-109.3381304
25923,0,25,20,0,6,33,84,38.26082000239764,-109.3378609
25924,1,21,18,0,2,31,73,38.26082000239764,-109.3375914
25925,2,21,17,0,2,29,71,38.26082000239764,-109.3373219
25926,3,22,17,1,4,27,74,38.26082000239764,-109.3370524
25927,2,21,16,2,2,27,70,38.26082000239764,-109.3367829
25928,1,26,13,2,4,21,67,38.26082000239764,-109.3365134
25929,1,24,13,2,3,21,64,38.26082000239764,-109.3362439
25930,1,20,14,2,3,22,62,38.26082000239764,-109.3359744
25931,1,20,15,2,3,23,64,38.26082000239764,-109.3357049
25932,1,31,12,1,9,16,70,38.26082000239764,-109.3354355
25933,1,35,11,1,12,12,72,38.26082000239764,-109.335166
25934,1,28,13,2,9,16,69,38.26082000239764,-109.3348965
25935,2,22,15,3,6,21,69,38.26082000239764,-109.334627
25936,2,20,17,2,4,26,71,38.26082000239764,-109.3343575
25937,2,18,15,1,2,24,62,38.26082000239764,-109.334088
25938,2,19,15,1,3,23,63,38.26082000239764,-109.3338185
25939,1,24,13,1,5,19,63,38.26082000239764,-109.333549
25940,3,43,10,3,12,7,78,38.260550507812404,-109.4432333
25941,5,41,9,3,11,5,74,38.260550507812404,-109.4429638
25942,4,38,9,4,9,6,70,38.260550507812404,-109.4426943
25943,4,39,9,4,12,5,73,38.260550507812404,-109.4424248
25944,2,40,9,2,12,6,71,38.260550507812404,-109.4421553
25945,4,40,9,3,11,5,72,38.260550507812404,-109.4418858
25946,5,38,8,5,9,4,69,38.260550507812404,-109.4416163
25947,5,36,9,4,8,5,67,38.260550507812404,-109.4413468
25948,10,38,9,6,10,2,75,38.260550507812404,-109.4410773
25949,3,39,8,2,10,7,69,38.260550507812404,-109.4408078
25950,3,40,8,2,11,6,70,38.260550507812404,-109.4405383
25951,4,42,9,3,12,4,74,38.260550507812404,-109.4402688
25952,2,38,9,0,6,12,67,38.260550507812404,-109.4399993
25953,1,41,10,0,13,10,75,38.260550507812404,-109.4397299
25954,3,47,10,3,16,4,83,38.260550507812404,-109.4394604
25955,4,52,10,6,13,2,87,38.260550507812404,-109.4391909
25956,3,55,9,5,12,3,87,38.260550507812404,-109.4389214
25957,2,54,9,4,14,3,86,38.260550507812404,-109.4386519
25958,2,47,11,2,15,6,83,38.260550507812404,-109.4383824
25959,2,41,10,0,12,11,76,38.260550507812404,-109.4381129
25960,1,35,10,0,10,13,69,38.260550507812404,-109.4378434
25961,2,31,10,0,11,11,65,38.260550507812404,-109.4375739
25962,0,36,9,1,11,10,67,38.260550507812404,-109.4373044
25963,1,41,9,0,11,10,72,38.260550507812404,-109.4370349
25964,2,43,10,0,14,8,77,38.260550507812404,-109.4367654
25965,3,44,10,3,15,5,80,38.260550507812404,-109.4364959
25966,4,47,11,5,15,4,86,38.260550507812404,-109.4362264
25967,5,49,12,6,16,2,90,38.260550507812404,-109.4359569
25968,8,45,13,10,15,1,92,38.260550507812404,-109.4356874
25969,11,42,13,12,14,0,92,38.260550507812404,-109.4354179
25970,11,41,13,12,14,0,91,38.260550507812404,-109.4351484
25971,11,41,13,13,14,1,93,38.260550507812404,-109.434879
25972,7,42,13,12,14,1,89,38.260550507812404,-109.4346095
25973,5,43,13,11,14,1,87,38.260550507812404,-109.43434
25974,5,45,13,12,14,1,90,38.260550507812404,-109.4340705
25975,4,45,14,14,14,1,92,38.260550507812404,-109.433801
25976,5,44,14,14,14,1,92,38.260550507812404,-109.4335315
25977,6,44,14,13,14,1,92,38.260550507812404,-109.433262
25978,8,44,14,12,14,1,93,38.260550507812404,-109.4329925
25979,9,43,14,12,15,1,94,38.260550507812404,-109.432723
25980,9,43,14,11,14,1,92,38.260550507812404,-109.4324535
25981,9,44,13,11,14,1,92,38.260550507812404,-109.432184
25982,9,45,14,11,14,1,94,38.260550507812404,-109.4319145
25983,11,43,14,11,14,0,93,38.260550507812404,-109.431645
25984,14,40,14,12,14,0,94,38.260550507812404,-109.4313755
25985,18,37,14,11,13,0,93,38.260550507812404,-109.431106
25986,12,41,14,11,14,0,92,38.260550507812404,-109.4308365
25987,11,42,14,12,14,0,93,38.260550507812404,-109.430567
25988,9,44,14,12,14,0,93,38.260550507812404,-109.4302975
25989,9,45,14,12,14,0,94,38.260550507812404,-109.430028
25990,10,45,14,12,15,0,96,38.260550507812404,-109.4297586
25991,10,43,14,12,15,0,94,38.260550507812404,-109.4294891
25992,10,43,14,12,15,0,94,38.260550507812404,-109.4292196
25993,10,43,13,11,15,0,92,38.260550507812404,-109.4289501
25994,9,44,14,12,16,0,95,38.260550507812404,-109.4286806
25995,9,43,14,12,16,0,94,38.260550507812404,-109.4284111
25996,8,44,14,11,16,0,93,38.260550507812404,-109.4281416
25997,7,44,14,11,16,1,93,38.260550507812404,-109.4278721
25998,8,44,14,11,15,1,93,38.260550507812404,-109.4276026
25999,12,42,14,11,14,1,94,38.260550507812404,-109.4273331
26000,13,42,14,11,14,0,94,38.260550507812404,-109.4270636
26001,11,43,14,11,15,0,94,38.260550507812404,-109.4267941
26002,9,45,14,11,15,1,95,38.260550507812404,-109.4265246
26003,8,45,14,11,15,1,94,38.260550507812404,-109.4262551
26004,8,44,14,13,15,0,94,38.260550507812404,-109.4259856
26005,10,43,14,13,15,0,95,38.260550507812404,-109.4257161
26006,10,44,14,12,15,0,95,38.260550507812404,-109.4254466
26007,8,44,14,11,15,0,92,38.260550507812404,-109.4251771
26008,9,44,14,11,15,0,93,38.260550507812404,-109.4249077
26009,9,43,14,13,14,1,94,38.260550507812404,-109.4246382
26010,11,41,15,13,14,1,95,38.260550507812404,-109.4243687
26011,14,39,14,13,14,0,94,38.260550507812404,-109.4240992
26012,15,38,14,12,14,0,93,38.260550507812404,-109.4238297
26013,14,40,14,12,14,0,94,38.260550507812404,-109.4235602
26014,11,43,14,12,15,0,95,38.260550507812404,-109.4232907
26015,9,44,13,12,15,1,94,38.260550507812404,-109.4230212
26016,8,45,14,12,15,1,95,38.260550507812404,-109.4227517
26017,8,47,14,12,14,1,96,38.260550507812404,-109.4224822
26018,8,46,13,12,15,1,95,38.260550507812404,-109.4222127
26019,8,45,13,11,15,1,93,38.260550507812404,-109.4219432
26020,8,44,13,11,15,1,92,38.260550507812404,-109.4216737
26021,9,44,14,11,15,1,94,38.260550507812404,-109.4214042
26022,11,40,14,13,14,1,93,38.260550507812404,-109.4211347
26023,14,37,14,13,13,0,91,38.260550507812404,-109.4208652
26024,14,36,14,13,13,1,91,38.260550507812404,-109.4205957
26025,15,34,14,13,13,0,89,38.260550507812404,-109.4203262
26026,17,34,14,13,14,0,92,38.260550507812404,-109.4200568
26027,14,34,14,14,14,1,91,38.260550507812404,-109.4197873
26028,14,35,14,13,14,0,90,38.260550507812404,-109.4195178
26029,10,42,13,11,15,0,91,38.260550507812404,-109.4192483
26030,6,48,11,8,15,1,89,38.260550507812404,-109.4189788
26031,5,50,10,7,15,1,88,38.260550507812404,-109.4187093
26032,10,43,13,11,16,0,93,38.260550507812404,-109.4184398
26033,13,37,13,13,14,0,90,38.260550507812404,-109.4181703
26034,16,34,14,13,14,0,91,38.260550507812404,-109.4179008
26035,16,34,14,12,14,0,90,38.260550507812404,-109.4176313
26036,15,34,13,12,13,0,87,38.260550507812404,-109.4173618
26037,12,33,13,12,13,1,84,38.260550507812404,-109.4170923
26038,15,32,13,12,12,1,85,38.260550507812404,-109.4168228
26039,13,35,14,11,12,1,86,38.260550507812404,-109.4165533
26040,11,39,13,10,12,1,86,38.260550507812404,-109.4162838
26041,10,39,13,10,11,1,84,38.260550507812404,-109.4160143
26042,10,40,13,9,11,1,84,38.260550507812404,-109.4157448
26043,8,42,12,9,11,1,83,38.260550507812404,-109.4154753
26044,8,41,13,10,11,1,84,38.260550507812404,-109.4152058
26045,9,37,14,11,11,1,83,38.260550507812404,-109.4149364
26046,8,38,14,11,10,2,83,38.260550507812404,-109.4146669
26047,9,36,14,13,11,1,84,38.260550507812404,-109.4143974
26048,11,38,15,13,11,1,89,38.260550507812404,-109.4141279
26049,9,43,14,11,11,1,89,38.260550507812404,-109.4138584
26050,6,47,12,8,12,2,87,38.260550507812404,-109.4135889
26051,6,48,13,8,12,2,89,38.260550507812404,-109.4133194
26052,7,46,13,9,12,2,89,38.260550507812404,-109.4130499
26053,6,46,13,10,13,1,89,38.260550507812404,-109.4127804
26054,7,47,14,11,14,1,94,38.260550507812404,-109.4125109
26055,6,48,14,10,15,1,94,38.260550507812404,-109.4122414
26056,6,47,13,10,15,1,92,38.260550507812404,-109.4119719
26057,6,46,14,11,15,1,93,38.260550507812404,-109.4117024
26058,6,46,14,10,14,1,91,38.260550507812404,-109.4114329
26059,5,48,14,10,14,1,92,38.260550507812404,-109.4111634
26060,5,49,13,7,14,2,90,38.260550507812404,-109.4108939
26061,4,50,13,8,16,1,92,38.260550507812404,-109.4106244
26062,4,50,13,9,16,1,93,38.260550507812404,-109.4103549
26063,5,48,13,8,17,1,92,38.260550507812404,-109.4100855
26064,6,47,13,9,17,0,92,38.260550507812404,-109.409816
26065,6,47,13,9,16,0,91,38.260550507812404,-109.4095465
26066,6,46,13,9,16,0,90,38.260550507812404,-109.409277
26067,7,45,13,9,16,0,90,38.260550507812404,-109.4090075
26068,7,46,13,9,17,0,92,38.260550507812404,-109.408738
26069,5,47,13,8,17,1,91,38.260550507812404,-109.4084685
26070,5,47,13,7,17,0,89,38.260550507812404,-109.408199
26071,5,47,13,8,18,1,92,38.260550507812404,-109.4079295
26072,4,47,14,8,18,1,92,38.260550507812404,-109.40766
26073,4,46,13,5,18,3,89,38.260550507812404,-109.4073905
26074,3,46,12,4,17,5,87,38.260550507812404,-109.407121
26075,2,45,11,0,15,7,80,38.260550507812404,-109.4068515
26076,1,33,10,0,11,14,69,38.260550507812404,-109.3882564
26077,1,30,10,0,9,15,65,38.260550507812404,-109.3879869
26078,2,34,11,0,12,12,71,38.260550507812404,-109.3877174
26079,4,41,12,2,15,7,81,38.260550507812404,-109.3874479
26080,5,45,12,5,17,3,87,38.260550507812404,-109.3871784
26081,5,47,12,6,17,2,89,38.260550507812404,-109.3869089
26082,2,44,10,4,15,4,79,38.260550507812404,-109.3866394
26083,1,45,10,3,14,5,78,38.260550507812404,-109.3863699
26084,1,45,10,2,13,6,77,38.260550507812404,-109.3861004
26085,1,32,11,2,12,11,69,38.260550507812404,-109.3858309
26086,2,33,9,4,8,6,62,38.260550507812404,-109.3855614
26087,3,36,7,6,7,3,62,38.260550507812404,-109.3852919
26088,4,35,8,7,8,4,66,38.260550507812404,-109.3850225
26089,4,30,12,8,12,6,72,38.260550507812404,-109.384753
26090,4,26,11,4,9,10,64,38.260550507812404,-109.3844835
26091,1,31,11,1,14,9,67,38.260550507812404,-109.384214
26092,0,31,11,0,12,14,68,38.260550507812404,-109.3839445
26093,0,32,10,0,10,15,67,38.260550507812404,-109.383675
26094,1,32,10,0,11,14,68,38.260550507812404,-109.3834055
26095,2,38,12,0,13,12,77,38.260550507812404,-109.383136
26096,3,41,13,2,16,8,83,38.260550507812404,-109.3828665
26097,5,44,13,4,18,5,89,38.260550507812404,-109.382597
26098,6,45,13,5,19,2,90,38.260550507812404,-109.3823275
26099,6,45,13,6,20,1,91,38.260550507812404,-109.382058
26100,7,42,13,9,19,0,90,38.260550507812404,-109.3817885
26101,9,39,14,11,18,0,91,38.260550507812404,-109.381519
26102,12,36,14,13,16,0,91,38.260550507812404,-109.3812495
26103,16,34,14,15,15,0,94,38.260550507812404,-109.38098
26104,20,29,13,14,13,0,89,38.260550507812404,-109.3807105
26105,14,32,13,15,14,1,89,38.260550507812404,-109.380441
26106,8,38,14,14,16,0,90,38.260550507812404,-109.3801716
26107,6,43,14,11,17,0,91,38.260550507812404,-109.3799021
26108,6,45,13,7,17,1,89,38.260550507812404,-109.3796326
26109,4,42,11,5,15,4,81,38.260550507812404,-109.3793631
26110,5,30,10,7,12,5,69,38.260550507812404,-109.3790936
26111,6,21,10,8,10,5,60,38.260550507812404,-109.3788241
26112,10,21,10,6,10,5,62,38.260550507812404,-109.3785546
26113,6,34,11,6,13,5,75,38.260550507812404,-109.3782851
26114,4,41,11,3,16,4,79,38.260550507812404,-109.3780156
26115,3,42,10,2,16,4,77,38.260550507812404,-109.3777461
26116,3,40,10,3,16,5,77,38.260550507812404,-109.3774766
26117,3,40,11,4,18,4,80,38.260550507812404,-109.3772071
26118,3,43,10,1,14,7,78,38.260550507812404,-109.3769376
26119,8,38,11,5,15,4,81,38.260550507812404,-109.3766681
26120,10,38,13,7,16,3,87,38.260550507812404,-109.3763986
26121,7,39,12,5,16,5,84,38.260550507812404,-109.3761291
26122,2,38,11,1,13,9,74,38.260550507812404,-109.3758596
26123,1,44,9,0,14,8,76,38.260550507812404,-109.3755901
26124,1,40,10,0,12,10,73,38.260550507812404,-109.3753206
26125,1,36,10,1,10,8,66,38.260550507812404,-109.3750512
26126,3,33,9,2,8,8,63,38.260550507812404,-109.3747817
26127,2,35,8,3,6,6,60,38.260550507812404,-109.3745122
26128,2,30,9,2,7,8,58,38.260550507812404,-109.3742427
26129,2,28,10,2,7,9,58,38.260550507812404,-109.3739732
26130,3,26,9,6,9,8,61,38.260550507812404,-109.3737037
26131,1,30,10,3,10,10,64,38.260550507812404,-109.3734342
26132,1,28,10,0,9,14,62,38.260550507812404,-109.3731647
26133,4,30,11,1,11,10,67,38.260550507812404,-109.3728952
26134,3,33,11,0,10,12,69,38.260550507812404,-109.3726257
26135,2,37,10,0,9,13,71,38.260550507812404,-109.3723562
26136,2,38,10,0,9,13,72,38.260550507812404,-109.3720867
26137,2,38,10,0,11,12,73,38.260550507812404,-109.3718172
26138,1,39,10,0,11,11,72,38.260550507812404,-109.3715477
26139,1,37,10,1,11,10,70,38.260550507812404,-109.3712782
26140,2,36,10,1,11,11,71,38.260550507812404,-109.3710087
26141,2,34,11,0,9,14,70,38.260550507812404,-109.3707392
26142,1,36,10,0,9,14,70,38.260550507812404,-109.3704697
26143,1,39,10,0,10,12,72,38.260550507812404,-109.3702003
26144,1,40,10,0,10,12,73,38.260550507812404,-109.3699308
26145,1,39,10,0,10,12,72,38.260550507812404,-109.3696613
26146,2,35,10,0,10,13,70,38.260550507812404,-109.3693918
26147,2,34,11,0,7,16,70,38.260550507812404,-109.3691223
26148,2,33,11,0,7,17,70,38.260550507812404,-109.3688528
26149,1,35,10,0,9,14,69,38.260550507812404,-109.3685833
26150,1,42,9,0,11,11,74,38.260550507812404,-109.3683138
26151,1,40,9,0,11,11,72,38.260550507812404,-109.3680443
26152,1,35,10,0,9,13,68,38.260550507812404,-109.3677748
26153,1,32,10,1,8,12,64,38.260550507812404,-109.3675053
26154,3,29,10,4,7,7,60,38.260550507812404,-109.3672358
26155,4,25,10,6,7,7,59,38.260550507812404,-109.3669663
26156,2,23,11,3,7,11,57,38.260550507812404,-109.3666968
26157,2,23,11,3,7,12,58,38.260550507812404,-109.3664273
26158,2,21,11,4,7,14,59,38.260550507812404,-109.3661578
26159,2,22,12,6,8,14,64,38.260550507812404,-109.3658883
26160,1,28,13,6,13,14,75,38.260550507812404,-109.3656188
26161,0,29,14,6,14,13,76,38.260550507812404,-109.3653493
26162,0,27,13,6,13,14,73,38.260550507812404,-109.3650799
26163,0,25,13,5,9,16,68,38.260550507812404,-109.3648104
26164,1,25,13,5,8,18,70,38.260550507812404,-109.3645409
26165,0,24,15,0,3,30,72,38.260550507812404,-109.3642714
26166,0,25,14,0,5,26,70,38.260550507812404,-109.3640019
26167,1,26,14,0,6,23,70,38.260550507812404,-109.3637324
26168,1,28,14,0,8,20,71,38.260550507812404,-109.3634629
26169,2,28,14,1,7,20,72,38.260550507812404,-109.3631934
26170,2,29,15,1,7,19,73,38.260550507812404,-109.3629239
26171,0,25,14,0,5,25,69,38.260550507812404,-109.3626544
26172,0,25,13,0,4,24,66,38.260550507812404,-109.3623849
26173,0,25,13,0,5,20,63,38.260550507812404,-109.3621154
26174,1,23,13,0,4,20,61,38.260550507812404,-109.3618459
26175,1,26,13,0,4,23,67,38.260550507812404,-109.3615764
26176,1,27,13,0,6,21,68,38.260550507812404,-109.3613069
26177,1,26,13,1,7,17,65,38.260550507812404,-109.3610374
26178,1,26,12,1,5,15,60,38.260550507812404,-109.3607679
26179,2,24,11,1,5,13,56,38.260550507812404,-109.3604984
26180,2,22,12,1,4,18,59,38.260550507812404,-109.360229
26181,2,22,13,0,3,22,62,38.260550507812404,-109.3599595
26182,2,23,12,0,3,23,63,38.260550507812404,-109.35969
26183,0,27,10,0,5,19,61,38.260550507812404,-109.3594205
26184,0,41,9,0,12,9,71,38.260550507812404,-109.359151
26185,1,45,8,0,12,6,72,38.260550507812404,-109.3588815
26186,1,44,8,1,11,6,71,38.260550507812404,-109.358612
26187,0,38,9,0,12,9,68,38.260550507812404,-109.3583425
26188,1,30,10,0,10,12,63,38.260550507812404,-109.358073
26189,1,24,10,0,6,16,57,38.260550507812404,-109.3578035
26190,1,22,11,2,7,17,60,38.260550507812404,-109.357534
26191,1,26,12,1,9,16,65,38.260550507812404,-109.3572645
26192,0,29,11,0,9,19,68,38.260550507812404,-109.356995
26193,4,31,12,7,5,17,76,38.260550507812404,-109.3567255
26194,6,31,9,13,11,4,74,38.260550507812404,-109.356456
26195,6,33,9,16,10,2,76,38.260550507812404,-109.3561865
26196,2,35,9,9,13,4,72,38.260550507812404,-109.355917
26197,3,44,9,5,10,3,74,38.260550507812404,-109.3556475
26198,0,45,9,4,11,4,73,38.260550507812404,-109.355378
26199,2,45,8,5,10,4,74,38.260550507812404,-109.3551086
26200,3,45,6,5,10,4,73,38.260550507812404,-109.3548391
26201,2,50,7,5,10,3,77,38.260550507812404,-109.3545696
26202,2,58,7,5,11,1,84,38.260550507812404,-109.3543001
26203,1,56,6,4,10,2,79,38.260550507812404,-109.3540306
26204,4,50,7,5,9,4,79,38.260550507812404,-109.3537611
26205,2,54,8,5,10,4,83,38.260550507812404,-109.3534916
26206,2,50,7,5,9,3,76,38.260550507812404,-109.3532221
26207,2,48,9,5,10,5,79,38.260550507812404,-109.3529526
26208,2,44,9,5,10,6,76,38.260550507812404,-109.3526831
26209,2,41,9,4,10,7,73,38.260550507812404,-109.3524136
26210,1,46,8,3,8,6,72,38.260550507812404,-109.3521441
26211,4,42,7,6,9,3,71,38.260550507812404,-109.3518746
26212,5,25,11,9,7,8,65,38.260550507812404,-109.3516051
26213,9,26,13,12,8,9,77,38.260550507812404,-109.3513356
26214,4,16,13,3,4,18,58,38.260550507812404,-109.3510661
26215,2,17,15,0,1,26,61,38.260550507812404,-109.3507966
26216,2,15,16,1,1,27,62,38.260550507812404,-109.3505271
26217,3,16,16,1,1,27,64,38.260550507812404,-109.3502577
26218,3,16,17,3,2,24,65,38.260550507812404,-109.3499882
26219,2,16,16,1,2,26,63,38.260550507812404,-109.3497187
26220,3,18,17,0,1,27,66,38.260550507812404,-109.3494492
26221,0,20,16,0,3,28,67,38.260550507812404,-109.3491797
26222,0,21,18,0,2,31,72,38.260550507812404,-109.3489102
26223,1,21,19,0,2,32,75,38.260550507812404,-109.3486407
26224,1,18,18,0,1,33,71,38.260550507812404,-109.3483712
26225,2,17,18,0,0,32,69,38.260550507812404,-109.3481017
26226,1,19,17,0,1,30,68,38.260550507812404,-109.3478322
26227,1,18,18,0,2,33,72,38.260550507812404,-109.3475627
26228,1,19,18,0,2,34,74,38.260550507812404,-109.3472932
26229,1,21,18,0,2,34,76,38.260550507812404,-109.3470237
26230,1,25,18,0,4,30,78,38.260550507812404,-109.3467542
26231,1,24,18,0,4,31,78,38.260550507812404,-109.3464847
26232,0,22,19,0,4,33,78,38.260550507812404,-109.3462152
26233,1,21,20,1,4,33,80,38.260550507812404,-109.3459457
26234,3,20,19,3,4,31,80,38.260550507812404,-109.3456762
26235,2,22,19,1,2,32,78,38.260550507812404,-109.3454068
26236,2,23,19,0,2,31,77,38.260550507812404,-109.3451373
26237,1,20,18,0,1,32,72,38.260550507812404,-109.3448678
26238,1,19,18,0,0,31,69,38.260550507812404,-109.3445983
26239,1,20,17,0,0,30,68,38.260550507812404,-109.3443288
26240,1,20,18,0,0,31,70,38.260550507812404,-109.3440593
26241,1,22,18,0,1,33,75,38.260550507812404,-109.3437898
26242,1,22,18,0,3,32,76,38.260550507812404,-109.3435203
26243,1,25,18,0,5,32,81,38.260550507812404,-109.3432508
26244,1,28,18,1,7,30,85,38.260550507812404,-109.3429813
26245,2,29,18,2,8,27,86,38.260550507812404,-109.3427118
26246,3,30,17,3,10,23,86,38.260550507812404,-109.3424423
26247,4,30,16,6,13,16,85,38.260550507812404,-109.3421728
26248,5,29,15,11,15,10,85,38.260550507812404,-109.3419033
26249,5,29,16,9,14,13,86,38.260550507812404,-109.3416338
26250,3,30,18,3,9,23,86,38.260550507812404,-109.3413643
26251,1,26,19,2,5,31,84,38.260550507812404,-109.3410948
26252,1,22,20,1,5,35,84,38.260550507812404,-109.3408253
26253,1,20,21,0,5,38,85,38.260550507812404,-109.3405558
26254,1,21,21,0,5,37,85,38.260550507812404,-109.3402864
26255,1,19,21,2,5,38,86,38.260550507812404,-109.3400169
26256,1,17,21,3,6,37,85,38.260550507812404,-109.3397474
26257,1,17,21,2,6,37,84,38.260550507812404,-109.3394779
26258,1,19,21,0,5,41,87,38.260550507812404,-109.3392084
26259,1,18,22,0,5,39,85,38.260550507812404,-109.3389389
26260,1,17,22,1,6,39,86,38.260550507812404,-109.3386694
26261,1,17,21,2,5,38,84,38.260550507812404,-109.3383999
26262,2,17,21,4,6,33,83,38.260550507812404,-109.3381304
26263,0,20,21,1,5,36,83,38.260550507812404,-109.3378609
26264,1,20,17,0,2,30,70,38.260550507812404,-109.3375914
26265,1,24,14,2,3,22,66,38.260550507812404,-109.3373219
26266,2,33,11,2,7,16,71,38.260550507812404,-109.3370524
26267,1,37,11,1,8,15,73,38.260550507812404,-109.3367829
26268,2,30,12,2,8,16,70,38.260550507812404,-109.3365134
26269,2,21,15,2,4,23,67,38.260550507812404,-109.3362439
26270,1,20,17,0,3,29,70,38.260550507812404,-109.3359744
26271,0,20,18,0,3,32,73,38.260550507812404,-109.3357049
26272,1,21,17,1,5,28,73,38.260550507812404,-109.3354355
26273,0,23,18,1,7,30,79,38.260550507812404,-109.335166
26274,0,22,20,1,7,31,81,38.260550507812404,-109.3348965
26275,0,21,19,0,6,31,77,38.260550507812404,-109.334627
26276,1,19,17,0,4,28,69,38.260550507812404,-109.3343575
26277,2,20,14,3,4,22,65,38.260550507812404,-109.334088
26278,1,17,14,2,3,22,59,38.260550507812404,-109.3338185
26279,2,21,14,1,4,22,64,38.260550507812404,-109.333549
26280,2,28,13,0,6,21,70,38.260550507812404,-109.3332795
26281,3,47,11,2,14,7,84,38.260281013227164,-109.4432333
26282,3,46,10,1,13,7,80,38.260281013227164,-109.4429638
26283,3,46,10,1,13,7,80,38.260281013227164,-109.4426943
26284,3,49,11,2,16,5,86,38.260281013227164,-109.4424248
26285,3,49,10,1,16,5,84,38.260281013227164,-109.4421553
26286,3,47,10,3,15,5,83,38.260281013227164,-109.4418858
26287,3,42,10,3,13,6,77,38.260281013227164,-109.4416163
26288,3,34,9,2,8,10,66,38.260281013227164,-109.4413468
26289,7,38,8,5,10,3,71,38.260281013227164,-109.4410773
26290,2,37,8,3,8,7,65,38.260281013227164,-109.4408078
26291,3,36,8,3,10,5,65,38.260281013227164,-109.4405383
26292,5,37,8,5,9,4,68,38.260281013227164,-109.4402688
26293,3,37,9,2,7,8,66,38.260281013227164,-109.4399993
26294,4,39,10,3,13,6,75,38.260281013227164,-109.4397299
26295,3,44,9,4,14,4,78,38.260281013227164,-109.4394604
26296,3,48,9,4,12,3,79,38.260281013227164,-109.4391909
26297,2,47,9,3,12,5,78,38.260281013227164,-109.4389214
26298,2,40,10,3,14,7,76,38.260281013227164,-109.4386519
26299,2,43,10,2,14,6,77,38.260281013227164,-109.4383824
26300,2,42,10,2,14,7,77,38.260281013227164,-109.4381129
26301,2,36,10,2,12,9,71,38.260281013227164,-109.4378434
26302,2,30,9,2,8,11,62,38.260281013227164,-109.4375739
26303,2,39,8,0,10,9,68,38.260281013227164,-109.4373044
26304,1,41,9,1,12,7,71,38.260281013227164,-109.4370349
26305,2,42,10,2,15,6,77,38.260281013227164,-109.4367654
26306,3,41,11,5,17,5,82,38.260281013227164,-109.4364959
26307,5,42,12,5,15,6,85,38.260281013227164,-109.4362264
26308,7,43,13,9,15,2,89,38.260281013227164,-109.4359569
26309,11,42,13,12,14,0,92,38.260281013227164,-109.4356874
26310,11,41,13,13,14,0,92,38.260281013227164,-109.4354179
26311,10,43,13,12,14,0,92,38.260281013227164,-109.4351484
26312,9,43,13,14,13,0,92,38.260281013227164,-109.434879
26313,7,42,13,13,13,1,89,38.260281013227164,-109.4346095
26314,5,43,12,12,13,1,86,38.260281013227164,-109.43434
26315,5,44,13,12,14,1,89,38.260281013227164,-109.4340705
26316,5,44,14,14,14,1,92,38.260281013227164,-109.433801
26317,6,44,14,12,14,1,91,38.260281013227164,-109.4335315
26318,8,43,14,13,14,1,93,38.260281013227164,-109.433262
26319,9,42,14,12,14,1,92,38.260281013227164,-109.4329925
26320,9,43,14,12,14,1,93,38.260281013227164,-109.432723
26321,9,44,14,11,14,1,93,38.260281013227164,-109.4324535
26322,11,44,13,10,15,0,93,38.260281013227164,-109.432184
26323,14,42,13,10,14,0,93,38.260281013227164,-109.4319145
26324,17,39,14,10,13,0,93,38.260281013227164,-109.431645
26325,21,35,13,10,13,0,92,38.260281013227164,-109.4313755
26326,29,30,12,7,10,0,88,38.260281013227164,-109.431106
26327,21,35,13,10,13,0,92,38.260281013227164,-109.4308365
26328,13,41,14,12,14,0,94,38.260281013227164,-109.430567
26329,10,44,14,12,14,0,94,38.260281013227164,-109.4302975
26330,9,45,13,11,15,0,93,38.260281013227164,-109.430028
26331,9,44,14,12,15,0,94,38.260281013227164,-109.4297586
26332,11,41,14,12,14,0,92,38.260281013227164,-109.4294891
26333,13,41,14,11,14,0,93,38.260281013227164,-109.4292196
26334,11,43,13,10,14,1,92,38.260281013227164,-109.4289501
26335,10,44,14,11,15,0,94,38.260281013227164,-109.4286806
26336,11,42,14,11,15,0,93,38.260281013227164,-109.4284111
26337,7,45,14,11,16,0,93,38.260281013227164,-109.4281416
26338,5,46,14,10,17,1,93,38.260281013227164,-109.4278721
26339,6,45,14,10,16,1,92,38.260281013227164,-109.4276026
26340,9,43,14,11,15,1,93,38.260281013227164,-109.4273331
26341,11,43,13,10,14,1,92,38.260281013227164,-109.4270636
26342,8,45,14,10,15,1,93,38.260281013227164,-109.4267941
26343,7,46,14,11,15,1,94,38.260281013227164,-109.4265246
26344,7,46,14,12,15,1,95,38.260281013227164,-109.4262551
26345,8,45,14,13,15,0,95,38.260281013227164,-109.4259856
26346,10,44,14,13,14,0,95,38.260281013227164,-109.4257161
26347,11,43,14,13,14,0,95,38.260281013227164,-109.4254466
26348,10,43,14,13,15,0,95,38.260281013227164,-109.4251771
26349,9,44,14,12,15,1,95,38.260281013227164,-109.4249077
26350,10,43,14,12,14,1,94,38.260281013227164,-109.4246382
26351,12,40,14,12,15,0,93,38.260281013227164,-109.4243687
26352,16,37,14,12,15,0,94,38.260281013227164,-109.4240992
26353,16,37,14,11,15,0,93,38.260281013227164,-109.4238297
26354,13,39,14,12,15,0,93,38.260281013227164,-109.4235602
26355,11,42,14,12,14,1,94,38.260281013227164,-109.4232907
26356,9,45,14,12,14,1,95,38.260281013227164,-109.4230212
26357,8,46,14,12,14,1,95,38.260281013227164,-109.4227517
26358,9,46,14,13,13,1,96,38.260281013227164,-109.4224822
26359,9,46,13,12,13,1,94,38.260281013227164,-109.4222127
26360,8,47,13,10,15,1,94,38.260281013227164,-109.4219432
26361,8,45,13,11,14,1,92,38.260281013227164,-109.4216737
26362,11,43,14,12,14,1,95,38.260281013227164,-109.4214042
26363,15,37,14,13,14,0,93,38.260281013227164,-109.4211347
26364,14,36,14,13,13,0,90,38.260281013227164,-109.4208652
26365,11,38,13,12,14,1,89,38.260281013227164,-109.4205957
26366,12,37,13,13,14,1,90,38.260281013227164,-109.4203262
26367,16,35,14,13,13,0,91,38.260281013227164,-109.4200568
26368,14,36,14,14,14,0,92,38.260281013227164,-109.4197873
26369,12,39,14,13,14,0,92,38.260281013227164,-109.4195178
26370,7,45,12,10,15,1,90,38.260281013227164,-109.4192483
26371,6,48,11,10,14,1,90,38.260281013227164,-109.4189788
26372,6,47,12,10,14,1,90,38.260281013227164,-109.4187093
26373,10,42,13,12,14,1,92,38.260281013227164,-109.4184398
26374,14,36,14,13,14,0,91,38.260281013227164,-109.4181703
26375,18,33,14,13,13,0,91,38.260281013227164,-109.4179008
26376,20,31,14,12,13,0,90,38.260281013227164,-109.4176313
26377,18,31,14,13,13,0,89,38.260281013227164,-109.4173618
26378,17,33,14,12,13,0,89,38.260281013227164,-109.4170923
26379,17,33,14,13,12,0,89,38.260281013227164,-109.4168228
26380,16,34,15,13,12,0,90,38.260281013227164,-109.4165533
26381,13,36,15,13,12,1,90,38.260281013227164,-109.4162838
26382,9,37,14,12,11,1,84,38.260281013227164,-109.4160143
26383,7,39,13,11,11,1,82,38.260281013227164,-109.4157448
26384,7,37,13,10,11,2,80,38.260281013227164,-109.4154753
26385,8,35,13,10,11,2,79,38.260281013227164,-109.4152058
26386,13,33,14,13,11,1,85,38.260281013227164,-109.4149364
26387,13,34,16,16,11,1,91,38.260281013227164,-109.4146669
26388,13,34,16,16,11,1,91,38.260281013227164,-109.4143974
26389,13,37,16,14,11,1,92,38.260281013227164,-109.4141279
26390,10,44,14,11,11,1,91,38.260281013227164,-109.4138584
26391,7,49,13,10,12,1,92,38.260281013227164,-109.4135889
26392,7,50,13,8,13,1,92,38.260281013227164,-109.4133194
26393,5,49,13,8,14,1,90,38.260281013227164,-109.4130499
26394,5,49,13,8,14,1,90,38.260281013227164,-109.4127804
26395,6,49,14,10,14,0,93,38.260281013227164,-109.4125109
26396,6,49,14,9,15,0,93,38.260281013227164,-109.4122414
26397,6,49,14,10,16,0,95,38.260281013227164,-109.4119719
26398,7,48,14,10,16,0,95,38.260281013227164,-109.4117024
26399,6,48,13,9,15,1,92,38.260281013227164,-109.4114329
26400,5,48,13,8,13,2,89,38.260281013227164,-109.4111634
26401,5,46,12,7,12,3,85,38.260281013227164,-109.4108939
26402,5,47,13,8,13,3,89,38.260281013227164,-109.4106244
26403,5,49,13,8,14,2,91,38.260281013227164,-109.4103549
26404,5,50,13,7,15,2,92,38.260281013227164,-109.4100855
26405,5,49,13,8,16,1,92,38.260281013227164,-109.409816
26406,5,49,13,8,16,1,92,38.260281013227164,-109.4095465
26407,5,49,13,9,16,1,93,38.260281013227164,-109.409277
26408,5,48,13,9,16,1,92,38.260281013227164,-109.4090075
26409,6,49,13,8,15,1,92,38.260281013227164,-109.408738
26410,5,49,13,8,16,1,92,38.260281013227164,-109.4084685
26411,4,49,13,7,17,1,91,38.260281013227164,-109.408199
26412,4,49,13,6,18,1,91,38.260281013227164,-109.4079295
26413,4,48,13,6,18,2,91,38.260281013227164,-109.40766
26414,4,46,12,4,16,4,86,38.260281013227164,-109.4073905
26415,3,45,11,3,16,6,84,38.260281013227164,-109.407121
26416,1,46,10,0,14,8,79,38.260281013227164,-109.4068515
26417,1,33,10,0,11,14,69,38.260281013227164,-109.3882564
26418,1,30,10,0,10,14,65,38.260281013227164,-109.3879869
26419,2,33,11,1,12,11,70,38.260281013227164,-109.3877174
26420,4,38,11,3,14,6,76,38.260281013227164,-109.3874479
26421,4,44,11,6,16,2,83,38.260281013227164,-109.3871784
26422,3,44,11,6,15,2,81,38.260281013227164,-109.3869089
26423,2,44,10,4,14,5,79,38.260281013227164,-109.3866394
26424,1,41,10,3,14,6,75,38.260281013227164,-109.3863699
26425,1,37,11,1,13,9,72,38.260281013227164,-109.3861004
26426,0,29,11,1,9,14,64,38.260281013227164,-109.3858309
26427,2,33,9,4,7,8,63,38.260281013227164,-109.3855614
26428,4,37,8,5,7,4,65,38.260281013227164,-109.3852919
26429,6,34,10,7,9,3,69,38.260281013227164,-109.3850225
26430,1,32,12,5,11,11,72,38.260281013227164,-109.384753
26431,0,30,12,0,9,17,68,38.260281013227164,-109.3844835
26432,0,31,11,0,10,16,68,38.260281013227164,-109.384214
26433,1,34,10,0,12,13,70,38.260281013227164,-109.3839445
26434,1,36,10,0,14,10,71,38.260281013227164,-109.383675
26435,1,38,10,0,15,8,72,38.260281013227164,-109.3834055
26436,3,41,12,1,16,8,81,38.260281013227164,-109.383136
26437,4,44,13,4,18,5,88,38.260281013227164,-109.3828665
26438,4,45,13,5,19,3,89,38.260281013227164,-109.382597
26439,5,45,13,6,19,2,90,38.260281013227164,-109.3823275
26440,5,44,13,6,19,1,88,38.260281013227164,-109.382058
26441,5,44,13,8,20,1,91,38.260281013227164,-109.3817885
26442,6,42,14,10,19,0,91,38.260281013227164,-109.381519
26443,9,39,14,11,18,0,91,38.260281013227164,-109.3812495
26444,12,36,13,13,16,0,90,38.260281013227164,-109.38098
26445,14,32,13,16,14,0,89,38.260281013227164,-109.3807105
26446,9,41,14,13,16,0,93,38.260281013227164,-109.380441
26447,6,46,14,9,17,0,92,38.260281013227164,-109.3801716
26448,5,48,13,7,18,1,92,38.260281013227164,-109.3799021
26449,4,47,12,5,17,1,86,38.260281013227164,-109.3796326
26450,3,38,11,5,14,5,76,38.260281013227164,-109.3793631
26451,4,25,10,8,11,5,63,38.260281013227164,-109.3790936
26452,6,20,10,7,10,5,58,38.260281013227164,-109.3788241
26453,7,26,10,6,10,5,64,38.260281013227164,-109.3785546
26454,6,39,11,6,16,3,81,38.260281013227164,-109.3782851
26455,5,40,11,5,15,3,79,38.260281013227164,-109.3780156
26456,4,39,11,4,16,4,78,38.260281013227164,-109.3777461
26457,4,39,11,4,16,4,78,38.260281013227164,-109.3774766
26458,3,42,11,4,15,4,79,38.260281013227164,-109.3772071
26459,3,43,11,3,16,4,80,38.260281013227164,-109.3769376
26460,5,39,11,5,17,3,80,38.260281013227164,-109.3766681
26461,5,40,12,6,18,3,84,38.260281013227164,-109.3763986
26462,4,39,12,5,17,4,81,38.260281013227164,-109.3761291
26463,1,34,11,3,12,9,70,38.260281013227164,-109.3758596
26464,1,36,10,1,10,10,68,38.260281013227164,-109.3755901
26465,1,34,10,2,9,10,66,38.260281013227164,-109.3753206
26466,3,33,10,2,7,8,63,38.260281013227164,-109.3750512
26467,3,34,10,4,7,7,65,38.260281013227164,-109.3747817
26468,3,37,9,4,7,5,65,38.260281013227164,-109.3745122
26469,2,29,12,3,6,13,65,38.260281013227164,-109.3742427
26470,2,26,10,4,9,10,61,38.260281013227164,-109.3739732
26471,2,28,9,5,9,8,61,38.260281013227164,-109.3737037
26472,0,39,8,3,10,7,67,38.260281013227164,-109.3734342
26473,2,43,8,1,14,4,72,38.260281013227164,-109.3731647
26474,2,38,10,2,15,6,73,38.260281013227164,-109.3728952
26475,2,40,10,0,13,9,74,38.260281013227164,-109.3726257
26476,2,38,10,0,11,11,72,38.260281013227164,-109.3723562
26477,2,35,10,1,8,12,68,38.260281013227164,-109.3720867
26478,2,31,10,2,8,12,65,38.260281013227164,-109.3718172
26479,2,33,10,2,10,10,67,38.260281013227164,-109.3715477
26480,2,30,10,2,8,11,63,38.260281013227164,-109.3712782
26481,2,27,11,2,6,14,62,38.260281013227164,-109.3710087
26482,2,29,11,1,6,16,65,38.260281013227164,-109.3707392
26483,2,34,10,0,8,14,68,38.260281013227164,-109.3704697
26484,2,35,10,0,8,13,68,38.260281013227164,-109.3702003
26485,2,35,10,0,8,14,69,38.260281013227164,-109.3699308
26486,1,34,10,0,9,13,67,38.260281013227164,-109.3696613
26487,2,35,11,0,9,13,70,38.260281013227164,-109.3693918
26488,2,33,10,0,7,16,68,38.260281013227164,-109.3691223
26489,2,35,11,0,8,15,71,38.260281013227164,-109.3688528
26490,1,36,10,0,9,14,70,38.260281013227164,-109.3685833
26491,1,37,9,0,8,14,69,38.260281013227164,-109.3683138
26492,2,35,10,2,9,8,66,38.260281013227164,-109.3680443
26493,1,31,10,2,7,10,61,38.260281013227164,-109.3677748
26494,2,29,10,3,7,8,59,38.260281013227164,-109.3675053
26495,4,31,10,4,6,7,62,38.260281013227164,-109.3672358
26496,3,27,11,5,9,9,64,38.260281013227164,-109.3669663
26497,1,26,12,3,7,17,66,38.260281013227164,-109.3666968
26498,0,27,13,2,8,21,71,38.260281013227164,-109.3664273
26499,1,28,15,4,10,20,78,38.260281013227164,-109.3661578
26500,1,28,15,2,9,22,77,38.260281013227164,-109.3658883
26501,1,28,16,2,9,24,80,38.260281013227164,-109.3656188
26502,0,27,16,1,8,25,77,38.260281013227164,-109.3653493
26503,0,28,14,0,9,22,73,38.260281013227164,-109.3650799
26504,0,30,12,1,7,19,69,38.260281013227164,-109.3648104
26505,1,30,12,4,7,16,70,38.260281013227164,-109.3645409
26506,0,26,13,2,5,21,67,38.260281013227164,-109.3642714
26507,0,26,13,1,5,21,66,38.260281013227164,-109.3640019
26508,0,27,13,0,6,22,68,38.260281013227164,-109.3637324
26509,0,26,14,0,5,25,70,38.260281013227164,-109.3634629
26510,0,24,16,0,4,30,74,38.260281013227164,-109.3631934
26511,0,25,17,0,7,27,76,38.260281013227164,-109.3629239
26512,0,23,16,0,5,29,73,38.260281013227164,-109.3626544
26513,1,24,15,0,4,26,70,38.260281013227164,-109.3623849
26514,1,26,14,0,5,23,69,38.260281013227164,-109.3621154
26515,1,29,12,0,6,20,68,38.260281013227164,-109.3618459
26516,1,27,12,0,6,20,66,38.260281013227164,-109.3615764
26517,1,29,11,0,7,17,65,38.260281013227164,-109.3613069
26518,1,29,11,2,7,13,63,38.260281013227164,-109.3610374
26519,2,29,11,2,7,11,62,38.260281013227164,-109.3607679
26520,1,26,11,2,6,15,61,38.260281013227164,-109.3604984
26521,1,24,12,2,6,16,61,38.260281013227164,-109.360229
26522,2,24,12,2,6,18,64,38.260281013227164,-109.3599595
26523,1,24,13,2,6,19,65,38.260281013227164,-109.35969
26524,0,27,11,1,7,17,63,38.260281013227164,-109.3594205
26525,1,34,10,0,10,13,68,38.260281013227164,-109.359151
26526,0,39,9,0,11,11,70,38.260281013227164,-109.3588815
26527,1,39,9,0,12,9,70,38.260281013227164,-109.358612
26528,1,33,10,1,12,10,67,38.260281013227164,-109.3583425
26529,1,30,10,0,10,15,66,38.260281013227164,-109.358073
26530,1,27,12,0,6,22,68,38.260281013227164,-109.3578035
26531,1,25,11,0,6,19,62,38.260281013227164,-109.357534
26532,1,33,10,0,11,12,67,38.260281013227164,-109.3572645
26533,1,41,10,0,12,9,73,38.260281013227164,-109.356995
26534,1,48,10,0,14,5,78,38.260281013227164,-109.3567255
26535,1,35,10,17,15,0,78,38.260281013227164,-109.356456
26536,2,32,7,11,11,2,65,38.260281013227164,-109.3561865
26537,2,39,10,4,10,6,71,38.260281013227164,-109.355917
26538,1,45,9,4,11,5,75,38.260281013227164,-109.3556475
26539,1,39,9,3,10,8,70,38.260281013227164,-109.355378
26540,0,42,9,1,11,7,70,38.260281013227164,-109.3551086
26541,2,44,9,4,11,6,76,38.260281013227164,-109.3548391
26542,3,47,9,6,11,4,80,38.260281013227164,-109.3545696
26543,2,50,9,4,12,3,80,38.260281013227164,-109.3543001
26544,1,42,10,4,11,6,74,38.260281013227164,-109.3540306
26545,0,45,9,2,11,5,72,38.260281013227164,-109.3537611
26546,2,47,11,5,12,3,80,38.260281013227164,-109.3534916
26547,5,40,12,12,9,7,85,38.260281013227164,-109.3532221
26548,7,32,11,13,10,7,80,38.260281013227164,-109.3529526
26549,7,32,10,11,10,6,76,38.260281013227164,-109.3526831
26550,6,33,10,11,10,5,75,38.260281013227164,-109.3524136
26551,3,30,10,5,8,9,65,38.260281013227164,-109.3521441
26552,3,28,10,5,11,6,63,38.260281013227164,-109.3518746
26553,6,27,11,11,6,7,68,38.260281013227164,-109.3516051
26554,10,27,12,14,7,6,76,38.260281013227164,-109.3513356
26555,8,10,10,7,10,7,52,38.260281013227164,-109.3510661
26556,3,14,12,3,3,16,51,38.260281013227164,-109.3507966
26557,2,13,14,2,2,21,54,38.260281013227164,-109.3505271
26558,2,13,15,1,1,23,55,38.260281013227164,-109.3502577
26559,2,15,15,0,2,24,58,38.260281013227164,-109.3499882
26560,2,18,17,0,3,28,68,38.260281013227164,-109.3497187
26561,0,20,19,0,3,32,74,38.260281013227164,-109.3494492
26562,0,21,18,0,3,31,73,38.260281013227164,-109.3491797
26563,0,22,19,0,3,32,76,38.260281013227164,-109.3489102
26564,1,22,19,0,3,31,76,38.260281013227164,-109.3486407
26565,1,22,19,0,3,31,76,38.260281013227164,-109.3483712
26566,1,22,18,0,2,31,74,38.260281013227164,-109.3481017
26567,1,23,18,0,4,30,76,38.260281013227164,-109.3478322
26568,0,21,19,0,3,33,76,38.260281013227164,-109.3475627
26569,0,22,20,0,3,34,79,38.260281013227164,-109.3472932
26570,1,23,19,0,3,32,78,38.260281013227164,-109.3470237
26571,1,25,18,0,4,29,77,38.260281013227164,-109.3467542
26572,1,24,18,0,4,31,78,38.260281013227164,-109.3464847
26573,0,22,19,0,4,34,79,38.260281013227164,-109.3462152
26574,1,21,20,0,5,34,81,38.260281013227164,-109.3459457
26575,2,21,20,2,4,32,81,38.260281013227164,-109.3456762
26576,1,22,20,1,3,33,80,38.260281013227164,-109.3454068
26577,1,20,19,0,3,33,76,38.260281013227164,-109.3451373
26578,1,22,18,0,2,31,74,38.260281013227164,-109.3448678
26579,1,23,18,0,2,29,73,38.260281013227164,-109.3445983
26580,1,24,16,0,2,27,70,38.260281013227164,-109.3443288
26581,2,24,17,0,2,26,71,38.260281013227164,-109.3440593
26582,1,23,17,0,3,29,73,38.260281013227164,-109.3437898
26583,1,24,18,0,5,31,79,38.260281013227164,-109.3435203
26584,1,26,18,1,6,31,83,38.260281013227164,-109.3432508
26585,2,27,18,1,8,28,84,38.260281013227164,-109.3429813
26586,2,29,17,3,8,24,83,38.260281013227164,-109.3427118
26587,3,31,16,5,11,19,85,38.260281013227164,-109.3424423
26588,4,31,16,7,13,13,84,38.260281013227164,-109.3421728
26589,4,31,15,9,15,11,85,38.260281013227164,-109.3419033
26590,4,31,16,6,14,14,85,38.260281013227164,-109.3416338
26591,2,29,18,2,8,27,86,38.260281013227164,-109.3413643
26592,0,24,20,0,5,34,83,38.260281013227164,-109.3410948
26593,0,20,21,0,5,37,83,38.260281013227164,-109.3408253
26594,1,17,22,0,5,40,85,38.260281013227164,-109.3405558
26595,1,17,21,1,5,41,86,38.260281013227164,-109.3402864
26596,1,20,20,2,6,35,84,38.260281013227164,-109.3400169
26597,0,23,20,1,6,33,83,38.260281013227164,-109.3397474
26598,0,23,21,0,4,35,83,38.260281013227164,-109.3394779
26599,1,21,21,1,4,36,84,38.260281013227164,-109.3392084
26600,1,18,21,2,5,36,83,38.260281013227164,-109.3389389
26601,1,18,21,3,6,36,85,38.260281013227164,-109.3386694
26602,1,20,20,2,7,35,85,38.260281013227164,-109.3383999
26603,1,22,19,1,6,34,83,38.260281013227164,-109.3381304
26604,1,18,17,1,2,30,69,38.260281013227164,-109.3378609
26605,2,23,11,3,7,16,62,38.260281013227164,-109.3375914
26606,1,29,9,2,10,9,60,38.260281013227164,-109.3373219
26607,1,34,8,1,10,7,61,38.260281013227164,-109.3370524
26608,1,32,9,2,10,8,62,38.260281013227164,-109.3367829
26609,1,26,11,3,7,16,64,38.260281013227164,-109.3365134
26610,2,19,15,2,4,22,64,38.260281013227164,-109.3362439
26611,1,22,17,1,5,29,75,38.260281013227164,-109.3359744
26612,1,23,20,1,6,33,84,38.260281013227164,-109.3357049
26613,1,23,20,1,6,34,85,38.260281013227164,-109.3354355
26614,1,21,20,2,8,32,84,38.260281013227164,-109.335166
26615,1,19,20,3,8,31,82,38.260281013227164,-109.3348965
26616,0,22,20,2,8,30,82,38.260281013227164,-109.334627
26617,1,22,17,1,5,27,73,38.260281013227164,-109.3343575
26618,2,20,15,4,4,21,66,38.260281013227164,-109.334088
26619,1,17,14,3,4,22,61,38.260281013227164,-109.3338185
26620,1,21,14,1,5,23,65,38.260281013227164,-109.333549
26621,2,27,15,0,7,23,74,38.260281013227164,-109.3332795
26622,4,50,11,4,15,4,88,38.26001151864193,-109.4432333
26623,3,48,11,4,15,4,85,38.26001151864193,-109.4429638
26624,4,49,11,5,15,4,88,38.26001151864193,-109.4426943
26625,4,48,11,2,14,6,85,38.26001151864193,-109.4424248
26626,3,52,11,1,14,6,87,38.26001151864193,-109.4421553
26627,3,50,11,4,14,4,86,38.26001151864193,-109.4418858
26628,3,46,11,3,13,6,82,38.26001151864193,-109.4416163
26629,4,40,10,2,12,8,76,38.26001151864193,-109.4413468
26630,2,32,10,4,9,10,67,38.26001151864193,-109.4410773
26631,2,37,10,1,9,11,70,38.26001151864193,-109.4408078
26632,2,38,10,3,12,7,72,38.26001151864193,-109.4405383
26633,2,36,9,3,11,8,69,38.26001151864193,-109.4402688
26634,3,34,11,1,11,10,70,38.26001151864193,-109.4399993
26635,2,31,10,6,12,7,68,38.26001151864193,-109.4397299
26636,4,39,9,5,11,5,73,38.26001151864193,-109.4394604
26637,3,39,8,4,11,4,69,38.26001151864193,-109.4391909
26638,2,37,8,2,8,8,65,38.26001151864193,-109.4389214
26639,2,36,9,2,10,9,68,38.26001151864193,-109.4386519
26640,3,39,9,4,13,5,73,38.26001151864193,-109.4383824
26641,2,42,10,3,12,6,75,38.26001151864193,-109.4381129
26642,2,42,9,2,11,7,73,38.26001151864193,-109.4378434
26643,3,40,8,3,9,6,69,38.26001151864193,-109.4375739
26644,2,41,8,2,9,8,70,38.26001151864193,-109.4373044
26645,1,35,9,2,10,10,67,38.26001151864193,-109.4370349
26646,1,33,10,2,11,10,67,38.26001151864193,-109.4367654
26647,3,36,10,2,13,7,71,38.26001151864193,-109.4364959
26648,3,41,11,3,15,6,79,38.26001151864193,-109.4362264
26649,7,46,12,9,14,2,90,38.26001151864193,-109.4359569
26650,9,46,13,11,14,1,94,38.26001151864193,-109.4356874
26651,9,45,13,11,14,0,92,38.26001151864193,-109.4354179
26652,8,44,13,13,13,1,92,38.26001151864193,-109.4351484
26653,9,43,13,14,13,1,93,38.26001151864193,-109.434879
26654,8,43,13,13,14,1,92,38.26001151864193,-109.4346095
26655,6,43,13,13,14,1,90,38.26001151864193,-109.43434
26656,6,42,13,13,14,1,89,38.26001151864193,-109.4340705
26657,6,43,14,13,14,1,91,38.26001151864193,-109.433801
26658,6,45,14,13,14,0,92,38.26001151864193,-109.4335315
26659,9,44,14,13,14,0,94,38.26001151864193,-109.433262
26660,8,44,14,11,14,1,92,38.26001151864193,-109.4329925
26661,8,45,14,11,15,1,94,38.26001151864193,-109.432723
26662,8,44,14,12,14,1,93,38.26001151864193,-109.4324535
26663,12,40,14,12,14,0,92,38.26001151864193,-109.432184
26664,19,36,13,10,13,0,91,38.26001151864193,-109.4319145
26665,26,33,13,8,12,0,92,38.26001151864193,-109.431645
26666,28,32,13,8,11,0,92,38.26001151864193,-109.4313755
26667,32,29,12,7,9,0,89,38.26001151864193,-109.431106
26668,27,31,13,9,11,0,91,38.26001151864193,-109.4308365
26669,13,39,14,12,14,0,92,38.26001151864193,-109.430567
26670,9,45,14,12,14,0,94,38.26001151864193,-109.4302975
26671,8,47,13,10,14,1,93,38.26001151864193,-109.430028
26672,10,45,13,10,14,1,93,38.26001151864193,-109.4297586
26673,18,36,14,10,13,0,91,38.26001151864193,-109.4294891
26674,20,35,13,10,12,0,90,38.26001151864193,-109.4292196
26675,17,38,13,10,13,0,91,38.26001151864193,-109.4289501
26676,13,41,13,11,14,0,92,38.26001151864193,-109.4286806
26677,13,41,13,11,15,0,93,38.26001151864193,-109.4284111
26678,7,44,14,11,16,0,92,38.26001151864193,-109.4281416
26679,6,45,14,11,17,0,93,38.26001151864193,-109.4278721
26680,7,45,14,11,16,0,93,38.26001151864193,-109.4276026
26681,10,42,14,11,16,0,93,38.26001151864193,-109.4273331
26682,13,40,13,11,15,0,92,38.26001151864193,-109.4270636
26683,10,43,14,12,15,0,94,38.26001151864193,-109.4267941
26684,7,47,14,11,15,1,95,38.26001151864193,-109.4265246
26685,7,49,13,11,14,1,95,38.26001151864193,-109.4262551
26686,8,48,14,11,15,0,96,38.26001151864193,-109.4259856
26687,9,44,14,12,14,0,93,38.26001151864193,-109.4257161
26688,11,42,14,12,15,0,94,38.26001151864193,-109.4254466
26689,10,42,14,12,16,0,94,38.26001151864193,-109.4251771
26690,8,45,13,11,15,1,93,38.26001151864193,-109.4249077
26691,9,43,14,11,15,1,93,38.26001151864193,-109.4246382
26692,10,41,14,11,16,1,93,38.26001151864193,-109.4243687
26693,12,39,14,11,16,0,92,38.26001151864193,-109.4240992
26694,13,38,14,12,16,0,93,38.26001151864193,-109.4238297
26695,11,41,14,12,15,1,94,38.26001151864193,-109.4235602
26696,10,43,14,12,15,0,94,38.26001151864193,-109.4232907
26697,10,44,14,12,14,0,94,38.26001151864193,-109.4230212
26698,9,45,14,13,14,0,95,38.26001151864193,-109.4227517
26699,8,46,14,13,14,0,95,38.26001151864193,-109.4224822
26700,8,48,13,11,14,1,95,38.26001151864193,-109.4222127
26701,7,48,13,10,15,1,94,38.26001151864193,-109.4219432
26702,10,44,13,11,14,1,93,38.26001151864193,-109.4216737
26703,15,39,14,12,14,0,94,38.26001151864193,-109.4214042
26704,16,37,14,12,14,0,93,38.26001151864193,-109.4211347
26705,12,40,14,12,14,0,92,38.26001151864193,-109.4208652
26706,8,44,13,12,15,1,93,38.26001151864193,-109.4205957
26707,9,43,13,12,15,0,92,38.26001151864193,-109.4203262
26708,12,41,14,12,14,0,93,38.26001151864193,-109.4200568
26709,10,38,13,12,15,1,89,38.26001151864193,-109.4197873
26710,8,41,12,11,15,1,88,38.26001151864193,-109.4195178
26711,8,46,11,10,14,0,89,38.26001151864193,-109.4192483
26712,8,45,12,10,14,0,89,38.26001151864193,-109.4189788
26713,11,42,13,12,14,0,92,38.26001151864193,-109.4187093
26714,14,37,14,13,13,0,91,38.26001151864193,-109.4184398
26715,16,34,14,13,14,0,91,38.26001151864193,-109.4181703
26716,18,31,14,13,14,0,90,38.26001151864193,-109.4179008
26717,17,31,14,13,14,1,90,38.26001151864193,-109.4176313
26718,16,31,14,13,14,1,89,38.26001151864193,-109.4173618
26719,16,31,14,13,14,1,89,38.26001151864193,-109.4170923
26720,18,32,14,13,14,0,91,38.26001151864193,-109.4168228
26721,17,32,14,14,13,0,90,38.26001151864193,-109.4165533
26722,15,33,15,14,13,0,90,38.26001151864193,-109.4162838
26723,12,33,14,13,12,1,85,38.26001151864193,-109.4160143
26724,13,35,15,13,11,1,88,38.26001151864193,-109.4157448
26725,12,34,14,13,11,1,85,38.26001151864193,-109.4154753
26726,12,33,15,14,11,1,86,38.26001151864193,-109.4152058
26727,12,33,15,15,11,1,87,38.26001151864193,-109.4149364
26728,12,35,15,15,11,1,89,38.26001151864193,-109.4146669
26729,11,36,15,15,12,1,90,38.26001151864193,-109.4143974
26730,14,37,15,14,12,1,93,38.26001151864193,-109.4141279
26731,14,38,15,13,12,1,93,38.26001151864193,-109.4138584
26732,10,43,14,13,12,1,93,38.26001151864193,-109.4135889
26733,7,48,13,9,14,1,92,38.26001151864193,-109.4133194
26734,6,49,13,9,16,0,93,38.26001151864193,-109.4130499
26735,5,49,13,9,15,0,91,38.26001151864193,-109.4127804
26736,5,49,13,10,15,1,93,38.26001151864193,-109.4125109
26737,4,51,13,9,15,0,92,38.26001151864193,-109.4122414
26738,5,51,13,7,16,1,93,38.26001151864193,-109.4119719
26739,5,52,13,7,16,1,94,38.26001151864193,-109.4117024
26740,5,51,13,7,16,1,93,38.26001151864193,-109.4114329
26741,5,49,13,7,14,2,90,38.26001151864193,-109.4111634
26742,5,44,13,8,13,3,86,38.26001151864193,-109.4108939
26743,5,43,13,9,14,2,86,38.26001151864193,-109.4106244
26744,5,46,13,9,13,2,88,38.26001151864193,-109.4103549
26745,5,48,13,7,13,2,88,38.26001151864193,-109.4100855
26746,5,48,13,7,16,1,90,38.26001151864193,-109.409816
26747,5,50,13,7,16,0,91,38.26001151864193,-109.4095465
26748,5,49,13,9,16,0,92,38.26001151864193,-109.409277
26749,5,48,14,9,16,1,93,38.26001151864193,-109.4090075
26750,5,48,14,10,16,0,93,38.26001151864193,-109.408738
26751,5,50,13,8,16,0,92,38.26001151864193,-109.4084685
26752,4,52,12,5,16,1,90,38.26001151864193,-109.408199
26753,4,53,12,5,16,1,91,38.26001151864193,-109.4079295
26754,4,52,12,4,16,3,91,38.26001151864193,-109.40766
26755,3,49,11,3,14,5,85,38.26001151864193,-109.4073905
26756,3,46,11,3,15,5,83,38.26001151864193,-109.407121
26757,1,45,10,0,13,9,78,38.26001151864193,-109.4068515
26758,1,32,10,0,9,15,67,38.26001151864193,-109.3882564
26759,2,33,10,0,11,12,68,38.26001151864193,-109.3879869
26760,3,37,10,2,14,8,74,38.26001151864193,-109.3877174
26761,3,43,10,4,16,3,79,38.26001151864193,-109.3874479
26762,3,46,10,6,14,2,81,38.26001151864193,-109.3871784
26763,2,45,10,4,15,4,80,38.26001151864193,-109.3869089
26764,2,44,10,4,15,4,79,38.26001151864193,-109.3866394
26765,2,40,10,4,13,5,74,38.26001151864193,-109.3863699
26766,2,36,10,3,12,7,70,38.26001151864193,-109.3861004
26767,2,35,10,2,11,9,69,38.26001151864193,-109.3858309
26768,1,33,10,1,9,10,64,38.26001151864193,-109.3855614
26769,2,34,10,3,9,8,66,38.26001151864193,-109.3852919
26770,2,35,11,2,13,8,71,38.26001151864193,-109.3850225
26771,1,32,12,1,10,14,70,38.26001151864193,-109.384753
26772,1,35,12,2,13,13,76,38.26001151864193,-109.3844835
26773,0,32,11,0,11,15,69,38.26001151864193,-109.384214
26774,1,35,10,0,12,13,71,38.26001151864193,-109.3839445
26775,1,42,9,0,15,7,74,38.26001151864193,-109.383675
26776,2,43,9,0,14,6,74,38.26001151864193,-109.3834055
26777,3,41,11,2,16,7,80,38.26001151864193,-109.383136
26778,4,44,12,3,17,6,86,38.26001151864193,-109.3828665
26779,4,45,12,4,18,5,88,38.26001151864193,-109.382597
26780,4,45,12,5,18,4,88,38.26001151864193,-109.3823275
26781,5,45,12,5,19,2,88,38.26001151864193,-109.382058
26782,5,44,13,6,19,2,89,38.26001151864193,-109.3817885
26783,5,43,13,8,19,1,89,38.26001151864193,-109.381519
26784,6,42,13,9,19,0,89,38.26001151864193,-109.3812495
26785,7,41,13,10,17,0,88,38.26001151864193,-109.38098
26786,7,43,13,11,17,0,91,38.26001151864193,-109.3807105
26787,6,48,13,8,18,0,93,38.26001151864193,-109.380441
26788,5,49,13,7,18,0,92,38.26001151864193,-109.3801716
26789,5,47,13,7,18,1,91,38.26001151864193,-109.3799021
26790,4,42,11,5,17,3,82,38.26001151864193,-109.3796326
26791,5,34,11,5,13,5,73,38.26001151864193,-109.3793631
26792,5,23,10,11,12,3,64,38.26001151864193,-109.3790936
26793,4,27,10,11,12,3,67,38.26001151864193,-109.3788241
26794,4,39,10,5,14,3,75,38.26001151864193,-109.3785546
26795,4,41,11,5,18,2,81,38.26001151864193,-109.3782851
26796,4,36,11,7,16,3,77,38.26001151864193,-109.3780156
26797,8,35,12,6,14,5,80,38.26001151864193,-109.3777461
26798,10,37,13,6,16,4,86,38.26001151864193,-109.3774766
26799,5,39,12,5,17,4,82,38.26001151864193,-109.3772071
26800,3,38,12,5,18,5,81,38.26001151864193,-109.3769376
26801,3,38,12,4,17,5,79,38.26001151864193,-109.3766681
26802,3,34,11,4,13,7,72,38.26001151864193,-109.3763986
26803,5,32,11,4,10,6,68,38.26001151864193,-109.3761291
26804,5,32,11,4,8,6,66,38.26001151864193,-109.3758596
26805,4,31,10,4,8,6,63,38.26001151864193,-109.3755901
26806,4,30,11,3,7,9,64,38.26001151864193,-109.3753206
26807,3,32,12,2,7,11,67,38.26001151864193,-109.3750512
26808,2,37,12,3,7,12,73,38.26001151864193,-109.3747817
26809,3,37,13,3,7,12,75,38.26001151864193,-109.3745122
26810,0,27,13,1,5,21,67,38.26001151864193,-109.3742427
26811,2,28,11,2,8,13,64,38.26001151864193,-109.3739732
26812,4,31,11,4,11,7,68,38.26001151864193,-109.3737037
26813,2,38,10,2,9,7,68,38.26001151864193,-109.3734342
26814,1,42,9,2,11,5,70,38.26001151864193,-109.3731647
26815,1,39,10,0,12,9,71,38.26001151864193,-109.3728952
26816,1,37,10,0,10,12,70,38.26001151864193,-109.3726257
26817,2,37,11,1,10,11,72,38.26001151864193,-109.3723562
26818,2,35,12,3,10,10,72,38.26001151864193,-109.3720867
26819,3,34,12,2,9,11,71,38.26001151864193,-109.3718172
26820,2,33,11,2,9,14,71,38.26001151864193,-109.3715477
26821,1,30,11,2,7,16,67,38.26001151864193,-109.3712782
26822,1,25,12,2,4,18,62,38.26001151864193,-109.3710087
26823,3,27,11,2,5,16,64,38.26001151864193,-109.3707392
26824,4,33,10,2,7,7,63,38.26001151864193,-109.3704697
26825,3,29,10,1,7,10,60,38.26001151864193,-109.3702003
26826,3,30,10,1,6,12,62,38.26001151864193,-109.3699308
26827,3,31,11,0,6,12,63,38.26001151864193,-109.3696613
26828,6,34,11,2,7,8,68,38.26001151864193,-109.3693918
26829,4,33,10,1,7,10,65,38.26001151864193,-109.3691223
26830,5,37,10,3,8,7,70,38.26001151864193,-109.3688528
26831,8,31,9,3,6,8,65,38.26001151864193,-109.3685833
26832,3,25,8,3,5,11,55,38.26001151864193,-109.3683138
26833,4,25,8,3,5,11,56,38.26001151864193,-109.3680443
26834,2,25,11,3,7,9,57,38.26001151864193,-109.3677748
26835,3,26,11,3,7,10,60,38.26001151864193,-109.3675053
26836,6,33,11,2,5,10,67,38.26001151864193,-109.3672358
26837,2,26,13,4,9,15,69,38.26001151864193,-109.3669663
26838,3,27,15,2,9,23,79,38.26001151864193,-109.3666968
26839,2,27,15,3,7,23,77,38.26001151864193,-109.3664273
26840,1,27,16,2,6,25,77,38.26001151864193,-109.3661578
26841,1,25,16,0,5,27,74,38.26001151864193,-109.3658883
26842,0,23,15,0,5,27,70,38.26001151864193,-109.3656188
26843,1,25,15,0,7,25,73,38.26001151864193,-109.3653493
26844,0,27,13,0,7,22,69,38.26001151864193,-109.3650799
26845,0,28,12,0,7,20,67,38.26001151864193,-109.3648104
26846,0,29,11,0,7,19,66,38.26001151864193,-109.3645409
26847,0,30,11,0,7,20,68,38.26001151864193,-109.3642714
26848,0,28,11,0,6,21,66,38.26001151864193,-109.3640019
26849,0,27,12,0,7,22,68,38.26001151864193,-109.3637324
26850,0,27,13,0,8,21,69,38.26001151864193,-109.3634629
26851,0,27,14,0,9,22,72,38.26001151864193,-109.3631934
26852,0,28,15,0,10,21,74,38.26001151864193,-109.3629239
26853,0,25,14,0,6,25,70,38.26001151864193,-109.3626544
26854,1,23,14,0,4,25,67,38.26001151864193,-109.3623849
26855,1,26,14,0,5,24,70,38.26001151864193,-109.3621154
26856,1,26,13,0,6,23,69,38.26001151864193,-109.3618459
26857,0,27,14,0,6,22,69,38.26001151864193,-109.3615764
26858,0,28,13,0,8,19,68,38.26001151864193,-109.3613069
26859,1,29,11,0,9,15,65,38.26001151864193,-109.3610374
26860,2,29,10,3,9,10,63,38.26001151864193,-109.3607679
26861,1,29,10,2,8,11,61,38.26001151864193,-109.3604984
26862,2,29,10,2,8,10,61,38.26001151864193,-109.360229
26863,3,29,10,2,8,10,62,38.26001151864193,-109.3599595
26864,2,28,11,2,7,13,63,38.26001151864193,-109.35969
26865,0,26,12,0,3,21,62,38.26001151864193,-109.3594205
26866,2,30,11,0,5,18,66,38.26001151864193,-109.359151
26867,0,25,11,0,5,19,60,38.26001151864193,-109.3588815
26868,0,24,11,0,6,20,61,38.26001151864193,-109.358612
26869,0,27,12,0,9,19,67,38.26001151864193,-109.3583425
26870,1,28,13,0,9,20,71,38.26001151864193,-109.358073
26871,1,27,14,0,7,19,68,38.26001151864193,-109.3578035
26872,1,27,12,1,8,17,66,38.26001151864193,-109.357534
26873,0,29,11,0,8,16,64,38.26001151864193,-109.3572645
26874,0,30,10,0,9,14,63,38.26001151864193,-109.356995
26875,1,41,8,0,13,8,71,38.26001151864193,-109.3567255
26876,7,32,10,8,8,1,66,38.26001151864193,-109.356456
26877,2,44,9,7,9,1,72,38.26001151864193,-109.3561865
26878,3,41,9,6,10,4,73,38.26001151864193,-109.355917
26879,3,31,9,6,9,8,66,38.26001151864193,-109.3556475
26880,3,27,12,2,5,17,66,38.26001151864193,-109.355378
26881,1,30,11,1,8,15,66,38.26001151864193,-109.3551086
26882,1,35,12,3,9,12,72,38.26001151864193,-109.3548391
26883,2,35,12,4,10,10,73,38.26001151864193,-109.3545696
26884,2,28,13,3,6,16,68,38.26001151864193,-109.3543001
26885,1,29,12,2,7,15,66,38.26001151864193,-109.3540306
26886,3,28,12,3,9,11,66,38.26001151864193,-109.3537611
26887,5,34,15,12,5,10,81,38.26001151864193,-109.3534916
26888,5,30,15,11,6,11,78,38.26001151864193,-109.3532221
26889,6,26,16,10,4,14,76,38.26001151864193,-109.3529526
26890,5,25,15,8,4,15,72,38.26001151864193,-109.3526831
26891,5,29,13,10,6,10,73,38.26001151864193,-109.3524136
26892,2,29,10,5,11,8,65,38.26001151864193,-109.3521441
26893,4,33,10,8,8,6,69,38.26001151864193,-109.3518746
26894,4,31,11,12,8,4,70,38.26001151864193,-109.3516051
26895,1,21,8,6,12,4,52,38.26001151864193,-109.3513356
26896,4,18,10,6,13,4,55,38.26001151864193,-109.3510661
26897,7,19,10,4,10,6,56,38.26001151864193,-109.3507966
26898,0,15,13,2,3,21,54,38.26001151864193,-109.3505271
26899,1,16,14,0,2,25,58,38.26001151864193,-109.3502577
26900,1,20,16,0,3,28,68,38.26001151864193,-109.3499882
26901,1,21,18,0,3,30,73,38.26001151864193,-109.3497187
26902,0,19,18,0,2,32,71,38.26001151864193,-109.3494492
26903,0,20,18,0,2,32,72,38.26001151864193,-109.3491797
26904,0,22,19,0,3,34,78,38.26001151864193,-109.3489102
26905,0,24,20,0,4,33,81,38.26001151864193,-109.3486407
26906,0,24,19,0,5,31,79,38.26001151864193,-109.3483712
26907,0,26,19,0,6,29,80,38.26001151864193,-109.3481017
26908,0,26,19,1,7,28,81,38.26001151864193,-109.3478322
26909,1,24,19,0,6,31,81,38.26001151864193,-109.3475627
26910,1,24,19,0,5,32,81,38.26001151864193,-109.3472932
26911,1,25,19,0,4,31,80,38.26001151864193,-109.3470237
26912,1,27,17,0,5,29,79,38.26001151864193,-109.3467542
26913,1,25,18,0,4,30,78,38.26001151864193,-109.3464847
26914,2,24,19,0,4,31,80,38.26001151864193,-109.3462152
26915,2,22,20,1,5,33,83,38.26001151864193,-109.3459457
26916,1,21,21,1,4,34,82,38.26001151864193,-109.3456762
26917,1,21,19,0,3,34,78,38.26001151864193,-109.3454068
26918,1,21,18,1,3,31,75,38.26001151864193,-109.3451373
26919,1,22,19,1,3,32,78,38.26001151864193,-109.3448678
26920,1,23,19,0,3,32,78,38.26001151864193,-109.3445983
26921,2,24,18,0,2,31,77,38.26001151864193,-109.3443288
26922,2,24,17,0,2,28,73,38.26001151864193,-109.3440593
26923,1,22,17,0,3,30,73,38.26001151864193,-109.3437898
26924,1,23,18,0,4,32,78,38.26001151864193,-109.3435203
26925,1,26,19,0,6,32,84,38.26001151864193,-109.3432508
26926,3,27,18,1,8,30,87,38.26001151864193,-109.3429813
26927,4,29,16,5,11,19,84,38.26001151864193,-109.3427118
26928,6,30,16,8,12,13,85,38.26001151864193,-109.3424423
26929,5,31,16,8,15,11,86,38.26001151864193,-109.3421728
26930,3,31,16,11,17,10,88,38.26001151864193,-109.3419033
26931,3,33,16,9,16,11,88,38.26001151864193,-109.3416338
26932,3,32,17,5,12,18,87,38.26001151864193,-109.3413643
26933,2,28,18,2,6,28,84,38.26001151864193,-109.3410948
26934,1,22,20,0,5,36,84,38.26001151864193,-109.3408253
26935,1,17,21,0,6,39,84,38.26001151864193,-109.3405558
26936,1,19,21,1,5,39,86,38.26001151864193,-109.3402864
26937,1,20,20,1,5,37,84,38.26001151864193,-109.3400169
26938,1,23,20,1,4,35,84,38.26001151864193,-109.3397474
26939,1,25,20,1,3,32,82,38.26001151864193,-109.3394779
26940,1,22,21,1,5,33,83,38.26001151864193,-109.3392084
26941,0,21,21,1,5,34,82,38.26001151864193,-109.3389389
26942,1,21,19,1,4,33,79,38.26001151864193,-109.3386694
26943,2,18,17,2,3,29,71,38.26001151864193,-109.3383999
26944,2,20,15,2,3,24,66,38.26001151864193,-109.3381304
26945,1,28,11,2,6,16,64,38.26001151864193,-109.3378609
26946,1,28,9,2,9,9,58,38.26001151864193,-109.3375914
26947,1,36,8,0,10,7,62,38.26001151864193,-109.3373219
26948,0,38,8,0,10,7,63,38.26001151864193,-109.3370524
26949,1,30,10,2,9,9,61,38.26001151864193,-109.3367829
26950,2,21,13,2,4,20,62,38.26001151864193,-109.3365134
26951,2,17,16,1,4,25,65,38.26001151864193,-109.3362439
26952,1,18,17,1,4,30,71,38.26001151864193,-109.3359744
26953,1,20,19,0,4,33,77,38.26001151864193,-109.3357049
26954,1,21,19,1,4,31,77,38.26001151864193,-109.3354355
26955,3,26,16,4,6,22,77,38.26001151864193,-109.335166
26956,3,27,16,4,7,22,79,38.26001151864193,-109.3348965
26957,2,23,17,4,7,24,77,38.26001151864193,-109.334627
26958,1,21,17,2,6,26,73,38.26001151864193,-109.3343575
26959,1,20,15,2,4,21,63,38.26001151864193,-109.334088
26960,2,19,13,3,4,20,61,38.26001151864193,-109.3338185
26961,1,19,14,1,4,24,63,38.26001151864193,-109.333549
26962,1,22,14,0,4,25,66,38.26001151864193,-109.3332795
26963,4,53,11,6,14,2,90,38.25974202405669,-109.4435028
26964,4,51,11,6,14,3,89,38.25974202405669,-109.4432333
26965,4,49,11,6,15,3,88,38.25974202405669,-109.4429638
26966,5,47,11,8,15,3,89,38.25974202405669,-109.4426943
26967,4,44,12,5,16,4,85,38.25974202405669,-109.4424248
26968,3,50,11,3,15,5,87,38.25974202405669,-109.4421553
26969,3,49,11,4,15,4,86,38.25974202405669,-109.4418858
26970,3,46,11,3,15,6,84,38.25974202405669,-109.4416163
26971,3,40,11,1,12,12,79,38.25974202405669,-109.4413468
26972,2,33,11,0,9,17,72,38.25974202405669,-109.4410773
26973,1,36,11,0,13,13,74,38.25974202405669,-109.4408078
26974,2,38,11,1,13,12,77,38.25974202405669,-109.4405383
26975,2,38,11,0,12,14,77,38.25974202405669,-109.4402688
26976,2,34,12,0,9,17,74,38.25974202405669,-109.4399993
26977,1,28,11,0,7,17,64,38.25974202405669,-109.4397299
26978,2,34,9,2,10,9,66,38.25974202405669,-109.4394604
26979,3,35,8,3,9,6,64,38.25974202405669,-109.4391909
26980,2,36,8,3,9,5,63,38.25974202405669,-109.4389214
26981,3,35,9,4,10,5,66,38.25974202405669,-109.4386519
26982,2,34,9,3,10,7,65,38.25974202405669,-109.4383824
26983,2,43,8,2,11,6,72,38.25974202405669,-109.4381129
26984,2,45,9,1,13,6,76,38.25974202405669,-109.4378434
26985,2,38,9,3,12,7,71,38.25974202405669,-109.4375739
26986,2,34,9,3,10,8,66,38.25974202405669,-109.4373044
26987,2,35,10,3,11,8,69,38.25974202405669,-109.4370349
26988,2,32,9,3,11,8,65,38.25974202405669,-109.4367654
26989,3,34,9,4,12,6,68,38.25974202405669,-109.4364959
26990,2,38,9,4,13,5,71,38.25974202405669,-109.4362264
26991,3,45,10,4,12,6,80,38.25974202405669,-109.4359569
26992,4,47,10,7,13,3,84,38.25974202405669,-109.4356874
26993,6,46,12,10,14,1,89,38.25974202405669,-109.4354179
26994,10,41,13,13,14,0,91,38.25974202405669,-109.4351484
26995,12,41,13,11,14,0,91,38.25974202405669,-109.434879
26996,9,41,12,10,15,1,88,38.25974202405669,-109.4346095
26997,7,43,12,10,15,1,88,38.25974202405669,-109.43434
26998,6,44,12,10,15,1,88,38.25974202405669,-109.4340705
26999,6,45,13,13,14,1,92,38.25974202405669,-109.433801
27000,7,43,14,15,14,0,93,38.25974202405669,-109.4335315
27001,11,43,14,12,14,0,94,38.25974202405669,-109.433262
27002,10,43,14,12,15,1,95,38.25974202405669,-109.4329925
27003,9,43,14,12,14,1,93,38.25974202405669,-109.432723
27004,9,43,14,13,14,1,94,38.25974202405669,-109.4324535
27005,16,38,14,12,14,0,94,38.25974202405669,-109.432184
27006,25,33,13,9,12,0,92,38.25974202405669,-109.4319145
27007,29,31,12,8,11,0,91,38.25974202405669,-109.431645
27008,28,30,12,8,11,0,89,38.25974202405669,-109.4313755
27009,28,32,13,8,11,0,92,38.25974202405669,-109.431106
27010,24,34,13,9,11,0,91,38.25974202405669,-109.4308365
27011,13,41,13,11,14,0,92,38.25974202405669,-109.430567
27012,8,45,14,12,14,0,93,38.25974202405669,-109.4302975
27013,8,46,13,11,14,1,93,38.25974202405669,-109.430028
27014,12,42,13,11,14,0,92,38.25974202405669,-109.4297586
27015,25,31,13,9,11,0,89,38.25974202405669,-109.4294891
27016,27,29,12,8,10,0,86,38.25974202405669,-109.4292196
27017,25,33,12,9,11,0,90,38.25974202405669,-109.4289501
27018,18,36,13,10,14,0,91,38.25974202405669,-109.4286806
27019,13,40,14,11,15,0,93,38.25974202405669,-109.4284111
27020,9,43,14,11,16,0,93,38.25974202405669,-109.4281416
27021,8,43,14,11,16,0,92,38.25974202405669,-109.4278721
27022,10,42,13,10,15,0,90,38.25974202405669,-109.4276026
27023,14,39,13,11,15,0,92,38.25974202405669,-109.4273331
27024,15,37,14,12,15,0,93,38.25974202405669,-109.4270636
27025,12,40,14,12,15,0,93,38.25974202405669,-109.4267941
27026,8,46,13,11,15,0,93,38.25974202405669,-109.4265246
27027,6,49,13,9,15,1,93,38.25974202405669,-109.4262551
27028,7,48,13,10,15,0,93,38.25974202405669,-109.4259856
27029,10,44,14,11,15,0,94,38.25974202405669,-109.4257161
27030,13,40,14,11,15,0,93,38.25974202405669,-109.4254466
27031,13,40,14,11,15,0,93,38.25974202405669,-109.4251771
27032,11,41,14,11,15,0,92,38.25974202405669,-109.4249077
27033,12,41,14,11,15,1,94,38.25974202405669,-109.4246382
27034,11,40,14,12,15,1,93,38.25974202405669,-109.4243687
27035,10,39,14,12,16,0,91,38.25974202405669,-109.4240992
27036,10,41,14,11,16,0,92,38.25974202405669,-109.4238297
27037,8,45,13,11,16,1,94,38.25974202405669,-109.4235602
27038,8,45,14,11,16,0,94,38.25974202405669,-109.4232907
27039,9,44,14,12,15,0,94,38.25974202405669,-109.4230212
27040,9,44,14,13,15,0,95,38.25974202405669,-109.4227517
27041,8,45,14,12,16,0,95,38.25974202405669,-109.4224822
27042,7,45,14,10,15,1,92,38.25974202405669,-109.4222127
27043,7,45,14,10,16,1,93,38.25974202405669,-109.4219432
27044,11,40,14,12,15,0,92,38.25974202405669,-109.4216737
27045,13,39,14,12,15,0,93,38.25974202405669,-109.4214042
27046,12,39,14,12,15,0,92,38.25974202405669,-109.4211347
27047,13,39,14,13,14,0,93,38.25974202405669,-109.4208652
27048,13,39,14,13,15,0,94,38.25974202405669,-109.4205957
27049,13,39,14,13,15,0,94,38.25974202405669,-109.4203262
27050,12,39,14,12,15,0,92,38.25974202405669,-109.4200568
27051,10,38,13,11,15,1,88,38.25974202405669,-109.4197873
27052,8,44,11,9,14,1,87,38.25974202405669,-109.4195178
27053,10,46,11,10,14,0,91,38.25974202405669,-109.4192483
27054,12,43,12,11,14,0,92,38.25974202405669,-109.4189788
27055,14,39,14,12,14,0,93,38.25974202405669,-109.4187093
27056,16,36,14,12,14,0,92,38.25974202405669,-109.4184398
27057,16,35,14,13,14,0,92,38.25974202405669,-109.4181703
27058,17,32,14,13,14,0,90,38.25974202405669,-109.4179008
27059,19,30,14,13,13,0,89,38.25974202405669,-109.4176313
27060,20,30,14,14,12,0,90,38.25974202405669,-109.4173618
27061,20,29,14,14,13,0,90,38.25974202405669,-109.4170923
27062,18,31,14,15,13,0,91,38.25974202405669,-109.4168228
27063,17,32,15,16,13,0,93,38.25974202405669,-109.4165533
27064,17,33,15,15,13,0,93,38.25974202405669,-109.4162838
27065,15,33,15,14,12,1,90,38.25974202405669,-109.4160143
27066,13,35,15,14,11,1,89,38.25974202405669,-109.4157448
27067,12,36,15,15,11,1,90,38.25974202405669,-109.4154753
27068,11,36,15,15,11,1,89,38.25974202405669,-109.4152058
27069,10,37,14,14,11,1,87,38.25974202405669,-109.4149364
27070,10,37,14,14,12,1,88,38.25974202405669,-109.4146669
27071,10,36,14,15,12,1,88,38.25974202405669,-109.4143974
27072,11,38,15,15,12,1,92,38.25974202405669,-109.4141279
27073,11,42,14,13,12,1,93,38.25974202405669,-109.4138584
27074,9,45,13,12,13,1,93,38.25974202405669,-109.4135889
27075,9,46,13,10,15,0,93,38.25974202405669,-109.4133194
27076,8,47,13,10,15,0,93,38.25974202405669,-109.4130499
27077,6,49,13,10,16,0,94,38.25974202405669,-109.4127804
27078,5,49,13,10,15,0,92,38.25974202405669,-109.4125109
27079,5,50,13,10,15,0,93,38.25974202405669,-109.4122414
27080,5,51,13,8,16,1,94,38.25974202405669,-109.4119719
27081,5,52,13,6,16,1,93,38.25974202405669,-109.4117024
27082,5,52,13,7,16,1,94,38.25974202405669,-109.4114329
27083,5,50,13,8,16,1,93,38.25974202405669,-109.4111634
27084,5,46,13,9,15,1,89,38.25974202405669,-109.4108939
27085,5,43,14,10,15,2,89,38.25974202405669,-109.4106244
27086,5,45,13,10,14,2,89,38.25974202405669,-109.4103549
27087,5,48,13,9,14,2,91,38.25974202405669,-109.4100855
27088,5,50,13,7,15,1,91,38.25974202405669,-109.409816
27089,5,49,13,7,16,1,91,38.25974202405669,-109.4095465
27090,5,49,13,8,16,1,92,38.25974202405669,-109.409277
27091,5,49,13,7,16,1,91,38.25974202405669,-109.4090075
27092,5,49,13,7,17,1,92,38.25974202405669,-109.408738
27093,5,49,13,7,17,0,91,38.25974202405669,-109.4084685
27094,5,51,12,5,17,1,91,38.25974202405669,-109.408199
27095,4,51,12,5,16,1,89,38.25974202405669,-109.4079295
27096,4,53,12,4,16,2,91,38.25974202405669,-109.40766
27097,3,51,11,2,14,5,86,38.25974202405669,-109.4073905
27098,3,47,11,5,14,5,85,38.25974202405669,-109.407121
27099,2,44,11,2,14,7,80,38.25974202405669,-109.4068515
27100,1,34,10,0,9,13,67,38.25974202405669,-109.3882564
27101,2,34,10,0,10,11,67,38.25974202405669,-109.3879869
27102,2,41,9,1,13,7,73,38.25974202405669,-109.3877174
27103,2,46,10,2,15,4,79,38.25974202405669,-109.3874479
27104,2,48,10,3,14,4,81,38.25974202405669,-109.3871784
27105,2,45,10,3,15,4,79,38.25974202405669,-109.3869089
27106,3,40,10,6,13,4,76,38.25974202405669,-109.3866394
27107,3,37,10,4,11,5,70,38.25974202405669,-109.3863699
27108,2,36,10,3,10,7,68,38.25974202405669,-109.3861004
27109,3,38,11,2,11,8,73,38.25974202405669,-109.3858309
27110,2,43,10,0,11,10,76,38.25974202405669,-109.3855614
27111,2,42,10,0,12,11,77,38.25974202405669,-109.3852919
27112,2,40,11,0,12,12,77,38.25974202405669,-109.3850225
27113,2,36,11,0,11,14,74,38.25974202405669,-109.384753
27114,2,37,12,3,14,11,79,38.25974202405669,-109.3844835
27115,1,31,12,2,11,14,71,38.25974202405669,-109.384214
27116,1,33,11,1,12,12,70,38.25974202405669,-109.3839445
27117,1,41,10,0,15,8,75,38.25974202405669,-109.383675
27118,2,42,9,0,15,7,75,38.25974202405669,-109.3834055
27119,3,37,11,1,14,10,76,38.25974202405669,-109.383136
27120,4,41,12,2,17,8,84,38.25974202405669,-109.3828665
27121,5,44,12,4,17,5,87,38.25974202405669,-109.382597
27122,5,45,12,5,18,3,88,38.25974202405669,-109.3823275
27123,5,45,12,6,18,2,88,38.25974202405669,-109.382058
27124,6,45,12,6,18,2,89,38.25974202405669,-109.3817885
27125,6,44,13,7,19,1,90,38.25974202405669,-109.381519
27126,6,44,12,8,18,1,89,38.25974202405669,-109.3812495
27127,7,44,12,8,17,1,89,38.25974202405669,-109.38098
27128,6,46,12,6,18,1,89,38.25974202405669,-109.3807105
27129,6,47,13,6,18,1,91,38.25974202405669,-109.380441
27130,6,46,13,6,18,1,90,38.25974202405669,-109.3801716
27131,5,45,12,5,18,2,87,38.25974202405669,-109.3799021
27132,4,36,10,4,14,6,74,38.25974202405669,-109.3796326
27133,6,26,10,7,11,5,65,38.25974202405669,-109.3793631
27134,5,23,9,11,12,3,63,38.25974202405669,-109.3790936
27135,4,29,10,9,13,3,68,38.25974202405669,-109.3788241
27136,4,39,10,5,15,4,77,38.25974202405669,-109.3785546
27137,2,37,10,5,13,4,71,38.25974202405669,-109.3782851
27138,4,36,11,6,16,4,77,38.25974202405669,-109.3780156
27139,4,39,11,4,16,6,80,38.25974202405669,-109.3777461
27140,4,40,12,3,17,6,82,38.25974202405669,-109.3774766
27141,3,40,12,4,17,5,81,38.25974202405669,-109.3772071
27142,2,30,11,6,12,8,69,38.25974202405669,-109.3769376
27143,1,30,11,3,10,11,66,38.25974202405669,-109.3766681
27144,2,30,10,3,8,8,61,38.25974202405669,-109.3763986
27145,3,31,10,3,8,7,62,38.25974202405669,-109.3761291
27146,3,32,10,3,8,7,63,38.25974202405669,-109.3758596
27147,3,32,10,3,9,7,64,38.25974202405669,-109.3755901
27148,3,32,11,3,8,10,67,38.25974202405669,-109.3753206
27149,2,34,12,2,8,12,70,38.25974202405669,-109.3750512
27150,1,34,12,1,8,16,72,38.25974202405669,-109.3747817
27151,1,30,13,0,4,20,68,38.25974202405669,-109.3745122
27152,2,30,13,1,4,22,72,38.25974202405669,-109.3742427
27153,2,28,11,2,7,14,64,38.25974202405669,-109.3739732
27154,4,35,10,4,9,6,68,38.25974202405669,-109.3737037
27155,4,34,9,5,8,5,65,38.25974202405669,-109.3734342
27156,4,36,8,5,8,4,65,38.25974202405669,-109.3731647
27157,5,34,9,4,9,5,66,38.25974202405669,-109.3728952
27158,3,36,11,3,10,8,71,38.25974202405669,-109.3726257
27159,1,35,12,2,10,12,72,38.25974202405669,-109.3723562
27160,2,36,11,1,9,14,73,38.25974202405669,-109.3720867
27161,2,31,12,2,8,14,69,38.25974202405669,-109.3718172
27162,2,34,11,2,9,14,72,38.25974202405669,-109.3715477
27163,1,34,11,1,8,17,72,38.25974202405669,-109.3712782
27164,1,29,12,2,7,16,67,38.25974202405669,-109.3710087
27165,4,34,11,2,8,9,68,38.25974202405669,-109.3707392
27166,2,31,9,3,8,6,59,38.25974202405669,-109.3704697
27167,3,25,9,4,7,8,56,38.25974202405669,-109.3702003
27168,3,23,10,3,6,10,55,38.25974202405669,-109.3699308
27169,3,24,11,2,6,11,57,38.25974202405669,-109.3696613
27170,5,24,10,3,8,9,59,38.25974202405669,-109.3693918
27171,2,23,9,3,7,8,52,38.25974202405669,-109.3691223
27172,3,27,9,4,7,6,56,38.25974202405669,-109.3688528
27173,3,24,10,5,8,7,57,38.25974202405669,-109.3685833
27174,3,22,9,4,5,11,54,38.25974202405669,-109.3683138
27175,3,24,10,4,5,12,58,38.25974202405669,-109.3680443
27176,2,26,12,4,6,14,64,38.25974202405669,-109.3677748
27177,2,28,12,3,5,15,65,38.25974202405669,-109.3675053
27178,3,29,12,1,5,18,68,38.25974202405669,-109.3672358
27179,3,27,13,7,13,12,75,38.25974202405669,-109.3669663
27180,3,24,13,3,9,20,72,38.25974202405669,-109.3666968
27181,1,20,14,1,5,26,67,38.25974202405669,-109.3664273
27182,2,21,14,0,2,27,66,38.25974202405669,-109.3661578
27183,2,22,14,0,2,25,65,38.25974202405669,-109.3658883
27184,1,23,13,0,4,23,64,38.25974202405669,-109.3656188
27185,1,24,13,0,5,23,66,38.25974202405669,-109.3653493
27186,1,24,14,0,6,24,69,38.25974202405669,-109.3650799
27187,1,24,14,0,6,25,70,38.25974202405669,-109.3648104
27188,1,24,14,0,6,24,69,38.25974202405669,-109.3645409
27189,0,23,15,0,5,27,70,38.25974202405669,-109.3642714
27190,0,22,15,0,5,27,69,38.25974202405669,-109.3640019
27191,0,23,14,0,5,26,68,38.25974202405669,-109.3637324
27192,0,25,13,0,7,23,68,38.25974202405669,-109.3634629
27193,1,29,13,0,10,18,71,38.25974202405669,-109.3631934
27194,0,29,13,0,9,21,72,38.25974202405669,-109.3629239
27195,1,27,14,0,7,22,71,38.25974202405669,-109.3626544
27196,1,26,14,0,5,24,70,38.25974202405669,-109.3623849
27197,0,26,14,0,5,24,69,38.25974202405669,-109.3621154
27198,0,26,14,0,5,24,69,38.25974202405669,-109.3618459
27199,1,27,15,0,6,24,73,38.25974202405669,-109.3615764
27200,0,26,15,0,5,27,73,38.25974202405669,-109.3613069
27201,0,27,15,0,4,27,73,38.25974202405669,-109.3610374
27202,0,29,14,0,6,23,72,38.25974202405669,-109.3607679
27203,1,27,11,3,6,16,64,38.25974202405669,-109.3604984
27204,2,26,11,6,8,11,64,38.25974202405669,-109.360229
27205,3,27,10,7,10,9,66,38.25974202405669,-109.3599595
27206,2,26,11,3,8,13,63,38.25974202405669,-109.35969
27207,0,24,11,0,4,21,60,38.25974202405669,-109.3594205
27208,1,33,10,0,10,13,67,38.25974202405669,-109.359151
27209,1,36,10,0,10,11,68,38.25974202405669,-109.3588815
27210,1,30,10,1,10,11,63,38.25974202405669,-109.358612
27211,1,25,11,2,9,13,61,38.25974202405669,-109.3583425
27212,1,25,11,0,7,18,62,38.25974202405669,-109.358073
27213,2,27,11,1,9,15,65,38.25974202405669,-109.3578035
27214,2,27,11,0,7,17,64,38.25974202405669,-109.357534
27215,1,25,11,0,5,19,61,38.25974202405669,-109.3572645
27216,1,23,11,0,5,18,58,38.25974202405669,-109.356995
27217,1,32,10,0,7,15,65,38.25974202405669,-109.3567255
27218,3,42,9,5,9,6,74,38.25974202405669,-109.356456
27219,1,43,8,2,10,8,72,38.25974202405669,-109.3561865
27220,1,36,10,4,10,10,71,38.25974202405669,-109.355917
27221,2,35,11,4,12,10,74,38.25974202405669,-109.3556475
27222,4,24,15,3,3,21,70,38.25974202405669,-109.355378
27223,2,30,14,0,7,19,72,38.25974202405669,-109.3551086
27224,3,34,13,0,10,15,75,38.25974202405669,-109.3548391
27225,3,31,13,0,9,15,71,38.25974202405669,-109.3545696
27226,3,18,14,3,3,22,63,38.25974202405669,-109.3543001
27227,3,16,14,2,3,25,63,38.25974202405669,-109.3540306
27228,4,15,15,4,3,23,64,38.25974202405669,-109.3537611
27229,4,16,14,5,5,19,63,38.25974202405669,-109.3534916
27230,5,22,15,1,6,18,67,38.25974202405669,-109.3532221
27231,3,22,14,2,5,20,66,38.25974202405669,-109.3529526
27232,6,35,14,15,5,9,84,38.25974202405669,-109.3526831
27233,7,35,12,12,9,5,80,38.25974202405669,-109.3524136
27234,6,30,11,10,13,3,73,38.25974202405669,-109.3521441
27235,2,25,9,15,11,3,65,38.25974202405669,-109.3518746
27236,13,35,9,11,8,1,77,38.25974202405669,-109.3516051
27237,6,37,10,7,14,0,74,38.25974202405669,-109.3513356
27238,2,30,11,1,20,2,66,38.25974202405669,-109.3510661
27239,3,27,17,2,13,10,72,38.25974202405669,-109.3507966
27240,0,20,14,0,4,22,60,38.25974202405669,-109.3505271
27241,2,23,17,0,5,25,72,38.25974202405669,-109.3502577
27242,0,22,18,0,4,29,73,38.25974202405669,-109.3499882
27243,0,22,19,0,4,31,76,38.25974202405669,-109.3497187
27244,0,22,19,0,3,32,76,38.25974202405669,-109.3494492
27245,0,22,20,0,4,34,80,38.25974202405669,-109.3491797
27246,0,23,20,0,5,34,82,38.25974202405669,-109.3489102
27247,0,25,20,0,4,32,81,38.25974202405669,-109.3486407
27248,0,25,19,0,5,31,80,38.25974202405669,-109.3483712
27249,0,26,19,0,6,30,81,38.25974202405669,-109.3481017
27250,0,27,19,0,6,29,81,38.25974202405669,-109.3478322
27251,1,25,19,0,7,29,81,38.25974202405669,-109.3475627
27252,1,26,19,0,7,30,83,38.25974202405669,-109.3472932
27253,1,25,19,0,6,31,82,38.25974202405669,-109.3470237
27254,1,24,19,0,5,30,79,38.25974202405669,-109.3467542
27255,2,23,20,0,4,32,81,38.25974202405669,-109.3464847
27256,2,23,20,0,3,33,81,38.25974202405669,-109.3462152
27257,2,22,21,0,4,34,83,38.25974202405669,-109.3459457
27258,2,20,21,0,4,35,82,38.25974202405669,-109.3456762
27259,2,21,18,1,1,29,72,38.25974202405669,-109.3454068
27260,2,22,18,2,3,27,74,38.25974202405669,-109.3451373
27261,1,22,19,0,3,30,75,38.25974202405669,-109.3448678
27262,1,21,19,0,4,34,79,38.25974202405669,-109.3445983
27263,1,21,19,0,3,34,78,38.25974202405669,-109.3443288
27264,1,21,18,0,2,31,73,38.25974202405669,-109.3440593
27265,1,22,17,0,3,29,72,38.25974202405669,-109.3437898
27266,2,23,18,1,4,29,77,38.25974202405669,-109.3435203
27267,2,25,19,1,6,31,84,38.25974202405669,-109.3432508
27268,1,25,19,1,7,32,85,38.25974202405669,-109.3429813
27269,1,26,19,0,7,32,85,38.25974202405669,-109.3427118
27270,2,29,18,2,10,25,86,38.25974202405669,-109.3424423
27271,3,29,16,9,15,15,87,38.25974202405669,-109.3421728
27272,3,29,15,13,17,9,86,38.25974202405669,-109.3419033
27273,2,31,17,10,16,11,87,38.25974202405669,-109.3416338
27274,3,32,16,10,17,10,88,38.25974202405669,-109.3413643
27275,3,31,16,5,12,18,85,38.25974202405669,-109.3410948
27276,2,27,18,2,8,28,85,38.25974202405669,-109.3408253
27277,1,24,19,1,6,34,85,38.25974202405669,-109.3405558
27278,1,21,19,3,5,35,84,38.25974202405669,-109.3402864
27279,1,19,20,2,5,38,85,38.25974202405669,-109.3400169
27280,1,20,20,1,2,38,82,38.25974202405669,-109.3397474
27281,2,18,20,1,1,33,75,38.25974202405669,-109.3394779
27282,3,19,18,2,2,28,72,38.25974202405669,-109.3392084
27283,2,16,17,1,2,29,67,38.25974202405669,-109.3389389
27284,3,18,15,1,2,25,64,38.25974202405669,-109.3386694
27285,2,20,13,1,3,21,60,38.25974202405669,-109.3383999
27286,2,23,11,3,6,13,58,38.25974202405669,-109.3381304
27287,2,30,8,2,9,8,59,38.25974202405669,-109.3378609
27288,1,35,7,1,10,6,60,38.25974202405669,-109.3375914
27289,0,42,7,0,10,6,65,38.25974202405669,-109.3373219
27290,0,41,7,0,10,8,66,38.25974202405669,-109.3370524
27291,1,31,10,2,8,13,65,38.25974202405669,-109.3367829
27292,2,28,12,2,5,19,68,38.25974202405669,-109.3365134
27293,2,20,15,2,3,23,65,38.25974202405669,-109.3362439
27294,2,18,16,2,3,25,66,38.25974202405669,-109.3359744
27295,2,19,17,2,3,27,70,38.25974202405669,-109.3357049
27296,2,23,18,1,4,28,76,38.25974202405669,-109.3354355
27297,2,25,16,2,4,25,74,38.25974202405669,-109.335166
27298,1,27,15,2,6,23,74,38.25974202405669,-109.3348965
27299,1,26,16,1,6,25,75,38.25974202405669,-109.334627
27300,2,22,16,1,5,25,71,38.25974202405669,-109.3343575
27301,1,22,13,1,4,20,61,38.25974202405669,-109.334088
27302,1,23,11,1,6,16,58,38.25974202405669,-109.3338185
27303,1,21,12,1,4,19,58,38.25974202405669,-109.333549
27304,0,22,12,0,4,20,58,38.25974202405669,-109.3332795
27305,1,24,12,0,4,20,61,38.25974202405669,-109.33301
27306,4,53,11,5,14,3,90,38.25947252947146,-109.4435028
27307,4,52,11,5,14,3,89,38.25947252947146,-109.4432333
27308,5,50,11,8,14,3,91,38.25947252947146,-109.4429638
27309,5,49,11,9,14,2,90,38.25947252947146,-109.4426943
27310,3,50,11,4,14,4,86,38.25947252947146,-109.4424248
27311,2,52,10,3,14,5,86,38.25947252947146,-109.4421553
27312,3,47,11,5,16,4,86,38.25947252947146,-109.4418858
27313,3,43,12,3,15,8,84,38.25947252947146,-109.4416163
27314,3,40,12,1,14,10,80,38.25947252947146,-109.4413468
27315,3,45,11,1,14,9,83,38.25947252947146,-109.4410773
27316,2,48,11,2,16,7,86,38.25947252947146,-109.4408078
27317,2,50,11,1,17,6,87,38.25947252947146,-109.4405383
27318,2,49,11,1,16,7,86,38.25947252947146,-109.4402688
27319,1,46,11,0,15,10,83,38.25947252947146,-109.4399993
27320,1,42,10,0,11,14,78,38.25947252947146,-109.4397299
27321,2,35,10,4,13,7,71,38.25947252947146,-109.4394604
27322,2,34,9,4,12,6,67,38.25947252947146,-109.4391909
27323,2,36,9,3,10,7,67,38.25947252947146,-109.4389214
27324,2,37,9,4,9,6,67,38.25947252947146,-109.4386519
27325,2,39,8,1,8,8,66,38.25947252947146,-109.4383824
27326,1,42,8,0,10,9,70,38.25947252947146,-109.4381129
27327,1,43,9,0,12,8,73,38.25947252947146,-109.4378434
27328,1,42,9,1,11,7,71,38.25947252947146,-109.4375739
27329,1,36,8,2,7,9,63,38.25947252947146,-109.4373044
27330,4,37,8,4,9,5,67,38.25947252947146,-109.4370349
27331,3,36,9,4,11,6,69,38.25947252947146,-109.4367654
27332,2,35,9,3,11,7,67,38.25947252947146,-109.4364959
27333,3,38,9,3,13,5,71,38.25947252947146,-109.4362264
27334,2,44,10,4,14,4,78,38.25947252947146,-109.4359569
27335,3,46,11,7,16,2,85,38.25947252947146,-109.4356874
27336,6,44,12,11,14,1,88,38.25947252947146,-109.4354179
27337,10,40,12,13,14,0,89,38.25947252947146,-109.4351484
27338,13,40,13,11,15,0,92,38.25947252947146,-109.434879
27339,10,41,12,9,16,2,90,38.25947252947146,-109.4346095
27340,7,42,12,7,17,3,88,38.25947252947146,-109.43434
27341,7,44,12,8,16,2,89,38.25947252947146,-109.4340705
27342,9,45,13,11,16,0,94,38.25947252947146,-109.433801
27343,9,42,14,13,15,1,94,38.25947252947146,-109.4335315
27344,10,42,14,13,14,0,93,38.25947252947146,-109.433262
27345,11,42,14,12,14,0,93,38.25947252947146,-109.4329925
27346,9,43,14,13,14,1,94,38.25947252947146,-109.432723
27347,9,43,14,12,14,1,93,38.25947252947146,-109.4324535
27348,17,38,14,11,13,0,93,38.25947252947146,-109.432184
27349,24,34,13,9,12,0,92,38.25947252947146,-109.4319145
27350,27,32,12,8,12,0,91,38.25947252947146,-109.431645
27351,27,32,12,8,11,0,90,38.25947252947146,-109.4313755
27352,24,35,13,8,12,0,92,38.25947252947146,-109.431106
27353,19,38,13,10,13,0,93,38.25947252947146,-109.4308365
27354,13,42,13,12,14,0,94,38.25947252947146,-109.430567
27355,10,44,13,12,14,0,93,38.25947252947146,-109.4302975
27356,10,44,14,12,14,0,94,38.25947252947146,-109.430028
27357,16,38,14,12,14,0,94,38.25947252947146,-109.4297586
27358,28,31,13,7,11,0,90,38.25947252947146,-109.4294891
27359,31,27,11,5,9,0,83,38.25947252947146,-109.4292196
27360,29,29,11,7,10,0,86,38.25947252947146,-109.4289501
27361,21,35,13,9,13,0,91,38.25947252947146,-109.4286806
27362,13,39,14,12,15,0,93,38.25947252947146,-109.4284111
27363,11,41,14,11,15,0,92,38.25947252947146,-109.4281416
27364,12,41,13,10,15,0,91,38.25947252947146,-109.4278721
27365,13,40,13,10,15,0,91,38.25947252947146,-109.4276026
27366,17,36,13,11,14,0,91,38.25947252947146,-109.4273331
27367,18,35,14,12,13,0,92,38.25947252947146,-109.4270636
27368,14,38,14,13,14,0,93,38.25947252947146,-109.4267941
27369,11,41,14,12,15,0,93,38.25947252947146,-109.4265246
27370,9,44,13,11,15,0,92,38.25947252947146,-109.4262551
27371,10,44,14,11,15,0,94,38.25947252947146,-109.4259856
27372,11,42,14,11,14,0,92,38.25947252947146,-109.4257161
27373,14,39,14,12,14,0,93,38.25947252947146,-109.4254466
27374,15,38,14,12,14,0,93,38.25947252947146,-109.4251771
27375,15,39,14,11,14,0,93,38.25947252947146,-109.4249077
27376,13,39,14,12,15,0,93,38.25947252947146,-109.4246382
27377,12,38,14,12,15,0,91,38.25947252947146,-109.4243687
27378,11,39,14,12,15,1,92,38.25947252947146,-109.4240992
27379,9,44,13,11,15,1,93,38.25947252947146,-109.4238297
27380,7,48,13,9,15,1,93,38.25947252947146,-109.4235602
27381,9,47,13,10,15,0,94,38.25947252947146,-109.4232907
27382,10,44,14,11,15,0,94,38.25947252947146,-109.4230212
27383,10,42,14,12,15,0,93,38.25947252947146,-109.4227517
27384,9,42,14,13,15,0,93,38.25947252947146,-109.4224822
27385,10,42,14,13,14,1,94,38.25947252947146,-109.4222127
27386,10,41,14,12,14,1,92,38.25947252947146,-109.4219432
27387,11,41,14,12,15,0,93,38.25947252947146,-109.4216737
27388,10,42,14,12,16,0,94,38.25947252947146,-109.4214042
27389,11,41,14,13,15,0,94,38.25947252947146,-109.4211347
27390,14,39,15,13,14,0,95,38.25947252947146,-109.4208652
27391,14,37,14,14,15,0,94,38.25947252947146,-109.4205957
27392,13,38,14,13,15,0,93,38.25947252947146,-109.4203262
27393,11,40,13,11,15,0,90,38.25947252947146,-109.4200568
27394,9,41,12,10,15,0,87,38.25947252947146,-109.4197873
27395,6,46,10,8,14,1,85,38.25947252947146,-109.4195178
27396,9,45,11,10,14,0,89,38.25947252947146,-109.4192483
27397,11,43,13,10,15,0,92,38.25947252947146,-109.4189788
27398,11,41,13,11,15,1,92,38.25947252947146,-109.4187093
27399,14,37,14,12,14,0,91,38.25947252947146,-109.4184398
27400,17,36,14,11,14,0,92,38.25947252947146,-109.4181703
27401,18,34,14,12,14,0,92,38.25947252947146,-109.4179008
27402,18,31,14,12,13,1,89,38.25947252947146,-109.4176313
27403,20,30,14,11,13,1,89,38.25947252947146,-109.4173618
27404,18,30,14,13,13,0,88,38.25947252947146,-109.4170923
27405,18,30,14,15,13,0,90,38.25947252947146,-109.4168228
27406,18,31,14,15,13,0,91,38.25947252947146,-109.4165533
27407,18,32,15,14,13,0,92,38.25947252947146,-109.4162838
27408,15,34,15,14,12,1,91,38.25947252947146,-109.4160143
27409,11,38,14,14,12,1,90,38.25947252947146,-109.4157448
27410,10,39,14,14,12,1,90,38.25947252947146,-109.4154753
27411,9,40,14,14,12,1,90,38.25947252947146,-109.4152058
27412,8,41,14,14,12,1,90,38.25947252947146,-109.4149364
27413,10,38,15,14,11,1,89,38.25947252947146,-109.4146669
27414,11,38,15,14,12,1,91,38.25947252947146,-109.4143974
27415,11,40,15,13,12,1,92,38.25947252947146,-109.4141279
27416,10,42,14,13,13,1,93,38.25947252947146,-109.4138584
27417,9,43,13,11,14,1,91,38.25947252947146,-109.4135889
27418,8,44,13,12,15,1,93,38.25947252947146,-109.4133194
27419,6,49,13,9,16,0,93,38.25947252947146,-109.4130499
27420,4,51,13,8,16,1,93,38.25947252947146,-109.4127804
27421,4,51,13,8,15,1,92,38.25947252947146,-109.4125109
27422,5,50,13,9,15,1,93,38.25947252947146,-109.4122414
27423,5,51,13,7,16,1,93,38.25947252947146,-109.4119719
27424,4,50,13,8,16,1,92,38.25947252947146,-109.4117024
27425,5,50,13,9,16,0,93,38.25947252947146,-109.4114329
27426,6,50,13,9,16,0,94,38.25947252947146,-109.4111634
27427,5,48,13,10,16,0,92,38.25947252947146,-109.4108939
27428,5,43,14,10,15,1,88,38.25947252947146,-109.4106244
27429,5,44,14,9,15,1,88,38.25947252947146,-109.4103549
27430,5,47,13,9,16,1,91,38.25947252947146,-109.4100855
27431,5,49,13,9,16,0,92,38.25947252947146,-109.409816
27432,5,49,13,8,17,1,93,38.25947252947146,-109.4095465
27433,5,48,12,6,17,1,89,38.25947252947146,-109.409277
27434,5,49,12,6,16,1,89,38.25947252947146,-109.4090075
27435,5,49,12,6,16,1,89,38.25947252947146,-109.408738
27436,5,49,12,6,17,1,90,38.25947252947146,-109.4084685
27437,5,49,12,6,17,0,89,38.25947252947146,-109.408199
27438,5,48,13,8,17,1,92,38.25947252947146,-109.4079295
27439,5,48,13,7,17,1,91,38.25947252947146,-109.40766
27440,4,49,12,5,16,3,89,38.25947252947146,-109.4073905
27441,2,48,11,4,14,5,84,38.25947252947146,-109.407121
27442,1,45,10,1,14,7,78,38.25947252947146,-109.4068515
27443,2,34,11,0,10,14,71,38.25947252947146,-109.3882564
27444,2,38,10,0,10,11,71,38.25947252947146,-109.3879869
27445,2,44,10,0,14,7,77,38.25947252947146,-109.3877174
27446,1,48,9,1,15,4,78,38.25947252947146,-109.3874479
27447,2,47,9,3,13,4,78,38.25947252947146,-109.3871784
27448,2,38,9,4,12,5,70,38.25947252947146,-109.3869089
27449,3,36,9,5,10,4,67,38.25947252947146,-109.3866394
27450,3,37,9,4,9,5,67,38.25947252947146,-109.3863699
27451,3,36,10,3,10,6,68,38.25947252947146,-109.3861004
27452,5,35,10,5,11,6,72,38.25947252947146,-109.3858309
27453,3,43,10,3,10,7,76,38.25947252947146,-109.3855614
27454,2,43,10,1,13,9,78,38.25947252947146,-109.3852919
27455,2,40,11,0,13,11,77,38.25947252947146,-109.3850225
27456,3,38,12,0,13,12,78,38.25947252947146,-109.384753
27457,3,38,12,1,13,13,80,38.25947252947146,-109.3844835
27458,2,34,13,0,9,17,75,38.25947252947146,-109.384214
27459,2,35,11,0,12,13,73,38.25947252947146,-109.3839445
27460,2,39,10,0,14,10,75,38.25947252947146,-109.383675
27461,2,37,10,0,14,10,73,38.25947252947146,-109.3834055
27462,3,36,11,1,13,11,75,38.25947252947146,-109.383136
27463,5,41,12,3,16,7,84,38.25947252947146,-109.3828665
27464,6,43,13,5,17,4,88,38.25947252947146,-109.382597
27465,6,44,12,5,17,3,87,38.25947252947146,-109.3823275
27466,5,45,12,6,18,3,89,38.25947252947146,-109.382058
27467,5,45,12,6,18,2,88,38.25947252947146,-109.3817885
27468,6,44,12,7,18,2,89,38.25947252947146,-109.381519
27469,8,41,12,9,16,1,87,38.25947252947146,-109.3812495
27470,10,40,12,9,15,1,87,38.25947252947146,-109.38098
27471,7,45,12,6,17,1,88,38.25947252947146,-109.3807105
27472,6,46,13,5,18,2,90,38.25947252947146,-109.380441
27473,6,46,13,5,18,2,90,38.25947252947146,-109.3801716
27474,5,41,11,4,16,4,81,38.25947252947146,-109.3799021
27475,3,30,10,5,10,8,66,38.25947252947146,-109.3796326
27476,3,23,9,10,11,4,60,38.25947252947146,-109.3793631
27477,6,28,9,7,10,4,64,38.25947252947146,-109.3790936
27478,4,31,9,5,10,6,65,38.25947252947146,-109.3788241
27479,2,31,9,4,10,7,63,38.25947252947146,-109.3785546
27480,4,31,11,5,10,6,67,38.25947252947146,-109.3782851
27481,2,31,11,4,12,9,69,38.25947252947146,-109.3780156
27482,3,42,11,1,14,10,81,38.25947252947146,-109.3777461
27483,3,42,12,1,14,10,82,38.25947252947146,-109.3774766
27484,2,36,12,1,11,13,75,38.25947252947146,-109.3772071
27485,1,28,12,3,10,13,67,38.25947252947146,-109.3769376
27486,2,34,11,2,8,9,66,38.25947252947146,-109.3766681
27487,3,32,11,2,7,8,63,38.25947252947146,-109.3763986
27488,4,29,11,3,7,8,62,38.25947252947146,-109.3761291
27489,5,32,13,5,8,8,71,38.25947252947146,-109.3758596
27490,3,30,14,4,9,14,74,38.25947252947146,-109.3755901
27491,2,31,13,1,8,17,72,38.25947252947146,-109.3753206
27492,3,31,14,1,9,14,72,38.25947252947146,-109.3750512
27493,2,31,13,2,8,13,69,38.25947252947146,-109.3747817
27494,1,30,13,2,8,14,68,38.25947252947146,-109.3745122
27495,1,29,13,0,8,17,68,38.25947252947146,-109.3742427
27496,2,28,12,1,8,12,63,38.25947252947146,-109.3739732
27497,2,30,11,2,8,9,62,38.25947252947146,-109.3737037
27498,2,29,10,3,7,8,59,38.25947252947146,-109.3734342
27499,2,29,9,3,7,8,58,38.25947252947146,-109.3731647
27500,2,32,9,3,7,7,60,38.25947252947146,-109.3728952
27501,2,35,10,1,6,8,62,38.25947252947146,-109.3726257
27502,2,36,11,1,7,8,65,38.25947252947146,-109.3723562
27503,4,37,11,2,8,8,70,38.25947252947146,-109.3720867
27504,4,37,11,2,7,9,70,38.25947252947146,-109.3718172
27505,4,35,11,2,8,10,70,38.25947252947146,-109.3715477
27506,4,33,11,2,8,10,68,38.25947252947146,-109.3712782
27507,4,35,12,2,8,8,69,38.25947252947146,-109.3710087
27508,4,39,11,3,7,6,70,38.25947252947146,-109.3707392
27509,3,28,11,5,9,8,64,38.25947252947146,-109.3704697
27510,3,24,12,6,10,9,64,38.25947252947146,-109.3702003
27511,4,23,13,6,9,10,65,38.25947252947146,-109.3699308
27512,3,24,13,4,7,12,63,38.25947252947146,-109.3696613
27513,2,28,12,2,7,12,63,38.25947252947146,-109.3693918
27514,4,31,11,3,8,9,66,38.25947252947146,-109.3691223
27515,4,29,12,5,8,8,66,38.25947252947146,-109.3688528
27516,3,24,12,5,7,11,62,38.25947252947146,-109.3685833
27517,2,24,12,4,7,14,63,38.25947252947146,-109.3683138
27518,1,26,12,2,7,18,66,38.25947252947146,-109.3680443
27519,1,28,13,2,7,19,70,38.25947252947146,-109.3677748
27520,1,28,13,1,7,19,69,38.25947252947146,-109.3675053
27521,1,28,12,3,10,14,68,38.25947252947146,-109.3672358
27522,3,31,13,8,21,5,81,38.25947252947146,-109.3669663
27523,3,26,11,4,9,14,67,38.25947252947146,-109.3666968
27524,1,22,13,0,6,22,64,38.25947252947146,-109.3664273
27525,1,22,13,0,3,23,62,38.25947252947146,-109.3661578
27526,2,23,12,0,3,21,61,38.25947252947146,-109.3658883
27527,2,29,11,0,8,17,67,38.25947252947146,-109.3656188
27528,2,26,12,0,6,19,65,38.25947252947146,-109.3653493
27529,2,24,13,0,4,24,67,38.25947252947146,-109.3650799
27530,1,24,14,0,3,25,67,38.25947252947146,-109.3648104
27531,1,24,14,0,5,26,70,38.25947252947146,-109.3645409
27532,1,24,15,0,5,26,71,38.25947252947146,-109.3642714
27533,0,24,15,0,5,26,70,38.25947252947146,-109.3640019
27534,1,26,15,0,6,24,72,38.25947252947146,-109.3637324
27535,2,29,14,0,6,21,72,38.25947252947146,-109.3634629
27536,3,34,13,0,9,17,76,38.25947252947146,-109.3631934
27537,4,36,12,0,11,14,77,38.25947252947146,-109.3629239
27538,2,29,13,0,6,21,71,38.25947252947146,-109.3626544
27539,2,25,15,0,5,25,72,38.25947252947146,-109.3623849
27540,1,24,15,0,5,26,71,38.25947252947146,-109.3621154
27541,1,24,15,0,5,25,70,38.25947252947146,-109.3618459
27542,1,25,15,0,4,26,71,38.25947252947146,-109.3615764
27543,2,23,15,0,4,27,71,38.25947252947146,-109.3613069
27544,2,25,14,0,5,24,70,38.25947252947146,-109.3610374
27545,3,29,14,0,7,20,73,38.25947252947146,-109.3607679
27546,2,28,15,0,5,23,73,38.25947252947146,-109.3604984
27547,2,26,15,0,6,22,71,38.25947252947146,-109.360229
27548,0,25,15,0,3,28,71,38.25947252947146,-109.3599595
27549,1,25,16,0,2,29,73,38.25947252947146,-109.35969
27550,1,24,15,0,3,26,69,38.25947252947146,-109.3594205
27551,1,27,12,0,5,20,65,38.25947252947146,-109.359151
27552,1,39,9,0,13,9,71,38.25947252947146,-109.3588815
27553,1,39,9,0,14,8,71,38.25947252947146,-109.358612
27554,1,30,11,0,11,12,65,38.25947252947146,-109.3583425
27555,2,30,12,1,9,13,67,38.25947252947146,-109.358073
27556,2,33,11,0,10,13,69,38.25947252947146,-109.3578035
27557,1,28,12,2,9,15,67,38.25947252947146,-109.357534
27558,2,27,11,2,6,17,65,38.25947252947146,-109.3572645
27559,2,28,11,1,6,16,64,38.25947252947146,-109.356995
27560,1,29,11,0,7,17,65,38.25947252947146,-109.3567255
27561,3,27,16,5,4,20,75,38.25947252947146,-109.356456
27562,4,29,15,4,5,18,75,38.25947252947146,-109.3561865
27563,2,39,14,2,5,18,80,38.25947252947146,-109.355917
27564,1,39,13,0,6,18,77,38.25947252947146,-109.3556475
27565,2,32,14,0,6,17,71,38.25947252947146,-109.355378
27566,2,37,13,1,9,14,76,38.25947252947146,-109.3551086
27567,3,36,13,0,9,14,75,38.25947252947146,-109.3548391
27568,4,29,14,7,5,16,75,38.25947252947146,-109.3545696
27569,5,25,16,7,3,20,76,38.25947252947146,-109.3543001
27570,5,23,15,6,3,22,74,38.25947252947146,-109.3540306
27571,4,22,15,5,3,23,72,38.25947252947146,-109.3537611
27572,4,24,15,6,3,21,73,38.25947252947146,-109.3534916
27573,1,23,12,1,8,19,64,38.25947252947146,-109.3532221
27574,1,29,11,2,13,13,69,38.25947252947146,-109.3529526
27575,9,31,10,15,8,6,79,38.25947252947146,-109.3526831
27576,10,34,11,15,12,2,84,38.25947252947146,-109.3524136
27577,9,27,14,16,16,2,84,38.25947252947146,-109.3521441
27578,8,26,11,19,19,0,83,38.25947252947146,-109.3518746
27579,7,32,11,11,15,1,77,38.25947252947146,-109.3516051
27580,3,32,11,13,18,0,77,38.25947252947146,-109.3513356
27581,2,27,12,6,21,1,69,38.25947252947146,-109.3510661
27582,1,25,17,1,12,15,71,38.25947252947146,-109.3507966
27583,2,23,17,0,4,25,71,38.25947252947146,-109.3505271
27584,1,24,18,0,4,28,75,38.25947252947146,-109.3502577
27585,1,24,17,0,4,29,75,38.25947252947146,-109.3499882
27586,0,24,18,0,4,29,75,38.25947252947146,-109.3497187
27587,1,26,20,0,5,29,81,38.25947252947146,-109.3494492
27588,0,22,21,0,4,33,80,38.25947252947146,-109.3491797
27589,1,24,20,0,5,32,82,38.25947252947146,-109.3489102
27590,1,24,19,0,5,31,80,38.25947252947146,-109.3486407
27591,0,23,19,0,3,33,78,38.25947252947146,-109.3483712
27592,1,22,20,0,2,35,80,38.25947252947146,-109.3481017
27593,0,20,20,0,2,35,77,38.25947252947146,-109.3478322
27594,1,19,19,0,3,33,75,38.25947252947146,-109.3475627
27595,0,19,19,0,2,34,74,38.25947252947146,-109.3472932
27596,0,19,18,0,2,34,73,38.25947252947146,-109.3470237
27597,0,17,18,0,1,34,70,38.25947252947146,-109.3467542
27598,1,17,19,0,0,35,72,38.25947252947146,-109.3464847
27599,1,16,19,0,0,35,71,38.25947252947146,-109.3462152
27600,1,16,19,0,0,34,70,38.25947252947146,-109.3459457
27601,2,17,19,0,0,32,70,38.25947252947146,-109.3456762
27602,2,21,19,0,0,30,72,38.25947252947146,-109.3454068
27603,3,20,17,1,1,28,70,38.25947252947146,-109.3451373
27604,1,19,18,0,2,30,70,38.25947252947146,-109.3448678
27605,1,20,19,0,3,32,75,38.25947252947146,-109.3445983
27606,1,21,19,0,3,33,77,38.25947252947146,-109.3443288
27607,1,20,18,0,1,32,72,38.25947252947146,-109.3440593
27608,2,21,17,0,3,27,70,38.25947252947146,-109.3437898
27609,2,22,17,1,3,28,73,38.25947252947146,-109.3435203
27610,2,22,18,1,4,33,80,38.25947252947146,-109.3432508
27611,0,20,20,0,6,36,82,38.25947252947146,-109.3429813
27612,1,21,20,1,6,35,84,38.25947252947146,-109.3427118
27613,2,26,19,3,9,30,89,38.25947252947146,-109.3424423
27614,3,28,18,5,12,24,90,38.25947252947146,-109.3421728
27615,4,29,17,9,15,18,92,38.25947252947146,-109.3419033
27616,3,31,16,8,15,14,87,38.25947252947146,-109.3416338
27617,2,32,16,5,13,18,86,38.25947252947146,-109.3413643
27618,2,29,17,3,10,24,85,38.25947252947146,-109.3410948
27619,2,25,19,4,7,28,85,38.25947252947146,-109.3408253
27620,1,26,19,2,7,31,86,38.25947252947146,-109.3405558
27621,2,29,19,3,3,29,85,38.25947252947146,-109.3402864
27622,1,20,21,0,2,38,82,38.25947252947146,-109.3400169
27623,1,13,19,0,0,35,68,38.25947252947146,-109.3397474
27624,1,13,17,0,0,31,62,38.25947252947146,-109.3394779
27625,2,16,16,0,0,30,64,38.25947252947146,-109.3392084
27626,1,17,15,0,0,28,61,38.25947252947146,-109.3389389
27627,2,18,13,0,1,22,56,38.25947252947146,-109.3386694
27628,2,18,10,2,4,14,50,38.25947252947146,-109.3383999
27629,2,24,9,2,9,8,54,38.25947252947146,-109.3381304
27630,1,39,7,1,9,5,62,38.25947252947146,-109.3378609
27631,0,46,6,0,10,5,67,38.25947252947146,-109.3375914
27632,0,47,7,0,10,5,69,38.25947252947146,-109.3373219
27633,0,41,7,0,9,8,65,38.25947252947146,-109.3370524
27634,1,33,10,1,9,13,67,38.25947252947146,-109.3367829
27635,2,33,11,1,8,15,70,38.25947252947146,-109.3365134
27636,1,26,12,2,6,18,65,38.25947252947146,-109.3362439
27637,1,28,12,3,9,14,67,38.25947252947146,-109.3359744
27638,2,30,12,2,8,15,69,38.25947252947146,-109.3357049
27639,2,20,16,2,4,24,68,38.25947252947146,-109.3354355
27640,1,24,18,1,4,29,77,38.25947252947146,-109.335166
27641,0,24,19,0,5,32,80,38.25947252947146,-109.3348965
27642,0,23,18,0,5,30,76,38.25947252947146,-109.334627
27643,2,23,16,1,4,24,70,38.25947252947146,-109.3343575
27644,1,27,12,1,7,16,64,38.25947252947146,-109.334088
27645,1,26,10,0,8,13,58,38.25947252947146,-109.3338185
27646,0,25,11,0,6,17,59,38.25947252947146,-109.333549
27647,2,26,14,0,6,21,69,38.25947252947146,-109.3332795
27648,2,27,16,1,6,25,77,38.25947252947146,-109.33301
27649,6,51,11,8,13,2,91,38.25920303488623,-109.4435028
27650,5,52,11,8,13,2,91,38.25920303488623,-109.4432333
27651,5,52,11,8,13,2,91,38.25920303488623,-109.4429638
27652,4,53,10,8,13,2,90,38.25920303488623,-109.4426943
27653,3,55,10,4,13,3,88,38.25920303488623,-109.4424248
27654,3,53,10,2,15,5,88,38.25920303488623,-109.4421553
27655,3,49,12,3,17,5,89,38.25920303488623,-109.4418858
27656,3,48,12,3,16,5,87,38.25920303488623,-109.4416163
27657,3,51,11,3,16,5,89,38.25920303488623,-109.4413468
27658,3,52,11,5,16,3,90,38.25920303488623,-109.4410773
27659,3,53,11,3,16,4,90,38.25920303488623,-109.4408078
27660,3,52,11,2,16,5,89,38.25920303488623,-109.4405383
27661,2,49,10,2,16,6,85,38.25920303488623,-109.4402688
27662,2,48,10,0,15,6,81,38.25920303488623,-109.4399993
27663,2,46,10,1,16,6,81,38.25920303488623,-109.4397299
27664,2,44,11,3,15,6,81,38.25920303488623,-109.4394604
27665,2,44,11,3,15,6,81,38.25920303488623,-109.4391909
27666,2,43,11,2,15,7,80,38.25920303488623,-109.4389214
27667,1,37,10,1,11,11,71,38.25920303488623,-109.4386519
27668,1,37,9,0,10,11,68,38.25920303488623,-109.4383824
27669,1,40,8,0,10,8,67,38.25920303488623,-109.4381129
27670,2,40,9,3,11,5,70,38.25920303488623,-109.4378434
27671,2,40,10,5,12,4,73,38.25920303488623,-109.4375739
27672,2,38,9,2,11,7,69,38.25920303488623,-109.4373044
27673,3,35,9,4,10,6,67,38.25920303488623,-109.4370349
27674,5,36,9,6,9,4,69,38.25920303488623,-109.4367654
27675,5,35,9,6,10,4,69,38.25920303488623,-109.4364959
27676,5,37,9,5,12,4,72,38.25920303488623,-109.4362264
27677,2,45,9,2,15,5,78,38.25920303488623,-109.4359569
27678,3,49,10,4,16,3,85,38.25920303488623,-109.4356874
27679,4,48,11,7,16,1,87,38.25920303488623,-109.4354179
27680,4,48,11,8,16,1,88,38.25920303488623,-109.4351484
27681,5,49,11,6,16,2,89,38.25920303488623,-109.434879
27682,6,42,11,6,17,2,84,38.25920303488623,-109.4346095
27683,7,40,11,4,17,4,83,38.25920303488623,-109.43434
27684,8,43,12,6,17,2,88,38.25920303488623,-109.4340705
27685,8,48,13,8,17,1,95,38.25920303488623,-109.433801
27686,9,45,14,11,16,1,96,38.25920303488623,-109.4335315
27687,9,42,14,13,15,1,94,38.25920303488623,-109.433262
27688,10,42,14,13,15,0,94,38.25920303488623,-109.4329925
27689,11,43,14,12,14,0,94,38.25920303488623,-109.432723
27690,11,42,14,12,14,0,93,38.25920303488623,-109.4324535
27691,16,38,13,11,14,0,92,38.25920303488623,-109.432184
27692,17,38,13,10,13,0,91,38.25920303488623,-109.4319145
27693,19,36,13,10,14,0,92,38.25920303488623,-109.431645
27694,19,37,13,10,13,0,92,38.25920303488623,-109.4313755
27695,17,39,13,11,13,0,93,38.25920303488623,-109.431106
27696,14,41,13,12,14,0,94,38.25920303488623,-109.4308365
27697,12,42,14,12,14,0,94,38.25920303488623,-109.430567
27698,11,43,13,12,14,0,93,38.25920303488623,-109.4302975
27699,12,41,14,13,14,0,94,38.25920303488623,-109.430028
27700,18,38,14,10,13,0,93,38.25920303488623,-109.4297586
27701,25,33,13,9,12,0,92,38.25920303488623,-109.4294891
27702,29,31,12,8,11,0,91,38.25920303488623,-109.4292196
27703,28,32,12,8,11,0,91,38.25920303488623,-109.4289501
27704,20,36,13,9,13,0,91,38.25920303488623,-109.4286806
27705,13,39,13,11,15,0,91,38.25920303488623,-109.4284111
27706,13,39,14,11,15,0,92,38.25920303488623,-109.4281416
27707,15,38,13,10,15,0,91,38.25920303488623,-109.4278721
27708,17,36,13,11,14,0,91,38.25920303488623,-109.4276026
27709,19,35,14,11,14,0,93,38.25920303488623,-109.4273331
27710,20,35,14,11,13,0,93,38.25920303488623,-109.4270636
27711,15,37,14,12,14,0,92,38.25920303488623,-109.4267941
27712,13,38,14,12,14,0,91,38.25920303488623,-109.4265246
27713,13,39,14,12,14,0,92,38.25920303488623,-109.4262551
27714,14,38,14,12,14,0,92,38.25920303488623,-109.4259856
27715,10,42,14,12,14,0,92,38.25920303488623,-109.4257161
27716,10,42,14,12,14,0,92,38.25920303488623,-109.4254466
27717,12,40,14,12,14,0,92,38.25920303488623,-109.4251771
27718,14,39,14,11,14,0,92,38.25920303488623,-109.4249077
27719,13,39,14,12,15,0,93,38.25920303488623,-109.4246382
27720,13,38,14,12,14,0,91,38.25920303488623,-109.4243687
27721,12,41,14,12,14,0,93,38.25920303488623,-109.4240992
27722,9,44,14,11,14,1,93,38.25920303488623,-109.4238297
27723,8,47,13,11,13,1,93,38.25920303488623,-109.4235602
27724,11,45,14,11,13,0,94,38.25920303488623,-109.4232907
27725,11,44,14,11,14,0,94,38.25920303488623,-109.4230212
27726,11,44,14,12,14,0,95,38.25920303488623,-109.4227517
27727,11,44,14,11,14,0,94,38.25920303488623,-109.4224822
27728,11,42,15,12,14,0,94,38.25920303488623,-109.4222127
27729,11,40,15,13,14,0,93,38.25920303488623,-109.4219432
27730,9,42,14,12,16,1,94,38.25920303488623,-109.4216737
27731,8,43,14,11,16,1,93,38.25920303488623,-109.4214042
27732,9,43,14,11,15,0,92,38.25920303488623,-109.4211347
27733,10,42,14,11,16,0,93,38.25920303488623,-109.4208652
27734,12,39,14,13,15,0,93,38.25920303488623,-109.4205957
27735,12,39,14,12,15,0,92,38.25920303488623,-109.4203262
27736,11,42,13,10,15,0,91,38.25920303488623,-109.4200568
27737,10,44,12,9,14,0,89,38.25920303488623,-109.4197873
27738,6,49,10,8,13,1,87,38.25920303488623,-109.4195178
27739,6,49,11,9,14,0,89,38.25920303488623,-109.4192483
27740,7,46,13,10,16,0,92,38.25920303488623,-109.4189788
27741,10,42,13,11,15,0,91,38.25920303488623,-109.4187093
27742,14,38,13,11,14,0,90,38.25920303488623,-109.4184398
27743,16,36,14,11,14,0,91,38.25920303488623,-109.4181703
27744,17,34,14,12,14,0,91,38.25920303488623,-109.4179008
27745,18,33,14,13,14,0,92,38.25920303488623,-109.4176313
27746,19,32,14,13,14,0,92,38.25920303488623,-109.4173618
27747,19,30,14,14,14,0,91,38.25920303488623,-109.4170923
27748,19,30,14,13,14,0,90,38.25920303488623,-109.4168228
27749,20,30,14,14,13,0,91,38.25920303488623,-109.4165533
27750,18,32,15,14,13,0,92,38.25920303488623,-109.4162838
27751,14,36,14,13,12,1,90,38.25920303488623,-109.4160143
27752,10,43,13,11,12,1,90,38.25920303488623,-109.4157448
27753,8,43,14,13,12,1,91,38.25920303488623,-109.4154753
27754,8,43,14,13,12,1,91,38.25920303488623,-109.4152058
27755,8,43,14,12,12,1,90,38.25920303488623,-109.4149364
27756,11,41,15,13,11,1,92,38.25920303488623,-109.4146669
27757,9,42,14,13,12,1,91,38.25920303488623,-109.4143974
27758,10,42,14,13,13,1,93,38.25920303488623,-109.4141279
27759,12,38,15,15,13,1,94,38.25920303488623,-109.4138584
27760,14,33,15,17,13,1,93,38.25920303488623,-109.4135889
27761,15,33,15,16,13,1,93,38.25920303488623,-109.4133194
27762,8,46,14,10,16,0,94,38.25920303488623,-109.4130499
27763,5,49,13,8,16,1,92,38.25920303488623,-109.4127804
27764,5,50,13,7,15,1,91,38.25920303488623,-109.4125109
27765,5,51,13,7,15,1,92,38.25920303488623,-109.4122414
27766,5,50,13,7,16,1,92,38.25920303488623,-109.4119719
27767,5,50,13,9,15,1,93,38.25920303488623,-109.4117024
27768,6,50,13,9,15,1,94,38.25920303488623,-109.4114329
27769,6,50,13,8,16,0,93,38.25920303488623,-109.4111634
27770,5,48,13,9,16,0,91,38.25920303488623,-109.4108939
27771,6,44,13,10,16,1,90,38.25920303488623,-109.4106244
27772,6,45,13,10,16,1,91,38.25920303488623,-109.4103549
27773,5,46,13,10,16,0,90,38.25920303488623,-109.4100855
27774,5,48,13,10,17,0,93,38.25920303488623,-109.409816
27775,4,48,13,8,17,0,90,38.25920303488623,-109.4095465
27776,5,47,12,7,17,1,89,38.25920303488623,-109.409277
27777,6,47,13,9,16,0,91,38.25920303488623,-109.4090075
27778,6,47,13,9,15,0,90,38.25920303488623,-109.408738
27779,6,48,12,7,16,1,90,38.25920303488623,-109.4084685
27780,6,48,13,7,16,0,90,38.25920303488623,-109.408199
27781,5,48,13,8,17,1,92,38.25920303488623,-109.4079295
27782,6,48,14,9,17,1,95,38.25920303488623,-109.40766
27783,5,48,13,8,18,1,93,38.25920303488623,-109.4073905
27784,3,49,12,5,15,3,87,38.25920303488623,-109.407121
27785,2,49,10,0,14,6,81,38.25920303488623,-109.4068515
27786,3,34,13,1,10,14,75,38.25920303488623,-109.3882564
27787,3,44,12,1,13,9,82,38.25920303488623,-109.3879869
27788,2,48,10,1,15,6,82,38.25920303488623,-109.3877174
27789,2,47,9,4,13,3,78,38.25920303488623,-109.3874479
27790,2,44,9,5,10,3,73,38.25920303488623,-109.3871784
27791,3,35,9,5,10,4,66,38.25920303488623,-109.3869089
27792,3,37,9,5,9,5,68,38.25920303488623,-109.3866394
27793,4,34,10,4,9,7,68,38.25920303488623,-109.3863699
27794,6,33,10,5,10,6,70,38.25920303488623,-109.3861004
27795,9,32,12,9,11,4,77,38.25920303488623,-109.3858309
27796,6,38,10,7,12,5,78,38.25920303488623,-109.3855614
27797,4,40,11,3,13,7,78,38.25920303488623,-109.3852919
27798,3,38,11,1,13,10,76,38.25920303488623,-109.3850225
27799,3,40,12,1,15,9,80,38.25920303488623,-109.384753
27800,3,41,13,3,15,8,83,38.25920303488623,-109.3844835
27801,2,36,11,0,13,12,74,38.25920303488623,-109.384214
27802,2,35,11,0,12,13,73,38.25920303488623,-109.3839445
27803,2,35,11,0,13,13,74,38.25920303488623,-109.383675
27804,3,35,11,1,13,12,75,38.25920303488623,-109.3834055
27805,4,37,12,2,14,11,80,38.25920303488623,-109.383136
27806,5,40,12,3,17,7,84,38.25920303488623,-109.3828665
27807,5,43,12,4,18,5,87,38.25920303488623,-109.382597
27808,6,44,12,5,18,3,88,38.25920303488623,-109.3823275
27809,5,45,12,5,18,3,88,38.25920303488623,-109.382058
27810,6,45,12,5,18,2,88,38.25920303488623,-109.3817885
27811,8,42,12,7,17,1,87,38.25920303488623,-109.381519
27812,15,36,12,9,14,1,87,38.25920303488623,-109.3812495
27813,20,34,12,10,13,0,89,38.25920303488623,-109.38098
27814,15,41,13,8,14,0,91,38.25920303488623,-109.3807105
27815,7,46,13,5,17,1,89,38.25920303488623,-109.380441
27816,6,46,12,5,17,2,88,38.25920303488623,-109.3801716
27817,5,40,11,4,15,4,79,38.25920303488623,-109.3799021
27818,4,26,9,5,10,6,60,38.25920303488623,-109.3796326
27819,4,23,9,8,9,6,59,38.25920303488623,-109.3793631
27820,3,37,9,7,9,4,69,38.25920303488623,-109.3790936
27821,3,35,9,5,8,6,66,38.25920303488623,-109.3788241
27822,2,32,10,3,7,9,63,38.25920303488623,-109.3785546
27823,5,33,11,2,8,8,67,38.25920303488623,-109.3782851
27824,5,33,11,3,10,7,69,38.25920303488623,-109.3780156
27825,0,30,11,1,9,13,64,38.25920303488623,-109.3777461
27826,0,28,11,1,8,15,63,38.25920303488623,-109.3774766
27827,4,30,12,3,8,9,66,38.25920303488623,-109.3772071
27828,8,29,13,6,9,4,69,38.25920303488623,-109.3769376
27829,6,31,11,5,9,5,67,38.25920303488623,-109.3766681
27830,8,30,14,6,9,6,73,38.25920303488623,-109.3763986
27831,3,31,14,3,8,13,72,38.25920303488623,-109.3761291
27832,2,35,12,0,8,16,73,38.25920303488623,-109.3758596
27833,3,39,14,2,13,9,80,38.25920303488623,-109.3755901
27834,1,40,13,1,12,10,77,38.25920303488623,-109.3753206
27835,2,39,11,1,11,9,73,38.25920303488623,-109.3750512
27836,1,36,11,1,10,12,71,38.25920303488623,-109.3747817
27837,0,28,12,1,9,17,67,38.25920303488623,-109.3745122
27838,0,29,13,0,5,23,70,38.25920303488623,-109.3742427
27839,0,29,13,1,9,16,68,38.25920303488623,-109.3739732
27840,1,30,11,3,11,10,66,38.25920303488623,-109.3737037
27841,2,30,10,4,10,9,65,38.25920303488623,-109.3734342
27842,3,30,13,6,9,12,73,38.25920303488623,-109.3731647
27843,6,30,13,4,10,11,74,38.25920303488623,-109.3728952
27844,5,33,12,3,9,8,70,38.25920303488623,-109.3726257
27845,5,34,12,2,8,8,69,38.25920303488623,-109.3723562
27846,6,35,12,3,8,8,72,38.25920303488623,-109.3720867
27847,4,35,13,2,7,11,72,38.25920303488623,-109.3718172
27848,3,30,13,2,7,15,70,38.25920303488623,-109.3715477
27849,2,31,12,2,6,14,67,38.25920303488623,-109.3712782
27850,3,39,12,2,7,10,73,38.25920303488623,-109.3710087
27851,3,40,12,3,7,10,75,38.25920303488623,-109.3707392
27852,2,26,14,5,8,18,73,38.25920303488623,-109.3704697
27853,2,25,13,5,11,16,72,38.25920303488623,-109.3702003
27854,1,25,13,5,10,17,71,38.25920303488623,-109.3699308
27855,0,23,13,4,8,20,68,38.25920303488623,-109.3696613
27856,0,25,13,2,6,22,68,38.25920303488623,-109.3693918
27857,1,28,13,2,7,20,71,38.25920303488623,-109.3691223
27858,1,27,14,3,8,20,73,38.25920303488623,-109.3688528
27859,1,27,13,3,8,20,72,38.25920303488623,-109.3685833
27860,0,28,13,3,8,19,71,38.25920303488623,-109.3683138
27861,0,24,13,4,9,18,68,38.25920303488623,-109.3680443
27862,0,25,13,4,11,18,71,38.25920303488623,-109.3677748
27863,0,27,13,4,13,15,72,38.25920303488623,-109.3675053
27864,0,28,12,8,15,12,75,38.25920303488623,-109.3672358
27865,2,32,12,8,18,6,78,38.25920303488623,-109.3669663
27866,3,29,11,0,8,16,67,38.25920303488623,-109.3666968
27867,1,26,12,0,7,21,67,38.25920303488623,-109.3664273
27868,2,24,13,0,5,23,67,38.25920303488623,-109.3661578
27869,2,24,13,0,5,23,67,38.25920303488623,-109.3658883
27870,1,28,12,0,6,21,68,38.25920303488623,-109.3656188
27871,1,27,11,0,7,19,65,38.25920303488623,-109.3653493
27872,1,24,12,0,5,23,65,38.25920303488623,-109.3650799
27873,1,22,14,0,4,26,67,38.25920303488623,-109.3648104
27874,2,26,14,0,4,25,71,38.25920303488623,-109.3645409
27875,2,27,13,0,4,23,69,38.25920303488623,-109.3642714
27876,2,29,12,0,6,20,69,38.25920303488623,-109.3640019
27877,4,32,13,0,7,18,74,38.25920303488623,-109.3637324
27878,5,35,13,0,9,17,79,38.25920303488623,-109.3634629
27879,5,37,13,0,10,14,79,38.25920303488623,-109.3631934
27880,5,38,13,1,12,12,81,38.25920303488623,-109.3629239
27881,3,33,13,0,8,19,76,38.25920303488623,-109.3626544
27882,3,28,14,0,5,24,74,38.25920303488623,-109.3623849
27883,3,27,15,0,4,25,74,38.25920303488623,-109.3621154
27884,2,24,14,0,3,25,68,38.25920303488623,-109.3618459
27885,2,23,15,0,2,26,68,38.25920303488623,-109.3615764
27886,2,23,15,0,3,26,69,38.25920303488623,-109.3613069
27887,2,25,13,0,5,24,69,38.25920303488623,-109.3610374
27888,1,24,13,0,6,24,68,38.25920303488623,-109.3607679
27889,1,21,15,0,4,27,68,38.25920303488623,-109.3604984
27890,2,21,16,0,4,27,70,38.25920303488623,-109.360229
27891,2,20,17,0,2,29,70,38.25920303488623,-109.3599595
27892,3,18,18,0,1,31,71,38.25920303488623,-109.35969
27893,3,18,18,0,1,31,71,38.25920303488623,-109.3594205
27894,2,22,15,1,2,25,67,38.25920303488623,-109.359151
27895,2,35,11,1,11,12,72,38.25920303488623,-109.3588815
27896,2,41,10,1,15,5,74,38.25920303488623,-109.358612
27897,3,43,11,2,16,4,79,38.25920303488623,-109.3583425
27898,3,40,11,3,15,4,76,38.25920303488623,-109.358073
27899,1,38,11,0,15,8,73,38.25920303488623,-109.3578035
27900,1,40,10,1,14,6,72,38.25920303488623,-109.357534
27901,1,37,10,2,14,7,71,38.25920303488623,-109.3572645
27902,0,29,11,1,11,13,65,38.25920303488623,-109.356995
27903,2,27,12,0,5,20,66,38.25920303488623,-109.3567255
27904,4,27,15,4,4,19,73,38.25920303488623,-109.356456
27905,4,29,15,4,4,19,75,38.25920303488623,-109.3561865
27906,1,38,13,1,6,18,77,38.25920303488623,-109.355917
27907,2,42,12,0,8,16,80,38.25920303488623,-109.3556475
27908,0,41,11,0,9,15,76,38.25920303488623,-109.355378
27909,3,32,14,8,6,14,77,38.25920303488623,-109.3551086
27910,3,31,14,7,6,15,76,38.25920303488623,-109.3548391
27911,3,32,13,3,9,12,72,38.25920303488623,-109.3545696
27912,3,34,12,2,11,10,72,38.25920303488623,-109.3543001
27913,3,35,13,6,8,12,77,38.25920303488623,-109.3540306
27914,1,31,12,0,9,17,70,38.25920303488623,-109.3537611
27915,2,33,12,1,6,20,74,38.25920303488623,-109.3534916
27916,3,34,11,3,7,16,74,38.25920303488623,-109.3532221
27917,8,32,12,11,16,3,82,38.25920303488623,-109.3529526
27918,10,31,12,16,15,4,88,38.25920303488623,-109.3526831
27919,12,29,13,13,19,4,90,38.25920303488623,-109.3524136
27920,11,23,13,19,20,2,88,38.25920303488623,-109.3521441
27921,9,17,11,23,20,2,82,38.25920303488623,-109.3518746
27922,5,19,12,15,20,3,74,38.25920303488623,-109.3516051
27923,7,19,12,18,14,1,71,38.25920303488623,-109.3513356
27924,5,28,12,4,21,2,72,38.25920303488623,-109.3510661
27925,2,28,18,0,11,18,77,38.25920303488623,-109.3507966
27926,1,20,17,0,3,29,70,38.25920303488623,-109.3505271
27927,0,21,17,0,3,31,72,38.25920303488623,-109.3502577
27928,1,24,17,0,3,30,75,38.25920303488623,-109.3499882
27929,1,25,18,0,4,30,78,38.25920303488623,-109.3497187
27930,1,25,20,0,4,31,81,38.25920303488623,-109.3494492
27931,0,26,20,0,4,32,82,38.25920303488623,-109.3491797
27932,1,25,20,0,5,31,82,38.25920303488623,-109.3489102
27933,1,23,19,0,4,32,79,38.25920303488623,-109.3486407
27934,1,19,19,0,2,35,76,38.25920303488623,-109.3483712
27935,1,17,20,0,1,36,75,38.25920303488623,-109.3481017
27936,1,14,19,0,0,36,70,38.25920303488623,-109.3478322
27937,1,16,19,0,0,35,71,38.25920303488623,-109.3475627
27938,1,17,18,0,0,34,70,38.25920303488623,-109.3472932
27939,1,17,18,0,0,33,69,38.25920303488623,-109.3470237
27940,1,15,18,0,0,33,67,38.25920303488623,-109.3467542
27941,2,15,19,0,0,34,70,38.25920303488623,-109.3464847
27942,1,14,19,0,0,34,68,38.25920303488623,-109.3462152
27943,1,14,18,0,0,33,66,38.25920303488623,-109.3459457
27944,2,15,19,0,0,32,68,38.25920303488623,-109.3456762
27945,1,17,18,0,0,31,67,38.25920303488623,-109.3454068
27946,3,17,18,0,0,30,68,38.25920303488623,-109.3451373
27947,1,15,18,0,0,32,66,38.25920303488623,-109.3448678
27948,1,16,18,0,1,33,69,38.25920303488623,-109.3445983
27949,1,20,18,0,3,31,73,38.25920303488623,-109.3443288
27950,1,21,18,0,3,32,75,38.25920303488623,-109.3440593
27951,3,23,18,1,4,29,78,38.25920303488623,-109.3437898
27952,3,23,18,2,4,29,79,38.25920303488623,-109.3435203
27953,2,21,18,0,3,32,76,38.25920303488623,-109.3432508
27954,1,20,20,0,5,35,81,38.25920303488623,-109.3429813
27955,1,18,20,1,6,37,83,38.25920303488623,-109.3427118
27956,1,17,21,1,6,38,84,38.25920303488623,-109.3424423
27957,1,19,21,0,7,36,84,38.25920303488623,-109.3421728
27958,0,26,19,0,8,31,84,38.25920303488623,-109.3419033
27959,1,29,18,5,10,23,86,38.25920303488623,-109.3416338
27960,1,30,17,4,11,22,85,38.25920303488623,-109.3413643
27961,2,25,18,4,8,25,82,38.25920303488623,-109.3410948
27962,3,20,20,4,6,30,83,38.25920303488623,-109.3408253
27963,2,22,21,1,5,34,85,38.25920303488623,-109.3405558
27964,3,22,21,4,3,30,83,38.25920303488623,-109.3402864
27965,1,12,19,0,0,34,66,38.25920303488623,-109.3400169
27966,2,11,17,1,1,29,61,38.25920303488623,-109.3397474
27967,2,14,14,0,1,27,58,38.25920303488623,-109.3394779
27968,2,15,13,0,1,25,56,38.25920303488623,-109.3392084
27969,2,17,13,0,1,22,55,38.25920303488623,-109.3389389
27970,1,19,10,3,4,14,51,38.25920303488623,-109.3386694
27971,1,24,9,2,7,10,53,38.25920303488623,-109.3383999
27972,1,31,7,0,9,7,55,38.25920303488623,-109.3381304
27973,0,42,6,0,10,6,64,38.25920303488623,-109.3378609
27974,0,47,6,0,11,5,69,38.25920303488623,-109.3375914
27975,0,44,6,0,9,7,66,38.25920303488623,-109.3373219
27976,1,34,8,1,8,10,62,38.25920303488623,-109.3370524
27977,1,31,11,3,9,13,68,38.25920303488623,-109.3367829
27978,1,30,11,2,9,14,67,38.25920303488623,-109.3365134
27979,1,27,13,2,9,16,68,38.25920303488623,-109.3362439
27980,2,36,11,1,12,11,73,38.25920303488623,-109.3359744
27981,2,39,10,1,12,10,74,38.25920303488623,-109.3357049
27982,2,33,15,2,9,14,75,38.25920303488623,-109.3354355
27983,2,23,17,1,4,27,74,38.25920303488623,-109.335166
27984,1,21,19,0,5,32,78,38.25920303488623,-109.3348965
27985,1,22,19,0,4,32,78,38.25920303488623,-109.334627
27986,1,23,16,0,4,27,71,38.25920303488623,-109.3343575
27987,2,26,12,0,6,17,63,38.25920303488623,-109.334088
27988,1,24,11,0,7,16,59,38.25920303488623,-109.3338185
27989,1,26,15,1,8,20,71,38.25920303488623,-109.333549
27990,3,28,16,1,7,25,80,38.25920303488623,-109.3332795
27991,1,25,16,0,4,28,74,38.25920303488623,-109.33301
27992,6,49,12,9,14,2,92,38.25893354030099,-109.4437723
27993,7,48,12,9,13,2,91,38.25893354030099,-109.4435028
27994,5,49,11,7,13,3,88,38.25893354030099,-109.4432333
27995,4,52,11,7,13,3,90,38.25893354030099,-109.4429638
27996,4,53,10,7,13,2,89,38.25893354030099,-109.4426943
27997,4,52,11,5,15,2,89,38.25893354030099,-109.4424248
27998,4,50,12,5,16,3,90,38.25893354030099,-109.4421553
27999,6,48,12,6,17,2,91,38.25893354030099,-109.4418858
28000,5,50,12,6,16,2,91,38.25893354030099,-109.4416163
28001,4,51,11,4,16,3,89,38.25893354030099,-109.4413468
28002,4,49,11,6,16,2,88,38.25893354030099,-109.4410773
28003,3,51,11,3,16,4,88,38.25893354030099,-109.4408078
28004,3,51,11,2,16,5,88,38.25893354030099,-109.4405383
28005,2,48,11,1,16,6,84,38.25893354030099,-109.4402688
28006,2,44,10,1,13,8,78,38.25893354030099,-109.4399993
28007,2,46,10,2,15,6,81,38.25893354030099,-109.4397299
28008,3,48,10,1,13,7,82,38.25893354030099,-109.4394604
28009,3,49,10,1,13,7,83,38.25893354030099,-109.4391909
28010,2,50,10,1,14,6,83,38.25893354030099,-109.4389214
28011,2,48,10,0,15,7,82,38.25893354030099,-109.4386519
28012,1,40,10,1,13,9,74,38.25893354030099,-109.4383824
28013,2,35,10,4,13,8,72,38.25893354030099,-109.4381129
28014,3,35,11,5,14,7,75,38.25893354030099,-109.4378434
28015,2,38,11,2,16,7,76,38.25893354030099,-109.4375739
28016,2,36,11,0,12,13,74,38.25893354030099,-109.4373044
28017,3,31,12,3,14,10,73,38.25893354030099,-109.4370349
28018,4,30,11,4,13,8,70,38.25893354030099,-109.4367654
28019,3,31,10,3,12,8,67,38.25893354030099,-109.4364959
28020,2,34,9,3,12,7,67,38.25893354030099,-109.4362264
28021,2,39,9,2,13,7,72,38.25893354030099,-109.4359569
28022,2,41,10,3,16,5,77,38.25893354030099,-109.4356874
28023,1,44,10,2,16,6,79,38.25893354030099,-109.4354179
28024,2,47,10,1,15,6,81,38.25893354030099,-109.4351484
28025,3,49,10,2,17,3,84,38.25893354030099,-109.434879
28026,3,45,10,2,19,2,81,38.25893354030099,-109.4346095
28027,5,42,11,2,18,4,82,38.25893354030099,-109.43434
28028,8,42,12,7,17,2,88,38.25893354030099,-109.4340705
28029,11,44,13,11,14,1,94,38.25893354030099,-109.433801
28030,12,43,14,12,14,1,96,38.25893354030099,-109.4335315
28031,9,42,14,13,14,1,93,38.25893354030099,-109.433262
28032,8,43,14,12,14,1,92,38.25893354030099,-109.4329925
28033,9,44,14,12,15,0,94,38.25893354030099,-109.432723
28034,10,44,13,12,15,0,94,38.25893354030099,-109.4324535
28035,12,43,13,11,14,0,93,38.25893354030099,-109.432184
28036,12,42,13,11,14,0,92,38.25893354030099,-109.4319145
28037,14,40,14,12,14,0,94,38.25893354030099,-109.431645
28038,16,39,14,11,14,0,94,38.25893354030099,-109.4313755
28039,16,39,13,11,14,0,93,38.25893354030099,-109.431106
28040,13,42,14,12,14,0,95,38.25893354030099,-109.4308365
28041,13,41,14,12,14,0,94,38.25893354030099,-109.430567
28042,12,41,14,12,14,0,93,38.25893354030099,-109.4302975
28043,13,40,14,12,13,0,92,38.25893354030099,-109.430028
28044,20,37,13,10,12,0,92,38.25893354030099,-109.4297586
28045,25,33,13,8,12,0,91,38.25893354030099,-109.4294891
28046,26,33,13,8,12,0,92,38.25893354030099,-109.4292196
28047,24,34,13,8,13,0,92,38.25893354030099,-109.4289501
28048,19,37,13,9,14,0,92,38.25893354030099,-109.4286806
28049,14,40,13,11,15,0,93,38.25893354030099,-109.4284111
28050,14,39,14,11,15,0,93,38.25893354030099,-109.4281416
28051,15,38,14,11,15,0,93,38.25893354030099,-109.4278721
28052,17,37,13,10,14,0,91,38.25893354030099,-109.4276026
28053,19,36,13,10,14,0,92,38.25893354030099,-109.4273331
28054,20,35,14,10,13,0,92,38.25893354030099,-109.4270636
28055,17,36,14,11,14,0,92,38.25893354030099,-109.4267941
28056,17,37,14,11,14,0,93,38.25893354030099,-109.4265246
28057,17,37,14,11,14,0,93,38.25893354030099,-109.4262551
28058,16,36,14,12,14,0,92,38.25893354030099,-109.4259856
28059,10,42,14,13,14,0,93,38.25893354030099,-109.4257161
28060,9,44,14,12,14,0,93,38.25893354030099,-109.4254466
28061,10,43,14,12,15,0,94,38.25893354030099,-109.4251771
28062,12,41,14,12,15,0,94,38.25893354030099,-109.4249077
28063,14,40,14,11,14,0,93,38.25893354030099,-109.4246382
28064,13,40,14,12,14,0,93,38.25893354030099,-109.4243687
28065,11,42,14,12,14,0,93,38.25893354030099,-109.4240992
28066,9,44,14,11,14,1,93,38.25893354030099,-109.4238297
28067,9,46,14,11,14,0,94,38.25893354030099,-109.4235602
28068,11,44,14,10,14,0,93,38.25893354030099,-109.4232907
28069,11,43,14,11,14,0,93,38.25893354030099,-109.4230212
28070,11,43,14,12,14,0,94,38.25893354030099,-109.4227517
28071,12,41,14,12,14,0,93,38.25893354030099,-109.4224822
28072,15,37,14,12,14,0,92,38.25893354030099,-109.4222127
28073,15,37,14,13,14,0,93,38.25893354030099,-109.4219432
28074,11,39,14,13,15,0,92,38.25893354030099,-109.4216737
28075,8,42,14,12,15,1,92,38.25893354030099,-109.4214042
28076,9,42,14,11,15,1,92,38.25893354030099,-109.4211347
28077,7,43,13,10,16,1,90,38.25893354030099,-109.4208652
28078,11,40,14,11,15,0,91,38.25893354030099,-109.4205957
28079,13,38,14,12,15,0,92,38.25893354030099,-109.4203262
28080,10,42,12,10,15,0,89,38.25893354030099,-109.4200568
28081,8,49,10,8,13,1,89,38.25893354030099,-109.4197873
28082,8,48,11,9,13,1,90,38.25893354030099,-109.4195178
28083,10,44,12,10,14,0,90,38.25893354030099,-109.4192483
28084,10,43,14,11,14,0,92,38.25893354030099,-109.4189788
28085,11,43,13,10,14,0,91,38.25893354030099,-109.4187093
28086,13,41,13,11,13,0,91,38.25893354030099,-109.4184398
28087,13,38,14,12,14,0,91,38.25893354030099,-109.4181703
28088,17,36,14,12,14,0,93,38.25893354030099,-109.4179008
28089,20,32,13,11,13,0,89,38.25893354030099,-109.4176313
28090,19,30,13,12,13,0,87,38.25893354030099,-109.4173618
28091,17,30,14,14,14,0,89,38.25893354030099,-109.4170923
28092,15,32,14,14,14,0,89,38.25893354030099,-109.4168228
28093,16,33,14,14,14,0,91,38.25893354030099,-109.4165533
28094,15,34,14,14,13,0,90,38.25893354030099,-109.4162838
28095,12,37,14,14,13,1,91,38.25893354030099,-109.4160143
28096,10,41,14,13,13,1,92,38.25893354030099,-109.4157448
28097,9,42,14,13,13,1,92,38.25893354030099,-109.4154753
28098,8,43,14,13,13,1,92,38.25893354030099,-109.4152058
28099,10,42,15,14,13,1,95,38.25893354030099,-109.4149364
28100,14,38,15,13,13,1,94,38.25893354030099,-109.4146669
28101,11,39,15,12,13,1,91,38.25893354030099,-109.4143974
28102,10,41,15,13,13,1,93,38.25893354030099,-109.4141279
28103,14,37,15,14,13,0,93,38.25893354030099,-109.4138584
28104,19,31,15,15,12,0,92,38.25893354030099,-109.4135889
28105,17,32,15,15,12,0,91,38.25893354030099,-109.4133194
28106,11,41,14,12,14,0,92,38.25893354030099,-109.4130499
28107,8,46,14,10,15,1,94,38.25893354030099,-109.4127804
28108,6,48,14,10,15,1,94,38.25893354030099,-109.4125109
28109,6,50,13,10,14,1,94,38.25893354030099,-109.4122414
28110,5,49,13,10,15,1,93,38.25893354030099,-109.4119719
28111,5,50,13,9,15,1,93,38.25893354030099,-109.4117024
28112,6,50,13,9,15,1,94,38.25893354030099,-109.4114329
28113,6,49,13,9,15,1,93,38.25893354030099,-109.4111634
28114,6,46,13,10,16,0,91,38.25893354030099,-109.4108939
28115,8,44,14,11,15,0,92,38.25893354030099,-109.4106244
28116,6,44,13,11,16,0,90,38.25893354030099,-109.4103549
28117,5,46,13,10,17,0,91,38.25893354030099,-109.4100855
28118,5,47,13,8,17,0,90,38.25893354030099,-109.409816
28119,5,47,13,8,17,0,90,38.25893354030099,-109.4095465
28120,6,45,13,10,16,0,90,38.25893354030099,-109.409277
28121,7,45,13,12,15,0,92,38.25893354030099,-109.4090075
28122,8,45,13,12,14,0,92,38.25893354030099,-109.408738
28123,7,47,13,10,15,0,92,38.25893354030099,-109.4084685
28124,6,48,13,9,16,0,92,38.25893354030099,-109.408199
28125,5,48,13,9,16,0,91,38.25893354030099,-109.4079295
28126,4,49,13,8,17,0,91,38.25893354030099,-109.40766
28127,4,50,13,7,18,1,93,38.25893354030099,-109.4073905
28128,4,48,12,5,16,2,87,38.25893354030099,-109.407121
28129,2,51,10,1,14,5,83,38.25893354030099,-109.4068515
28130,4,42,12,2,14,9,83,38.25893354030099,-109.3882564
28131,4,46,11,2,14,7,84,38.25893354030099,-109.3879869
28132,2,41,9,3,13,5,73,38.25893354030099,-109.3877174
28133,1,39,8,3,10,5,66,38.25893354030099,-109.3874479
28134,3,43,8,4,9,3,70,38.25893354030099,-109.3871784
28135,5,35,9,6,11,4,70,38.25893354030099,-109.3869089
28136,3,35,10,4,10,7,69,38.25893354030099,-109.3866394
28137,5,30,10,6,9,9,69,38.25893354030099,-109.3863699
28138,10,28,12,9,9,7,75,38.25893354030099,-109.3861004
28139,14,31,13,12,12,3,85,38.25893354030099,-109.3858309
28140,7,36,12,9,14,5,83,38.25893354030099,-109.3855614
28141,5,41,11,5,15,7,84,38.25893354030099,-109.3852919
28142,3,40,11,1,14,11,80,38.25893354030099,-109.3850225
28143,2,38,12,1,13,12,78,38.25893354030099,-109.384753
28144,2,37,12,2,15,8,76,38.25893354030099,-109.3844835
28145,2,37,10,0,15,9,73,38.25893354030099,-109.384214
28146,2,37,11,0,13,11,74,38.25893354030099,-109.3839445
28147,3,36,11,0,12,12,74,38.25893354030099,-109.383675
28148,4,37,12,1,14,11,79,38.25893354030099,-109.3834055
28149,4,42,12,2,16,8,84,38.25893354030099,-109.383136
28150,6,43,13,3,18,5,88,38.25893354030099,-109.3828665
28151,6,44,12,4,18,3,87,38.25893354030099,-109.382597
28152,6,44,12,5,18,2,87,38.25893354030099,-109.3823275
28153,6,45,12,5,18,2,88,38.25893354030099,-109.382058
28154,5,46,12,4,18,2,87,38.25893354030099,-109.3817885
28155,11,40,12,8,16,1,88,38.25893354030099,-109.381519
28156,19,35,12,9,13,0,88,38.25893354030099,-109.3812495
28157,20,35,13,10,12,0,90,38.25893354030099,-109.38098
28158,16,40,13,9,14,0,92,38.25893354030099,-109.3807105
28159,8,46,13,7,17,0,91,38.25893354030099,-109.380441
28160,5,45,12,3,16,4,85,38.25893354030099,-109.3801716
28161,4,40,9,2,13,5,73,38.25893354030099,-109.3799021
28162,5,32,8,6,8,5,64,38.25893354030099,-109.3796326
28163,5,42,8,9,7,1,72,38.25893354030099,-109.3793631
28164,3,42,8,6,10,3,72,38.25893354030099,-109.3790936
28165,3,37,9,4,8,6,67,38.25893354030099,-109.3788241
28166,3,31,10,2,7,9,62,38.25893354030099,-109.3785546
28167,4,30,10,2,9,7,62,38.25893354030099,-109.3782851
28168,6,35,9,5,10,4,69,38.25893354030099,-109.3780156
28169,3,32,8,3,7,7,60,38.25893354030099,-109.3777461
28170,3,29,9,2,7,8,58,38.25893354030099,-109.3774766
28171,4,28,10,3,8,8,61,38.25893354030099,-109.3772071
28172,3,27,11,2,7,10,60,38.25893354030099,-109.3769376
28173,4,32,14,5,8,9,72,38.25893354030099,-109.3766681
28174,3,38,12,2,11,10,76,38.25893354030099,-109.3763986
28175,1,37,11,0,9,16,74,38.25893354030099,-109.3761291
28176,0,33,12,0,8,19,72,38.25893354030099,-109.3758596
28177,0,31,11,3,14,11,70,38.25893354030099,-109.3755901
28178,3,38,10,4,16,6,77,38.25893354030099,-109.3753206
28179,1,36,10,4,15,7,73,38.25893354030099,-109.3750512
28180,0,31,11,2,15,10,69,38.25893354030099,-109.3747817
28181,0,29,13,0,9,21,72,38.25893354030099,-109.3745122
28182,0,31,16,0,7,28,82,38.25893354030099,-109.3742427
28183,0,26,15,0,7,26,74,38.25893354030099,-109.3739732
28184,1,24,13,3,8,18,67,38.25893354030099,-109.3737037
28185,3,26,13,7,11,13,73,38.25893354030099,-109.3734342
28186,4,28,15,3,8,18,76,38.25893354030099,-109.3731647
28187,3,29,14,2,6,19,73,38.25893354030099,-109.3728952
28188,2,31,12,2,9,16,72,38.25893354030099,-109.3726257
28189,1,27,12,2,7,18,67,38.25893354030099,-109.3723562
28190,1,27,13,1,7,20,69,38.25893354030099,-109.3720867
28191,1,29,14,2,7,20,73,38.25893354030099,-109.3718172
28192,1,32,14,1,7,20,75,38.25893354030099,-109.3715477
28193,1,35,13,0,8,19,76,38.25893354030099,-109.3712782
28194,1,31,13,1,10,17,73,38.25893354030099,-109.3710087
28195,1,29,13,4,11,16,74,38.25893354030099,-109.3707392
28196,2,30,14,4,13,18,81,38.25893354030099,-109.3704697
28197,1,31,15,2,12,21,82,38.25893354030099,-109.3702003
28198,0,30,15,3,8,24,80,38.25893354030099,-109.3699308
28199,0,28,16,2,7,25,78,38.25893354030099,-109.3696613
28200,1,30,16,1,8,23,79,38.25893354030099,-109.3693918
28201,1,32,17,1,9,23,83,38.25893354030099,-109.3691223
28202,1,29,16,3,8,24,81,38.25893354030099,-109.3688528
28203,3,27,15,6,8,21,80,38.25893354030099,-109.3685833
28204,4,27,15,7,9,17,79,38.25893354030099,-109.3683138
28205,3,28,14,6,10,17,78,38.25893354030099,-109.3680443
28206,3,27,15,8,12,14,79,38.25893354030099,-109.3677748
28207,1,27,14,3,10,19,74,38.25893354030099,-109.3675053
28208,0,26,13,0,8,23,70,38.25893354030099,-109.3672358
28209,1,26,13,1,8,20,69,38.25893354030099,-109.3669663
28210,3,29,13,0,8,22,75,38.25893354030099,-109.3666968
28211,1,25,13,0,6,24,69,38.25893354030099,-109.3664273
28212,2,26,13,0,7,23,71,38.25893354030099,-109.3661578
28213,2,28,13,0,8,21,72,38.25893354030099,-109.3658883
28214,2,30,11,0,9,19,71,38.25893354030099,-109.3656188
28215,2,33,11,0,11,16,73,38.25893354030099,-109.3653493
28216,1,30,12,0,10,18,71,38.25893354030099,-109.3650799
28217,1,29,12,0,8,20,70,38.25893354030099,-109.3648104
28218,2,31,13,0,9,19,74,38.25893354030099,-109.3645409
28219,2,30,12,0,8,19,71,38.25893354030099,-109.3642714
28220,3,33,12,1,8,16,73,38.25893354030099,-109.3640019
28221,5,36,12,0,9,14,76,38.25893354030099,-109.3637324
28222,6,37,13,1,10,14,81,38.25893354030099,-109.3634629
28223,7,36,14,3,10,13,83,38.25893354030099,-109.3631934
28224,6,35,14,1,9,16,81,38.25893354030099,-109.3629239
28225,5,36,14,1,9,16,81,38.25893354030099,-109.3626544
28226,4,34,13,0,8,19,78,38.25893354030099,-109.3623849
28227,3,31,13,0,6,21,74,38.25893354030099,-109.3621154
28228,2,27,13,0,3,24,69,38.25893354030099,-109.3618459
28229,2,22,16,0,1,27,68,38.25893354030099,-109.3615764
28230,2,22,16,0,3,28,71,38.25893354030099,-109.3613069
28231,2,23,15,0,5,26,71,38.25893354030099,-109.3610374
28232,2,25,15,0,5,25,72,38.25893354030099,-109.3607679
28233,0,20,16,0,2,29,67,38.25893354030099,-109.3604984
28234,2,22,17,0,2,28,71,38.25893354030099,-109.360229
28235,1,18,16,0,1,30,66,38.25893354030099,-109.3599595
28236,1,18,16,0,1,29,65,38.25893354030099,-109.35969
28237,2,20,15,0,2,27,66,38.25893354030099,-109.3594205
28238,1,24,12,0,2,21,60,38.25893354030099,-109.359151
28239,1,32,9,2,8,11,63,38.25893354030099,-109.3588815
28240,2,37,9,4,11,6,69,38.25893354030099,-109.358612
28241,4,43,10,7,13,2,79,38.25893354030099,-109.3583425
28242,2,42,10,6,13,3,76,38.25893354030099,-109.358073
28243,1,33,12,1,13,12,72,38.25893354030099,-109.3578035
28244,2,34,13,2,12,11,74,38.25893354030099,-109.357534
28245,1,32,12,1,13,10,69,38.25893354030099,-109.3572645
28246,0,26,11,1,11,13,62,38.25893354030099,-109.356995
28247,2,28,13,2,10,13,68,38.25893354030099,-109.3567255
28248,2,37,13,3,5,16,76,38.25893354030099,-109.356456
28249,1,34,14,0,9,13,71,38.25893354030099,-109.3561865
28250,2,36,14,0,10,14,76,38.25893354030099,-109.355917
28251,1,43,12,0,8,15,79,38.25893354030099,-109.3556475
28252,0,37,12,1,8,15,73,38.25893354030099,-109.355378
28253,1,31,12,4,10,13,71,38.25893354030099,-109.3551086
28254,0,32,12,2,11,12,69,38.25893354030099,-109.3548391
28255,1,37,12,1,6,17,74,38.25893354030099,-109.3545696
28256,1,38,10,1,8,14,72,38.25893354030099,-109.3543001
28257,1,31,12,1,10,14,69,38.25893354030099,-109.3540306
28258,1,34,11,0,11,13,70,38.25893354030099,-109.3537611
28259,1,33,11,0,13,13,71,38.25893354030099,-109.3534916
28260,5,30,12,11,12,7,77,38.25893354030099,-109.3532221
28261,14,33,12,11,18,2,90,38.25893354030099,-109.3529526
28262,12,27,14,13,21,1,88,38.25893354030099,-109.3526831
28263,12,27,14,12,21,1,87,38.25893354030099,-109.3524136
28264,10,29,13,14,22,0,88,38.25893354030099,-109.3521441
28265,10,21,11,19,18,0,79,38.25893354030099,-109.3518746
28266,7,13,11,18,14,1,64,38.25893354030099,-109.3516051
28267,11,17,11,14,17,1,71,38.25893354030099,-109.3513356
28268,6,23,13,10,12,9,73,38.25893354030099,-109.3510661
28269,3,22,18,3,6,24,76,38.25893354030099,-109.3507966
28270,3,22,20,0,6,30,81,38.25893354030099,-109.3505271
28271,2,25,20,0,5,31,83,38.25893354030099,-109.3502577
28272,3,26,19,0,5,30,83,38.25893354030099,-109.3499882
28273,1,24,18,0,4,31,78,38.25893354030099,-109.3497187
28274,0,22,17,0,2,31,72,38.25893354030099,-109.3494492
28275,0,20,17,0,1,32,70,38.25893354030099,-109.3491797
28276,0,19,18,0,2,34,73,38.25893354030099,-109.3489102
28277,0,20,18,0,1,35,74,38.25893354030099,-109.3486407
28278,1,19,18,0,1,35,74,38.25893354030099,-109.3483712
28279,1,18,19,0,1,33,72,38.25893354030099,-109.3481017
28280,1,17,17,0,0,32,67,38.25893354030099,-109.3478322
28281,2,19,18,0,0,32,71,38.25893354030099,-109.3475627
28282,2,17,18,0,0,32,69,38.25893354030099,-109.3472932
28283,2,16,17,0,0,32,67,38.25893354030099,-109.3470237
28284,2,15,17,0,0,32,66,38.25893354030099,-109.3467542
28285,2,13,18,0,0,33,66,38.25893354030099,-109.3464847
28286,2,14,18,0,0,33,67,38.25893354030099,-109.3462152
28287,2,14,18,0,0,33,67,38.25893354030099,-109.3459457
28288,2,15,18,0,0,31,66,38.25893354030099,-109.3456762
28289,2,15,17,0,0,29,63,38.25893354030099,-109.3454068
28290,2,13,17,0,0,29,61,38.25893354030099,-109.3451373
28291,2,12,17,0,0,31,62,38.25893354030099,-109.3448678
28292,1,15,17,0,0,32,65,38.25893354030099,-109.3445983
28293,1,18,17,0,0,30,66,38.25893354030099,-109.3443288
28294,0,19,18,0,2,31,70,38.25893354030099,-109.3440593
28295,2,24,18,1,5,30,80,38.25893354030099,-109.3437898
28296,2,22,19,0,4,32,79,38.25893354030099,-109.3435203
28297,1,21,18,0,1,33,74,38.25893354030099,-109.3432508
28298,2,21,18,0,1,30,72,38.25893354030099,-109.3429813
28299,2,20,19,2,4,33,80,38.25893354030099,-109.3427118
28300,1,19,20,1,5,37,83,38.25893354030099,-109.3424423
28301,1,20,20,0,6,36,83,38.25893354030099,-109.3421728
28302,1,24,20,0,7,33,85,38.25893354030099,-109.3419033
28303,2,27,19,3,10,24,85,38.25893354030099,-109.3416338
28304,2,28,18,3,12,24,87,38.25893354030099,-109.3413643
28305,1,22,20,2,6,32,83,38.25893354030099,-109.3410948
28306,1,18,23,0,4,36,82,38.25893354030099,-109.3408253
28307,1,18,21,0,2,35,77,38.25893354030099,-109.3405558
28308,3,15,18,3,2,28,69,38.25893354030099,-109.3402864
28309,3,10,17,0,0,30,60,38.25893354030099,-109.3400169
28310,2,12,16,1,1,28,60,38.25893354030099,-109.3397474
28311,3,17,14,1,2,25,62,38.25893354030099,-109.3394779
28312,2,15,14,1,2,24,58,38.25893354030099,-109.3392084
28313,2,16,14,1,2,22,57,38.25893354030099,-109.3389389
28314,1,21,11,3,5,16,57,38.25893354030099,-109.3386694
28315,2,31,9,3,10,8,63,38.25893354030099,-109.3383999
28316,1,40,8,2,11,6,68,38.25893354030099,-109.3381304
28317,1,43,8,2,12,7,73,38.25893354030099,-109.3378609
28318,1,29,9,3,9,12,63,38.25893354030099,-109.3375914
28319,1,21,12,6,6,17,63,38.25893354030099,-109.3373219
28320,1,19,16,4,4,22,66,38.25893354030099,-109.3370524
28321,0,19,16,1,3,27,66,38.25893354030099,-109.3367829
28322,1,20,14,0,3,23,61,38.25893354030099,-109.3365134
28323,1,20,15,1,4,24,65,38.25893354030099,-109.3362439
28324,1,20,16,0,4,24,65,38.25893354030099,-109.3359744
28325,1,19,16,0,4,25,65,38.25893354030099,-109.3357049
28326,1,20,17,1,4,26,69,38.25893354030099,-109.3354355
28327,3,21,16,2,4,23,69,38.25893354030099,-109.335166
28328,2,20,17,1,4,27,71,38.25893354030099,-109.3348965
28329,2,22,17,1,4,27,73,38.25893354030099,-109.334627
28330,2,24,16,0,5,26,73,38.25893354030099,-109.3343575
28331,3,21,14,2,5,21,66,38.25893354030099,-109.334088
28332,1,20,14,1,5,22,63,38.25893354030099,-109.3338185
28333,2,25,16,0,6,24,73,38.25893354030099,-109.333549
28334,2,25,15,0,4,26,72,38.25893354030099,-109.3332795
28335,2,24,14,0,3,26,69,38.25893354030099,-109.33301
28336,2,20,15,0,2,27,66,38.25893354030099,-109.3327405
28337,6,49,11,9,13,2,90,38.25866404571575,-109.4437723
28338,5,53,11,8,13,2,92,38.25866404571575,-109.4435028
28339,4,54,10,8,13,2,91,38.25866404571575,-109.4432333
28340,4,54,11,8,13,2,92,38.25866404571575,-109.4429638
28341,4,51,11,7,15,2,90,38.25866404571575,-109.4426943
28342,4,50,11,6,16,2,89,38.25866404571575,-109.4424248
28343,5,51,12,5,17,2,92,38.25866404571575,-109.4421553
28344,6,49,12,6,16,1,90,38.25866404571575,-109.4418858
28345,4,50,12,5,16,2,89,38.25866404571575,-109.4416163
28346,4,51,11,4,16,3,89,38.25866404571575,-109.4413468
28347,5,51,11,6,16,2,91,38.25866404571575,-109.4410773
28348,4,50,11,5,16,3,89,38.25866404571575,-109.4408078
28349,3,51,11,3,16,4,88,38.25866404571575,-109.4405383
28350,3,51,11,2,15,6,88,38.25866404571575,-109.4402688
28351,3,49,11,1,15,8,87,38.25866404571575,-109.4399993
28352,2,47,11,2,15,7,84,38.25866404571575,-109.4397299
28353,2,51,10,2,14,6,85,38.25866404571575,-109.4394604
28354,3,49,10,2,13,6,83,38.25866404571575,-109.4391909
28355,2,45,10,1,14,7,79,38.25866404571575,-109.4389214
28356,2,42,11,0,15,8,78,38.25866404571575,-109.4386519
28357,1,38,11,0,12,14,76,38.25866404571575,-109.4383824
28358,1,38,12,0,12,15,78,38.25866404571575,-109.4381129
28359,2,39,12,2,15,13,83,38.25866404571575,-109.4378434
28360,4,39,13,3,15,11,85,38.25866404571575,-109.4375739
28361,4,38,13,2,11,14,82,38.25866404571575,-109.4373044
28362,3,35,13,2,9,16,78,38.25866404571575,-109.4370349
28363,3,31,11,1,12,12,70,38.25866404571575,-109.4367654
28364,3,31,10,0,12,10,66,38.25866404571575,-109.4364959
28365,1,33,10,0,12,10,66,38.25866404571575,-109.4362264
28366,1,35,9,3,12,8,68,38.25866404571575,-109.4359569
28367,1,39,10,1,15,6,72,38.25866404571575,-109.4356874
28368,1,44,8,0,13,8,74,38.25866404571575,-109.4354179
28369,1,44,9,0,15,7,76,38.25866404571575,-109.4351484
28370,3,44,10,3,18,3,81,38.25866404571575,-109.434879
28371,2,45,9,0,16,5,77,38.25866404571575,-109.4346095
28372,5,41,11,3,18,3,81,38.25866404571575,-109.43434
28373,7,43,12,7,17,2,88,38.25866404571575,-109.4340705
28374,9,44,13,11,15,1,93,38.25866404571575,-109.433801
28375,11,43,14,12,14,1,95,38.25866404571575,-109.4335315
28376,9,43,14,12,15,1,94,38.25866404571575,-109.433262
28377,9,44,14,12,15,1,95,38.25866404571575,-109.4329925
28378,12,42,14,11,15,0,94,38.25866404571575,-109.432723
28379,15,40,13,11,14,0,93,38.25866404571575,-109.4324535
28380,13,42,13,11,14,0,93,38.25866404571575,-109.432184
28381,15,38,14,12,14,0,93,38.25866404571575,-109.4319145
28382,18,37,14,11,13,0,93,38.25866404571575,-109.431645
28383,21,36,14,10,13,0,94,38.25866404571575,-109.4313755
28384,20,36,14,11,13,0,94,38.25866404571575,-109.431106
28385,16,38,14,12,13,0,93,38.25866404571575,-109.4308365
28386,14,41,14,11,14,0,94,38.25866404571575,-109.430567
28387,13,42,14,11,14,0,94,38.25866404571575,-109.4302975
28388,13,41,13,12,14,0,93,38.25866404571575,-109.430028
28389,18,37,13,10,13,0,91,38.25866404571575,-109.4297586
28390,27,33,13,8,11,0,92,38.25866404571575,-109.4294891
28391,26,33,13,8,12,0,92,38.25866404571575,-109.4292196
28392,23,34,13,8,13,0,91,38.25866404571575,-109.4289501
28393,19,37,14,10,14,0,94,38.25866404571575,-109.4286806
28394,13,40,13,11,15,0,92,38.25866404571575,-109.4284111
28395,11,42,14,11,15,0,93,38.25866404571575,-109.4281416
28396,12,40,14,12,15,0,93,38.25866404571575,-109.4278721
28397,15,39,13,11,15,0,93,38.25866404571575,-109.4276026
28398,19,35,13,10,14,0,91,38.25866404571575,-109.4273331
28399,24,32,14,10,13,0,93,38.25866404571575,-109.4270636
28400,25,33,14,9,12,0,93,38.25866404571575,-109.4267941
28401,23,35,14,9,13,0,94,38.25866404571575,-109.4265246
28402,20,35,14,11,13,0,93,38.25866404571575,-109.4262551
28403,15,37,14,13,13,0,92,38.25866404571575,-109.4259856
28404,11,40,15,14,14,0,94,38.25866404571575,-109.4257161
28405,9,44,14,13,15,1,96,38.25866404571575,-109.4254466
28406,9,45,14,11,16,0,95,38.25866404571575,-109.4251771
28407,10,45,14,11,16,0,96,38.25866404571575,-109.4249077
28408,13,41,14,11,14,0,93,38.25866404571575,-109.4246382
28409,13,39,14,12,14,0,92,38.25866404571575,-109.4243687
28410,12,40,14,12,14,0,92,38.25866404571575,-109.4240992
28411,11,41,14,12,13,1,92,38.25866404571575,-109.4238297
28412,12,40,14,12,13,0,91,38.25866404571575,-109.4235602
28413,13,42,14,10,14,0,93,38.25866404571575,-109.4232907
28414,10,43,14,12,15,0,94,38.25866404571575,-109.4230212
28415,10,42,14,12,14,0,92,38.25866404571575,-109.4227517
28416,13,39,14,12,14,0,92,38.25866404571575,-109.4224822
28417,18,35,14,12,13,0,92,38.25866404571575,-109.4222127
28418,15,37,14,12,14,0,92,38.25866404571575,-109.4219432
28419,12,39,14,13,14,0,92,38.25866404571575,-109.4216737
28420,10,41,14,12,15,0,92,38.25866404571575,-109.4214042
28421,9,43,14,11,15,0,92,38.25866404571575,-109.4211347
28422,9,44,13,11,16,0,93,38.25866404571575,-109.4208652
28423,13,40,14,11,14,0,92,38.25866404571575,-109.4205957
28424,11,40,13,11,15,0,90,38.25866404571575,-109.4203262
28425,8,46,11,9,14,1,89,38.25866404571575,-109.4200568
28426,7,50,10,8,13,1,89,38.25866404571575,-109.4197873
28427,10,44,12,9,13,1,89,38.25866404571575,-109.4195178
28428,12,40,13,11,14,0,90,38.25866404571575,-109.4192483
28429,11,40,14,12,14,0,91,38.25866404571575,-109.4189788
28430,12,40,14,12,13,0,91,38.25866404571575,-109.4187093
28431,14,36,14,14,13,0,91,38.25866404571575,-109.4184398
28432,17,35,14,11,13,0,90,38.25866404571575,-109.4181703
28433,17,34,14,12,14,0,91,38.25866404571575,-109.4179008
28434,19,32,14,12,13,0,90,38.25866404571575,-109.4176313
28435,22,31,14,11,13,0,91,38.25866404571575,-109.4173618
28436,23,31,14,12,13,0,93,38.25866404571575,-109.4170923
28437,21,32,14,12,14,0,93,38.25866404571575,-109.4168228
28438,16,35,14,13,14,0,92,38.25866404571575,-109.4165533
28439,12,38,14,13,14,0,91,38.25866404571575,-109.4162838
28440,10,40,14,13,14,1,92,38.25866404571575,-109.4160143
28441,10,40,15,13,14,0,92,38.25866404571575,-109.4157448
28442,7,43,14,13,14,1,92,38.25866404571575,-109.4154753
28443,7,44,14,12,13,1,91,38.25866404571575,-109.4152058
28444,11,41,15,14,13,0,94,38.25866404571575,-109.4149364
28445,14,37,15,14,13,0,93,38.25866404571575,-109.4146669
28446,8,39,14,13,14,1,89,38.25866404571575,-109.4143974
28447,9,40,15,14,14,1,93,38.25866404571575,-109.4141279
28448,11,39,15,15,13,0,93,38.25866404571575,-109.4138584
28449,15,35,14,14,13,0,91,38.25866404571575,-109.4135889
28450,18,32,14,15,13,0,92,38.25866404571575,-109.4133194
28451,14,37,15,14,14,0,94,38.25866404571575,-109.4130499
28452,11,41,15,13,14,0,94,38.25866404571575,-109.4127804
28453,9,45,14,12,15,0,95,38.25866404571575,-109.4125109
28454,7,47,14,11,15,0,94,38.25866404571575,-109.4122414
28455,7,48,13,10,15,0,93,38.25866404571575,-109.4119719
28456,7,49,13,9,15,0,93,38.25866404571575,-109.4117024
28457,7,47,13,10,15,0,92,38.25866404571575,-109.4114329
28458,7,46,13,10,15,0,91,38.25866404571575,-109.4111634
28459,7,46,13,9,15,0,90,38.25866404571575,-109.4108939
28460,8,44,13,12,15,0,92,38.25866404571575,-109.4106244
28461,8,45,13,13,15,0,94,38.25866404571575,-109.4103549
28462,6,46,13,11,16,0,92,38.25866404571575,-109.4100855
28463,6,46,13,9,17,0,91,38.25866404571575,-109.409816
28464,6,45,13,12,15,0,91,38.25866404571575,-109.4095465
28465,10,41,14,15,14,0,94,38.25866404571575,-109.409277
28466,10,40,14,15,13,0,92,38.25866404571575,-109.4090075
28467,10,42,13,14,13,0,92,38.25866404571575,-109.408738
28468,10,43,13,12,14,0,92,38.25866404571575,-109.4084685
28469,7,46,13,11,15,0,92,38.25866404571575,-109.408199
28470,5,48,13,9,17,0,92,38.25866404571575,-109.4079295
28471,4,50,13,7,17,1,92,38.25866404571575,-109.40766
28472,4,50,13,7,17,1,92,38.25866404571575,-109.4073905
28473,4,47,12,6,16,3,88,38.25866404571575,-109.407121
28474,3,48,10,1,15,6,83,38.25866404571575,-109.4068515
28475,3,45,12,3,15,7,85,38.25866404571575,-109.3882564
28476,2,43,10,4,14,4,77,38.25866404571575,-109.3879869
28477,4,32,9,4,11,5,65,38.25866404571575,-109.3877174
28478,3,33,9,4,8,6,63,38.25866404571575,-109.3874479
28479,4,36,9,4,9,6,68,38.25866404571575,-109.3871784
28480,4,36,10,3,11,8,72,38.25866404571575,-109.3869089
28481,2,36,10,5,11,7,71,38.25866404571575,-109.3866394
28482,4,37,10,7,12,5,75,38.25866404571575,-109.3863699
28483,7,39,11,9,13,3,82,38.25866404571575,-109.3861004
28484,13,36,12,11,14,1,87,38.25866404571575,-109.3858309
28485,5,37,12,7,16,7,84,38.25866404571575,-109.3855614
28486,4,42,12,5,18,5,86,38.25866404571575,-109.3852919
28487,2,40,12,3,16,9,82,38.25866404571575,-109.3850225
28488,2,37,12,2,14,12,79,38.25866404571575,-109.384753
28489,4,38,10,1,16,7,76,38.25866404571575,-109.3844835
28490,3,38,10,0,14,9,74,38.25866404571575,-109.384214
28491,2,36,10,0,13,11,72,38.25866404571575,-109.3839445
28492,4,38,11,0,14,10,77,38.25866404571575,-109.383675
28493,5,43,12,2,17,6,85,38.25866404571575,-109.3834055
28494,5,44,12,2,18,5,86,38.25866404571575,-109.383136
28495,6,45,12,4,18,3,88,38.25866404571575,-109.3828665
28496,6,44,12,5,18,2,87,38.25866404571575,-109.382597
28497,7,45,12,5,17,1,87,38.25866404571575,-109.3823275
28498,8,46,12,5,17,1,89,38.25866404571575,-109.382058
28499,7,45,12,6,18,1,89,38.25866404571575,-109.3817885
28500,14,37,12,9,13,1,86,38.25866404571575,-109.381519
28501,20,34,12,10,12,0,88,38.25866404571575,-109.3812495
28502,18,37,13,10,13,0,91,38.25866404571575,-109.38098
28503,12,44,13,8,15,0,92,38.25866404571575,-109.3807105
28504,8,42,12,7,15,1,85,38.25866404571575,-109.380441
28505,6,40,11,4,14,4,79,38.25866404571575,-109.3801716
28506,6,34,9,6,12,3,70,38.25866404571575,-109.3799021
28507,4,37,9,10,8,1,69,38.25866404571575,-109.3796326
28508,2,48,8,6,9,2,75,38.25866404571575,-109.3793631
28509,3,37,9,5,10,5,69,38.25866404571575,-109.3790936
28510,4,31,10,5,9,8,67,38.25866404571575,-109.3788241
28511,4,28,12,3,8,12,67,38.25866404571575,-109.3785546
28512,1,32,11,0,8,14,66,38.25866404571575,-109.3782851
28513,2,40,10,0,11,8,71,38.25866404571575,-109.3780156
28514,5,36,11,3,7,6,68,38.25866404571575,-109.3777461
28515,5,36,10,4,8,6,69,38.25866404571575,-109.3774766
28516,3,35,9,4,10,7,68,38.25866404571575,-109.3772071
28517,2,38,11,3,12,8,74,38.25866404571575,-109.3769376
28518,1,34,12,0,6,19,72,38.25866404571575,-109.3766681
28519,1,38,12,0,11,16,78,38.25866404571575,-109.3763986
28520,0,36,12,0,14,14,76,38.25866404571575,-109.3761291
28521,0,35,13,2,16,13,79,38.25866404571575,-109.3758596
28522,2,33,14,5,16,12,82,38.25866404571575,-109.3755901
28523,0,31,14,0,14,16,75,38.25866404571575,-109.3753206
28524,0,31,11,0,12,18,72,38.25866404571575,-109.3750512
28525,0,31,12,0,12,17,72,38.25866404571575,-109.3747817
28526,1,34,14,2,13,17,81,38.25866404571575,-109.3745122
28527,0,32,16,2,10,21,81,38.25866404571575,-109.3742427
28528,0,30,15,2,10,20,77,38.25866404571575,-109.3739732
28529,0,28,15,3,9,21,76,38.25866404571575,-109.3737037
28530,0,26,16,2,7,24,75,38.25866404571575,-109.3734342
28531,0,26,16,0,6,27,75,38.25866404571575,-109.3731647
28532,0,26,15,1,8,25,75,38.25866404571575,-109.3728952
28533,2,27,14,5,10,19,77,38.25866404571575,-109.3726257
28534,2,25,14,5,10,19,75,38.25866404571575,-109.3723562
28535,1,25,14,3,7,22,72,38.25866404571575,-109.3720867
28536,3,31,13,1,9,21,78,38.25866404571575,-109.3718172
28537,2,31,13,0,10,21,77,38.25866404571575,-109.3715477
28538,1,34,12,0,10,21,78,38.25866404571575,-109.3712782
28539,0,28,13,1,12,20,74,38.25866404571575,-109.3710087
28540,3,31,14,6,20,9,83,38.25866404571575,-109.3707392
28541,1,29,14,4,12,18,78,38.25866404571575,-109.3704697
28542,1,30,15,2,11,21,80,38.25866404571575,-109.3702003
28543,0,28,16,0,8,25,77,38.25866404571575,-109.3699308
28544,1,27,16,0,5,28,77,38.25866404571575,-109.3696613
28545,1,31,15,0,6,26,79,38.25866404571575,-109.3693918
28546,1,26,16,0,5,29,77,38.25866404571575,-109.3691223
28547,0,27,18,0,6,30,81,38.25866404571575,-109.3688528
28548,0,26,17,0,6,28,77,38.25866404571575,-109.3685833
28549,0,26,15,0,9,25,75,38.25866404571575,-109.3683138
28550,1,30,14,0,9,22,76,38.25866404571575,-109.3680443
28551,1,27,13,1,11,18,71,38.25866404571575,-109.3677748
28552,1,29,13,0,10,18,71,38.25866404571575,-109.3675053
28553,1,28,13,0,9,21,72,38.25866404571575,-109.3672358
28554,2,27,14,0,7,22,72,38.25866404571575,-109.3669663
28555,1,24,13,0,5,26,69,38.25866404571575,-109.3666968
28556,1,24,13,0,6,26,70,38.25866404571575,-109.3664273
28557,2,25,13,0,7,23,70,38.25866404571575,-109.3661578
28558,2,27,12,0,9,19,69,38.25866404571575,-109.3658883
28559,1,31,12,0,13,14,71,38.25866404571575,-109.3656188
28560,7,25,10,12,10,11,75,38.25866404571575,-109.3653493
28561,7,25,10,11,9,14,76,38.25866404571575,-109.3650799
28562,7,25,11,11,9,13,76,38.25866404571575,-109.3648104
28563,3,32,13,2,12,13,75,38.25866404571575,-109.3645409
28564,2,31,13,2,12,14,74,38.25866404571575,-109.3642714
28565,2,29,13,0,7,19,70,38.25866404571575,-109.3640019
28566,3,30,13,0,7,20,73,38.25866404571575,-109.3637324
28567,4,33,13,0,8,18,76,38.25866404571575,-109.3634629
28568,6,36,14,1,9,16,82,38.25866404571575,-109.3631934
28569,5,34,14,0,8,18,79,38.25866404571575,-109.3629239
28570,5,36,14,0,10,17,82,38.25866404571575,-109.3626544
28571,4,34,13,0,9,19,79,38.25866404571575,-109.3623849
28572,3,30,14,0,6,22,75,38.25866404571575,-109.3621154
28573,2,25,15,0,3,26,71,38.25866404571575,-109.3618459
28574,1,20,16,0,3,28,68,38.25866404571575,-109.3615764
28575,1,21,16,0,3,29,70,38.25866404571575,-109.3613069
28576,0,20,16,0,3,30,69,38.25866404571575,-109.3610374
28577,1,21,15,0,3,29,69,38.25866404571575,-109.3607679
28578,0,22,16,0,3,27,68,38.25866404571575,-109.3604984
28579,0,20,15,0,2,28,65,38.25866404571575,-109.360229
28580,0,19,16,0,2,28,65,38.25866404571575,-109.3599595
28581,1,19,16,0,2,29,67,38.25866404571575,-109.35969
28582,1,21,15,0,4,27,68,38.25866404571575,-109.3594205
28583,0,25,13,0,4,23,65,38.25866404571575,-109.359151
28584,0,29,12,0,9,18,68,38.25866404571575,-109.3588815
28585,1,30,12,0,11,15,69,38.25866404571575,-109.358612
28586,1,31,12,0,9,18,71,38.25866404571575,-109.3583425
28587,0,28,12,0,6,21,67,38.25866404571575,-109.358073
28588,1,25,14,0,7,22,69,38.25866404571575,-109.3578035
28589,0,23,14,0,3,24,64,38.25866404571575,-109.357534
28590,0,27,11,0,7,17,62,38.25866404571575,-109.3572645
28591,0,38,9,1,13,7,68,38.25866404571575,-109.356995
28592,2,51,9,4,8,8,82,38.25866404571575,-109.3567255
28593,0,50,10,0,9,12,81,38.25866404571575,-109.356456
28594,2,35,14,0,11,13,75,38.25866404571575,-109.3561865
28595,3,31,15,0,8,16,73,38.25866404571575,-109.355917
28596,1,31,14,0,5,20,71,38.25866404571575,-109.3556475
28597,0,33,13,0,5,21,72,38.25866404571575,-109.355378
28598,3,30,14,2,7,18,74,38.25866404571575,-109.3551086
28599,3,33,15,2,10,17,80,38.25866404571575,-109.3548391
28600,1,29,14,0,7,21,72,38.25866404571575,-109.3545696
28601,1,33,12,0,9,19,74,38.25866404571575,-109.3543001
28602,2,31,13,1,5,23,75,38.25866404571575,-109.3540306
28603,5,28,15,3,12,17,80,38.25866404571575,-109.3537611
28604,6,29,15,6,16,11,83,38.25866404571575,-109.3534916
28605,3,27,15,15,18,8,86,38.25866404571575,-109.3532221
28606,3,26,15,17,15,6,82,38.25866404571575,-109.3529526
28607,5,16,15,20,14,9,79,38.25866404571575,-109.3526831
28608,5,22,14,20,16,3,80,38.25866404571575,-109.3524136
28609,9,24,13,17,21,1,85,38.25866404571575,-109.3521441
28610,3,17,11,17,16,0,64,38.25866404571575,-109.3518746
28611,3,11,12,17,18,2,63,38.25866404571575,-109.3516051
28612,4,20,15,5,13,13,70,38.25866404571575,-109.3513356
28613,5,22,17,3,6,23,76,38.25866404571575,-109.3510661
28614,1,22,19,1,5,29,77,38.25866404571575,-109.3507966
28615,1,22,20,0,6,32,81,38.25866404571575,-109.3505271
28616,1,24,20,0,5,32,82,38.25866404571575,-109.3502577
28617,2,26,19,0,5,30,82,38.25866404571575,-109.3499882
28618,1,20,17,0,2,31,71,38.25866404571575,-109.3497187
28619,1,18,17,0,1,31,68,38.25866404571575,-109.3494492
28620,2,17,18,0,1,33,71,38.25866404571575,-109.3491797
28621,1,20,18,0,2,32,73,38.25866404571575,-109.3489102
28622,1,20,18,0,2,33,74,38.25866404571575,-109.3486407
28623,1,18,18,0,0,33,70,38.25866404571575,-109.3483712
28624,1,18,16,0,0,31,66,38.25866404571575,-109.3481017
28625,2,19,16,0,0,29,66,38.25866404571575,-109.3478322
28626,2,19,16,0,0,29,66,38.25866404571575,-109.3475627
28627,2,17,16,0,0,29,64,38.25866404571575,-109.3472932
28628,2,16,16,0,1,29,64,38.25866404571575,-109.3470237
28629,2,15,16,0,1,29,63,38.25866404571575,-109.3467542
28630,3,14,16,1,1,30,65,38.25866404571575,-109.3464847
28631,2,14,17,0,1,31,65,38.25866404571575,-109.3462152
28632,2,14,17,0,0,31,64,38.25866404571575,-109.3459457
28633,2,15,17,0,0,30,64,38.25866404571575,-109.3456762
28634,2,15,16,0,1,30,64,38.25866404571575,-109.3454068
28635,2,15,17,0,1,31,66,38.25866404571575,-109.3451373
28636,1,16,17,0,1,32,67,38.25866404571575,-109.3448678
28637,1,17,17,0,0,31,66,38.25866404571575,-109.3445983
28638,0,18,17,0,0,30,65,38.25866404571575,-109.3443288
28639,1,19,16,0,1,29,66,38.25866404571575,-109.3440593
28640,1,21,18,0,4,30,74,38.25866404571575,-109.3437898
28641,1,22,19,0,4,33,79,38.25866404571575,-109.3435203
28642,1,21,18,0,2,32,74,38.25866404571575,-109.3432508
28643,2,22,16,0,1,27,68,38.25866404571575,-109.3429813
28644,2,21,17,0,2,30,72,38.25866404571575,-109.3427118
28645,2,21,20,0,5,36,84,38.25866404571575,-109.3424423
28646,1,21,20,1,6,36,85,38.25866404571575,-109.3421728
28647,1,23,20,1,7,33,85,38.25866404571575,-109.3419033
28648,2,26,20,3,9,26,86,38.25866404571575,-109.3416338
28649,2,25,19,4,7,29,86,38.25866404571575,-109.3413643
28650,2,21,21,2,6,34,86,38.25866404571575,-109.3410948
28651,0,18,21,0,3,37,79,38.25866404571575,-109.3408253
28652,1,15,19,0,0,34,69,38.25866404571575,-109.3405558
28653,4,14,18,0,0,30,66,38.25866404571575,-109.3402864
28654,2,16,18,0,0,31,67,38.25866404571575,-109.3400169
28655,2,18,17,0,1,30,68,38.25866404571575,-109.3397474
28656,3,20,17,0,1,28,69,38.25866404571575,-109.3394779
28657,2,17,16,0,2,28,65,38.25866404571575,-109.3392084
28658,1,16,17,0,2,29,65,38.25866404571575,-109.3389389
28659,1,17,18,0,2,29,67,38.25866404571575,-109.3386694
28660,1,17,17,0,2,28,65,38.25866404571575,-109.3383999
28661,1,21,15,2,3,25,67,38.25866404571575,-109.3381304
28662,1,28,12,2,7,19,69,38.25866404571575,-109.3378609
28663,1,31,11,3,8,14,68,38.25866404571575,-109.3375914
28664,0,26,11,1,4,19,61,38.25866404571575,-109.3373219
28665,1,18,16,0,3,26,64,38.25866404571575,-109.3370524
28666,0,18,20,0,4,35,77,38.25866404571575,-109.3367829
28667,0,21,21,0,5,34,81,38.25866404571575,-109.3365134
28668,0,19,22,1,6,35,83,38.25866404571575,-109.3362439
28669,0,17,22,1,5,37,82,38.25866404571575,-109.3359744
28670,0,17,22,0,4,39,82,38.25866404571575,-109.3357049
28671,0,18,20,0,2,37,77,38.25866404571575,-109.3354355
28672,1,19,18,0,3,32,73,38.25866404571575,-109.335166
28673,1,21,16,0,3,27,68,38.25866404571575,-109.3348965
28674,1,22,15,0,4,25,67,38.25866404571575,-109.334627
28675,2,22,15,0,4,23,66,38.25866404571575,-109.3343575
28676,2,23,13,1,5,20,64,38.25866404571575,-109.334088
28677,1,22,11,2,5,16,57,38.25866404571575,-109.3338185
28678,1,24,11,0,5,17,58,38.25866404571575,-109.333549
28679,2,24,12,1,4,20,63,38.25866404571575,-109.3332795
28680,2,22,14,0,3,24,65,38.25866404571575,-109.33301
28681,4,22,15,1,4,25,71,38.25866404571575,-109.3327405
28682,4,52,11,9,13,2,91,38.258394551130515,-109.4437723
28683,3,55,8,6,13,3,88,38.258394551130515,-109.4435028
28684,3,56,9,7,13,2,90,38.258394551130515,-109.4432333
28685,4,53,11,8,13,2,91,38.258394551130515,-109.4429638
28686,4,51,11,6,16,2,90,38.258394551130515,-109.4426943
28687,5,51,12,6,16,1,91,38.258394551130515,-109.4424248
28688,7,50,12,7,16,0,92,38.258394551130515,-109.4421553
28689,6,50,12,6,16,1,91,38.258394551130515,-109.4418858
28690,5,51,12,5,16,2,91,38.258394551130515,-109.4416163
28691,4,52,11,4,16,3,90,38.258394551130515,-109.4413468
28692,4,53,11,4,16,2,90,38.258394551130515,-109.4410773
28693,4,52,11,5,15,2,89,38.258394551130515,-109.4408078
28694,4,53,11,5,15,3,91,38.258394551130515,-109.4405383
28695,3,53,11,3,15,4,89,38.258394551130515,-109.4402688
28696,3,53,11,2,14,5,88,38.258394551130515,-109.4399993
28697,3,49,10,2,12,7,83,38.258394551130515,-109.4397299
28698,3,47,10,1,12,6,79,38.258394551130515,-109.4394604
28699,2,46,10,0,12,8,78,38.258394551130515,-109.4391909
28700,1,42,10,0,12,12,77,38.258394551130515,-109.4389214
28701,1,30,11,0,9,17,68,38.258394551130515,-109.4386519
28702,3,39,11,0,12,13,78,38.258394551130515,-109.4383824
28703,3,45,11,0,14,10,83,38.258394551130515,-109.4381129
28704,3,45,11,2,16,8,85,38.258394551130515,-109.4378434
28705,3,43,12,4,16,7,85,38.258394551130515,-109.4375739
28706,4,41,12,3,13,10,83,38.258394551130515,-109.4373044
28707,3,37,11,0,11,13,75,38.258394551130515,-109.4370349
28708,3,34,10,2,10,12,71,38.258394551130515,-109.4367654
28709,2,32,11,2,12,11,70,38.258394551130515,-109.4364959
28710,2,31,11,3,13,10,70,38.258394551130515,-109.4362264
28711,3,32,10,4,13,7,69,38.258394551130515,-109.4359569
28712,3,36,10,4,15,5,73,38.258394551130515,-109.4356874
28713,4,37,10,4,15,4,74,38.258394551130515,-109.4354179
28714,5,38,10,5,16,3,77,38.258394551130515,-109.4351484
28715,7,41,11,6,16,1,82,38.258394551130515,-109.434879
28716,3,44,11,1,18,3,80,38.258394551130515,-109.4346095
28717,6,39,11,4,16,4,80,38.258394551130515,-109.43434
28718,8,43,12,8,16,1,88,38.258394551130515,-109.4340705
28719,8,46,13,11,14,1,93,38.258394551130515,-109.433801
28720,9,45,13,11,14,1,93,38.258394551130515,-109.4335315
28721,8,44,13,11,14,1,91,38.258394551130515,-109.433262
28722,9,44,14,11,15,1,94,38.258394551130515,-109.4329925
28723,14,40,14,11,14,0,93,38.258394551130515,-109.432723
28724,17,38,13,10,14,0,92,38.258394551130515,-109.4324535
28725,15,40,13,11,14,0,93,38.258394551130515,-109.432184
28726,18,36,13,11,13,0,91,38.258394551130515,-109.4319145
28727,23,34,14,10,12,0,93,38.258394551130515,-109.431645
28728,24,34,14,10,12,0,94,38.258394551130515,-109.4313755
28729,20,35,14,11,13,0,93,38.258394551130515,-109.431106
28730,17,36,14,12,13,0,92,38.258394551130515,-109.4308365
28731,14,39,14,12,14,0,93,38.258394551130515,-109.430567
28732,13,41,14,11,14,0,93,38.258394551130515,-109.4302975
28733,12,42,13,11,14,0,92,38.258394551130515,-109.430028
28734,14,40,13,12,14,0,93,38.258394551130515,-109.4297586
28735,23,35,13,8,12,0,91,38.258394551130515,-109.4294891
28736,24,34,13,9,13,0,93,38.258394551130515,-109.4292196
28737,23,34,14,9,13,0,93,38.258394551130515,-109.4289501
28738,19,36,14,10,14,0,93,38.258394551130515,-109.4286806
28739,13,40,14,11,15,0,93,38.258394551130515,-109.4284111
28740,9,41,13,11,15,0,89,38.258394551130515,-109.4281416
28741,10,43,13,11,16,0,93,38.258394551130515,-109.4278721
28742,13,40,14,11,15,0,93,38.258394551130515,-109.4276026
28743,21,34,14,10,14,0,93,38.258394551130515,-109.4273331
28744,27,29,14,10,12,0,92,38.258394551130515,-109.4270636
28745,28,31,14,9,12,0,94,38.258394551130515,-109.4267941
28746,23,33,14,10,13,0,93,38.258394551130515,-109.4265246
28747,18,35,14,12,14,0,93,38.258394551130515,-109.4262551
28748,14,37,14,14,14,0,93,38.258394551130515,-109.4259856
28749,11,41,14,13,14,0,93,38.258394551130515,-109.4257161
28750,9,45,14,12,15,0,95,38.258394551130515,-109.4254466
28751,9,45,13,10,16,0,93,38.258394551130515,-109.4251771
28752,10,44,13,11,16,0,94,38.258394551130515,-109.4249077
28753,14,40,14,12,14,0,94,38.258394551130515,-109.4246382
28754,15,38,14,12,14,0,93,38.258394551130515,-109.4243687
28755,13,39,14,12,14,0,92,38.258394551130515,-109.4240992
28756,13,40,14,12,14,0,93,38.258394551130515,-109.4238297
28757,14,39,14,11,14,0,92,38.258394551130515,-109.4235602
28758,14,39,14,12,13,0,92,38.258394551130515,-109.4232907
28759,9,43,13,12,15,0,92,38.258394551130515,-109.4230212
28760,11,42,13,12,14,0,92,38.258394551130515,-109.4227517
28761,15,39,14,12,14,0,94,38.258394551130515,-109.4224822
28762,16,37,13,11,14,0,91,38.258394551130515,-109.4222127
28763,9,44,14,10,15,0,92,38.258394551130515,-109.4219432
28764,9,42,14,13,15,0,93,38.258394551130515,-109.4216737
28765,10,41,14,13,14,0,92,38.258394551130515,-109.4214042
28766,10,42,14,12,15,0,93,38.258394551130515,-109.4211347
28767,13,40,14,11,15,0,93,38.258394551130515,-109.4208652
28768,10,43,14,10,15,0,92,38.258394551130515,-109.4205957
28769,7,48,11,9,14,1,90,38.258394551130515,-109.4203262
28770,6,50,11,9,14,1,91,38.258394551130515,-109.4200568
28771,7,48,11,8,15,1,90,38.258394551130515,-109.4197873
28772,8,44,13,10,15,1,91,38.258394551130515,-109.4195178
28773,7,44,14,11,15,0,91,38.258394551130515,-109.4192483
28774,8,43,14,12,14,0,91,38.258394551130515,-109.4189788
28775,12,39,14,13,13,0,91,38.258394551130515,-109.4187093
28776,18,35,14,12,13,0,92,38.258394551130515,-109.4184398
28777,21,32,14,11,13,0,91,38.258394551130515,-109.4181703
28778,20,34,14,11,13,0,92,38.258394551130515,-109.4179008
28779,22,33,14,10,12,0,91,38.258394551130515,-109.4176313
28780,23,31,15,11,12,0,92,38.258394551130515,-109.4173618
28781,20,32,14,13,13,0,92,38.258394551130515,-109.4170923
28782,16,36,14,13,13,0,92,38.258394551130515,-109.4168228
28783,14,36,14,13,14,0,91,38.258394551130515,-109.4165533
28784,13,37,14,13,14,0,91,38.258394551130515,-109.4162838
28785,12,40,14,12,13,0,91,38.258394551130515,-109.4160143
28786,12,41,14,11,14,0,92,38.258394551130515,-109.4157448
28787,8,45,14,11,14,0,92,38.258394551130515,-109.4154753
28788,8,45,14,12,14,0,93,38.258394551130515,-109.4152058
28789,11,42,15,13,13,0,94,38.258394551130515,-109.4149364
28790,13,39,15,13,13,0,93,38.258394551130515,-109.4146669
28791,12,40,15,14,14,0,95,38.258394551130515,-109.4143974
28792,11,39,15,14,14,0,93,38.258394551130515,-109.4141279
28793,15,35,15,14,13,0,92,38.258394551130515,-109.4138584
28794,21,31,14,13,13,0,92,38.258394551130515,-109.4135889
28795,21,31,14,14,13,0,93,38.258394551130515,-109.4133194
28796,17,33,15,15,14,0,94,38.258394551130515,-109.4130499
28797,13,37,15,15,14,0,94,38.258394551130515,-109.4127804
28798,11,40,15,15,14,0,95,38.258394551130515,-109.4125109
28799,10,41,15,15,14,0,95,38.258394551130515,-109.4122414
28800,9,42,15,13,15,0,94,38.258394551130515,-109.4119719
28801,9,44,14,11,15,0,93,38.258394551130515,-109.4117024
28802,8,45,13,11,15,0,92,38.258394551130515,-109.4114329
28803,7,45,13,10,16,0,91,38.258394551130515,-109.4111634
28804,7,45,12,9,15,0,88,38.258394551130515,-109.4108939
28805,6,45,12,10,16,0,89,38.258394551130515,-109.4106244
28806,6,45,13,11,16,0,91,38.258394551130515,-109.4103549
28807,7,45,13,11,15,0,91,38.258394551130515,-109.4100855
28808,7,45,13,11,15,0,91,38.258394551130515,-109.409816
28809,10,43,13,12,15,0,93,38.258394551130515,-109.4095465
28810,12,38,14,15,13,0,92,38.258394551130515,-109.409277
28811,13,36,14,16,13,0,92,38.258394551130515,-109.4090075
28812,15,36,14,15,13,0,93,38.258394551130515,-109.408738
28813,17,37,14,13,12,0,93,38.258394551130515,-109.4084685
28814,12,42,14,13,13,0,94,38.258394551130515,-109.408199
28815,7,47,13,8,15,0,90,38.258394551130515,-109.4079295
28816,5,48,13,7,16,1,90,38.258394551130515,-109.40766
28817,5,49,13,7,17,1,92,38.258394551130515,-109.4073905
28818,4,48,13,6,17,2,90,38.258394551130515,-109.407121
28819,3,47,11,3,16,4,84,38.258394551130515,-109.4068515
28820,5,44,12,7,15,3,86,38.258394551130515,-109.3882564
28821,5,33,9,6,11,4,68,38.258394551130515,-109.3879869
28822,5,29,9,5,9,6,63,38.258394551130515,-109.3877174
28823,6,29,10,5,9,7,66,38.258394551130515,-109.3874479
28824,4,33,11,4,11,8,71,38.258394551130515,-109.3871784
28825,4,44,11,2,11,9,81,38.258394551130515,-109.3869089
28826,3,45,10,5,12,3,78,38.258394551130515,-109.3866394
28827,2,44,9,4,13,4,76,38.258394551130515,-109.3863699
28828,4,45,10,5,14,4,82,38.258394551130515,-109.3861004
28829,8,44,12,7,16,2,89,38.258394551130515,-109.3858309
28830,4,42,13,7,17,3,86,38.258394551130515,-109.3855614
28831,4,39,11,5,15,6,80,38.258394551130515,-109.3852919
28832,4,39,11,3,15,7,79,38.258394551130515,-109.3850225
28833,4,40,11,3,16,6,80,38.258394551130515,-109.384753
28834,6,43,12,5,18,2,86,38.258394551130515,-109.3844835
28835,3,41,11,1,16,7,79,38.258394551130515,-109.384214
28836,3,38,10,0,13,10,74,38.258394551130515,-109.3839445
28837,5,40,11,1,15,8,80,38.258394551130515,-109.383675
28838,6,44,12,4,18,3,87,38.258394551130515,-109.3834055
28839,6,45,12,4,18,2,87,38.258394551130515,-109.383136
28840,6,45,12,5,18,1,87,38.258394551130515,-109.3828665
28841,6,45,12,5,18,2,88,38.258394551130515,-109.382597
28842,7,46,12,5,18,1,89,38.258394551130515,-109.3823275
28843,8,46,13,6,17,0,90,38.258394551130515,-109.382058
28844,13,42,12,8,15,0,90,38.258394551130515,-109.3817885
28845,21,33,11,10,11,1,87,38.258394551130515,-109.381519
28846,20,35,12,10,12,0,89,38.258394551130515,-109.3812495
28847,14,41,13,10,14,0,92,38.258394551130515,-109.38098
28848,8,46,12,7,16,0,89,38.258394551130515,-109.3807105
28849,8,39,11,5,14,2,79,38.258394551130515,-109.380441
28850,7,34,10,5,12,4,72,38.258394551130515,-109.3801716
28851,7,38,11,9,10,1,76,38.258394551130515,-109.3799021
28852,6,45,11,12,7,0,81,38.258394551130515,-109.3796326
28853,5,49,10,5,10,2,81,38.258394551130515,-109.3793631
28854,4,33,12,3,8,9,69,38.258394551130515,-109.3790936
28855,3,36,11,0,9,11,70,38.258394551130515,-109.3788241
28856,2,39,10,0,11,10,72,38.258394551130515,-109.3785546
28857,1,42,9,0,12,7,71,38.258394551130515,-109.3782851
28858,1,41,9,3,11,5,70,38.258394551130515,-109.3780156
28859,1,37,9,1,10,9,67,38.258394551130515,-109.3777461
28860,0,33,11,1,10,12,67,38.258394551130515,-109.3774766
28861,0,32,12,0,10,15,69,38.258394551130515,-109.3772071
28862,3,35,14,6,12,14,84,38.258394551130515,-109.3769376
28863,5,33,16,6,12,14,86,38.258394551130515,-109.3766681
28864,1,34,16,3,11,18,83,38.258394551130515,-109.3763986
28865,1,34,15,1,13,17,81,38.258394551130515,-109.3761291
28866,2,36,14,0,14,14,80,38.258394551130515,-109.3758596
28867,2,30,13,0,8,18,71,38.258394551130515,-109.3755901
28868,2,27,12,0,8,18,67,38.258394551130515,-109.3753206
28869,4,29,13,0,7,19,72,38.258394551130515,-109.3750512
28870,3,30,14,0,6,21,74,38.258394551130515,-109.3747817
28871,1,28,14,0,5,24,72,38.258394551130515,-109.3745122
28872,2,27,14,0,5,24,72,38.258394551130515,-109.3742427
28873,1,26,15,0,5,25,72,38.258394551130515,-109.3739732
28874,2,28,14,0,6,23,73,38.258394551130515,-109.3737037
28875,2,31,13,0,8,20,74,38.258394551130515,-109.3734342
28876,2,32,12,0,10,18,74,38.258394551130515,-109.3731647
28877,1,28,14,0,7,23,73,38.258394551130515,-109.3728952
28878,1,29,16,0,8,23,77,38.258394551130515,-109.3726257
28879,0,27,16,0,8,25,76,38.258394551130515,-109.3723562
28880,0,24,15,1,7,25,72,38.258394551130515,-109.3720867
28881,0,26,14,2,10,21,73,38.258394551130515,-109.3718172
28882,0,26,14,6,14,15,75,38.258394551130515,-109.3715477
28883,1,27,14,6,13,15,76,38.258394551130515,-109.3712782
28884,2,28,14,5,13,16,78,38.258394551130515,-109.3710087
28885,4,25,15,6,12,16,78,38.258394551130515,-109.3707392
28886,3,27,16,4,11,20,81,38.258394551130515,-109.3704697
28887,3,29,16,1,9,21,79,38.258394551130515,-109.3702003
28888,3,29,14,0,8,22,76,38.258394551130515,-109.3699308
28889,3,31,14,0,9,20,77,38.258394551130515,-109.3696613
28890,3,31,14,0,7,22,77,38.258394551130515,-109.3693918
28891,1,23,15,0,3,29,71,38.258394551130515,-109.3691223
28892,2,26,16,0,5,27,76,38.258394551130515,-109.3688528
28893,1,29,14,0,9,23,76,38.258394551130515,-109.3685833
28894,2,34,13,0,14,16,79,38.258394551130515,-109.3683138
28895,5,37,13,2,14,12,83,38.258394551130515,-109.3680443
28896,4,35,13,2,14,12,80,38.258394551130515,-109.3677748
28897,3,35,13,2,13,13,79,38.258394551130515,-109.3675053
28898,2,33,13,0,10,16,74,38.258394551130515,-109.3672358
28899,2,31,14,0,8,17,72,38.258394551130515,-109.3669663
28900,1,26,13,0,6,23,69,38.258394551130515,-109.3666968
28901,4,29,14,2,4,23,76,38.258394551130515,-109.3664273
28902,6,25,13,7,7,21,79,38.258394551130515,-109.3661578
28903,6,24,13,7,7,20,77,38.258394551130515,-109.3658883
28904,4,24,12,6,5,19,70,38.258394551130515,-109.3656188
28905,6,25,10,9,8,16,74,38.258394551130515,-109.3653493
28906,7,24,10,11,9,14,75,38.258394551130515,-109.3650799
28907,5,27,13,11,6,16,78,38.258394551130515,-109.3648104
28908,3,33,14,9,4,13,76,38.258394551130515,-109.3645409
28909,2,26,13,2,9,18,70,38.258394551130515,-109.3642714
28910,2,27,14,0,7,23,73,38.258394551130515,-109.3640019
28911,2,24,14,0,6,25,71,38.258394551130515,-109.3637324
28912,2,27,13,0,6,23,71,38.258394551130515,-109.3634629
28913,2,32,12,0,9,20,75,38.258394551130515,-109.3631934
28914,2,33,13,1,14,15,78,38.258394551130515,-109.3629239
28915,4,31,14,1,12,18,80,38.258394551130515,-109.3626544
28916,3,31,13,0,9,21,77,38.258394551130515,-109.3623849
28917,2,29,14,0,7,22,74,38.258394551130515,-109.3621154
28918,1,25,15,0,6,23,70,38.258394551130515,-109.3618459
28919,0,22,15,0,5,25,67,38.258394551130515,-109.3615764
28920,1,22,16,0,5,26,70,38.258394551130515,-109.3613069
28921,1,21,17,0,5,29,73,38.258394551130515,-109.3610374
28922,0,21,17,0,3,31,72,38.258394551130515,-109.3607679
28923,0,20,16,0,2,30,68,38.258394551130515,-109.3604984
28924,0,19,15,0,4,25,63,38.258394551130515,-109.360229
28925,1,19,15,0,4,26,65,38.258394551130515,-109.3599595
28926,2,19,16,0,3,30,70,38.258394551130515,-109.35969
28927,0,20,17,0,3,33,73,38.258394551130515,-109.3594205
28928,1,22,16,0,5,28,72,38.258394551130515,-109.359151
28929,1,26,15,0,5,25,72,38.258394551130515,-109.3588815
28930,1,28,13,0,6,23,71,38.258394551130515,-109.358612
28931,1,29,13,0,10,19,72,38.258394551130515,-109.3583425
28932,1,26,12,0,8,20,67,38.258394551130515,-109.358073
28933,0,25,14,0,5,25,69,38.258394551130515,-109.3578035
28934,0,25,14,0,5,25,69,38.258394551130515,-109.357534
28935,0,24,13,0,6,23,66,38.258394551130515,-109.3572645
28936,0,25,12,1,10,16,64,38.258394551130515,-109.356995
28937,1,31,13,2,10,14,71,38.258394551130515,-109.3567255
28938,2,31,14,2,9,15,73,38.258394551130515,-109.356456
28939,2,30,15,0,9,16,72,38.258394551130515,-109.3561865
28940,2,28,13,0,8,16,67,38.258394551130515,-109.355917
28941,1,29,12,0,8,17,67,38.258394551130515,-109.3556475
28942,1,30,14,0,4,21,70,38.258394551130515,-109.355378
28943,3,28,15,0,8,25,79,38.258394551130515,-109.3551086
28944,2,29,16,1,5,25,78,38.258394551130515,-109.3548391
28945,2,29,17,0,8,27,83,38.258394551130515,-109.3545696
28946,2,29,16,0,9,26,82,38.258394551130515,-109.3543001
28947,3,28,14,1,6,23,75,38.258394551130515,-109.3540306
28948,4,29,15,2,11,20,81,38.258394551130515,-109.3537611
28949,6,28,16,6,15,13,84,38.258394551130515,-109.3534916
28950,3,32,13,17,17,4,86,38.258394551130515,-109.3532221
28951,4,26,14,14,28,2,88,38.258394551130515,-109.3529526
28952,5,21,14,18,22,4,84,38.258394551130515,-109.3526831
28953,7,22,14,18,19,3,83,38.258394551130515,-109.3524136
28954,3,9,7,7,8,1,35,38.258394551130515,-109.3521441
28955,2,9,10,27,13,1,62,38.258394551130515,-109.3518746
28956,5,17,13,12,18,2,67,38.258394551130515,-109.3516051
28957,3,23,16,1,10,20,73,38.258394551130515,-109.3513356
28958,4,22,18,1,7,27,79,38.258394551130515,-109.3510661
28959,1,22,19,1,5,31,79,38.258394551130515,-109.3507966
28960,1,23,20,0,4,32,80,38.258394551130515,-109.3505271
28961,1,23,20,0,5,33,82,38.258394551130515,-109.3502577
28962,2,24,19,1,4,33,83,38.258394551130515,-109.3499882
28963,2,19,18,0,1,33,73,38.258394551130515,-109.3497187
28964,2,15,18,0,0,33,68,38.258394551130515,-109.3494492
28965,2,14,18,0,0,33,67,38.258394551130515,-109.3491797
28966,1,16,17,0,1,31,66,38.258394551130515,-109.3489102
28967,1,15,17,0,1,31,65,38.258394551130515,-109.3486407
28968,1,16,16,0,1,29,63,38.258394551130515,-109.3483712
28969,1,17,15,0,1,26,60,38.258394551130515,-109.3481017
28970,2,19,13,3,4,19,60,38.258394551130515,-109.3478322
28971,2,20,12,4,5,17,60,38.258394551130515,-109.3475627
28972,2,18,12,4,4,19,59,38.258394551130515,-109.3472932
28973,2,17,13,2,4,20,58,38.258394551130515,-109.3470237
28974,3,17,13,1,3,20,57,38.258394551130515,-109.3467542
28975,3,13,13,1,2,22,54,38.258394551130515,-109.3464847
28976,2,13,15,1,2,25,58,38.258394551130515,-109.3462152
28977,2,15,16,0,1,29,63,38.258394551130515,-109.3459457
28978,2,16,17,0,0,31,66,38.258394551130515,-109.3456762
28979,1,16,18,0,1,34,70,38.258394551130515,-109.3454068
28980,1,19,18,0,1,34,73,38.258394551130515,-109.3451373
28981,1,19,18,0,2,33,73,38.258394551130515,-109.3448678
28982,1,17,17,0,0,31,66,38.258394551130515,-109.3445983
28983,1,18,16,0,0,29,64,38.258394551130515,-109.3443288
28984,1,18,16,0,0,28,63,38.258394551130515,-109.3440593
28985,1,20,18,0,2,31,72,38.258394551130515,-109.3437898
28986,1,22,19,0,3,32,77,38.258394551130515,-109.3435203
28987,1,22,19,0,3,32,77,38.258394551130515,-109.3432508
28988,1,23,17,0,2,30,73,38.258394551130515,-109.3429813
28989,2,23,17,1,2,29,74,38.258394551130515,-109.3427118
28990,3,22,19,2,4,32,82,38.258394551130515,-109.3424423
28991,2,21,20,1,5,35,84,38.258394551130515,-109.3421728
28992,2,21,20,1,5,36,85,38.258394551130515,-109.3419033
28993,2,21,20,1,5,35,84,38.258394551130515,-109.3416338
28994,1,19,21,1,6,38,86,38.258394551130515,-109.3413643
28995,1,20,22,0,4,35,82,38.258394551130515,-109.3410948
28996,1,17,19,0,1,32,70,38.258394551130515,-109.3408253
28997,2,17,18,0,1,31,69,38.258394551130515,-109.3405558
28998,3,15,18,0,1,31,68,38.258394551130515,-109.3402864
28999,2,21,19,0,1,32,75,38.258394551130515,-109.3400169
29000,2,21,19,1,2,30,75,38.258394551130515,-109.3397474
29001,2,21,18,1,3,29,74,38.258394551130515,-109.3394779
29002,2,19,16,0,2,27,66,38.258394551130515,-109.3392084
29003,2,18,15,2,3,25,65,38.258394551130515,-109.3389389
29004,2,18,15,2,3,24,64,38.258394551130515,-109.3386694
29005,1,19,16,2,3,24,65,38.258394551130515,-109.3383999
29006,1,25,13,3,5,21,68,38.258394551130515,-109.3381304
29007,1,39,10,1,10,13,74,38.258394551130515,-109.3378609
29008,1,51,8,1,12,4,77,38.258394551130515,-109.3375914
29009,0,44,7,0,8,8,67,38.258394551130515,-109.3373219
29010,1,27,11,1,5,18,63,38.258394551130515,-109.3370524
29011,2,22,19,1,5,30,79,38.258394551130515,-109.3367829
29012,0,19,22,0,5,34,80,38.258394551130515,-109.3365134
29013,0,19,22,0,6,35,82,38.258394551130515,-109.3362439
29014,0,17,22,1,6,36,82,38.258394551130515,-109.3359744
29015,0,17,22,0,5,38,82,38.258394551130515,-109.3357049
29016,0,18,22,0,3,38,81,38.258394551130515,-109.3354355
29017,0,18,19,0,2,35,74,38.258394551130515,-109.335166
29018,1,17,17,0,2,30,67,38.258394551130515,-109.3348965
29019,1,20,15,0,3,25,64,38.258394551130515,-109.334627
29020,2,24,13,1,5,19,64,38.258394551130515,-109.3343575
29021,2,29,11,0,7,16,65,38.258394551130515,-109.334088
29022,1,27,10,0,8,14,60,38.258394551130515,-109.3338185
29023,1,26,10,0,8,13,58,38.258394551130515,-109.333549
29024,0,24,11,0,5,19,59,38.258394551130515,-109.3332795
29025,0,22,15,0,5,25,67,38.258394551130515,-109.33301
29026,1,22,15,0,4,25,67,38.258394551130515,-109.3327405
29027,3,51,10,8,13,2,87,38.25812505654528,-109.4440418
29028,3,52,9,7,13,3,87,38.25812505654528,-109.4437723
29029,2,55,8,5,12,3,85,38.25812505654528,-109.4435028
29030,3,56,10,7,13,2,91,38.25812505654528,-109.4432333
29031,6,51,11,8,14,1,91,38.25812505654528,-109.4429638
29032,6,49,12,7,16,1,91,38.25812505654528,-109.4426943
29033,5,49,12,6,16,2,90,38.25812505654528,-109.4424248
29034,5,50,12,7,16,1,91,38.25812505654528,-109.4421553
29035,6,49,12,7,16,1,91,38.25812505654528,-109.4418858
29036,6,50,12,6,16,1,91,38.25812505654528,-109.4416163
29037,5,51,12,5,16,2,91,38.25812505654528,-109.4413468
29038,4,52,12,4,16,2,90,38.25812505654528,-109.4410773
29039,5,52,12,4,16,3,92,38.25812505654528,-109.4408078
29040,5,52,12,5,16,2,92,38.25812505654528,-109.4405383
29041,5,53,12,5,16,2,93,38.25812505654528,-109.4402688
29042,4,56,11,5,15,2,93,38.25812505654528,-109.4399993
29043,4,55,10,5,13,4,91,38.25812505654528,-109.4397299
29044,2,45,10,0,12,10,79,38.25812505654528,-109.4394604
29045,2,39,10,0,11,13,75,38.25812505654528,-109.4391909
29046,2,37,10,0,9,14,72,38.25812505654528,-109.4389214
29047,2,42,10,0,11,12,77,38.25812505654528,-109.4386519
29048,2,51,11,0,15,7,86,38.25812505654528,-109.4383824
29049,2,47,11,1,14,9,84,38.25812505654528,-109.4381129
29050,2,47,11,0,14,10,84,38.25812505654528,-109.4378434
29051,2,51,11,0,15,9,88,38.25812505654528,-109.4375739
29052,3,54,10,1,15,5,88,38.25812505654528,-109.4373044
29053,2,48,10,2,14,6,82,38.25812505654528,-109.4370349
29054,1,42,10,0,13,10,76,38.25812505654528,-109.4367654
29055,1,37,11,0,11,14,74,38.25812505654528,-109.4364959
29056,0,32,11,1,11,14,69,38.25812505654528,-109.4362264
29057,2,37,11,0,11,13,74,38.25812505654528,-109.4359569
29058,2,37,11,0,14,10,74,38.25812505654528,-109.4356874
29059,3,38,11,1,15,9,77,38.25812505654528,-109.4354179
29060,4,40,10,1,16,6,77,38.25812505654528,-109.4351484
29061,4,44,11,3,17,4,83,38.25812505654528,-109.434879
29062,3,45,11,2,18,2,81,38.25812505654528,-109.4346095
29063,4,39,11,3,17,5,79,38.25812505654528,-109.43434
29064,10,40,12,8,16,1,87,38.25812505654528,-109.4340705
29065,12,41,13,12,14,1,93,38.25812505654528,-109.433801
29066,11,40,14,12,14,1,92,38.25812505654528,-109.4335315
29067,10,42,14,13,14,1,94,38.25812505654528,-109.433262
29068,12,41,14,13,14,0,94,38.25812505654528,-109.4329925
29069,16,37,14,12,14,0,93,38.25812505654528,-109.432723
29070,18,35,14,12,14,0,93,38.25812505654528,-109.4324535
29071,20,35,13,11,13,0,92,38.25812505654528,-109.432184
29072,23,33,14,10,13,0,93,38.25812505654528,-109.4319145
29073,23,33,14,10,12,0,92,38.25812505654528,-109.431645
29074,24,32,14,10,12,0,92,38.25812505654528,-109.4313755
29075,23,32,15,12,12,0,94,38.25812505654528,-109.431106
29076,18,35,14,13,13,0,93,38.25812505654528,-109.4308365
29077,13,40,14,12,14,0,93,38.25812505654528,-109.430567
29078,13,41,14,12,14,0,94,38.25812505654528,-109.4302975
29079,14,40,14,11,14,0,93,38.25812505654528,-109.430028
29080,13,40,13,11,15,0,92,38.25812505654528,-109.4297586
29081,14,39,14,11,14,0,92,38.25812505654528,-109.4294891
29082,15,38,13,11,14,0,91,38.25812505654528,-109.4292196
29083,17,37,13,11,14,0,92,38.25812505654528,-109.4289501
29084,16,37,14,10,14,0,91,38.25812505654528,-109.4286806
29085,12,41,14,11,15,0,93,38.25812505654528,-109.4284111
29086,9,43,13,11,15,0,91,38.25812505654528,-109.4281416
29087,10,43,13,11,15,0,92,38.25812505654528,-109.4278721
29088,14,38,14,11,15,0,92,38.25812505654528,-109.4276026
29089,22,33,14,10,14,0,93,38.25812505654528,-109.4273331
29090,27,30,14,10,13,0,94,38.25812505654528,-109.4270636
29091,24,32,14,10,13,0,93,38.25812505654528,-109.4267941
29092,20,33,14,11,14,0,92,38.25812505654528,-109.4265246
29093,16,35,14,12,15,0,92,38.25812505654528,-109.4262551
29094,13,38,15,14,15,0,95,38.25812505654528,-109.4259856
29095,11,41,14,12,16,0,94,38.25812505654528,-109.4257161
29096,11,42,14,12,15,0,94,38.25812505654528,-109.4254466
29097,12,41,14,12,15,0,94,38.25812505654528,-109.4251771
29098,14,39,14,11,15,0,93,38.25812505654528,-109.4249077
29099,17,37,14,11,14,0,93,38.25812505654528,-109.4246382
29100,16,37,14,12,14,0,93,38.25812505654528,-109.4243687
29101,14,39,14,12,14,0,93,38.25812505654528,-109.4240992
29102,12,40,14,12,14,0,92,38.25812505654528,-109.4238297
29103,12,40,13,11,14,1,91,38.25812505654528,-109.4235602
29104,12,40,14,12,14,0,92,38.25812505654528,-109.4232907
29105,10,41,14,13,14,0,92,38.25812505654528,-109.4230212
29106,12,40,14,12,14,0,92,38.25812505654528,-109.4227517
29107,14,39,13,11,14,0,91,38.25812505654528,-109.4224822
29108,13,41,13,11,15,0,93,38.25812505654528,-109.4222127
29109,8,44,14,12,15,0,93,38.25812505654528,-109.4219432
29110,7,45,14,12,15,0,93,38.25812505654528,-109.4216737
29111,10,41,14,14,14,0,93,38.25812505654528,-109.4214042
29112,14,37,14,14,14,0,93,38.25812505654528,-109.4211347
29113,14,38,14,12,14,0,92,38.25812505654528,-109.4208652
29114,10,45,13,10,16,0,94,38.25812505654528,-109.4205957
29115,7,51,11,9,14,1,93,38.25812505654528,-109.4203262
29116,6,50,11,9,14,1,91,38.25812505654528,-109.4200568
29117,10,42,13,10,14,0,89,38.25812505654528,-109.4197873
29118,13,36,13,12,14,1,89,38.25812505654528,-109.4195178
29119,11,39,14,13,14,0,91,38.25812505654528,-109.4192483
29120,11,39,14,14,13,0,91,38.25812505654528,-109.4189788
29121,14,35,14,14,13,0,90,38.25812505654528,-109.4187093
29122,20,31,14,12,13,0,90,38.25812505654528,-109.4184398
29123,20,31,14,12,13,0,90,38.25812505654528,-109.4181703
29124,20,32,14,11,13,0,90,38.25812505654528,-109.4179008
29125,19,33,14,12,13,0,91,38.25812505654528,-109.4176313
29126,18,32,14,14,13,0,91,38.25812505654528,-109.4173618
29127,15,35,14,14,13,0,91,38.25812505654528,-109.4170923
29128,20,33,15,12,12,0,92,38.25812505654528,-109.4168228
29129,19,34,15,12,13,0,93,38.25812505654528,-109.4165533
29130,18,34,14,12,13,0,91,38.25812505654528,-109.4162838
29131,17,35,14,12,14,0,92,38.25812505654528,-109.4160143
29132,14,38,14,12,13,0,91,38.25812505654528,-109.4157448
29133,12,41,14,12,13,0,92,38.25812505654528,-109.4154753
29134,11,42,14,12,13,0,92,38.25812505654528,-109.4152058
29135,13,41,14,12,13,0,93,38.25812505654528,-109.4149364
29136,15,38,15,12,13,0,93,38.25812505654528,-109.4146669
29137,15,36,15,14,13,0,93,38.25812505654528,-109.4143974
29138,16,36,15,14,12,0,93,38.25812505654528,-109.4141279
29139,18,34,14,14,12,0,92,38.25812505654528,-109.4138584
29140,20,31,14,14,12,0,91,38.25812505654528,-109.4135889
29141,21,31,14,14,13,0,93,38.25812505654528,-109.4133194
29142,22,30,14,13,13,0,92,38.25812505654528,-109.4130499
29143,19,32,14,14,13,0,92,38.25812505654528,-109.4127804
29144,18,33,14,14,13,0,92,38.25812505654528,-109.4125109
29145,19,33,14,14,13,0,93,38.25812505654528,-109.4122414
29146,19,33,14,14,13,0,93,38.25812505654528,-109.4119719
29147,16,37,14,13,13,0,93,38.25812505654528,-109.4117024
29148,11,41,14,13,14,0,93,38.25812505654528,-109.4114329
29149,8,45,13,11,15,0,92,38.25812505654528,-109.4111634
29150,6,46,12,9,16,0,89,38.25812505654528,-109.4108939
29151,5,47,12,7,18,0,89,38.25812505654528,-109.4106244
29152,6,45,13,11,16,0,91,38.25812505654528,-109.4103549
29153,8,43,13,14,15,0,93,38.25812505654528,-109.4100855
29154,11,40,14,16,14,0,95,38.25812505654528,-109.409816
29155,11,40,13,15,14,0,93,38.25812505654528,-109.4095465
29156,7,43,12,11,16,0,89,38.25812505654528,-109.409277
29157,9,42,13,14,15,0,93,38.25812505654528,-109.4090075
29158,14,38,14,15,13,0,94,38.25812505654528,-109.408738
29159,19,34,14,13,12,0,92,38.25812505654528,-109.4084685
29160,17,36,15,15,12,0,95,38.25812505654528,-109.408199
29161,12,42,14,13,13,0,94,38.25812505654528,-109.4079295
29162,9,46,14,10,15,0,94,38.25812505654528,-109.40766
29163,7,48,14,9,15,1,94,38.25812505654528,-109.4073905
29164,6,48,14,8,16,2,94,38.25812505654528,-109.407121
29165,5,47,13,7,16,2,90,38.25812505654528,-109.4068515
29166,5,45,10,6,14,2,82,38.25812505654528,-109.3882564
29167,7,30,9,6,11,3,66,38.25812505654528,-109.3879869
29168,3,29,10,4,8,8,62,38.25812505654528,-109.3877174
29169,2,34,11,3,9,9,68,38.25812505654528,-109.3874479
29170,3,40,11,2,12,8,76,38.25812505654528,-109.3871784
29171,4,38,10,5,12,5,74,38.25812505654528,-109.3869089
29172,3,35,11,5,11,7,72,38.25812505654528,-109.3866394
29173,3,34,11,5,13,8,74,38.25812505654528,-109.3863699
29174,3,37,12,4,14,7,77,38.25812505654528,-109.3861004
29175,4,41,12,4,16,6,83,38.25812505654528,-109.3858309
29176,3,38,13,5,16,6,81,38.25812505654528,-109.3855614
29177,2,30,12,3,12,11,70,38.25812505654528,-109.3852919
29178,3,34,11,2,12,10,72,38.25812505654528,-109.3850225
29179,4,40,11,2,15,6,78,38.25812505654528,-109.384753
29180,6,43,12,5,18,2,86,38.25812505654528,-109.3844835
29181,5,44,12,3,18,4,86,38.25812505654528,-109.384214
29182,4,41,11,1,15,7,79,38.25812505654528,-109.3839445
29183,5,42,11,3,16,6,83,38.25812505654528,-109.383675
29184,6,45,12,4,18,2,87,38.25812505654528,-109.3834055
29185,6,46,12,4,18,2,88,38.25812505654528,-109.383136
29186,6,45,12,5,18,1,87,38.25812505654528,-109.3828665
29187,6,46,12,5,18,1,88,38.25812505654528,-109.382597
29188,5,47,13,5,17,1,88,38.25812505654528,-109.3823275
29189,7,47,12,6,16,0,88,38.25812505654528,-109.382058
29190,16,36,12,10,12,1,87,38.25812505654528,-109.3817885
29191,18,34,12,11,12,0,87,38.25812505654528,-109.381519
29192,13,42,12,10,14,0,91,38.25812505654528,-109.3812495
29193,8,46,11,8,14,1,88,38.25812505654528,-109.38098
29194,4,45,10,8,13,2,82,38.25812505654528,-109.3807105
29195,3,41,9,5,14,3,75,38.25812505654528,-109.380441
29196,5,39,9,7,8,3,71,38.25812505654528,-109.3801716
29197,3,35,8,7,8,4,65,38.25812505654528,-109.3799021
29198,2,39,8,7,8,4,68,38.25812505654528,-109.3796326
29199,3,41,9,4,9,5,71,38.25812505654528,-109.3793631
29200,2,34,10,2,8,11,67,38.25812505654528,-109.3790936
29201,2,36,10,1,9,10,68,38.25812505654528,-109.3788241
29202,3,36,10,3,10,8,70,38.25812505654528,-109.3785546
29203,4,34,11,7,10,7,73,38.25812505654528,-109.3782851
29204,4,37,11,0,10,12,74,38.25812505654528,-109.3780156
29205,0,32,12,0,6,19,69,38.25812505654528,-109.3777461
29206,0,31,12,0,7,20,70,38.25812505654528,-109.3774766
29207,1,29,13,0,8,20,71,38.25812505654528,-109.3772071
29208,2,29,14,2,9,18,74,38.25812505654528,-109.3769376
29209,3,29,13,2,10,15,72,38.25812505654528,-109.3766681
29210,4,32,13,0,9,17,75,38.25812505654528,-109.3763986
29211,2,28,13,0,6,20,69,38.25812505654528,-109.3761291
29212,2,26,13,0,6,20,67,38.25812505654528,-109.3758596
29213,3,27,12,0,8,16,66,38.25812505654528,-109.3755901
29214,4,29,13,0,7,17,70,38.25812505654528,-109.3753206
29215,6,30,13,1,7,16,73,38.25812505654528,-109.3750512
29216,9,33,13,4,10,10,79,38.25812505654528,-109.3747817
29217,10,34,12,6,11,8,81,38.25812505654528,-109.3745122
29218,5,32,13,1,7,17,75,38.25812505654528,-109.3742427
29219,5,34,12,1,9,15,76,38.25812505654528,-109.3739732
29220,5,36,12,1,12,13,79,38.25812505654528,-109.3737037
29221,4,38,13,0,11,13,79,38.25812505654528,-109.3734342
29222,3,41,13,0,12,14,83,38.25812505654528,-109.3731647
29223,2,31,13,0,6,21,73,38.25812505654528,-109.3728952
29224,3,29,15,0,6,24,77,38.25812505654528,-109.3726257
29225,2,27,15,0,6,24,74,38.25812505654528,-109.3723562
29226,0,25,15,0,6,24,70,38.25812505654528,-109.3720867
29227,0,27,17,0,7,25,76,38.25812505654528,-109.3718172
29228,0,27,16,1,8,23,75,38.25812505654528,-109.3715477
29229,0,25,15,2,8,23,73,38.25812505654528,-109.3712782
29230,1,26,16,3,9,22,77,38.25812505654528,-109.3710087
29231,2,26,17,1,7,24,77,38.25812505654528,-109.3707392
29232,3,25,16,0,5,28,77,38.25812505654528,-109.3704697
29233,3,29,16,0,7,23,78,38.25812505654528,-109.3702003
29234,4,33,14,1,11,17,80,38.25812505654528,-109.3699308
29235,6,36,13,3,14,11,83,38.25812505654528,-109.3696613
29236,5,36,13,2,14,12,82,38.25812505654528,-109.3693918
29237,2,26,15,0,6,25,74,38.25812505654528,-109.3691223
29238,3,30,15,1,11,19,79,38.25812505654528,-109.3688528
29239,5,32,14,5,15,11,82,38.25812505654528,-109.3685833
29240,6,35,13,8,16,6,84,38.25812505654528,-109.3683138
29241,9,35,13,11,16,4,88,38.25812505654528,-109.3680443
29242,7,36,13,7,16,7,86,38.25812505654528,-109.3677748
29243,7,35,13,6,14,8,83,38.25812505654528,-109.3675053
29244,3,34,13,3,11,12,76,38.25812505654528,-109.3672358
29245,2,34,13,2,10,13,74,38.25812505654528,-109.3669663
29246,2,31,14,0,10,17,74,38.25812505654528,-109.3666968
29247,3,30,14,2,9,18,76,38.25812505654528,-109.3664273
29248,5,27,13,10,6,18,79,38.25812505654528,-109.3661578
29249,5,26,12,11,6,16,76,38.25812505654528,-109.3658883
29250,4,29,14,11,4,17,79,38.25812505654528,-109.3656188
29251,3,28,15,6,3,20,75,38.25812505654528,-109.3653493
29252,2,31,13,1,6,23,76,38.25812505654528,-109.3650799
29253,2,28,13,0,9,20,72,38.25812505654528,-109.3648104
29254,4,34,12,9,6,14,79,38.25812505654528,-109.3645409
29255,2,23,14,3,6,22,70,38.25812505654528,-109.3642714
29256,1,22,15,0,7,26,71,38.25812505654528,-109.3640019
29257,1,29,16,0,4,29,79,38.25812505654528,-109.3637324
29258,2,29,15,0,4,26,76,38.25812505654528,-109.3634629
29259,3,31,15,4,5,19,77,38.25812505654528,-109.3631934
29260,10,27,14,17,9,9,86,38.25812505654528,-109.3629239
29261,7,26,14,12,12,10,81,38.25812505654528,-109.3626544
29262,7,26,13,11,15,8,80,38.25812505654528,-109.3623849
29263,4,27,13,4,14,13,75,38.25812505654528,-109.3621154
29264,2,27,14,1,11,18,73,38.25812505654528,-109.3618459
29265,2,25,14,0,6,22,69,38.25812505654528,-109.3615764
29266,1,24,15,0,7,23,70,38.25812505654528,-109.3613069
29267,1,21,16,2,7,26,73,38.25812505654528,-109.3610374
29268,1,21,17,3,6,27,75,38.25812505654528,-109.3607679
29269,1,21,17,0,5,29,73,38.25812505654528,-109.3604984
29270,0,16,15,0,2,28,61,38.25812505654528,-109.360229
29271,2,19,16,1,4,28,70,38.25812505654528,-109.3599595
29272,2,21,18,1,5,28,75,38.25812505654528,-109.35969
29273,1,22,17,0,6,28,74,38.25812505654528,-109.3594205
29274,1,26,18,0,7,26,78,38.25812505654528,-109.359151
29275,0,25,15,0,6,24,70,38.25812505654528,-109.3588815
29276,0,23,15,0,7,24,69,38.25812505654528,-109.358612
29277,0,23,14,0,7,25,69,38.25812505654528,-109.3583425
29278,0,24,15,0,6,27,72,38.25812505654528,-109.358073
29279,8,18,12,11,9,17,75,38.25812505654528,-109.3578035
29280,6,21,13,10,6,21,77,38.25812505654528,-109.357534
29281,5,20,13,7,4,23,72,38.25812505654528,-109.3572645
29282,6,20,14,10,4,20,74,38.25812505654528,-109.356995
29283,4,25,15,11,4,18,77,38.25812505654528,-109.3567255
29284,4,26,15,3,7,19,74,38.25812505654528,-109.356456
29285,1,26,13,0,6,21,67,38.25812505654528,-109.3561865
29286,3,27,13,1,7,18,69,38.25812505654528,-109.355917
29287,5,29,13,1,9,14,71,38.25812505654528,-109.3556475
29288,3,29,13,0,8,16,69,38.25812505654528,-109.355378
29289,4,26,14,5,6,16,71,38.25812505654528,-109.3551086
29290,3,24,15,1,6,22,71,38.25812505654528,-109.3548391
29291,2,29,14,1,4,26,76,38.25812505654528,-109.3545696
29292,2,29,13,1,4,25,74,38.25812505654528,-109.3543001
29293,1,33,12,0,4,19,69,38.25812505654528,-109.3540306
29294,7,31,14,5,13,12,82,38.25812505654528,-109.3537611
29295,2,27,14,15,19,6,83,38.25812505654528,-109.3534916
29296,2,25,14,15,22,6,84,38.25812505654528,-109.3532221
29297,1,24,13,14,28,2,82,38.25812505654528,-109.3529526
29298,2,15,10,15,17,0,59,38.25812505654528,-109.3526831
29299,0,9,9,11,9,7,45,38.25812505654528,-109.3524136
29300,0,7,8,14,13,2,44,38.25812505654528,-109.3521441
29301,3,13,11,15,21,1,64,38.25812505654528,-109.3518746
29302,2,23,15,3,15,14,72,38.25812505654528,-109.3516051
29303,5,22,16,2,9,21,75,38.25812505654528,-109.3513356
29304,4,21,18,0,8,27,78,38.25812505654528,-109.3510661
29305,1,24,19,1,4,32,81,38.25812505654528,-109.3507966
29306,1,24,18,0,3,33,79,38.25812505654528,-109.3505271
29307,1,20,19,0,2,35,77,38.25812505654528,-109.3502577
29308,2,19,19,0,1,34,75,38.25812505654528,-109.3499882
29309,3,17,19,0,0,33,72,38.25812505654528,-109.3497187
29310,4,17,18,0,0,31,70,38.25812505654528,-109.3494492
29311,3,17,16,1,1,28,66,38.25812505654528,-109.3491797
29312,1,17,15,1,2,26,62,38.25812505654528,-109.3489102
29313,1,17,12,2,3,21,56,38.25812505654528,-109.3486407
29314,3,16,10,4,3,15,51,38.25812505654528,-109.3483712
29315,4,19,9,4,5,10,51,38.25812505654528,-109.3481017
29316,3,25,7,5,8,7,55,38.25812505654528,-109.3478322
29317,2,27,7,5,8,8,57,38.25812505654528,-109.3475627
29318,2,25,8,4,8,10,57,38.25812505654528,-109.3472932
29319,1,27,8,3,7,11,57,38.25812505654528,-109.3470237
29320,2,24,9,5,7,11,58,38.25812505654528,-109.3467542
29321,3,16,10,5,4,14,52,38.25812505654528,-109.3464847
29322,3,11,12,3,3,18,50,38.25812505654528,-109.3462152
29323,1,14,15,1,2,26,59,38.25812505654528,-109.3459457
29324,1,15,18,0,1,33,68,38.25812505654528,-109.3456762
29325,0,18,19,0,2,35,74,38.25812505654528,-109.3454068
29326,1,20,18,0,3,33,75,38.25812505654528,-109.3451373
29327,2,19,18,0,2,30,71,38.25812505654528,-109.3448678
29328,2,17,17,0,1,30,67,38.25812505654528,-109.3445983
29329,2,16,17,0,1,30,66,38.25812505654528,-109.3443288
29330,0,17,16,0,1,30,64,38.25812505654528,-109.3440593
29331,1,19,18,0,2,33,73,38.25812505654528,-109.3437898
29332,1,21,19,0,3,33,77,38.25812505654528,-109.3435203
29333,1,22,19,0,4,33,79,38.25812505654528,-109.3432508
29334,1,22,19,1,4,31,78,38.25812505654528,-109.3429813
29335,2,23,18,1,3,30,77,38.25812505654528,-109.3427118
29336,2,23,19,2,3,31,80,38.25812505654528,-109.3424423
29337,2,22,20,1,4,33,82,38.25812505654528,-109.3421728
29338,1,21,20,1,5,35,83,38.25812505654528,-109.3419033
29339,1,19,21,0,5,37,83,38.25812505654528,-109.3416338
29340,1,18,22,1,5,36,83,38.25812505654528,-109.3413643
29341,1,17,18,0,2,33,71,38.25812505654528,-109.3410948
29342,1,14,16,0,1,29,61,38.25812505654528,-109.3408253
29343,2,16,16,0,1,28,63,38.25812505654528,-109.3405558
29344,3,18,16,1,2,28,68,38.25812505654528,-109.3402864
29345,1,21,18,1,3,33,77,38.25812505654528,-109.3400169
29346,1,18,18,0,3,33,73,38.25812505654528,-109.3397474
29347,1,16,15,1,2,28,63,38.25812505654528,-109.3394779
29348,2,17,15,3,3,23,63,38.25812505654528,-109.3392084
29349,4,19,14,2,3,20,62,38.25812505654528,-109.3389389
29350,1,13,14,2,3,22,55,38.25812505654528,-109.3386694
29351,1,22,11,2,4,19,59,38.25812505654528,-109.3383999
29352,1,35,9,2,10,11,68,38.25812505654528,-109.3381304
29353,0,49,8,2,11,4,74,38.25812505654528,-109.3378609
29354,0,55,7,1,11,3,77,38.25812505654528,-109.3375914
29355,0,41,8,2,11,5,67,38.25812505654528,-109.3373219
29356,1,26,11,4,8,14,64,38.25812505654528,-109.3370524
29357,3,21,17,4,4,24,73,38.25812505654528,-109.3367829
29358,1,17,18,2,3,26,67,38.25812505654528,-109.3365134
29359,1,18,16,3,4,24,66,38.25812505654528,-109.3362439
29360,0,18,18,1,4,28,69,38.25812505654528,-109.3359744
29361,0,20,19,0,4,31,74,38.25812505654528,-109.3357049
29362,0,21,19,0,4,32,76,38.25812505654528,-109.3354355
29363,0,20,18,0,3,31,72,38.25812505654528,-109.335166
29364,1,18,15,0,2,27,63,38.25812505654528,-109.3348965
29365,1,22,13,2,4,21,63,38.25812505654528,-109.334627
29366,2,30,11,1,7,15,66,38.25812505654528,-109.3343575
29367,1,34,10,0,8,13,66,38.25812505654528,-109.334088
29368,2,29,10,0,11,11,63,38.25812505654528,-109.3338185
29369,2,28,9,1,9,10,59,38.25812505654528,-109.333549
29370,1,26,10,1,5,14,57,38.25812505654528,-109.3332795
29371,1,21,11,1,3,19,56,38.25812505654528,-109.33301
29372,1,21,12,0,3,20,57,38.25812505654528,-109.3327405
29373,1,21,13,0,3,23,61,38.25812505654528,-109.332471
29374,3,54,9,6,12,2,86,38.25785556196004,-109.4440418
29375,3,53,9,6,12,1,84,38.25785556196004,-109.4437723
29376,2,59,9,5,13,2,90,38.25785556196004,-109.4435028
29377,5,53,11,8,14,1,92,38.25785556196004,-109.4432333
29378,6,51,12,8,16,1,94,38.25785556196004,-109.4429638
29379,6,49,12,7,16,1,91,38.25785556196004,-109.4426943
29380,6,49,13,8,16,1,93,38.25785556196004,-109.4424248
29381,6,50,12,8,16,1,93,38.25785556196004,-109.4421553
29382,5,49,13,7,16,1,91,38.25785556196004,-109.4418858
29383,5,49,13,6,17,2,92,38.25785556196004,-109.4416163
29384,5,50,12,5,17,2,91,38.25785556196004,-109.4413468
29385,5,50,12,5,17,2,91,38.25785556196004,-109.4410773
29386,4,52,12,4,17,3,92,38.25785556196004,-109.4408078
29387,4,51,12,3,16,4,90,38.25785556196004,-109.4405383
29388,5,53,12,5,15,3,93,38.25785556196004,-109.4402688
29389,4,55,11,7,14,2,93,38.25785556196004,-109.4399993
29390,4,56,10,6,13,3,92,38.25785556196004,-109.4397299
29391,2,46,11,0,13,10,82,38.25785556196004,-109.4394604
29392,1,41,10,0,11,14,77,38.25785556196004,-109.4391909
29393,2,40,10,0,11,12,75,38.25785556196004,-109.4389214
29394,1,40,10,0,14,10,75,38.25785556196004,-109.4386519
29395,2,50,10,0,15,8,85,38.25785556196004,-109.4383824
29396,2,48,11,0,14,10,85,38.25785556196004,-109.4381129
29397,2,47,12,2,15,9,87,38.25785556196004,-109.4378434
29398,3,44,12,4,16,7,86,38.25785556196004,-109.4375739
29399,4,39,11,5,15,6,80,38.25785556196004,-109.4373044
29400,3,39,10,1,11,10,74,38.25785556196004,-109.4370349
29401,4,40,10,1,11,9,75,38.25785556196004,-109.4367654
29402,3,41,9,0,12,9,74,38.25785556196004,-109.4364959
29403,3,43,10,0,12,9,77,38.25785556196004,-109.4362264
29404,3,46,11,3,17,5,85,38.25785556196004,-109.4359569
29405,4,42,11,4,13,6,80,38.25785556196004,-109.4356874
29406,4,42,10,2,13,7,78,38.25785556196004,-109.4354179
29407,3,43,10,0,14,8,78,38.25785556196004,-109.4351484
29408,3,45,9,0,16,5,78,38.25785556196004,-109.434879
29409,4,45,11,4,17,2,83,38.25785556196004,-109.4346095
29410,3,39,11,1,16,7,77,38.25785556196004,-109.43434
29411,9,38,12,6,15,4,84,38.25785556196004,-109.4340705
29412,12,37,13,12,14,1,89,38.25785556196004,-109.433801
29413,9,40,13,11,14,1,88,38.25785556196004,-109.4335315
29414,10,41,14,13,15,1,94,38.25785556196004,-109.433262
29415,12,40,14,13,14,0,93,38.25785556196004,-109.4329925
29416,15,36,14,13,14,0,92,38.25785556196004,-109.432723
29417,20,33,14,12,13,0,92,38.25785556196004,-109.4324535
29418,24,31,14,11,12,0,92,38.25785556196004,-109.432184
29419,21,33,14,11,12,0,91,38.25785556196004,-109.4319145
29420,23,32,14,11,12,0,92,38.25785556196004,-109.431645
29421,25,31,14,11,11,0,92,38.25785556196004,-109.4313755
29422,25,30,15,12,11,1,94,38.25785556196004,-109.431106
29423,16,36,14,13,13,0,92,38.25785556196004,-109.4308365
29424,12,40,14,13,13,0,92,38.25785556196004,-109.430567
29425,15,38,14,12,14,0,93,38.25785556196004,-109.4302975
29426,19,36,14,11,14,0,94,38.25785556196004,-109.430028
29427,17,37,14,10,14,0,92,38.25785556196004,-109.4297586
29428,13,40,14,11,14,0,92,38.25785556196004,-109.4294891
29429,11,41,14,12,15,0,93,38.25785556196004,-109.4292196
29430,11,41,14,11,15,0,92,38.25785556196004,-109.4289501
29431,11,42,14,11,15,0,93,38.25785556196004,-109.4286806
29432,8,42,13,12,15,0,90,38.25785556196004,-109.4284111
29433,11,42,13,11,15,0,92,38.25785556196004,-109.4281416
29434,15,38,14,11,15,0,93,38.25785556196004,-109.4278721
29435,18,35,13,10,15,0,91,38.25785556196004,-109.4276026
29436,20,33,14,11,15,0,93,38.25785556196004,-109.4273331
29437,19,33,14,11,15,0,92,38.25785556196004,-109.4270636
29438,16,35,14,12,15,0,92,38.25785556196004,-109.4267941
29439,18,34,14,12,14,0,92,38.25785556196004,-109.4265246
29440,18,35,14,12,14,0,93,38.25785556196004,-109.4262551
29441,14,38,14,14,15,0,95,38.25785556196004,-109.4259856
29442,12,39,14,13,15,0,93,38.25785556196004,-109.4257161
29443,13,39,14,12,15,0,93,38.25785556196004,-109.4254466
29444,15,38,14,11,15,0,93,38.25785556196004,-109.4251771
29445,15,39,14,11,15,0,94,38.25785556196004,-109.4249077
29446,14,40,14,12,14,0,94,38.25785556196004,-109.4246382
29447,15,37,13,12,13,0,90,38.25785556196004,-109.4243687
29448,13,40,13,11,14,0,91,38.25785556196004,-109.4240992
29449,11,41,13,12,15,0,92,38.25785556196004,-109.4238297
29450,11,38,13,14,14,1,91,38.25785556196004,-109.4235602
29451,11,38,14,14,14,1,92,38.25785556196004,-109.4232907
29452,10,39,14,13,14,1,91,38.25785556196004,-109.4230212
29453,12,39,14,12,14,0,91,38.25785556196004,-109.4227517
29454,13,39,14,12,15,0,93,38.25785556196004,-109.4224822
29455,11,40,14,12,15,0,92,38.25785556196004,-109.4222127
29456,7,47,13,10,16,0,93,38.25785556196004,-109.4219432
29457,8,45,13,10,16,0,92,38.25785556196004,-109.4216737
29458,13,39,14,11,15,0,92,38.25785556196004,-109.4214042
29459,15,36,14,11,15,0,91,38.25785556196004,-109.4211347
29460,10,42,13,10,16,0,91,38.25785556196004,-109.4208652
29461,5,51,11,8,15,1,91,38.25785556196004,-109.4205957
29462,6,50,11,9,14,0,90,38.25785556196004,-109.4203262
29463,9,45,11,10,14,0,89,38.25785556196004,-109.4200568
29464,16,35,13,11,14,0,89,38.25785556196004,-109.4197873
29465,17,33,13,12,13,0,88,38.25785556196004,-109.4195178
29466,16,34,14,14,13,0,91,38.25785556196004,-109.4192483
29467,15,35,13,14,13,0,90,38.25785556196004,-109.4189788
29468,18,33,13,13,13,0,90,38.25785556196004,-109.4187093
29469,22,31,13,12,13,0,91,38.25785556196004,-109.4184398
29470,21,31,14,12,13,0,91,38.25785556196004,-109.4181703
29471,20,33,13,11,13,0,90,38.25785556196004,-109.4179008
29472,17,36,14,12,13,0,92,38.25785556196004,-109.4176313
29473,14,36,14,13,13,0,90,38.25785556196004,-109.4173618
29474,15,35,14,13,13,0,90,38.25785556196004,-109.4170923
29475,18,32,14,14,12,0,90,38.25785556196004,-109.4168228
29476,21,31,14,13,12,0,91,38.25785556196004,-109.4165533
29477,21,31,14,12,12,0,90,38.25785556196004,-109.4162838
29478,20,32,14,11,13,0,90,38.25785556196004,-109.4160143
29479,16,35,14,12,14,0,91,38.25785556196004,-109.4157448
29480,14,37,14,13,13,0,91,38.25785556196004,-109.4154753
29481,14,38,14,13,14,0,93,38.25785556196004,-109.4152058
29482,14,38,14,13,14,0,93,38.25785556196004,-109.4149364
29483,14,37,14,12,13,0,90,38.25785556196004,-109.4146669
29484,15,38,15,12,12,0,92,38.25785556196004,-109.4143974
29485,17,35,15,14,12,0,93,38.25785556196004,-109.4141279
29486,18,33,14,14,13,0,92,38.25785556196004,-109.4138584
29487,17,32,14,13,14,0,90,38.25785556196004,-109.4135889
29488,17,33,14,13,14,0,91,38.25785556196004,-109.4133194
29489,21,32,14,12,13,0,92,38.25785556196004,-109.4130499
29490,22,32,14,12,13,0,93,38.25785556196004,-109.4127804
29491,20,34,14,13,13,0,94,38.25785556196004,-109.4125109
29492,19,34,14,13,13,0,93,38.25785556196004,-109.4122414
29493,21,33,14,12,13,0,93,38.25785556196004,-109.4119719
29494,19,35,14,13,13,0,94,38.25785556196004,-109.4117024
29495,16,35,14,14,13,0,92,38.25785556196004,-109.4114329
29496,13,38,13,14,14,0,92,38.25785556196004,-109.4111634
29497,10,41,13,13,15,0,92,38.25785556196004,-109.4108939
29498,7,45,12,10,16,0,90,38.25785556196004,-109.4106244
29499,9,42,13,11,15,0,90,38.25785556196004,-109.4103549
29500,14,38,13,14,13,0,92,38.25785556196004,-109.4100855
29501,15,36,13,15,13,0,92,38.25785556196004,-109.409816
29502,10,41,13,15,13,0,92,38.25785556196004,-109.4095465
29503,6,46,12,10,17,0,91,38.25785556196004,-109.409277
29504,6,46,12,8,17,0,89,38.25785556196004,-109.4090075
29505,10,42,13,13,15,0,93,38.25785556196004,-109.408738
29506,17,33,14,15,13,0,92,38.25785556196004,-109.4084685
29507,17,34,15,15,13,0,94,38.25785556196004,-109.408199
29508,13,38,15,14,14,0,94,38.25785556196004,-109.4079295
29509,10,42,14,13,15,0,94,38.25785556196004,-109.40766
29510,8,45,14,12,16,0,95,38.25785556196004,-109.4073905
29511,7,45,14,11,16,1,94,38.25785556196004,-109.407121
29512,6,44,13,9,15,2,89,38.25785556196004,-109.4068515
29513,3,47,9,5,14,1,79,38.25785556196004,-109.3882564
29514,6,37,9,6,12,2,72,38.25785556196004,-109.3879869
29515,2,34,9,3,9,7,64,38.25785556196004,-109.3877174
29516,2,38,10,3,10,7,70,38.25785556196004,-109.3874479
29517,6,39,10,5,12,3,75,38.25785556196004,-109.3871784
29518,1,27,10,4,10,10,62,38.25785556196004,-109.3869089
29519,3,26,11,6,13,8,67,38.25785556196004,-109.3866394
29520,5,32,12,7,15,6,77,38.25785556196004,-109.3863699
29521,4,38,12,4,14,7,79,38.25785556196004,-109.3861004
29522,2,38,12,1,13,12,78,38.25785556196004,-109.3858309
29523,2,34,14,2,14,14,80,38.25785556196004,-109.3855614
29524,3,33,14,1,13,15,79,38.25785556196004,-109.3852919
29525,2,35,12,0,12,14,75,38.25785556196004,-109.3850225
29526,3,38,11,0,13,11,76,38.25785556196004,-109.384753
29527,4,40,12,4,16,5,81,38.25785556196004,-109.3844835
29528,7,43,12,6,18,1,87,38.25785556196004,-109.384214
29529,7,43,12,6,18,1,87,38.25785556196004,-109.3839445
29530,7,44,12,5,18,1,87,38.25785556196004,-109.383675
29531,6,44,12,5,18,1,86,38.25785556196004,-109.3834055
29532,6,45,12,5,19,1,88,38.25785556196004,-109.383136
29533,6,46,13,5,19,1,90,38.25785556196004,-109.3828665
29534,6,47,12,5,18,1,89,38.25785556196004,-109.382597
29535,6,49,12,6,17,1,91,38.25785556196004,-109.3823275
29536,8,48,12,7,15,0,90,38.25785556196004,-109.382058
29537,16,39,11,8,12,0,86,38.25785556196004,-109.3817885
29538,10,39,11,10,13,1,84,38.25785556196004,-109.381519
29539,5,45,10,8,13,1,82,38.25785556196004,-109.3812495
29540,2,48,9,5,12,2,78,38.25785556196004,-109.38098
29541,1,50,8,4,11,3,77,38.25785556196004,-109.3807105
29542,1,48,7,3,12,3,74,38.25785556196004,-109.380441
29543,3,36,8,5,7,5,64,38.25785556196004,-109.3801716
29544,2,30,9,6,8,5,60,38.25785556196004,-109.3799021
29545,4,35,10,4,10,6,69,38.25785556196004,-109.3796326
29546,2,34,11,3,8,9,67,38.25785556196004,-109.3793631
29547,5,38,13,0,7,13,76,38.25785556196004,-109.3790936
29548,3,40,11,0,8,15,77,38.25785556196004,-109.3788241
29549,3,40,12,0,8,16,79,38.25785556196004,-109.3785546
29550,3,38,13,0,8,16,78,38.25785556196004,-109.3782851
29551,1,35,12,0,8,17,73,38.25785556196004,-109.3780156
29552,1,35,11,0,9,15,71,38.25785556196004,-109.3777461
29553,2,37,11,0,10,13,73,38.25785556196004,-109.3774766
29554,3,38,11,0,12,11,75,38.25785556196004,-109.3772071
29555,3,35,12,2,12,10,74,38.25785556196004,-109.3769376
29556,4,36,11,1,12,9,73,38.25785556196004,-109.3766681
29557,3,36,11,0,13,11,74,38.25785556196004,-109.3763986
29558,2,31,11,0,9,14,67,38.25785556196004,-109.3761291
29559,2,28,11,0,7,15,63,38.25785556196004,-109.3758596
29560,4,29,11,2,8,11,65,38.25785556196004,-109.3755901
29561,8,36,11,6,12,5,78,38.25785556196004,-109.3753206
29562,15,38,12,8,14,1,88,38.25785556196004,-109.3750512
29563,20,35,13,10,12,0,90,38.25785556196004,-109.3747817
29564,22,34,13,10,12,0,91,38.25785556196004,-109.3745122
29565,15,36,13,10,14,1,89,38.25785556196004,-109.3742427
29566,12,38,13,8,13,4,88,38.25785556196004,-109.3739732
29567,9,40,13,7,13,5,87,38.25785556196004,-109.3737037
29568,8,42,14,6,14,6,90,38.25785556196004,-109.3734342
29569,7,42,14,3,13,8,87,38.25785556196004,-109.3731647
29570,5,37,12,0,10,14,78,38.25785556196004,-109.3728952
29571,5,34,13,0,8,18,78,38.25785556196004,-109.3726257
29572,5,32,13,0,8,18,76,38.25785556196004,-109.3723562
29573,4,32,13,0,8,17,74,38.25785556196004,-109.3720867
29574,5,33,13,1,9,17,78,38.25785556196004,-109.3718172
29575,4,30,15,0,7,21,77,38.25785556196004,-109.3715477
29576,6,30,14,2,8,17,77,38.25785556196004,-109.3712782
29577,8,31,14,5,9,13,80,38.25785556196004,-109.3710087
29578,9,31,14,5,10,13,82,38.25785556196004,-109.3707392
29579,7,31,14,4,8,17,81,38.25785556196004,-109.3704697
29580,7,35,13,2,10,15,82,38.25785556196004,-109.3702003
29581,6,37,13,2,14,11,83,38.25785556196004,-109.3699308
29582,5,40,12,3,16,8,84,38.25785556196004,-109.3696613
29583,5,39,13,5,15,6,83,38.25785556196004,-109.3693918
29584,4,33,14,3,13,13,80,38.25785556196004,-109.3691223
29585,5,29,15,1,9,20,79,38.25785556196004,-109.3688528
29586,4,31,14,2,12,16,79,38.25785556196004,-109.3685833
29587,4,35,13,6,15,8,81,38.25785556196004,-109.3683138
29588,8,35,13,10,16,4,86,38.25785556196004,-109.3680443
29589,7,34,13,9,15,6,84,38.25785556196004,-109.3677748
29590,7,34,17,10,9,12,89,38.25785556196004,-109.3675053
29591,6,34,16,10,8,13,87,38.25785556196004,-109.3672358
29592,4,32,14,2,8,17,77,38.25785556196004,-109.3669663
29593,3,32,15,0,7,19,76,38.25785556196004,-109.3666968
29594,3,31,14,2,8,17,75,38.25785556196004,-109.3664273
29595,3,29,13,12,4,15,76,38.25785556196004,-109.3661578
29596,4,33,13,16,4,11,81,38.25785556196004,-109.3658883
29597,5,33,14,10,9,11,82,38.25785556196004,-109.3656188
29598,7,32,14,6,10,13,82,38.25785556196004,-109.3653493
29599,2,28,15,1,7,23,76,38.25785556196004,-109.3650799
29600,3,30,14,2,6,21,76,38.25785556196004,-109.3648104
29601,2,27,11,9,7,10,66,38.25785556196004,-109.3645409
29602,6,28,13,13,10,10,80,38.25785556196004,-109.3642714
29603,11,30,13,8,11,10,83,38.25785556196004,-109.3640019
29604,3,30,14,4,7,18,76,38.25785556196004,-109.3637324
29605,6,28,14,9,7,14,78,38.25785556196004,-109.3634629
29606,10,25,13,14,5,10,77,38.25785556196004,-109.3631934
29607,7,28,12,16,4,9,76,38.25785556196004,-109.3629239
29608,10,30,11,19,11,5,86,38.25785556196004,-109.3626544
29609,9,26,11,19,13,5,83,38.25785556196004,-109.3623849
29610,7,24,13,19,15,6,84,38.25785556196004,-109.3621154
29611,6,23,14,13,13,12,81,38.25785556196004,-109.3618459
29612,5,23,15,4,10,18,75,38.25785556196004,-109.3615764
29613,2,20,17,4,8,22,73,38.25785556196004,-109.3613069
29614,2,21,17,5,9,24,78,38.25785556196004,-109.3610374
29615,2,20,17,5,7,26,77,38.25785556196004,-109.3607679
29616,2,20,16,2,4,26,70,38.25785556196004,-109.3604984
29617,5,22,15,9,8,14,73,38.25785556196004,-109.360229
29618,3,23,17,6,7,20,76,38.25785556196004,-109.3599595
29619,2,22,16,3,6,22,71,38.25785556196004,-109.35969
29620,2,21,15,4,6,20,68,38.25785556196004,-109.3594205
29621,1,26,18,4,7,25,81,38.25785556196004,-109.359151
29622,0,24,15,0,8,23,70,38.25785556196004,-109.3588815
29623,3,24,17,9,9,17,79,38.25785556196004,-109.358612
29624,3,25,18,5,7,23,81,38.25785556196004,-109.3583425
29625,1,24,18,5,8,24,80,38.25785556196004,-109.358073
29626,2,26,19,0,9,23,79,38.25785556196004,-109.3578035
29627,3,26,18,0,8,24,79,38.25785556196004,-109.357534
29628,2,23,15,1,0,24,65,38.25785556196004,-109.3572645
29629,1,21,14,1,1,23,61,38.25785556196004,-109.356995
29630,3,22,17,5,2,24,73,38.25785556196004,-109.3567255
29631,4,22,17,5,3,26,77,38.25785556196004,-109.356456
29632,0,23,16,0,7,27,73,38.25785556196004,-109.3561865
29633,4,28,16,0,9,23,80,38.25785556196004,-109.355917
29634,3,30,15,0,10,20,78,38.25785556196004,-109.3556475
29635,5,26,15,7,7,16,76,38.25785556196004,-109.355378
29636,6,23,13,11,7,14,74,38.25785556196004,-109.3551086
29637,3,23,12,8,4,15,65,38.25785556196004,-109.3548391
29638,3,27,12,5,8,13,68,38.25785556196004,-109.3545696
29639,5,29,11,6,10,8,69,38.25785556196004,-109.3543001
29640,6,31,13,7,14,10,81,38.25785556196004,-109.3540306
29641,9,32,13,11,16,4,85,38.25785556196004,-109.3537611
29642,2,28,14,14,21,3,82,38.25785556196004,-109.3534916
29643,3,23,12,18,20,1,77,38.25785556196004,-109.3532221
29644,3,11,10,20,14,2,60,38.25785556196004,-109.3529526
29645,4,5,7,20,11,1,48,38.25785556196004,-109.3526831
29646,2,9,11,22,15,6,65,38.25785556196004,-109.3524136
29647,1,15,13,14,19,5,67,38.25785556196004,-109.3521441
29648,2,24,15,5,16,13,75,38.25785556196004,-109.3518746
29649,3,22,15,5,9,22,76,38.25785556196004,-109.3516051
29650,4,21,17,2,7,26,77,38.25785556196004,-109.3513356
29651,1,24,19,1,4,32,81,38.25785556196004,-109.3510661
29652,1,20,18,0,2,35,76,38.25785556196004,-109.3507966
29653,2,16,19,0,0,34,71,38.25785556196004,-109.3505271
29654,4,19,18,2,0,30,73,38.25785556196004,-109.3502577
29655,1,17,17,0,0,31,66,38.25785556196004,-109.3499882
29656,1,17,17,0,0,31,66,38.25785556196004,-109.3497187
29657,2,18,16,0,0,29,65,38.25785556196004,-109.3494492
29658,6,18,13,2,0,22,61,38.25785556196004,-109.3491797
29659,6,23,10,3,4,13,59,38.25785556196004,-109.3489102
29660,3,24,7,4,8,8,54,38.25785556196004,-109.3486407
29661,2,26,6,4,8,6,52,38.25785556196004,-109.3483712
29662,2,30,7,4,7,6,56,38.25785556196004,-109.3481017
29663,4,37,7,6,9,4,67,38.25785556196004,-109.3478322
29664,3,32,7,6,9,6,63,38.25785556196004,-109.3475627
29665,2,28,7,6,9,7,59,38.25785556196004,-109.3472932
29666,3,27,8,4,8,8,58,38.25785556196004,-109.3470237
29667,3,42,9,4,9,7,74,38.25785556196004,-109.3467542
29668,3,13,11,6,6,12,51,38.25785556196004,-109.3464847
29669,3,8,12,7,6,14,50,38.25785556196004,-109.3462152
29670,2,11,13,2,2,25,55,38.25785556196004,-109.3459457
29671,0,17,17,0,2,33,69,38.25785556196004,-109.3456762
29672,0,20,17,0,3,32,72,38.25785556196004,-109.3454068
29673,0,19,17,0,3,31,70,38.25785556196004,-109.3451373
29674,1,17,17,0,2,30,67,38.25785556196004,-109.3448678
29675,1,16,17,0,1,32,67,38.25785556196004,-109.3445983
29676,1,16,18,0,1,33,69,38.25785556196004,-109.3443288
29677,1,18,18,0,3,32,72,38.25785556196004,-109.3440593
29678,2,20,19,1,3,31,76,38.25785556196004,-109.3437898
29679,1,20,19,0,3,32,75,38.25785556196004,-109.3435203
29680,1,22,20,1,5,31,80,38.25785556196004,-109.3432508
29681,1,23,19,2,5,32,82,38.25785556196004,-109.3429813
29682,2,22,20,2,4,32,82,38.25785556196004,-109.3427118
29683,2,22,19,2,3,30,78,38.25785556196004,-109.3424423
29684,2,22,18,2,3,29,76,38.25785556196004,-109.3421728
29685,1,22,18,0,3,31,75,38.25785556196004,-109.3419033
29686,1,20,19,0,2,33,75,38.25785556196004,-109.3416338
29687,1,19,19,0,2,32,73,38.25785556196004,-109.3413643
29688,1,19,15,0,1,26,62,38.25785556196004,-109.3410948
29689,1,16,14,2,3,23,59,38.25785556196004,-109.3408253
29690,2,15,13,3,3,22,58,38.25785556196004,-109.3405558
29691,3,24,18,5,5,27,82,38.25785556196004,-109.3402864
29692,1,24,19,0,4,34,82,38.25785556196004,-109.3400169
29693,1,18,16,0,2,29,66,38.25785556196004,-109.3397474
29694,2,19,14,2,3,23,63,38.25785556196004,-109.3394779
29695,2,20,12,2,4,17,57,38.25785556196004,-109.3392084
29696,3,19,13,3,4,18,60,38.25785556196004,-109.3389389
29697,2,19,13,2,3,22,61,38.25785556196004,-109.3386694
29698,1,30,10,2,7,14,64,38.25785556196004,-109.3383999
29699,0,47,7,0,11,6,71,38.25785556196004,-109.3381304
29700,0,54,6,1,11,3,75,38.25785556196004,-109.3378609
29701,0,55,6,1,10,3,75,38.25785556196004,-109.3375914
29702,0,43,8,2,10,5,68,38.25785556196004,-109.3373219
29703,1,32,10,3,9,12,67,38.25785556196004,-109.3370524
29704,2,25,13,4,5,20,69,38.25785556196004,-109.3367829
29705,2,29,12,3,8,16,70,38.25785556196004,-109.3365134
29706,1,30,11,4,10,11,67,38.25785556196004,-109.3362439
29707,2,29,11,4,10,11,67,38.25785556196004,-109.3359744
29708,2,25,13,3,8,15,66,38.25785556196004,-109.3357049
29709,1,23,15,2,5,23,69,38.25785556196004,-109.3354355
29710,1,23,18,0,4,28,74,38.25785556196004,-109.335166
29711,0,19,15,0,2,27,63,38.25785556196004,-109.3348965
29712,1,26,12,1,6,17,63,38.25785556196004,-109.334627
29713,1,36,10,0,11,11,69,38.25785556196004,-109.3343575
29714,0,42,9,0,11,9,71,38.25785556196004,-109.334088
29715,4,45,10,3,16,2,80,38.25785556196004,-109.3338185
29716,2,47,8,0,13,4,74,38.25785556196004,-109.333549
29717,1,39,8,0,13,7,68,38.25785556196004,-109.3332795
29718,1,27,10,0,8,13,59,38.25785556196004,-109.33301
29719,0,21,11,0,4,20,56,38.25785556196004,-109.3327405
29720,0,21,14,0,4,26,65,38.25785556196004,-109.332471
29721,3,51,9,8,10,1,82,38.25758606737481,-109.4440418
29722,4,50,9,9,10,1,83,38.25758606737481,-109.4437723
29723,5,52,10,9,14,0,90,38.25758606737481,-109.4435028
29724,6,53,11,7,16,1,94,38.25758606737481,-109.4432333
29725,6,51,12,7,16,1,93,38.25758606737481,-109.4429638
29726,6,50,12,8,16,1,93,38.25758606737481,-109.4426943
29727,6,49,13,8,16,1,93,38.25758606737481,-109.4424248
29728,6,49,13,9,16,1,94,38.25758606737481,-109.4421553
29729,6,49,13,7,17,1,93,38.25758606737481,-109.4418858
29730,5,50,13,5,17,1,91,38.25758606737481,-109.4416163
29731,5,50,13,5,18,2,93,38.25758606737481,-109.4413468
29732,6,50,12,6,17,1,92,38.25758606737481,-109.4410773
29733,5,53,12,5,17,2,94,38.25758606737481,-109.4408078
29734,4,52,12,3,17,4,92,38.25758606737481,-109.4405383
29735,4,52,12,4,15,4,91,38.25758606737481,-109.4402688
29736,3,54,11,6,14,3,91,38.25758606737481,-109.4399993
29737,3,54,11,2,15,5,90,38.25758606737481,-109.4397299
29738,1,47,11,1,15,9,84,38.25758606737481,-109.4394604
29739,1,45,11,0,14,11,82,38.25758606737481,-109.4391909
29740,1,43,11,0,13,12,80,38.25758606737481,-109.4389214
29741,2,45,11,0,14,10,82,38.25758606737481,-109.4386519
29742,3,51,11,2,15,7,89,38.25758606737481,-109.4383824
29743,3,54,11,3,15,5,91,38.25758606737481,-109.4381129
29744,3,54,11,3,14,6,91,38.25758606737481,-109.4378434
29745,3,52,10,2,13,6,86,38.25758606737481,-109.4375739
29746,2,48,10,0,12,8,80,38.25758606737481,-109.4373044
29747,3,41,10,1,13,8,76,38.25758606737481,-109.4370349
29748,2,38,9,0,12,9,70,38.25758606737481,-109.4367654
29749,3,35,10,1,12,8,69,38.25758606737481,-109.4364959
29750,5,38,10,4,14,6,77,38.25758606737481,-109.4362264
29751,3,48,10,3,15,4,83,38.25758606737481,-109.4359569
29752,6,48,12,9,15,1,91,38.25758606737481,-109.4356874
29753,5,49,10,7,15,1,87,38.25758606737481,-109.4354179
29754,3,47,9,4,15,2,80,38.25758606737481,-109.4351484
29755,2,45,9,1,15,4,76,38.25758606737481,-109.434879
29756,3,45,10,0,16,5,79,38.25758606737481,-109.4346095
29757,5,42,11,0,16,6,80,38.25758606737481,-109.43434
29758,10,37,12,5,14,5,83,38.25758606737481,-109.4340705
29759,14,36,13,11,13,2,89,38.25758606737481,-109.433801
29760,12,39,14,13,14,1,93,38.25758606737481,-109.4335315
29761,10,41,14,13,14,0,92,38.25758606737481,-109.433262
29762,12,39,14,13,14,0,92,38.25758606737481,-109.4329925
29763,14,38,14,13,13,0,92,38.25758606737481,-109.432723
29764,15,39,14,13,13,0,94,38.25758606737481,-109.4324535
29765,15,37,14,13,13,0,92,38.25758606737481,-109.432184
29766,12,41,14,13,13,0,93,38.25758606737481,-109.4319145
29767,15,37,14,12,13,1,92,38.25758606737481,-109.431645
29768,17,35,14,12,13,1,92,38.25758606737481,-109.4313755
29769,17,35,14,12,13,0,91,38.25758606737481,-109.431106
29770,13,38,14,13,13,1,92,38.25758606737481,-109.4308365
29771,12,40,14,13,13,1,93,38.25758606737481,-109.430567
29772,14,39,14,12,14,0,93,38.25758606737481,-109.4302975
29773,18,36,13,11,14,0,92,38.25758606737481,-109.430028
29774,20,35,14,10,13,0,92,38.25758606737481,-109.4297586
29775,12,41,13,11,15,0,92,38.25758606737481,-109.4294891
29776,8,44,14,12,15,0,93,38.25758606737481,-109.4292196
29777,8,45,14,11,15,0,93,38.25758606737481,-109.4289501
29778,8,45,13,11,15,0,92,38.25758606737481,-109.4286806
29779,6,44,12,11,15,1,89,38.25758606737481,-109.4284111
29780,14,39,13,10,14,0,90,38.25758606737481,-109.4281416
29781,17,37,13,10,14,0,91,38.25758606737481,-109.4278721
29782,17,36,13,10,15,0,91,38.25758606737481,-109.4276026
29783,18,35,14,11,15,0,93,38.25758606737481,-109.4273331
29784,17,35,14,12,15,0,93,38.25758606737481,-109.4270636
29785,16,35,14,13,15,0,93,38.25758606737481,-109.4267941
29786,18,34,14,12,14,0,92,38.25758606737481,-109.4265246
29787,17,34,14,13,14,0,92,38.25758606737481,-109.4262551
29788,13,37,14,14,15,0,93,38.25758606737481,-109.4259856
29789,13,37,14,14,14,0,92,38.25758606737481,-109.4257161
29790,14,37,14,13,14,0,92,38.25758606737481,-109.4254466
29791,14,39,14,11,15,0,93,38.25758606737481,-109.4251771
29792,13,40,14,11,15,0,93,38.25758606737481,-109.4249077
29793,11,42,13,11,15,0,92,38.25758606737481,-109.4246382
29794,13,39,13,12,14,0,91,38.25758606737481,-109.4243687
29795,13,40,13,12,14,0,92,38.25758606737481,-109.4240992
29796,12,39,13,13,14,0,91,38.25758606737481,-109.4238297
29797,12,38,14,14,14,0,92,38.25758606737481,-109.4235602
29798,10,39,14,14,13,1,91,38.25758606737481,-109.4232907
29799,11,38,14,13,14,1,91,38.25758606737481,-109.4230212
29800,12,39,14,13,14,0,92,38.25758606737481,-109.4227517
29801,11,41,13,12,14,0,91,38.25758606737481,-109.4224822
29802,8,44,14,12,16,0,94,38.25758606737481,-109.4222127
29803,8,45,13,10,16,1,93,38.25758606737481,-109.4219432
29804,9,44,13,10,16,0,92,38.25758606737481,-109.4216737
29805,12,41,13,10,15,0,91,38.25758606737481,-109.4214042
29806,11,41,13,10,15,0,90,38.25758606737481,-109.4211347
29807,7,47,13,9,16,1,93,38.25758606737481,-109.4208652
29808,4,53,11,6,14,1,89,38.25758606737481,-109.4205957
29809,6,48,11,9,15,1,90,38.25758606737481,-109.4203262
29810,13,38,12,11,15,0,89,38.25758606737481,-109.4200568
29811,19,32,14,12,13,0,90,38.25758606737481,-109.4197873
29812,15,36,13,12,14,0,90,38.25758606737481,-109.4195178
29813,13,34,13,13,15,0,88,38.25758606737481,-109.4192483
29814,14,32,13,13,15,1,88,38.25758606737481,-109.4189788
29815,16,32,13,12,15,0,88,38.25758606737481,-109.4187093
29816,18,31,13,12,14,0,88,38.25758606737481,-109.4184398
29817,20,31,13,12,13,0,89,38.25758606737481,-109.4181703
29818,19,31,14,13,13,0,90,38.25758606737481,-109.4179008
29819,16,36,14,12,13,0,91,38.25758606737481,-109.4176313
29820,13,40,14,12,14,0,93,38.25758606737481,-109.4173618
29821,12,38,14,13,13,1,91,38.25758606737481,-109.4170923
29822,18,33,14,13,13,0,91,38.25758606737481,-109.4168228
29823,22,30,14,14,12,0,92,38.25758606737481,-109.4165533
29824,24,29,14,13,11,0,91,38.25758606737481,-109.4162838
29825,25,29,14,11,12,0,91,38.25758606737481,-109.4160143
29826,18,30,14,14,13,1,90,38.25758606737481,-109.4157448
29827,16,32,14,15,13,0,90,38.25758606737481,-109.4154753
29828,15,34,14,15,13,0,91,38.25758606737481,-109.4152058
29829,13,36,14,14,13,0,90,38.25758606737481,-109.4149364
29830,14,38,14,13,12,0,91,38.25758606737481,-109.4146669
29831,15,37,15,13,12,0,92,38.25758606737481,-109.4143974
29832,17,34,15,14,13,0,93,38.25758606737481,-109.4141279
29833,18,32,14,14,13,0,91,38.25758606737481,-109.4138584
29834,19,32,14,13,14,0,92,38.25758606737481,-109.4135889
29835,17,34,14,14,14,0,93,38.25758606737481,-109.4133194
29836,17,35,14,14,14,0,94,38.25758606737481,-109.4130499
29837,17,35,14,14,13,0,93,38.25758606737481,-109.4127804
29838,17,36,14,14,14,0,95,38.25758606737481,-109.4125109
29839,16,36,15,14,14,0,95,38.25758606737481,-109.4122414
29840,16,36,14,14,14,0,94,38.25758606737481,-109.4119719
29841,16,36,14,14,14,0,94,38.25758606737481,-109.4117024
29842,13,37,14,15,14,0,93,38.25758606737481,-109.4114329
29843,11,38,14,14,15,0,92,38.25758606737481,-109.4111634
29844,12,39,13,14,15,0,93,38.25758606737481,-109.4108939
29845,11,41,13,12,15,0,92,38.25758606737481,-109.4106244
29846,13,39,13,12,14,0,91,38.25758606737481,-109.4103549
29847,15,37,13,14,13,0,92,38.25758606737481,-109.4100855
29848,13,38,14,15,13,0,93,38.25758606737481,-109.409816
29849,7,45,13,13,14,0,92,38.25758606737481,-109.4095465
29850,5,47,13,9,16,0,90,38.25758606737481,-109.409277
29851,5,47,12,8,18,0,90,38.25758606737481,-109.4090075
29852,8,43,13,11,16,0,91,38.25758606737481,-109.408738
29853,12,37,14,14,14,0,91,38.25758606737481,-109.4084685
29854,13,36,14,14,13,0,90,38.25758606737481,-109.408199
29855,9,41,14,13,14,1,92,38.25758606737481,-109.4079295
29856,6,43,13,11,15,1,89,38.25758606737481,-109.40766
29857,4,44,12,9,15,1,85,38.25758606737481,-109.4073905
29858,4,45,12,9,14,1,85,38.25758606737481,-109.407121
29859,4,44,12,7,14,2,83,38.25758606737481,-109.4068515
29860,1,44,8,3,12,4,72,38.25758606737481,-109.3882564
29861,6,43,9,6,12,2,78,38.25758606737481,-109.3879869
29862,2,36,9,4,11,5,67,38.25758606737481,-109.3877174
29863,4,38,9,5,11,4,71,38.25758606737481,-109.3874479
29864,8,39,10,7,11,2,77,38.25758606737481,-109.3871784
29865,0,28,10,3,9,12,62,38.25758606737481,-109.3869089
29866,2,34,11,4,14,8,73,38.25758606737481,-109.3866394
29867,7,40,13,9,16,2,87,38.25758606737481,-109.3863699
29868,7,41,13,8,15,2,86,38.25758606737481,-109.3861004
29869,3,39,12,3,14,9,80,38.25758606737481,-109.3858309
29870,3,35,12,0,12,14,76,38.25758606737481,-109.3855614
29871,4,34,12,2,13,11,76,38.25758606737481,-109.3852919
29872,4,35,11,1,13,10,74,38.25758606737481,-109.3850225
29873,5,40,11,1,15,6,78,38.25758606737481,-109.384753
29874,6,42,12,5,18,2,85,38.25758606737481,-109.3844835
29875,9,42,13,7,18,0,89,38.25758606737481,-109.384214
29876,8,44,12,6,18,0,88,38.25758606737481,-109.3839445
29877,8,45,12,6,18,0,89,38.25758606737481,-109.383675
29878,8,44,13,6,19,0,90,38.25758606737481,-109.3834055
29879,8,44,13,5,18,0,88,38.25758606737481,-109.383136
29880,7,45,12,5,19,0,88,38.25758606737481,-109.3828665
29881,6,47,13,6,18,0,90,38.25758606737481,-109.382597
29882,7,46,12,8,16,0,89,38.25758606737481,-109.3823275
29883,11,39,11,10,14,1,86,38.25758606737481,-109.382058
29884,11,38,10,8,13,1,81,38.25758606737481,-109.3817885
29885,2,48,9,4,14,2,79,38.25758606737481,-109.381519
29886,1,53,8,2,13,2,79,38.25758606737481,-109.3812495
29887,0,54,7,2,13,3,79,38.25758606737481,-109.38098
29888,0,51,7,1,13,3,75,38.25758606737481,-109.3807105
29889,2,36,9,1,7,7,62,38.25758606737481,-109.380441
29890,7,26,10,8,10,3,64,38.25758606737481,-109.3801716
29891,6,27,11,7,11,5,67,38.25758606737481,-109.3799021
29892,4,32,12,4,13,7,72,38.25758606737481,-109.3796326
29893,3,37,12,1,11,12,76,38.25758606737481,-109.3793631
29894,4,37,12,0,6,17,76,38.25758606737481,-109.3790936
29895,2,36,12,0,6,19,75,38.25758606737481,-109.3788241
29896,3,35,12,0,8,17,75,38.25758606737481,-109.3785546
29897,7,39,13,1,12,13,85,38.25758606737481,-109.3782851
29898,4,39,12,0,12,13,80,38.25758606737481,-109.3780156
29899,3,39,11,0,14,10,77,38.25758606737481,-109.3777461
29900,4,40,11,0,15,9,79,38.25758606737481,-109.3774766
29901,5,40,12,0,14,10,81,38.25758606737481,-109.3772071
29902,3,37,11,0,13,11,75,38.25758606737481,-109.3769376
29903,4,38,11,1,14,8,76,38.25758606737481,-109.3766681
29904,4,38,10,2,14,6,74,38.25758606737481,-109.3763986
29905,3,37,10,2,12,7,71,38.25758606737481,-109.3761291
29906,4,37,10,2,11,8,72,38.25758606737481,-109.3758596
29907,7,39,11,4,12,5,78,38.25758606737481,-109.3755901
29908,9,43,11,5,14,2,84,38.25758606737481,-109.3753206
29909,10,43,12,7,15,1,88,38.25758606737481,-109.3750512
29910,13,41,13,10,14,0,91,38.25758606737481,-109.3747817
29911,15,38,13,10,13,0,89,38.25758606737481,-109.3745122
29912,13,38,13,10,14,2,90,38.25758606737481,-109.3742427
29913,11,42,13,7,14,3,90,38.25758606737481,-109.3739732
29914,10,41,13,7,13,4,88,38.25758606737481,-109.3737037
29915,12,39,13,8,13,4,89,38.25758606737481,-109.3734342
29916,16,36,13,8,12,3,88,38.25758606737481,-109.3731647
29917,12,36,13,6,12,7,86,38.25758606737481,-109.3728952
29918,11,36,13,5,12,8,85,38.25758606737481,-109.3726257
29919,11,37,13,5,12,9,87,38.25758606737481,-109.3723562
29920,10,37,13,6,12,8,86,38.25758606737481,-109.3720867
29921,11,38,13,7,12,6,87,38.25758606737481,-109.3718172
29922,8,36,13,5,12,9,83,38.25758606737481,-109.3715477
29923,10,34,13,6,11,8,82,38.25758606737481,-109.3712782
29924,13,34,14,7,11,7,86,38.25758606737481,-109.3710087
29925,13,34,14,8,11,7,87,38.25758606737481,-109.3707392
29926,10,36,14,7,11,8,86,38.25758606737481,-109.3704697
29927,8,40,13,5,13,8,87,38.25758606737481,-109.3702003
29928,7,41,13,4,14,8,87,38.25758606737481,-109.3699308
29929,7,42,12,4,14,7,86,38.25758606737481,-109.3696613
29930,7,43,12,5,15,5,87,38.25758606737481,-109.3693918
29931,6,40,13,4,12,9,84,38.25758606737481,-109.3691223
29932,5,32,14,1,9,18,79,38.25758606737481,-109.3688528
29933,5,31,14,0,7,18,75,38.25758606737481,-109.3685833
29934,6,34,13,2,10,13,78,38.25758606737481,-109.3683138
29935,6,34,13,7,14,6,80,38.25758606737481,-109.3680443
29936,8,30,13,10,13,7,81,38.25758606737481,-109.3677748
29937,5,33,16,4,9,15,82,38.25758606737481,-109.3675053
29938,6,33,16,4,10,14,83,38.25758606737481,-109.3672358
29939,3,32,14,3,6,19,77,38.25758606737481,-109.3669663
29940,2,33,14,2,5,21,77,38.25758606737481,-109.3666968
29941,3,30,14,2,6,23,78,38.25758606737481,-109.3664273
29942,3,27,13,4,12,13,72,38.25758606737481,-109.3661578
29943,3,31,14,1,10,18,77,38.25758606737481,-109.3658883
29944,4,30,14,1,11,18,78,38.25758606737481,-109.3656188
29945,7,31,14,6,14,14,86,38.25758606737481,-109.3653493
29946,7,27,15,6,13,13,81,38.25758606737481,-109.3650799
29947,9,26,13,22,11,5,86,38.25758606737481,-109.3648104
29948,16,32,10,22,10,0,90,38.25758606737481,-109.3645409
29949,12,31,12,20,10,2,87,38.25758606737481,-109.3642714
29950,13,30,13,18,10,4,88,38.25758606737481,-109.3640019
29951,9,28,14,21,11,7,90,38.25758606737481,-109.3637324
29952,7,29,15,17,5,7,80,38.25758606737481,-109.3634629
29953,6,27,16,15,6,10,80,38.25758606737481,-109.3631934
29954,7,26,13,21,6,4,77,38.25758606737481,-109.3629239
29955,7,24,13,26,14,2,86,38.25758606737481,-109.3626544
29956,7,23,13,23,14,3,83,38.25758606737481,-109.3623849
29957,11,24,12,20,14,1,82,38.25758606737481,-109.3621154
29958,8,23,13,19,14,6,83,38.25758606737481,-109.3618459
29959,6,26,13,6,8,11,70,38.25758606737481,-109.3615764
29960,4,25,17,9,12,17,84,38.25758606737481,-109.3613069
29961,3,26,18,5,8,24,84,38.25758606737481,-109.3610374
29962,3,26,18,4,10,22,83,38.25758606737481,-109.3607679
29963,2,21,16,4,8,22,73,38.25758606737481,-109.3604984
29964,2,23,15,3,8,20,71,38.25758606737481,-109.360229
29965,1,25,14,0,9,20,69,38.25758606737481,-109.3599595
29966,1,23,14,1,8,21,68,38.25758606737481,-109.35969
29967,1,23,15,2,8,20,69,38.25758606737481,-109.3594205
29968,2,26,16,3,6,22,75,38.25758606737481,-109.359151
29969,1,22,15,0,6,22,66,38.25758606737481,-109.3588815
29970,4,23,16,4,7,19,73,38.25758606737481,-109.358612
29971,9,26,15,11,13,13,87,38.25758606737481,-109.3583425
29972,5,23,16,7,11,14,76,38.25758606737481,-109.358073
29973,3,26,14,2,10,14,69,38.25758606737481,-109.3578035
29974,3,27,13,1,9,15,68,38.25758606737481,-109.357534
29975,10,23,11,14,9,9,76,38.25758606737481,-109.3572645
29976,8,25,12,13,9,11,78,38.25758606737481,-109.356995
29977,7,19,13,8,5,17,69,38.25758606737481,-109.3567255
29978,7,16,14,8,5,21,71,38.25758606737481,-109.356456
29979,0,25,18,1,8,27,79,38.25758606737481,-109.3561865
29980,1,25,15,2,9,23,75,38.25758606737481,-109.355917
29981,5,29,15,6,11,14,80,38.25758606737481,-109.3556475
29982,5,28,15,5,12,14,79,38.25758606737481,-109.355378
29983,5,27,13,18,7,11,81,38.25758606737481,-109.3551086
29984,8,21,11,21,9,8,78,38.25758606737481,-109.3548391
29985,9,29,9,21,9,4,81,38.25758606737481,-109.3545696
29986,11,32,9,20,10,1,83,38.25758606737481,-109.3543001
29987,5,34,12,18,13,2,84,38.25758606737481,-109.3540306
29988,5,34,12,13,18,2,84,38.25758606737481,-109.3537611
29989,3,24,13,17,20,1,78,38.25758606737481,-109.3534916
29990,5,14,10,17,15,0,61,38.25758606737481,-109.3532221
29991,0,3,7,20,9,1,40,38.25758606737481,-109.3529526
29992,2,7,11,23,15,6,64,38.25758606737481,-109.3526831
29993,1,15,15,10,14,11,66,38.25758606737481,-109.3524136
29994,3,21,16,8,13,16,77,38.25758606737481,-109.3521441
29995,2,23,16,1,12,22,76,38.25758606737481,-109.3518746
29996,5,21,16,6,5,25,78,38.25758606737481,-109.3516051
29997,3,23,18,1,3,30,78,38.25758606737481,-109.3513356
29998,1,20,17,0,2,33,73,38.25758606737481,-109.3510661
29999,1,18,18,0,1,33,71,38.25758606737481,-109.3507966
30000,2,17,18,1,1,32,71,38.25758606737481,-109.3505271
30001,2,18,18,1,1,31,71,38.25758606737481,-109.3502577
30002,1,18,17,0,0,31,67,38.25758606737481,-109.3499882
30003,1,18,16,0,0,28,63,38.25758606737481,-109.3497187
30004,2,21,14,0,2,22,61,38.25758606737481,-109.3494492
30005,5,24,10,2,5,12,58,38.25758606737481,-109.3491797
30006,3,36,6,5,9,4,63,38.25758606737481,-109.3489102
30007,2,38,6,4,9,3,62,38.25758606737481,-109.3486407
30008,2,35,6,4,8,5,60,38.25758606737481,-109.3483712
30009,2,37,7,3,8,6,63,38.25758606737481,-109.3481017
30010,6,37,8,5,10,4,70,38.25758606737481,-109.3478322
30011,2,29,10,5,8,9,63,38.25758606737481,-109.3475627
30012,3,23,13,6,8,12,65,38.25758606737481,-109.3472932
30013,2,20,12,4,8,14,60,38.25758606737481,-109.3470237
30014,1,16,11,3,5,15,51,38.25758606737481,-109.3467542
30015,4,26,12,3,11,13,69,38.25758606737481,-109.3464847
30016,6,24,13,6,10,12,71,38.25758606737481,-109.3462152
30017,8,18,12,11,9,16,74,38.25758606737481,-109.3459457
30018,1,24,18,1,4,32,80,38.25758606737481,-109.3456762
30019,0,21,18,0,3,34,76,38.25758606737481,-109.3454068
30020,0,20,19,0,2,36,77,38.25758606737481,-109.3451373
30021,0,20,18,0,3,34,75,38.25758606737481,-109.3448678
30022,1,20,18,0,2,33,74,38.25758606737481,-109.3445983
30023,1,20,18,0,2,33,74,38.25758606737481,-109.3443288
30024,1,19,18,0,3,32,73,38.25758606737481,-109.3440593
30025,1,20,19,0,4,31,75,38.25758606737481,-109.3437898
30026,0,18,18,0,3,32,71,38.25758606737481,-109.3435203
30027,1,20,18,1,3,31,74,38.25758606737481,-109.3432508
30028,3,23,19,3,4,29,81,38.25758606737481,-109.3429813
30029,3,24,18,4,4,28,81,38.25758606737481,-109.3427118
30030,2,22,18,2,3,30,77,38.25758606737481,-109.3424423
30031,1,22,17,1,2,28,71,38.25758606737481,-109.3421728
30032,1,21,16,0,1,28,67,38.25758606737481,-109.3419033
30033,1,20,16,0,1,28,66,38.25758606737481,-109.3416338
30034,2,23,16,0,1,26,68,38.25758606737481,-109.3413643
30035,1,21,15,0,1,26,64,38.25758606737481,-109.3410948
30036,0,19,14,0,2,25,60,38.25758606737481,-109.3408253
30037,1,19,15,3,4,23,65,38.25758606737481,-109.3405558
30038,2,23,17,2,3,27,74,38.25758606737481,-109.3402864
30039,2,21,16,0,2,28,69,38.25758606737481,-109.3400169
30040,2,22,15,1,2,24,66,38.25758606737481,-109.3397474
30041,1,21,14,1,3,20,60,38.25758606737481,-109.3394779
30042,1,21,13,2,3,19,59,38.25758606737481,-109.3392084
30043,1,18,14,3,4,20,60,38.25758606737481,-109.3389389
30044,1,23,11,3,7,17,62,38.25758606737481,-109.3386694
30045,0,35,8,1,9,11,64,38.25758606737481,-109.3383999
30046,0,48,7,0,11,6,72,38.25758606737481,-109.3381304
30047,0,52,7,1,12,5,77,38.25758606737481,-109.3378609
30048,1,47,8,2,11,4,73,38.25758606737481,-109.3375914
30049,0,46,8,0,10,6,70,38.25758606737481,-109.3373219
30050,1,38,9,1,9,11,69,38.25758606737481,-109.3370524
30051,1,36,10,2,10,11,70,38.25758606737481,-109.3367829
30052,1,44,9,2,11,5,72,38.25758606737481,-109.3365134
30053,2,42,10,5,11,4,74,38.25758606737481,-109.3362439
30054,2,43,10,6,12,4,77,38.25758606737481,-109.3359744
30055,2,37,11,6,13,6,75,38.25758606737481,-109.3357049
30056,2,23,14,4,6,20,69,38.25758606737481,-109.3354355
30057,1,23,17,0,4,27,72,38.25758606737481,-109.335166
30058,1,20,14,0,2,25,62,38.25758606737481,-109.3348965
30059,2,30,11,0,6,17,66,38.25758606737481,-109.334627
30060,1,35,10,0,11,12,69,38.25758606737481,-109.3343575
30061,0,36,9,0,11,10,66,38.25758606737481,-109.334088
30062,4,40,9,2,14,4,73,38.25758606737481,-109.3338185
30063,1,41,9,0,14,6,71,38.25758606737481,-109.333549
30064,1,33,9,0,13,7,63,38.25758606737481,-109.3332795
30065,2,26,10,0,8,13,59,38.25758606737481,-109.33301
30066,0,24,13,0,6,21,64,38.25758606737481,-109.3327405
30067,0,21,13,0,3,23,60,38.25758606737481,-109.332471
30068,4,50,10,8,13,1,86,38.25731657278957,-109.4440418
30069,5,51,10,8,15,0,89,38.25731657278957,-109.4437723
30070,4,54,11,6,16,1,92,38.25731657278957,-109.4435028
30071,5,54,12,5,17,1,94,38.25731657278957,-109.4432333
30072,5,53,12,6,17,1,94,38.25731657278957,-109.4429638
30073,5,51,12,7,17,1,93,38.25731657278957,-109.4426943
30074,5,51,12,7,17,1,93,38.25731657278957,-109.4424248
30075,5,50,12,7,17,1,92,38.25731657278957,-109.4421553
30076,5,51,12,5,17,2,92,38.25731657278957,-109.4418858
30077,5,51,12,4,17,3,92,38.25731657278957,-109.4416163
30078,5,51,12,4,17,3,92,38.25731657278957,-109.4413468
30079,5,53,12,4,17,2,93,38.25731657278957,-109.4410773
30080,4,55,12,4,17,2,94,38.25731657278957,-109.4408078
30081,4,54,12,4,16,3,93,38.25731657278957,-109.4405383
30082,4,55,11,5,14,3,92,38.25731657278957,-109.4402688
30083,3,56,10,5,14,3,91,38.25731657278957,-109.4399993
30084,3,55,11,4,15,3,91,38.25731657278957,-109.4397299
30085,2,51,11,1,17,6,88,38.25731657278957,-109.4394604
30086,2,46,11,0,13,11,83,38.25731657278957,-109.4391909
30087,2,46,10,0,13,11,82,38.25731657278957,-109.4389214
30088,2,50,11,1,16,7,87,38.25731657278957,-109.4386519
30089,3,54,11,3,15,6,92,38.25731657278957,-109.4383824
30090,3,53,11,5,14,4,90,38.25731657278957,-109.4381129
30091,3,50,11,3,14,6,87,38.25731657278957,-109.4378434
30092,2,47,11,1,13,9,83,38.25731657278957,-109.4375739
30093,2,41,10,0,11,11,75,38.25731657278957,-109.4373044
30094,2,43,9,0,12,8,74,38.25731657278957,-109.4370349
30095,2,41,9,0,12,9,73,38.25731657278957,-109.4367654
30096,2,35,10,1,13,9,70,38.25731657278957,-109.4364959
30097,4,34,11,4,14,7,74,38.25731657278957,-109.4362264
30098,3,45,11,3,15,6,83,38.25731657278957,-109.4359569
30099,5,51,11,7,14,1,89,38.25731657278957,-109.4356874
30100,7,50,10,6,14,1,88,38.25731657278957,-109.4354179
30101,7,45,9,5,13,1,80,38.25731657278957,-109.4351484
30102,5,39,9,4,12,3,72,38.25731657278957,-109.434879
30103,2,42,10,0,15,6,75,38.25731657278957,-109.4346095
30104,4,40,11,0,14,8,77,38.25731657278957,-109.43434
30105,6,42,12,3,13,8,84,38.25731657278957,-109.4340705
30106,10,40,14,10,15,2,91,38.25731657278957,-109.433801
30107,13,38,14,13,14,1,93,38.25731657278957,-109.4335315
30108,10,39,14,13,14,1,91,38.25731657278957,-109.433262
30109,13,40,13,12,14,0,92,38.25731657278957,-109.4329925
30110,12,41,13,12,13,0,91,38.25731657278957,-109.432723
30111,9,46,14,12,13,0,94,38.25731657278957,-109.4324535
30112,8,47,14,12,13,0,94,38.25731657278957,-109.432184
30113,10,43,14,12,13,0,92,38.25731657278957,-109.4319145
30114,12,41,14,12,13,1,93,38.25731657278957,-109.431645
30115,13,41,14,12,13,0,93,38.25731657278957,-109.4313755
30116,13,40,14,12,13,0,92,38.25731657278957,-109.431106
30117,11,41,14,13,13,0,92,38.25731657278957,-109.4308365
30118,10,43,14,12,13,1,93,38.25731657278957,-109.430567
30119,11,42,13,12,14,0,92,38.25731657278957,-109.4302975
30120,15,38,13,11,14,0,91,38.25731657278957,-109.430028
30121,20,35,14,9,13,0,91,38.25731657278957,-109.4297586
30122,16,37,13,10,14,0,90,38.25731657278957,-109.4294891
30123,10,42,14,12,15,1,94,38.25731657278957,-109.4292196
30124,8,43,13,12,15,1,92,38.25731657278957,-109.4289501
30125,8,44,13,11,15,1,92,38.25731657278957,-109.4286806
30126,8,44,13,11,16,0,92,38.25731657278957,-109.4284111
30127,11,43,13,10,15,0,92,38.25731657278957,-109.4281416
30128,11,41,13,10,15,0,90,38.25731657278957,-109.4278721
30129,13,38,13,11,15,0,90,38.25731657278957,-109.4276026
30130,15,36,13,12,15,0,91,38.25731657278957,-109.4273331
30131,14,36,14,13,15,0,92,38.25731657278957,-109.4270636
30132,16,34,14,12,15,0,91,38.25731657278957,-109.4267941
30133,16,34,14,13,14,0,91,38.25731657278957,-109.4265246
30134,15,35,14,14,14,0,92,38.25731657278957,-109.4262551
30135,13,36,14,14,15,0,92,38.25731657278957,-109.4259856
30136,12,37,14,14,14,0,91,38.25731657278957,-109.4257161
30137,14,36,14,13,15,0,92,38.25731657278957,-109.4254466
30138,15,37,14,12,15,0,93,38.25731657278957,-109.4251771
30139,14,39,14,12,15,0,94,38.25731657278957,-109.4249077
30140,12,41,13,11,16,0,93,38.25731657278957,-109.4246382
30141,14,40,13,11,15,0,93,38.25731657278957,-109.4243687
30142,14,38,13,12,14,0,91,38.25731657278957,-109.4240992
30143,12,38,13,13,14,0,90,38.25731657278957,-109.4238297
30144,9,39,13,14,14,1,90,38.25731657278957,-109.4235602
30145,10,41,15,14,14,0,94,38.25731657278957,-109.4232907
30146,10,42,15,14,14,0,95,38.25731657278957,-109.4230212
30147,11,41,14,14,14,0,94,38.25731657278957,-109.4227517
30148,10,42,13,12,15,0,92,38.25731657278957,-109.4224822
30149,8,42,13,11,16,1,91,38.25731657278957,-109.4222127
30150,9,42,13,11,16,0,91,38.25731657278957,-109.4219432
30151,10,42,13,11,16,0,92,38.25731657278957,-109.4216737
30152,10,43,13,10,16,0,92,38.25731657278957,-109.4214042
30153,8,47,12,9,16,0,92,38.25731657278957,-109.4211347
30154,6,50,11,7,15,1,90,38.25731657278957,-109.4208652
30155,5,49,11,8,15,1,89,38.25731657278957,-109.4205957
30156,9,41,12,10,15,1,88,38.25731657278957,-109.4203262
30157,15,35,13,11,14,0,88,38.25731657278957,-109.4200568
30158,13,36,13,12,15,0,89,38.25731657278957,-109.4197873
30159,13,36,13,12,15,0,89,38.25731657278957,-109.4195178
30160,12,33,13,13,15,1,87,38.25731657278957,-109.4192483
30161,16,31,13,13,15,1,89,38.25731657278957,-109.4189788
30162,19,30,13,12,14,0,88,38.25731657278957,-109.4187093
30163,20,29,13,12,14,0,88,38.25731657278957,-109.4184398
30164,21,28,13,12,14,1,89,38.25731657278957,-109.4181703
30165,20,31,13,11,13,0,88,38.25731657278957,-109.4179008
30166,17,35,14,12,13,0,91,38.25731657278957,-109.4176313
30167,15,37,14,13,13,0,92,38.25731657278957,-109.4173618
30168,18,32,14,12,13,0,89,38.25731657278957,-109.4170923
30169,21,29,13,11,13,1,88,38.25731657278957,-109.4168228
30170,22,28,14,13,13,0,90,38.25731657278957,-109.4165533
30171,22,28,14,13,13,0,90,38.25731657278957,-109.4162838
30172,22,29,14,12,13,0,90,38.25731657278957,-109.4160143
30173,21,29,14,13,13,0,90,38.25731657278957,-109.4157448
30174,17,32,14,14,13,0,90,38.25731657278957,-109.4154753
30175,14,36,14,14,13,0,91,38.25731657278957,-109.4152058
30176,11,39,14,14,13,0,91,38.25731657278957,-109.4149364
30177,13,38,14,14,13,0,92,38.25731657278957,-109.4146669
30178,15,36,14,14,12,0,91,38.25731657278957,-109.4143974
30179,16,34,15,14,13,0,92,38.25731657278957,-109.4141279
30180,20,31,14,13,13,0,91,38.25731657278957,-109.4138584
30181,21,31,14,13,13,0,92,38.25731657278957,-109.4135889
30182,16,36,14,13,14,0,93,38.25731657278957,-109.4133194
30183,17,35,14,12,14,0,92,38.25731657278957,-109.4130499
30184,17,35,14,13,14,0,93,38.25731657278957,-109.4127804
30185,17,36,14,13,14,0,94,38.25731657278957,-109.4125109
30186,15,37,14,14,14,0,94,38.25731657278957,-109.4122414
30187,14,37,14,14,15,0,94,38.25731657278957,-109.4119719
30188,15,37,14,14,14,0,94,38.25731657278957,-109.4117024
30189,13,37,14,14,14,0,92,38.25731657278957,-109.4114329
30190,12,38,14,13,15,0,92,38.25731657278957,-109.4111634
30191,13,38,14,14,14,0,93,38.25731657278957,-109.4108939
30192,14,38,13,12,14,0,91,38.25731657278957,-109.4106244
30193,14,37,13,12,14,0,90,38.25731657278957,-109.4103549
30194,13,39,13,13,14,0,92,38.25731657278957,-109.4100855
30195,10,42,13,13,14,0,92,38.25731657278957,-109.409816
30196,7,46,12,9,15,0,89,38.25731657278957,-109.4095465
30197,6,47,13,8,16,1,91,38.25731657278957,-109.409277
30198,5,47,12,7,17,1,89,38.25731657278957,-109.4090075
30199,5,47,12,7,18,1,90,38.25731657278957,-109.408738
30200,7,46,13,10,17,0,93,38.25731657278957,-109.4084685
30201,8,43,13,11,15,0,90,38.25731657278957,-109.408199
30202,4,45,12,9,15,1,86,38.25731657278957,-109.4079295
30203,3,47,11,6,15,2,84,38.25731657278957,-109.40766
30204,2,50,10,4,14,3,83,38.25731657278957,-109.4073905
30205,2,51,9,3,14,3,82,38.25731657278957,-109.407121
30206,1,50,9,3,14,4,81,38.25731657278957,-109.4068515
30207,1,34,9,3,11,6,64,38.25731657278957,-109.3882564
30208,6,44,9,5,11,2,77,38.25731657278957,-109.3879869
30209,3,39,8,3,10,5,68,38.25731657278957,-109.3877174
30210,3,38,9,4,10,5,69,38.25731657278957,-109.3874479
30211,5,39,10,6,10,4,74,38.25731657278957,-109.3871784
30212,2,34,9,6,11,6,68,38.25731657278957,-109.3869089
30213,2,39,10,4,14,6,75,38.25731657278957,-109.3866394
30214,6,39,11,9,16,2,83,38.25731657278957,-109.3863699
30215,5,34,12,7,15,5,78,38.25731657278957,-109.3861004
30216,1,29,12,2,10,14,68,38.25731657278957,-109.3858309
30217,3,33,11,0,11,12,70,38.25731657278957,-109.3855614
30218,5,36,11,4,14,6,76,38.25731657278957,-109.3852919
30219,6,39,11,4,15,4,79,38.25731657278957,-109.3850225
30220,8,43,12,5,17,1,86,38.25731657278957,-109.384753
30221,10,43,13,8,16,0,90,38.25731657278957,-109.3844835
30222,9,45,13,7,17,0,91,38.25731657278957,-109.384214
30223,10,44,13,7,17,0,91,38.25731657278957,-109.3839445
30224,10,43,13,8,16,0,90,38.25731657278957,-109.383675
30225,11,42,14,9,16,0,92,38.25731657278957,-109.3834055
30226,12,41,13,8,17,0,91,38.25731657278957,-109.383136
30227,10,43,13,7,17,0,90,38.25731657278957,-109.3828665
30228,7,47,12,8,17,0,91,38.25731657278957,-109.382597
30229,8,42,11,8,15,1,85,38.25731657278957,-109.3823275
30230,8,40,10,7,14,1,80,38.25731657278957,-109.382058
30231,3,45,9,6,14,2,79,38.25731657278957,-109.3817885
30232,0,59,7,1,13,2,82,38.25731657278957,-109.381519
30233,0,59,7,0,14,3,83,38.25731657278957,-109.3812495
30234,0,52,8,0,15,3,78,38.25731657278957,-109.38098
30235,2,34,10,2,12,7,67,38.25731657278957,-109.3807105
30236,3,17,10,5,6,12,53,38.25731657278957,-109.380441
30237,8,20,11,9,11,4,63,38.25731657278957,-109.3801716
30238,5,27,11,5,12,7,67,38.25731657278957,-109.3799021
30239,3,34,12,1,10,13,73,38.25731657278957,-109.3796326
30240,4,36,12,0,8,15,75,38.25731657278957,-109.3793631
30241,4,37,12,0,7,16,76,38.25731657278957,-109.3790936
30242,3,33,13,0,6,20,75,38.25731657278957,-109.3788241
30243,4,32,14,0,7,20,77,38.25731657278957,-109.3785546
30244,7,36,13,2,9,15,82,38.25731657278957,-109.3782851
30245,4,37,12,0,12,14,79,38.25731657278957,-109.3780156
30246,4,40,12,1,15,8,80,38.25731657278957,-109.3777461
30247,5,42,12,2,16,6,83,38.25731657278957,-109.3774766
30248,5,42,12,2,15,8,84,38.25731657278957,-109.3772071
30249,5,39,12,2,13,10,81,38.25731657278957,-109.3769376
30250,9,38,13,6,15,6,87,38.25731657278957,-109.3766681
30251,10,39,12,4,14,7,86,38.25731657278957,-109.3763986
30252,9,40,12,4,13,6,84,38.25731657278957,-109.3761291
30253,7,42,11,5,14,4,83,38.25731657278957,-109.3758596
30254,8,42,11,5,14,2,82,38.25731657278957,-109.3755901
30255,6,40,10,5,14,3,78,38.25731657278957,-109.3753206
30256,5,38,11,4,14,6,78,38.25731657278957,-109.3750512
30257,9,41,12,5,14,5,86,38.25731657278957,-109.3747817
30258,12,42,13,6,14,3,90,38.25731657278957,-109.3745122
30259,9,40,14,7,14,6,90,38.25731657278957,-109.3742427
30260,9,43,13,7,14,3,89,38.25731657278957,-109.3739732
30261,9,42,13,7,14,4,89,38.25731657278957,-109.3737037
30262,11,40,13,8,13,3,88,38.25731657278957,-109.3734342
30263,13,38,13,10,13,2,89,38.25731657278957,-109.3731647
30264,13,38,13,9,13,3,89,38.25731657278957,-109.3728952
30265,12,39,13,7,13,4,88,38.25731657278957,-109.3726257
30266,12,39,14,8,12,5,90,38.25731657278957,-109.3723562
30267,13,38,14,9,12,3,89,38.25731657278957,-109.3720867
30268,17,36,13,9,12,2,89,38.25731657278957,-109.3718172
30269,15,37,13,9,12,3,89,38.25731657278957,-109.3715477
30270,12,36,14,9,12,5,88,38.25731657278957,-109.3712782
30271,10,37,14,8,12,7,88,38.25731657278957,-109.3710087
30272,10,37,14,7,12,7,87,38.25731657278957,-109.3707392
30273,8,39,13,6,12,8,86,38.25731657278957,-109.3704697
30274,8,42,13,5,13,7,88,38.25731657278957,-109.3702003
30275,7,41,14,5,12,8,87,38.25731657278957,-109.3699308
30276,8,40,15,6,11,8,88,38.25731657278957,-109.3696613
30277,10,38,14,8,11,7,88,38.25731657278957,-109.3693918
30278,8,39,14,7,10,9,87,38.25731657278957,-109.3691223
30279,4,28,15,7,3,16,73,38.25731657278957,-109.3688528
30280,3,29,16,6,3,18,75,38.25731657278957,-109.3685833
30281,2,28,15,3,2,19,69,38.25731657278957,-109.3683138
30282,5,30,14,1,8,17,75,38.25731657278957,-109.3680443
30283,5,32,15,2,10,15,79,38.25731657278957,-109.3677748
30284,3,34,15,3,6,20,81,38.25731657278957,-109.3675053
30285,3,32,15,4,6,20,80,38.25731657278957,-109.3672358
30286,10,28,15,9,11,10,83,38.25731657278957,-109.3669663
30287,8,28,14,9,9,13,81,38.25731657278957,-109.3666968
30288,5,29,15,0,12,19,80,38.25731657278957,-109.3664273
30289,5,29,15,0,9,20,78,38.25731657278957,-109.3661578
30290,1,32,15,0,7,21,76,38.25731657278957,-109.3658883
30291,2,32,14,0,6,23,77,38.25731657278957,-109.3656188
30292,6,29,11,10,11,9,76,38.25731657278957,-109.3653493
30293,9,24,14,15,10,8,80,38.25731657278957,-109.3650799
30294,12,27,11,13,10,4,77,38.25731657278957,-109.3648104
30295,15,32,11,18,11,0,87,38.25731657278957,-109.3645409
30296,11,27,14,17,16,4,89,38.25731657278957,-109.3642714
30297,12,31,13,16,17,2,91,38.25731657278957,-109.3640019
30298,9,27,16,14,13,9,88,38.25731657278957,-109.3637324
30299,5,24,18,16,11,12,86,38.25731657278957,-109.3634629
30300,4,21,15,24,14,7,85,38.25731657278957,-109.3631934
30301,5,17,13,25,16,5,81,38.25731657278957,-109.3629239
30302,10,21,12,27,14,1,85,38.25731657278957,-109.3626544
30303,11,21,11,29,14,0,86,38.25731657278957,-109.3623849
30304,8,29,11,18,15,1,82,38.25731657278957,-109.3621154
30305,3,35,9,15,14,3,79,38.25731657278957,-109.3618459
30306,6,33,10,16,11,4,80,38.25731657278957,-109.3615764
30307,7,25,11,14,8,8,73,38.25731657278957,-109.3613069
30308,5,23,14,10,9,13,74,38.25731657278957,-109.3610374
30309,3,26,17,8,11,17,82,38.25731657278957,-109.3607679
30310,2,28,19,7,12,13,81,38.25731657278957,-109.3604984
30311,6,26,16,12,4,15,79,38.25731657278957,-109.360229
30312,7,29,14,7,10,13,80,38.25731657278957,-109.3599595
30313,5,29,14,6,11,13,78,38.25731657278957,-109.35969
30314,5,37,15,11,7,10,85,38.25731657278957,-109.3594205
30315,9,36,11,15,10,3,84,38.25731657278957,-109.359151
30316,5,29,11,16,8,7,76,38.25731657278957,-109.3588815
30317,8,30,13,16,8,8,83,38.25731657278957,-109.358612
30318,6,29,14,15,12,11,87,38.25731657278957,-109.3583425
30319,4,23,14,17,11,9,78,38.25731657278957,-109.358073
30320,2,33,13,5,14,8,75,38.25731657278957,-109.3578035
30321,2,35,13,6,6,15,77,38.25731657278957,-109.357534
30322,5,33,13,11,7,13,82,38.25731657278957,-109.3572645
30323,7,27,11,14,10,9,78,38.25731657278957,-109.356995
30324,3,19,12,13,4,12,63,38.25731657278957,-109.3567255
30325,6,20,13,15,8,16,78,38.25731657278957,-109.356456
30326,1,27,18,5,10,23,84,38.25731657278957,-109.3561865
30327,1,26,17,3,10,23,80,38.25731657278957,-109.355917
30328,3,27,16,9,7,19,81,38.25731657278957,-109.3556475
30329,4,31,14,13,7,13,82,38.25731657278957,-109.355378
30330,4,32,14,14,9,12,85,38.25731657278957,-109.3551086
30331,4,23,15,17,13,10,82,38.25731657278957,-109.3548391
30332,6,31,12,20,14,2,85,38.25731657278957,-109.3545696
30333,6,31,11,21,18,1,88,38.25731657278957,-109.3543001
30334,3,26,14,13,18,7,81,38.25731657278957,-109.3540306
30335,3,27,14,9,18,7,78,38.25731657278957,-109.3537611
30336,4,20,12,13,21,2,72,38.25731657278957,-109.3534916
30337,7,9,7,23,8,1,55,38.25731657278957,-109.3532221
30338,9,7,9,25,15,3,68,38.25731657278957,-109.3529526
30339,8,18,10,11,19,5,71,38.25731657278957,-109.3526831
30340,3,22,14,6,17,13,75,38.25731657278957,-109.3524136
30341,1,24,17,1,11,22,76,38.25731657278957,-109.3521441
30342,1,26,18,0,7,29,81,38.25731657278957,-109.3518746
30343,2,20,18,0,2,33,75,38.25731657278957,-109.3516051
30344,2,20,17,0,0,30,69,38.25731657278957,-109.3513356
30345,1,18,18,0,1,32,70,38.25731657278957,-109.3510661
30346,1,17,18,0,1,33,70,38.25731657278957,-109.3507966
30347,1,18,18,0,2,33,72,38.25731657278957,-109.3505271
30348,1,20,19,0,3,35,78,38.25731657278957,-109.3502577
30349,1,17,18,0,1,31,68,38.25731657278957,-109.3499882
30350,1,19,15,0,1,25,61,38.25731657278957,-109.3497187
30351,4,20,9,2,2,14,51,38.25731657278957,-109.3494492
30352,2,29,6,3,8,5,53,38.25731657278957,-109.3491797
30353,2,36,6,5,8,4,61,38.25731657278957,-109.3489102
30354,2,37,6,4,9,3,61,38.25731657278957,-109.3486407
30355,2,32,7,5,9,5,60,38.25731657278957,-109.3483712
30356,2,36,8,4,9,8,67,38.25731657278957,-109.3481017
30357,6,30,12,8,9,8,73,38.25731657278957,-109.3478322
30358,1,19,13,2,5,19,59,38.25731657278957,-109.3475627
30359,3,21,15,1,4,22,66,38.25731657278957,-109.3472932
30360,5,23,17,2,4,21,72,38.25731657278957,-109.3470237
30361,4,24,14,2,8,17,69,38.25731657278957,-109.3467542
30362,3,23,12,3,14,12,67,38.25731657278957,-109.3464847
30363,5,22,14,5,13,14,73,38.25731657278957,-109.3462152
30364,5,21,14,7,7,22,76,38.25731657278957,-109.3459457
30365,1,24,18,1,4,32,80,38.25731657278957,-109.3456762
30366,1,20,19,0,3,36,79,38.25731657278957,-109.3454068
30367,0,20,21,0,3,37,81,38.25731657278957,-109.3451373
30368,0,21,20,0,4,35,80,38.25731657278957,-109.3448678
30369,0,21,19,0,4,34,78,38.25731657278957,-109.3445983
30370,0,20,19,0,3,33,75,38.25731657278957,-109.3443288
30371,0,19,19,0,3,33,74,38.25731657278957,-109.3440593
30372,1,18,20,0,3,33,75,38.25731657278957,-109.3437898
30373,1,17,19,0,1,33,71,38.25731657278957,-109.3435203
30374,1,18,17,0,1,30,67,38.25731657278957,-109.3432508
30375,1,21,17,0,2,28,69,38.25731657278957,-109.3429813
30376,2,24,18,2,4,28,78,38.25731657278957,-109.3427118
30377,2,24,18,2,4,30,80,38.25731657278957,-109.3424423
30378,1,22,18,0,2,30,73,38.25731657278957,-109.3421728
30379,1,22,17,0,2,27,69,38.25731657278957,-109.3419033
30380,0,20,14,1,4,22,61,38.25731657278957,-109.3416338
30381,1,23,14,2,4,21,65,38.25731657278957,-109.3413643
30382,1,23,15,0,3,26,68,38.25731657278957,-109.3410948
30383,1,20,16,0,4,27,68,38.25731657278957,-109.3408253
30384,1,18,15,2,3,25,64,38.25731657278957,-109.3405558
30385,1,26,13,0,2,23,65,38.25731657278957,-109.3402864
30386,2,27,13,0,4,20,66,38.25731657278957,-109.3400169
30387,1,25,14,1,3,21,65,38.25731657278957,-109.3397474
30388,1,23,14,1,2,21,62,38.25731657278957,-109.3394779
30389,1,21,13,1,3,21,60,38.25731657278957,-109.3392084
30390,2,23,13,4,6,17,65,38.25731657278957,-109.3389389
30391,1,24,11,2,5,18,61,38.25731657278957,-109.3386694
30392,1,33,9,2,10,12,67,38.25731657278957,-109.3383999
30393,0,42,8,1,10,8,69,38.25731657278957,-109.3381304
30394,0,42,8,1,9,7,67,38.25731657278957,-109.3378609
30395,1,41,8,1,10,6,67,38.25731657278957,-109.3375914
30396,2,39,9,1,8,11,70,38.25731657278957,-109.3373219
30397,1,36,10,1,11,11,70,38.25731657278957,-109.3370524
30398,0,43,9,2,11,7,72,38.25731657278957,-109.3367829
30399,1,48,9,1,9,4,72,38.25731657278957,-109.3365134
30400,2,42,9,5,11,4,73,38.25731657278957,-109.3362439
30401,2,33,11,7,11,8,72,38.25731657278957,-109.3359744
30402,1,25,12,5,8,14,65,38.25731657278957,-109.3357049
30403,2,22,13,3,5,19,64,38.25731657278957,-109.3354355
30404,2,22,15,3,5,22,69,38.25731657278957,-109.335166
30405,1,21,14,2,3,22,63,38.25731657278957,-109.3348965
30406,1,25,11,1,5,18,61,38.25731657278957,-109.334627
30407,1,28,10,0,7,16,62,38.25731657278957,-109.3343575
30408,0,30,10,0,9,14,63,38.25731657278957,-109.334088
30409,2,28,11,0,10,14,65,38.25731657278957,-109.3338185
30410,1,27,10,0,8,14,60,38.25731657278957,-109.333549
30411,1,26,10,0,8,13,58,38.25731657278957,-109.3332795
30412,1,24,11,0,6,17,59,38.25731657278957,-109.33301
30413,1,22,13,0,4,22,62,38.25731657278957,-109.3327405
30414,0,23,11,0,4,19,57,38.25731657278957,-109.332471
30415,5,50,11,7,16,0,89,38.25704707820434,-109.4443113
30416,5,50,11,7,17,0,90,38.25704707820434,-109.4440418
30417,5,50,12,6,17,1,91,38.25704707820434,-109.4437723
30418,4,55,11,5,17,1,93,38.25704707820434,-109.4435028
30419,4,55,12,5,17,1,94,38.25704707820434,-109.4432333
30420,4,54,12,5,17,1,93,38.25704707820434,-109.4429638
30421,5,52,12,5,17,1,92,38.25704707820434,-109.4426943
30422,5,51,12,6,17,1,92,38.25704707820434,-109.4424248
30423,5,51,13,6,18,0,93,38.25704707820434,-109.4421553
30424,4,53,12,4,18,1,92,38.25704707820434,-109.4418858
30425,4,54,12,4,17,1,92,38.25704707820434,-109.4416163
30426,4,54,12,4,17,2,93,38.25704707820434,-109.4413468
30427,4,55,12,4,17,2,94,38.25704707820434,-109.4410773
30428,3,55,12,3,16,4,93,38.25704707820434,-109.4408078
30429,6,53,12,5,15,3,94,38.25704707820434,-109.4405383
30430,3,57,10,5,14,3,92,38.25704707820434,-109.4402688
30431,2,57,9,5,13,3,89,38.25704707820434,-109.4399993
30432,3,55,11,5,15,3,92,38.25704707820434,-109.4397299
30433,3,52,12,3,16,5,91,38.25704707820434,-109.4394604
30434,5,49,12,4,16,4,90,38.25704707820434,-109.4391909
30435,4,51,12,4,16,4,91,38.25704707820434,-109.4389214
30436,3,54,11,3,15,5,91,38.25704707820434,-109.4386519
30437,2,53,10,3,14,5,87,38.25704707820434,-109.4383824
30438,3,48,11,4,13,6,85,38.25704707820434,-109.4381129
30439,3,44,11,4,14,6,82,38.25704707820434,-109.4378434
30440,2,41,11,2,13,8,77,38.25704707820434,-109.4375739
30441,2,41,10,0,12,10,75,38.25704707820434,-109.4373044
30442,2,38,10,2,12,8,72,38.25704707820434,-109.4370349
30443,2,36,10,1,13,10,72,38.25704707820434,-109.4367654
30444,3,33,11,2,13,8,70,38.25704707820434,-109.4364959
30445,5,37,10,4,12,5,73,38.25704707820434,-109.4362264
30446,3,46,10,5,15,3,82,38.25704707820434,-109.4359569
30447,3,48,10,2,16,6,85,38.25704707820434,-109.4356874
30448,2,44,10,1,15,6,78,38.25704707820434,-109.4354179
30449,4,38,9,4,11,5,71,38.25704707820434,-109.4351484
30450,4,37,9,7,9,4,70,38.25704707820434,-109.434879
30451,2,47,9,0,16,5,79,38.25704707820434,-109.4346095
30452,3,36,10,1,12,10,72,38.25704707820434,-109.43434
30453,4,45,12,3,14,7,85,38.25704707820434,-109.4340705
30454,7,48,13,8,16,2,94,38.25704707820434,-109.433801
30455,12,41,14,13,15,0,95,38.25704707820434,-109.4335315
30456,14,38,14,13,13,0,92,38.25704707820434,-109.433262
30457,13,39,14,12,13,0,91,38.25704707820434,-109.4329925
30458,12,41,14,13,13,0,93,38.25704707820434,-109.432723
30459,11,42,14,12,13,0,92,38.25704707820434,-109.4324535
30460,12,42,14,12,13,0,93,38.25704707820434,-109.432184
30461,10,42,14,12,13,1,92,38.25704707820434,-109.4319145
30462,11,42,14,12,13,1,93,38.25704707820434,-109.431645
30463,11,42,14,12,13,1,93,38.25704707820434,-109.4313755
30464,11,41,14,13,13,0,92,38.25704707820434,-109.431106
30465,11,42,14,13,13,0,93,38.25704707820434,-109.4308365
30466,11,43,14,12,13,0,93,38.25704707820434,-109.430567
30467,11,43,13,12,13,0,92,38.25704707820434,-109.4302975
30468,14,39,13,12,13,0,91,38.25704707820434,-109.430028
30469,20,34,13,10,13,0,90,38.25704707820434,-109.4297586
30470,20,34,14,11,13,0,92,38.25704707820434,-109.4294891
30471,15,38,13,11,14,0,91,38.25704707820434,-109.4292196
30472,11,41,13,12,15,1,93,38.25704707820434,-109.4289501
30473,10,42,13,12,15,1,93,38.25704707820434,-109.4286806
30474,10,43,13,11,15,0,92,38.25704707820434,-109.4284111
30475,7,44,13,9,17,0,90,38.25704707820434,-109.4281416
30476,9,41,13,10,16,0,89,38.25704707820434,-109.4278721
30477,13,38,13,10,15,0,89,38.25704707820434,-109.4276026
30478,15,36,13,11,15,0,90,38.25704707820434,-109.4273331
30479,11,38,13,12,15,0,89,38.25704707820434,-109.4270636
30480,11,38,13,12,15,0,89,38.25704707820434,-109.4267941
30481,12,36,14,13,15,0,90,38.25704707820434,-109.4265246
30482,12,36,14,14,14,0,90,38.25704707820434,-109.4262551
30483,13,36,14,14,14,0,91,38.25704707820434,-109.4259856
30484,12,38,14,13,14,0,91,38.25704707820434,-109.4257161
30485,13,37,14,13,15,0,92,38.25704707820434,-109.4254466
30486,11,40,14,12,16,0,93,38.25704707820434,-109.4251771
30487,9,44,13,11,16,0,93,38.25704707820434,-109.4249077
30488,8,45,13,10,17,0,93,38.25704707820434,-109.4246382
30489,13,41,13,12,14,0,93,38.25704707820434,-109.4243687
30490,14,38,13,13,14,0,92,38.25704707820434,-109.4240992
30491,11,39,13,14,14,0,91,38.25704707820434,-109.4238297
30492,9,42,14,14,14,1,94,38.25704707820434,-109.4235602
30493,9,42,14,13,14,0,92,38.25704707820434,-109.4232907
30494,11,40,14,13,14,0,92,38.25704707820434,-109.4230212
30495,14,37,14,12,15,0,92,38.25704707820434,-109.4227517
30496,15,36,13,11,15,0,90,38.25704707820434,-109.4224822
30497,14,38,13,10,15,1,91,38.25704707820434,-109.4222127
30498,9,40,14,11,17,0,91,38.25704707820434,-109.4219432
30499,11,42,14,11,15,0,93,38.25704707820434,-109.4216737
30500,11,42,13,11,15,0,92,38.25704707820434,-109.4214042
30501,10,44,12,10,15,0,91,38.25704707820434,-109.4211347
30502,10,46,11,9,14,0,90,38.25704707820434,-109.4208652
30503,10,43,12,10,15,0,90,38.25704707820434,-109.4205957
30504,14,37,12,10,15,0,88,38.25704707820434,-109.4203262
30505,12,35,13,12,16,0,88,38.25704707820434,-109.4200568
30506,9,37,14,13,16,0,89,38.25704707820434,-109.4197873
30507,9,37,14,14,16,0,90,38.25704707820434,-109.4195178
30508,11,36,14,13,16,0,90,38.25704707820434,-109.4192483
30509,14,33,13,13,15,1,89,38.25704707820434,-109.4189788
30510,17,30,13,12,14,1,87,38.25704707820434,-109.4187093
30511,19,30,13,12,14,1,89,38.25704707820434,-109.4184398
30512,17,30,14,13,14,1,89,38.25704707820434,-109.4181703
30513,21,31,14,12,13,0,91,38.25704707820434,-109.4179008
30514,19,32,14,12,13,0,90,38.25704707820434,-109.4176313
30515,15,35,14,13,13,0,90,38.25704707820434,-109.4173618
30516,18,31,13,12,14,0,88,38.25704707820434,-109.4170923
30517,21,29,14,11,14,0,89,38.25704707820434,-109.4168228
30518,19,29,14,12,14,1,89,38.25704707820434,-109.4165533
30519,19,29,14,12,14,1,89,38.25704707820434,-109.4162838
30520,19,30,14,12,14,0,89,38.25704707820434,-109.4160143
30521,16,31,14,14,14,0,89,38.25704707820434,-109.4157448
30522,15,33,14,14,14,0,90,38.25704707820434,-109.4154753
30523,14,36,14,14,14,0,92,38.25704707820434,-109.4152058
30524,13,38,14,14,14,0,93,38.25704707820434,-109.4149364
30525,16,36,14,13,13,0,92,38.25704707820434,-109.4146669
30526,20,32,14,13,13,0,92,38.25704707820434,-109.4143974
30527,19,31,14,14,13,0,91,38.25704707820434,-109.4141279
30528,20,32,14,14,13,0,93,38.25704707820434,-109.4138584
30529,20,34,14,13,13,0,94,38.25704707820434,-109.4135889
30530,19,35,14,12,14,0,94,38.25704707820434,-109.4133194
30531,19,35,14,13,13,0,94,38.25704707820434,-109.4130499
30532,19,35,14,13,14,0,95,38.25704707820434,-109.4127804
30533,16,36,14,14,14,0,94,38.25704707820434,-109.4125109
30534,12,38,14,13,15,0,92,38.25704707820434,-109.4122414
30535,12,39,14,12,16,0,93,38.25704707820434,-109.4119719
30536,13,39,14,13,15,0,94,38.25704707820434,-109.4117024
30537,13,37,15,15,14,0,94,38.25704707820434,-109.4114329
30538,13,36,15,15,15,0,94,38.25704707820434,-109.4111634
30539,13,36,14,14,15,0,92,38.25704707820434,-109.4108939
30540,16,35,14,13,13,0,91,38.25704707820434,-109.4106244
30541,14,37,14,13,14,0,92,38.25704707820434,-109.4103549
30542,12,40,13,12,14,0,91,38.25704707820434,-109.4100855
30543,9,43,13,11,15,0,91,38.25704707820434,-109.409816
30544,8,45,13,9,15,0,90,38.25704707820434,-109.4095465
30545,7,45,13,10,16,0,91,38.25704707820434,-109.409277
30546,6,46,13,8,17,1,91,38.25704707820434,-109.4090075
30547,5,48,12,7,17,1,90,38.25704707820434,-109.408738
30548,4,48,12,7,17,1,89,38.25704707820434,-109.4084685
30549,4,46,12,8,16,1,87,38.25704707820434,-109.408199
30550,2,49,10,4,15,3,83,38.25704707820434,-109.4079295
30551,1,53,10,2,14,3,83,38.25704707820434,-109.40766
30552,1,56,9,1,15,3,85,38.25704707820434,-109.4073905
30553,0,57,8,0,15,4,84,38.25704707820434,-109.407121
30554,0,55,9,0,16,4,84,38.25704707820434,-109.4068515
30555,1,55,9,0,15,4,84,38.25704707820434,-109.406582
30556,1,52,9,1,14,5,82,38.25704707820434,-109.4063125
30557,1,47,10,0,13,8,79,38.25704707820434,-109.406043
30558,2,43,11,1,12,9,78,38.25704707820434,-109.4057735
30559,2,40,10,1,10,10,73,38.25704707820434,-109.405504
30560,1,36,10,2,9,8,66,38.25704707820434,-109.4052345
30561,2,37,9,3,7,7,65,38.25704707820434,-109.4049651
30562,3,38,8,4,7,5,65,38.25704707820434,-109.4046956
30563,4,38,8,4,9,4,67,38.25704707820434,-109.4044261
30564,3,36,10,5,11,5,70,38.25704707820434,-109.4041566
30565,2,34,11,4,12,8,71,38.25704707820434,-109.4038871
30566,1,34,13,2,13,15,78,38.25704707820434,-109.4036176
30567,0,35,14,1,15,16,81,38.25704707820434,-109.4033481
30568,0,38,13,0,16,12,79,38.25704707820434,-109.4030786
30569,1,41,13,1,17,9,82,38.25704707820434,-109.4028091
30570,1,43,13,1,18,8,84,38.25704707820434,-109.4025396
30571,2,43,13,1,18,8,85,38.25704707820434,-109.4022701
30572,2,42,12,4,18,6,84,38.25704707820434,-109.4020006
30573,2,44,12,0,17,7,82,38.25704707820434,-109.4017311
30574,2,40,11,0,14,11,78,38.25704707820434,-109.4014616
30575,1,37,11,0,12,15,76,38.25704707820434,-109.4011921
30576,2,38,12,0,14,13,79,38.25704707820434,-109.4009226
30577,3,45,12,1,16,8,85,38.25704707820434,-109.4006531
30578,4,48,13,3,18,5,91,38.25704707820434,-109.4003836
30579,4,48,13,5,18,3,91,38.25704707820434,-109.4001142
30580,3,48,13,5,18,3,90,38.25704707820434,-109.3998447
30581,3,45,11,3,16,4,82,38.25704707820434,-109.3995752
30582,2,45,10,1,14,8,80,38.25704707820434,-109.3993057
30583,2,44,11,2,16,5,80,38.25704707820434,-109.3990362
30584,2,44,11,3,15,5,80,38.25704707820434,-109.3987667
30585,2,44,11,2,14,6,79,38.25704707820434,-109.3984972
30586,2,44,11,3,14,6,80,38.25704707820434,-109.3982277
30587,2,45,11,2,14,6,80,38.25704707820434,-109.3979582
30588,2,43,10,1,13,8,77,38.25704707820434,-109.3976887
30589,2,46,10,2,14,5,79,38.25704707820434,-109.3974192
30590,2,50,10,4,14,3,83,38.25704707820434,-109.3971497
30591,2,47,10,4,12,5,80,38.25704707820434,-109.3968802
30592,3,49,10,4,14,3,83,38.25704707820434,-109.3966107
30593,3,47,11,5,15,3,84,38.25704707820434,-109.3963412
30594,3,45,11,5,15,4,83,38.25704707820434,-109.3960717
30595,3,44,12,5,14,5,83,38.25704707820434,-109.3958022
30596,3,51,12,3,16,5,90,38.25704707820434,-109.3955327
30597,3,50,12,3,16,3,87,38.25704707820434,-109.3952632
30598,4,49,12,3,16,4,88,38.25704707820434,-109.3949938
30599,4,49,12,2,17,4,88,38.25704707820434,-109.3947243
30600,3,51,12,3,17,2,88,38.25704707820434,-109.3944548
30601,3,51,12,4,17,2,89,38.25704707820434,-109.3941853
30602,4,48,11,4,15,3,85,38.25704707820434,-109.3939158
30603,4,46,11,5,15,3,84,38.25704707820434,-109.3936463
30604,3,47,11,6,14,2,83,38.25704707820434,-109.3933768
30605,2,50,9,3,11,4,79,38.25704707820434,-109.3931073
30606,1,53,9,1,12,4,80,38.25704707820434,-109.3928378
30607,1,40,9,1,10,7,68,38.25704707820434,-109.3925683
30608,2,32,9,2,7,9,61,38.25704707820434,-109.3922988
30609,5,34,10,4,7,6,66,38.25704707820434,-109.3920293
30610,8,31,12,7,8,4,70,38.25704707820434,-109.3917598
30611,2,26,11,2,6,14,61,38.25704707820434,-109.3914903
30612,2,32,11,1,8,11,65,38.25704707820434,-109.3912208
30613,3,35,11,2,10,9,70,38.25704707820434,-109.3909513
30614,1,26,12,4,9,13,65,38.25704707820434,-109.3906818
30615,0,27,12,2,12,16,69,38.25704707820434,-109.3904123
30616,1,29,12,4,10,14,70,38.25704707820434,-109.3901429
30617,2,31,11,3,10,12,69,38.25704707820434,-109.3898734
30618,1,30,11,0,10,12,64,38.25704707820434,-109.3896039
30619,2,30,11,0,12,11,66,38.25704707820434,-109.3893344
30620,3,31,11,3,12,9,69,38.25704707820434,-109.3890649
30621,2,36,11,4,13,6,72,38.25704707820434,-109.3887954
30622,2,32,9,4,9,8,64,38.25704707820434,-109.3885259
30623,2,28,10,4,8,8,60,38.25704707820434,-109.3882564
30624,6,42,9,4,11,3,75,38.25704707820434,-109.3879869
30625,4,39,8,3,10,4,68,38.25704707820434,-109.3877174
30626,3,37,9,3,8,6,66,38.25704707820434,-109.3874479
30627,2,37,9,3,8,7,66,38.25704707820434,-109.3871784
30628,2,35,9,4,10,7,67,38.25704707820434,-109.3869089
30629,4,37,10,7,13,4,75,38.25704707820434,-109.3866394
30630,6,37,11,9,15,2,80,38.25704707820434,-109.3863699
30631,5,35,11,8,16,3,78,38.25704707820434,-109.3861004
30632,3,30,11,5,12,9,70,38.25704707820434,-109.3858309
30633,3,31,12,2,12,10,70,38.25704707820434,-109.3855614
30634,3,35,10,1,13,9,71,38.25704707820434,-109.3852919
30635,6,39,11,3,16,4,79,38.25704707820434,-109.3850225
30636,10,42,13,7,17,0,89,38.25704707820434,-109.384753
30637,9,46,13,8,16,0,92,38.25704707820434,-109.3844835
30638,9,48,14,8,16,0,95,38.25704707820434,-109.384214
30639,14,40,14,12,13,0,93,38.25704707820434,-109.3839445
30640,17,37,14,14,12,0,94,38.25704707820434,-109.383675
30641,15,37,14,13,13,0,92,38.25704707820434,-109.3834055
30642,13,39,13,13,14,0,92,38.25704707820434,-109.383136
30643,12,41,12,10,15,0,90,38.25704707820434,-109.3828665
30644,11,41,11,8,14,1,86,38.25704707820434,-109.382597
30645,9,42,9,6,13,1,80,38.25704707820434,-109.3823275
30646,4,46,9,5,14,2,80,38.25704707820434,-109.382058
30647,0,52,8,0,14,3,77,38.25704707820434,-109.3817885
30648,0,57,8,1,14,2,82,38.25704707820434,-109.381519
30649,0,50,8,0,15,4,77,38.25704707820434,-109.3812495
30650,2,42,10,1,15,6,76,38.25704707820434,-109.38098
30651,7,29,11,5,13,5,70,38.25704707820434,-109.3807105
30652,9,16,10,7,9,9,60,38.25704707820434,-109.380441
30653,11,19,12,8,9,8,67,38.25704707820434,-109.3801716
30654,5,28,12,6,10,10,71,38.25704707820434,-109.3799021
30655,6,31,15,3,7,15,77,38.25704707820434,-109.3796326
30656,7,30,15,2,6,18,78,38.25704707820434,-109.3793631
30657,3,33,12,5,12,12,77,38.25704707820434,-109.3790936
30658,2,34,14,0,15,14,79,38.25704707820434,-109.3788241
30659,3,33,16,0,12,20,84,38.25704707820434,-109.3785546
30660,4,29,15,1,8,22,79,38.25704707820434,-109.3782851
30661,2,26,13,0,4,24,69,38.25704707820434,-109.3780156
30662,3,34,12,1,13,12,75,38.25704707820434,-109.3777461
30663,4,40,12,2,15,8,81,38.25704707820434,-109.3774766
30664,5,42,12,2,16,7,84,38.25704707820434,-109.3772071
30665,5,43,13,3,16,7,87,38.25704707820434,-109.3769376
30666,8,40,13,6,15,6,88,38.25704707820434,-109.3766681
30667,10,38,14,6,15,6,89,38.25704707820434,-109.3763986
30668,10,38,14,6,14,6,88,38.25704707820434,-109.3761291
30669,10,39,14,6,15,6,90,38.25704707820434,-109.3758596
30670,9,39,13,6,15,5,87,38.25704707820434,-109.3755901
30671,7,40,13,3,15,8,86,38.25704707820434,-109.3753206
30672,7,39,13,1,13,10,83,38.25704707820434,-109.3750512
30673,6,40,12,2,14,9,83,38.25704707820434,-109.3747817
30674,6,43,12,4,14,7,86,38.25704707820434,-109.3745122
30675,7,44,13,6,15,4,89,38.25704707820434,-109.3742427
30676,9,43,13,8,14,2,89,38.25704707820434,-109.3739732
30677,8,43,13,8,14,3,89,38.25704707820434,-109.3737037
30678,9,43,13,8,13,3,89,38.25704707820434,-109.3734342
30679,12,42,13,9,14,1,91,38.25704707820434,-109.3731647
30680,13,41,13,8,14,2,91,38.25704707820434,-109.3728952
30681,12,43,13,7,14,2,91,38.25704707820434,-109.3726257
30682,11,42,13,8,13,2,89,38.25704707820434,-109.3723562
30683,11,41,13,9,13,2,89,38.25704707820434,-109.3720867
30684,12,41,13,9,13,3,91,38.25704707820434,-109.3718172
30685,14,39,13,8,12,3,89,38.25704707820434,-109.3715477
30686,11,39,13,9,12,4,88,38.25704707820434,-109.3712782
30687,9,39,13,8,13,6,88,38.25704707820434,-109.3710087
30688,8,39,13,6,12,8,86,38.25704707820434,-109.3707392
30689,8,40,14,5,11,9,87,38.25704707820434,-109.3704697
30690,9,40,14,6,11,8,88,38.25704707820434,-109.3702003
30691,8,40,16,6,10,8,88,38.25704707820434,-109.3699308
30692,10,38,16,8,10,8,90,38.25704707820434,-109.3696613
30693,12,33,16,10,8,9,88,38.25704707820434,-109.3693918
30694,9,37,15,8,9,10,88,38.25704707820434,-109.3691223
30695,6,29,15,8,7,12,77,38.25704707820434,-109.3688528
30696,4,30,15,7,6,15,77,38.25704707820434,-109.3685833
30697,3,30,14,3,8,17,75,38.25704707820434,-109.3683138
30698,5,28,14,0,8,19,74,38.25704707820434,-109.3680443
30699,7,27,15,6,8,13,76,38.25704707820434,-109.3677748
30700,5,30,14,2,11,16,78,38.25704707820434,-109.3675053
30701,6,29,14,3,11,15,78,38.25704707820434,-109.3672358
30702,9,29,14,9,13,10,84,38.25704707820434,-109.3669663
30703,9,32,13,8,12,11,85,38.25704707820434,-109.3666968
30704,9,30,13,8,14,12,86,38.25704707820434,-109.3664273
30705,7,29,16,7,10,15,84,38.25704707820434,-109.3661578
30706,4,31,15,5,8,17,80,38.25704707820434,-109.3658883
30707,3,31,15,3,10,13,75,38.25704707820434,-109.3656188
30708,9,31,11,11,9,2,73,38.25704707820434,-109.3653493
30709,16,25,12,16,12,3,84,38.25704707820434,-109.3650799
30710,16,24,12,20,16,0,88,38.25704707820434,-109.3648104
30711,6,17,15,24,13,2,77,38.25704707820434,-109.3645409
30712,5,16,15,25,14,2,77,38.25704707820434,-109.3642714
30713,8,22,14,20,14,1,79,38.25704707820434,-109.3640019
30714,12,19,12,20,20,1,84,38.25704707820434,-109.3637324
30715,9,18,13,25,19,2,86,38.25704707820434,-109.3634629
30716,7,15,11,27,17,4,81,38.25704707820434,-109.3631934
30717,3,6,6,19,9,3,46,38.25704707820434,-109.3629239
30718,7,11,10,35,10,1,74,38.25704707820434,-109.3626544
30719,8,20,10,30,15,0,83,38.25704707820434,-109.3623849
30720,4,28,12,15,16,2,77,38.25704707820434,-109.3621154
30721,3,34,11,10,16,4,78,38.25704707820434,-109.3618459
30722,4,35,11,12,14,3,79,38.25704707820434,-109.3615764
30723,6,33,11,14,14,6,84,38.25704707820434,-109.3613069
30724,7,27,12,17,11,8,82,38.25704707820434,-109.3610374
30725,3,23,16,12,10,13,77,38.25704707820434,-109.3607679
30726,4,23,17,14,10,12,80,38.25704707820434,-109.3604984
30727,4,24,18,15,3,12,76,38.25704707820434,-109.360229
30728,5,27,17,13,13,10,85,38.25704707820434,-109.3599595
30729,7,29,13,13,13,6,81,38.25704707820434,-109.35969
30730,7,37,9,19,9,3,84,38.25704707820434,-109.3594205
30731,11,31,11,18,8,5,84,38.25704707820434,-109.359151
30732,3,34,12,12,6,11,78,38.25704707820434,-109.3588815
30733,6,33,13,15,8,9,84,38.25704707820434,-109.358612
30734,7,30,14,15,13,10,89,38.25704707820434,-109.3583425
30735,11,29,10,17,10,3,80,38.25704707820434,-109.358073
30736,14,33,9,15,10,2,83,38.25704707820434,-109.3578035
30737,11,36,9,19,8,1,84,38.25704707820434,-109.357534
30738,7,39,12,15,7,7,87,38.25704707820434,-109.3572645
30739,5,27,15,12,14,10,83,38.25704707820434,-109.356995
30740,2,26,18,13,12,15,86,38.25704707820434,-109.3567255
30741,3,21,19,16,9,18,86,38.25704707820434,-109.356456
30742,5,23,17,18,7,15,85,38.25704707820434,-109.3561865
30743,4,25,16,20,9,11,85,38.25704707820434,-109.355917
30744,4,25,15,15,14,12,85,38.25704707820434,-109.3556475
30745,4,24,16,16,11,14,85,38.25704707820434,-109.355378
30746,7,26,14,22,10,6,85,38.25704707820434,-109.3551086
30747,7,24,13,25,13,3,85,38.25704707820434,-109.3548391
30748,10,26,12,22,17,0,87,38.25704707820434,-109.3545696
30749,5,24,12,22,22,2,87,38.25704707820434,-109.3543001
30750,4,21,12,17,15,8,77,38.25704707820434,-109.3540306
30751,4,16,11,15,12,9,67,38.25704707820434,-109.3537611
30752,5,11,7,13,8,2,46,38.25704707820434,-109.3534916
30753,8,8,8,15,8,2,49,38.25704707820434,-109.3532221
30754,11,11,11,19,17,6,75,38.25704707820434,-109.3529526
30755,6,18,12,16,13,10,75,38.25704707820434,-109.3526831
30756,2,24,16,5,8,24,79,38.25704707820434,-109.3524136
30757,4,23,18,0,3,31,79,38.25704707820434,-109.3521441
30758,1,18,18,0,1,34,72,38.25704707820434,-109.3518746
30759,2,16,19,1,0,34,72,38.25704707820434,-109.3516051
30760,2,17,18,0,0,32,69,38.25704707820434,-109.3513356
30761,2,17,18,0,1,32,70,38.25704707820434,-109.3510661
30762,2,19,18,0,2,31,72,38.25704707820434,-109.3507966
30763,2,20,18,1,2,30,73,38.25704707820434,-109.3505271
30764,2,22,17,3,2,28,74,38.25704707820434,-109.3502577
30765,2,20,15,1,2,26,66,38.25704707820434,-109.3499882
30766,2,25,11,2,4,18,62,38.25704707820434,-109.3497187
30767,4,26,7,3,8,7,55,38.25704707820434,-109.3494492
30768,2,34,6,4,9,3,58,38.25704707820434,-109.3491797
30769,2,37,7,3,11,5,65,38.25704707820434,-109.3489102
30770,2,28,8,5,10,6,59,38.25704707820434,-109.3486407
30771,3,31,10,5,10,6,65,38.25704707820434,-109.3483712
30772,6,24,13,3,11,12,69,38.25704707820434,-109.3481017
30773,7,22,16,2,10,21,78,38.25704707820434,-109.3478322
30774,3,23,14,0,7,19,66,38.25704707820434,-109.3475627
30775,2,25,13,1,6,18,65,38.25704707820434,-109.3472932
30776,0,22,12,0,7,17,58,38.25704707820434,-109.3470237
30777,0,23,13,1,11,14,62,38.25704707820434,-109.3467542
30778,3,21,14,0,14,14,66,38.25704707820434,-109.3464847
30779,3,23,14,5,13,14,72,38.25704707820434,-109.3462152
30780,2,26,15,6,8,21,78,38.25704707820434,-109.3459457
30781,1,23,18,1,4,31,78,38.25704707820434,-109.3456762
30782,1,20,19,0,3,34,77,38.25704707820434,-109.3454068
30783,0,19,20,0,4,36,79,38.25704707820434,-109.3451373
30784,0,20,19,0,4,34,77,38.25704707820434,-109.3448678
30785,0,20,19,0,4,33,76,38.25704707820434,-109.3445983
30786,1,20,20,0,5,33,79,38.25704707820434,-109.3443288
30787,1,17,21,0,4,36,79,38.25704707820434,-109.3440593
30788,0,16,21,0,2,37,76,38.25704707820434,-109.3437898
30789,1,16,19,0,1,34,71,38.25704707820434,-109.3435203
30790,1,17,18,0,1,33,70,38.25704707820434,-109.3432508
30791,0,18,19,0,2,34,73,38.25704707820434,-109.3429813
30792,0,21,20,0,4,34,79,38.25704707820434,-109.3427118
30793,1,23,19,0,4,33,80,38.25704707820434,-109.3424423
30794,1,22,18,0,2,31,74,38.25704707820434,-109.3421728
30795,1,19,17,0,1,29,67,38.25704707820434,-109.3419033
30796,0,17,16,0,1,27,61,38.25704707820434,-109.3416338
30797,2,23,14,0,3,21,63,38.25704707820434,-109.3413643
30798,0,19,16,0,2,28,65,38.25704707820434,-109.3410948
30799,1,19,15,1,4,22,62,38.25704707820434,-109.3408253
30800,1,24,13,0,5,18,61,38.25704707820434,-109.3405558
30801,1,29,11,0,4,18,63,38.25704707820434,-109.3402864
30802,2,25,13,2,6,17,65,38.25704707820434,-109.3400169
30803,2,23,14,1,3,20,63,38.25704707820434,-109.3397474
30804,1,20,14,0,1,24,60,38.25704707820434,-109.3394779
30805,1,17,14,0,1,25,58,38.25704707820434,-109.3392084
30806,3,18,15,2,3,23,64,38.25704707820434,-109.3389389
30807,0,20,13,1,3,23,60,38.25704707820434,-109.3386694
30808,1,27,10,2,7,16,63,38.25704707820434,-109.3383999
30809,0,32,9,1,10,12,64,38.25704707820434,-109.3381304
30810,0,34,9,1,8,10,62,38.25704707820434,-109.3378609
30811,1,30,10,4,10,10,65,38.25704707820434,-109.3375914
30812,1,23,12,3,5,20,64,38.25704707820434,-109.3373219
30813,1,30,12,2,9,16,70,38.25704707820434,-109.3370524
30814,1,39,11,3,13,8,75,38.25704707820434,-109.3367829
30815,1,45,9,3,12,6,76,38.25704707820434,-109.3365134
30816,2,31,12,2,7,16,70,38.25704707820434,-109.3362439
30817,1,17,15,1,3,24,61,38.25704707820434,-109.3359744
30818,0,16,15,0,2,26,59,38.25704707820434,-109.3357049
30819,1,19,14,2,3,22,61,38.25704707820434,-109.3354355
30820,2,25,13,2,6,19,67,38.25704707820434,-109.335166
30821,1,31,11,0,7,16,66,38.25704707820434,-109.3348965
30822,1,32,10,1,9,14,67,38.25704707820434,-109.334627
30823,1,31,10,1,11,11,65,38.25704707820434,-109.3343575
30824,2,32,10,2,11,10,67,38.25704707820434,-109.334088
30825,1,25,11,0,7,17,61,38.25704707820434,-109.3338185
30826,1,27,11,1,10,12,62,38.25704707820434,-109.333549
30827,1,24,10,1,8,14,58,38.25704707820434,-109.3332795
30828,0,21,11,0,5,19,56,38.25704707820434,-109.33301
30829,1,21,13,0,3,24,62,38.25704707820434,-109.3327405
30830,1,24,12,0,3,22,62,38.25704707820434,-109.332471
30831,1,26,11,0,5,18,61,38.25704707820434,-109.3322015
30832,5,49,12,7,17,0,90,38.25677758,-109.4443113
30833,5,49,12,7,18,0,91,38.25677758,-109.4440418
30834,4,50,12,6,18,0,90,38.25677758,-109.4437723
30835,4,53,12,5,17,0,91,38.25677758,-109.4435028
30836,4,55,11,4,17,1,92,38.25677758,-109.4432333
30837,4,55,12,4,17,1,93,38.25677758,-109.4429638
30838,4,53,12,4,18,1,92,38.25677758,-109.4426943
30839,5,51,12,5,19,0,92,38.25677758,-109.4424248
30840,4,53,12,4,18,0,91,38.25677758,-109.4421553
30841,4,55,12,4,18,1,94,38.25677758,-109.4418858
30842,4,55,12,4,17,1,93,38.25677758,-109.4416163
30843,4,55,12,4,17,1,93,38.25677758,-109.4413468
30844,4,54,12,4,17,2,93,38.25677758,-109.4410773
30845,4,53,12,4,17,3,93,38.25677758,-109.4408078
30846,4,55,11,5,14,3,92,38.25677758,-109.4405383
30847,3,52,9,6,13,3,86,38.25677758,-109.4402688
30848,3,53,9,6,13,3,87,38.25677758,-109.4399993
30849,2,55,10,4,14,3,88,38.25677758,-109.4397299
30850,4,53,12,6,15,2,92,38.25677758,-109.4394604
30851,4,52,12,7,15,2,92,38.25677758,-109.4391909
30852,4,53,12,6,15,2,92,38.25677758,-109.4389214
30853,3,52,11,4,15,3,88,38.25677758,-109.4386519
30854,2,52,10,3,14,4,85,38.25677758,-109.4383824
30855,2,51,10,3,14,4,84,38.25677758,-109.4381129
30856,2,49,10,2,14,5,82,38.25677758,-109.4378434
30857,2,45,10,0,14,8,79,38.25677758,-109.4375739
30858,2,38,10,0,13,9,72,38.25677758,-109.4373044
30859,2,36,11,1,13,9,72,38.25677758,-109.4370349
30860,3,32,11,1,12,9,68,38.25677758,-109.4367654
30861,3,34,10,1,11,8,67,38.25677758,-109.4364959
30862,3,41,9,3,11,5,72,38.25677758,-109.4362264
30863,3,46,8,4,12,3,76,38.25677758,-109.4359569
30864,2,45,10,0,15,6,78,38.25677758,-109.4356874
30865,3,41,10,0,14,6,74,38.25677758,-109.4354179
30866,3,39,9,1,11,7,70,38.25677758,-109.4351484
30867,2,40,8,1,9,7,67,38.25677758,-109.434879
30868,2,49,9,0,16,4,80,38.25677758,-109.4346095
30869,3,41,10,0,15,6,75,38.25677758,-109.43434
30870,4,47,11,4,17,4,87,38.25677758,-109.4340705
30871,9,44,13,10,15,1,92,38.25677758,-109.433801
30872,13,39,14,13,14,1,94,38.25677758,-109.4335315
30873,14,36,15,12,13,1,91,38.25677758,-109.433262
30874,12,38,14,13,13,1,91,38.25677758,-109.4329925
30875,11,40,14,13,13,1,92,38.25677758,-109.432723
30876,12,40,14,12,13,1,92,38.25677758,-109.4324535
30877,13,39,14,12,13,1,92,38.25677758,-109.432184
30878,10,41,14,13,13,1,92,38.25677758,-109.4319145
30879,10,41,14,13,13,1,92,38.25677758,-109.431645
30880,10,41,14,14,13,1,93,38.25677758,-109.4313755
30881,11,41,14,13,12,1,92,38.25677758,-109.431106
30882,13,39,14,13,13,0,92,38.25677758,-109.4308365
30883,12,41,14,12,13,1,93,38.25677758,-109.430567
30884,11,42,13,12,13,0,91,38.25677758,-109.4302975
30885,13,40,13,12,13,0,91,38.25677758,-109.430028
30886,18,35,13,11,13,0,90,38.25677758,-109.4297586
30887,20,34,14,11,13,0,92,38.25677758,-109.4294891
30888,16,38,13,11,14,0,92,38.25677758,-109.4292196
30889,12,42,13,11,14,0,92,38.25677758,-109.4289501
30890,11,43,13,11,14,1,93,38.25677758,-109.4286806
30891,11,44,13,10,15,0,93,38.25677758,-109.4284111
30892,10,44,13,9,16,0,92,38.25677758,-109.4281416
30893,14,38,13,11,15,0,91,38.25677758,-109.4278721
30894,16,35,13,11,14,0,89,38.25677758,-109.4276026
30895,17,34,13,11,14,0,89,38.25677758,-109.4273331
30896,18,33,13,11,14,0,89,38.25677758,-109.4270636
30897,17,33,13,11,14,0,88,38.25677758,-109.4267941
30898,14,34,13,12,15,1,89,38.25677758,-109.4265246
30899,13,34,14,13,14,1,89,38.25677758,-109.4262551
30900,14,34,14,14,14,0,90,38.25677758,-109.4259856
30901,18,32,14,13,14,0,91,38.25677758,-109.4257161
30902,16,34,14,12,14,0,90,38.25677758,-109.4254466
30903,12,38,13,12,15,0,90,38.25677758,-109.4251771
30904,9,43,13,11,16,0,92,38.25677758,-109.4249077
30905,8,46,13,11,15,0,93,38.25677758,-109.4246382
30906,7,46,13,10,16,0,92,38.25677758,-109.4243687
30907,10,40,13,14,13,1,91,38.25677758,-109.4240992
30908,11,38,14,15,13,1,92,38.25677758,-109.4238297
30909,10,41,14,13,14,0,92,38.25677758,-109.4235602
30910,8,45,13,11,15,0,92,38.25677758,-109.4232907
30911,15,36,13,12,14,0,90,38.25677758,-109.4230212
30912,17,34,13,12,14,0,90,38.25677758,-109.4227517
30913,16,34,13,11,15,0,89,38.25677758,-109.4224822
30914,13,38,13,11,15,0,90,38.25677758,-109.4222127
30915,13,38,14,12,15,0,92,38.25677758,-109.4219432
30916,11,40,14,12,15,1,93,38.25677758,-109.4216737
30917,10,41,13,11,16,0,91,38.25677758,-109.4214042
30918,8,42,12,9,15,1,87,38.25677758,-109.4211347
30919,8,46,10,8,13,1,86,38.25677758,-109.4208652
30920,9,40,11,9,16,1,86,38.25677758,-109.4205957
30921,11,36,13,11,16,0,87,38.25677758,-109.4203262
30922,11,36,13,12,16,0,88,38.25677758,-109.4200568
30923,10,37,14,12,17,0,90,38.25677758,-109.4197873
30924,12,37,14,11,16,0,90,38.25677758,-109.4195178
30925,11,36,14,12,16,0,89,38.25677758,-109.4192483
30926,15,33,14,13,15,0,90,38.25677758,-109.4189788
30927,19,30,14,13,14,0,90,38.25677758,-109.4187093
30928,22,30,14,11,13,0,90,38.25677758,-109.4184398
30929,20,30,14,13,14,0,91,38.25677758,-109.4181703
30930,19,32,14,13,13,0,91,38.25677758,-109.4179008
30931,18,32,14,14,13,0,91,38.25677758,-109.4176313
30932,17,30,14,13,14,1,89,38.25677758,-109.4173618
30933,17,29,14,13,14,1,88,38.25677758,-109.4170923
30934,17,30,14,12,15,0,88,38.25677758,-109.4168228
30935,17,30,13,12,14,1,87,38.25677758,-109.4165533
30936,19,29,13,12,14,1,88,38.25677758,-109.4162838
30937,20,29,14,12,14,1,90,38.25677758,-109.4160143
30938,19,30,14,14,13,0,90,38.25677758,-109.4157448
30939,16,32,14,14,13,0,89,38.25677758,-109.4154753
30940,14,35,14,14,13,0,90,38.25677758,-109.4152058
30941,14,36,14,14,13,0,91,38.25677758,-109.4149364
30942,19,34,14,12,13,0,92,38.25677758,-109.4146669
30943,19,32,14,13,13,0,91,38.25677758,-109.4143974
30944,17,33,14,14,13,0,91,38.25677758,-109.4141279
30945,17,34,14,14,14,0,93,38.25677758,-109.4138584
30946,19,35,14,13,14,0,95,38.25677758,-109.4135889
30947,20,35,14,12,14,0,95,38.25677758,-109.4133194
30948,17,36,14,14,13,0,94,38.25677758,-109.4130499
30949,18,35,14,14,14,0,95,38.25677758,-109.4127804
30950,16,36,14,14,15,0,95,38.25677758,-109.4125109
30951,12,37,14,13,16,0,92,38.25677758,-109.4122414
30952,13,38,15,14,15,0,95,38.25677758,-109.4119719
30953,11,39,15,14,16,0,95,38.25677758,-109.4117024
30954,13,38,15,15,15,0,96,38.25677758,-109.4114329
30955,14,37,15,15,14,0,95,38.25677758,-109.4111634
30956,14,36,15,15,14,0,94,38.25677758,-109.4108939
30957,16,35,14,14,13,0,92,38.25677758,-109.4106244
30958,14,37,15,14,14,0,94,38.25677758,-109.4103549
30959,13,38,14,13,14,0,92,38.25677758,-109.4100855
30960,12,40,14,12,15,0,93,38.25677758,-109.409816
30961,10,41,14,12,16,0,93,38.25677758,-109.4095465
30962,12,39,14,14,14,0,93,38.25677758,-109.409277
30963,10,41,14,13,15,0,93,38.25677758,-109.4090075
30964,5,46,12,8,16,1,88,38.25677758,-109.408738
30965,2,49,11,4,15,3,84,38.25677758,-109.4084685
30966,2,49,10,2,14,4,81,38.25677758,-109.408199
30967,1,55,9,0,14,5,84,38.25677758,-109.4079295
30968,0,55,8,0,14,4,81,38.25677758,-109.40766
30969,1,54,9,0,14,4,82,38.25677758,-109.4073905
30970,1,48,9,0,12,6,76,38.25677758,-109.407121
30971,0,43,9,1,11,6,70,38.25677758,-109.4068515
30972,1,44,9,0,11,6,71,38.25677758,-109.406582
30973,1,45,9,1,12,6,74,38.25677758,-109.4063125
30974,2,44,10,1,12,6,75,38.25677758,-109.406043
30975,2,41,11,2,12,7,75,38.25677758,-109.4057735
30976,2,38,10,2,10,8,70,38.25677758,-109.405504
30977,1,35,10,2,8,10,66,38.25677758,-109.4052345
30978,1,35,10,3,8,8,65,38.25677758,-109.4049651
30979,3,36,9,4,7,6,65,38.25677758,-109.4046956
30980,4,36,9,5,9,4,67,38.25677758,-109.4044261
30981,4,40,11,5,12,6,78,38.25677758,-109.4041566
30982,2,34,12,2,12,14,76,38.25677758,-109.4038871
30983,0,35,14,0,13,18,80,38.25677758,-109.4036176
30984,2,38,13,0,14,13,80,38.25677758,-109.4033481
30985,3,46,12,1,17,7,86,38.25677758,-109.4030786
30986,2,44,12,1,17,8,84,38.25677758,-109.4028091
30987,1,41,12,0,16,11,81,38.25677758,-109.4025396
30988,1,40,12,0,14,13,80,38.25677758,-109.4022701
30989,2,40,12,0,15,10,79,38.25677758,-109.4020006
30990,2,38,12,1,16,10,79,38.25677758,-109.4017311
30991,2,38,12,0,14,14,80,38.25677758,-109.4014616
30992,2,40,12,0,14,12,80,38.25677758,-109.4011921
30993,3,45,13,3,17,7,88,38.25677758,-109.4009226
30994,4,51,12,4,16,4,91,38.25677758,-109.4006531
30995,4,50,13,5,18,3,93,38.25677758,-109.4003836
30996,3,47,12,5,17,3,87,38.25677758,-109.4001142
30997,3,46,12,5,17,3,86,38.25677758,-109.3998447
30998,2,44,11,3,15,5,80,38.25677758,-109.3995752
30999,2,41,11,1,15,7,77,38.25677758,-109.3993057
31000,2,39,11,1,15,8,76,38.25677758,-109.3990362
31001,1,40,11,1,14,8,75,38.25677758,-109.3987667
31002,1,43,10,1,14,7,76,38.25677758,-109.3984972
31003,2,46,10,1,15,4,78,38.25677758,-109.3982277
31004,1,44,9,0,13,7,74,38.25677758,-109.3979582
31005,1,42,9,0,12,9,73,38.25677758,-109.3976887
31006,1,45,9,0,12,8,75,38.25677758,-109.3974192
31007,2,47,9,2,14,5,79,38.25677758,-109.3971497
31008,2,44,10,3,13,6,78,38.25677758,-109.3968802
31009,3,43,11,5,15,4,81,38.25677758,-109.3966107
31010,3,39,10,3,13,8,76,38.25677758,-109.3963412
31011,2,36,10,2,11,10,71,38.25677758,-109.3960717
31012,2,37,11,3,11,10,74,38.25677758,-109.3958022
31013,3,43,11,1,13,8,79,38.25677758,-109.3955327
31014,3,40,11,3,14,7,78,38.25677758,-109.3952632
31015,3,37,11,3,13,8,75,38.25677758,-109.3949938
31016,3,39,11,3,14,7,77,38.25677758,-109.3947243
31017,2,46,11,4,16,4,83,38.25677758,-109.3944548
31018,2,48,10,3,14,4,81,38.25677758,-109.3941853
31019,3,46,10,4,14,4,81,38.25677758,-109.3939158
31020,3,47,10,4,13,4,81,38.25677758,-109.3936463
31021,2,49,10,4,12,4,81,38.25677758,-109.3933768
31022,1,51,9,1,13,4,79,38.25677758,-109.3931073
31023,2,46,11,3,11,5,78,38.25677758,-109.3928378
31024,1,34,10,3,8,8,64,38.25677758,-109.3925683
31025,2,29,10,3,6,9,59,38.25677758,-109.3922988
31026,5,32,11,3,7,7,65,38.25677758,-109.3920293
31027,8,33,12,9,11,4,77,38.25677758,-109.3917598
31028,1,28,11,2,8,13,63,38.25677758,-109.3914903
31029,2,32,10,4,9,8,65,38.25677758,-109.3912208
31030,5,34,11,7,12,4,73,38.25677758,-109.3909513
31031,2,25,12,6,11,11,67,38.25677758,-109.3906818
31032,0,29,13,0,10,20,72,38.25677758,-109.3904123
31033,1,30,12,1,9,18,71,38.25677758,-109.3901429
31034,2,32,11,1,10,13,69,38.25677758,-109.3898734
31035,1,30,11,0,9,12,63,38.25677758,-109.3896039
31036,1,26,10,0,8,13,58,38.25677758,-109.3893344
31037,4,36,11,3,12,7,73,38.25677758,-109.3890649
31038,2,36,10,5,12,5,70,38.25677758,-109.3887954
31039,2,28,10,5,9,8,62,38.25677758,-109.3885259
31040,3,25,10,5,8,10,61,38.25677758,-109.3882564
31041,5,42,11,4,12,4,78,38.25677758,-109.3879869
31042,5,38,9,7,11,2,72,38.25677758,-109.3877174
31043,4,36,9,5,10,4,68,38.25677758,-109.3874479
31044,2,39,9,3,8,7,68,38.25677758,-109.3871784
31045,3,32,10,5,10,8,68,38.25677758,-109.3869089
31046,5,34,10,9,12,3,73,38.25677758,-109.3866394
31047,7,36,11,9,15,2,80,38.25677758,-109.3863699
31048,5,37,11,9,14,3,79,38.25677758,-109.3861004
31049,5,36,10,7,13,4,75,38.25677758,-109.3858309
31050,10,33,12,8,14,2,79,38.25677758,-109.3855614
31051,2,32,10,1,13,9,67,38.25677758,-109.3852919
31052,9,39,12,6,16,2,84,38.25677758,-109.3850225
31053,14,42,13,8,14,0,91,38.25677758,-109.384753
31054,11,45,13,9,12,0,90,38.25677758,-109.3844835
31055,12,44,14,8,13,1,92,38.25677758,-109.384214
31056,16,37,14,12,12,0,91,38.25677758,-109.3839445
31057,16,36,14,13,13,0,92,38.25677758,-109.383675
31058,14,38,13,12,13,0,90,38.25677758,-109.3834055
31059,9,39,11,10,14,1,84,38.25677758,-109.383136
31060,10,38,10,8,14,1,81,38.25677758,-109.3828665
31061,6,40,8,5,13,3,75,38.25677758,-109.382597
31062,2,46,8,3,14,3,76,38.25677758,-109.3823275
31063,0,53,8,1,14,3,79,38.25677758,-109.382058
31064,0,55,8,0,15,4,82,38.25677758,-109.3817885
31065,2,53,10,2,15,2,84,38.25677758,-109.381519
31066,0,39,9,1,12,8,69,38.25677758,-109.3812495
31067,1,30,9,4,10,9,63,38.25677758,-109.38098
31068,17,22,12,14,11,1,77,38.25677758,-109.3807105
31069,8,15,11,16,11,9,70,38.25677758,-109.380441
31070,13,18,12,9,9,9,70,38.25677758,-109.3801716
31071,6,23,12,8,9,12,70,38.25677758,-109.3799021
31072,3,32,11,3,12,13,74,38.25677758,-109.3796326
31073,2,32,14,0,11,18,77,38.25677758,-109.3793631
31074,0,28,14,0,8,22,72,38.25677758,-109.3790936
31075,1,30,14,0,8,21,74,38.25677758,-109.3788241
31076,4,32,15,0,8,20,79,38.25677758,-109.3785546
31077,7,31,14,0,8,19,79,38.25677758,-109.3782851
31078,7,32,13,0,8,16,76,38.25677758,-109.3780156
31079,7,39,13,3,12,10,84,38.25677758,-109.3777461
31080,4,36,13,2,12,12,79,38.25677758,-109.3774766
31081,5,37,13,3,13,10,81,38.25677758,-109.3772071
31082,7,41,13,3,15,7,86,38.25677758,-109.3769376
31083,6,41,13,3,14,9,86,38.25677758,-109.3766681
31084,7,43,13,3,15,7,88,38.25677758,-109.3763986
31085,8,42,13,5,15,6,89,38.25677758,-109.3761291
31086,7,41,13,6,15,5,87,38.25677758,-109.3758596
31087,6,39,13,4,15,7,84,38.25677758,-109.3755901
31088,8,41,13,4,15,7,88,38.25677758,-109.3753206
31089,5,42,13,3,15,8,86,38.25677758,-109.3750512
31090,6,44,13,5,15,4,87,38.25677758,-109.3747817
31091,7,46,13,7,15,2,90,38.25677758,-109.3745122
31092,7,46,13,8,15,1,90,38.25677758,-109.3742427
31093,10,45,13,9,14,1,92,38.25677758,-109.3739732
31094,10,44,13,9,14,1,91,38.25677758,-109.3737037
31095,8,42,13,8,13,3,87,38.25677758,-109.3734342
31096,8,41,14,9,14,3,89,38.25677758,-109.3731647
31097,9,42,14,9,14,3,91,38.25677758,-109.3728952
31098,11,42,14,9,14,2,92,38.25677758,-109.3726257
31099,12,42,14,9,13,2,92,38.25677758,-109.3723562
31100,10,43,13,9,13,3,91,38.25677758,-109.3720867
31101,8,43,13,8,13,4,89,38.25677758,-109.3718172
31102,11,42,13,9,12,3,90,38.25677758,-109.3715477
31103,10,40,13,9,12,5,89,38.25677758,-109.3712782
31104,8,40,14,8,12,6,88,38.25677758,-109.3710087
31105,8,39,14,8,11,7,87,38.25677758,-109.3707392
31106,9,40,14,7,10,8,88,38.25677758,-109.3704697
31107,9,40,15,7,10,8,89,38.25677758,-109.3702003
31108,9,39,16,8,10,7,89,38.25677758,-109.3699308
31109,12,36,16,9,9,7,89,38.25677758,-109.3696613
31110,13,32,16,11,8,8,88,38.25677758,-109.3693918
31111,10,34,15,9,9,10,87,38.25677758,-109.3691223
31112,7,36,15,4,10,13,85,38.25677758,-109.3688528
31113,4,34,14,2,10,16,80,38.25677758,-109.3685833
31114,2,31,13,0,9,18,73,38.25677758,-109.3683138
31115,1,26,13,0,6,23,69,38.25677758,-109.3680443
31116,2,25,13,0,9,19,68,38.25677758,-109.3677748
31117,2,26,13,0,9,19,69,38.25677758,-109.3675053
31118,2,32,14,1,11,17,77,38.25677758,-109.3672358
31119,6,29,14,7,13,12,81,38.25677758,-109.3669663
31120,17,30,11,19,9,2,88,38.25677758,-109.3666968
31121,17,30,11,18,8,1,85,38.25677758,-109.3664273
31122,5,24,14,17,11,9,80,38.25677758,-109.3661578
31123,10,25,13,19,12,4,83,38.25677758,-109.3658883
31124,16,28,12,18,13,1,88,38.25677758,-109.3656188
31125,14,28,12,18,10,0,82,38.25677758,-109.3653493
31126,12,26,13,21,18,2,92,38.25677758,-109.3650799
31127,8,22,13,20,20,2,85,38.25677758,-109.3648104
31128,5,16,12,25,16,1,75,38.25677758,-109.3645409
31129,7,16,11,28,18,0,80,38.25677758,-109.3642714
31130,5,21,17,24,15,2,84,38.25677758,-109.3640019
31131,4,20,16,24,14,4,82,38.25677758,-109.3637324
31132,6,18,13,25,19,2,83,38.25677758,-109.3634629
31133,8,15,12,28,16,3,82,38.25677758,-109.3631934
31134,2,8,11,27,13,2,63,38.25677758,-109.3629239
31135,0,17,14,19,15,8,73,38.25677758,-109.3626544
31136,1,20,14,8,12,13,68,38.25677758,-109.3623849
31137,3,25,15,8,8,17,76,38.25677758,-109.3621154
31138,1,31,17,0,8,22,79,38.25677758,-109.3618459
31139,1,30,14,0,9,20,74,38.25677758,-109.3615764
31140,3,32,13,4,15,10,77,38.25677758,-109.3613069
31141,7,29,12,15,15,4,82,38.25677758,-109.3610374
31142,10,24,12,19,13,5,83,38.25677758,-109.3607679
31143,7,25,15,16,9,13,85,38.25677758,-109.3604984
31144,4,18,18,14,11,19,84,38.25677758,-109.360229
31145,6,22,18,14,8,17,85,38.25677758,-109.3599595
31146,10,27,12,14,7,12,82,38.25677758,-109.35969
31147,13,29,9,13,6,5,75,38.25677758,-109.3594205
31148,13,31,11,18,9,5,87,38.25677758,-109.359151
31149,10,32,13,20,11,3,89,38.25677758,-109.3588815
31150,4,26,15,19,12,9,85,38.25677758,-109.358612
31151,5,21,17,14,13,15,85,38.25677758,-109.3583425
31152,9,27,11,23,11,3,84,38.25677758,-109.358073
31153,7,29,13,14,10,7,80,38.25677758,-109.3578035
31154,8,28,14,12,8,9,79,38.25677758,-109.357534
31155,8,25,13,16,12,7,81,38.25677758,-109.3572645
31156,5,22,17,16,15,12,87,38.25677758,-109.356995
31157,5,25,16,18,12,17,93,38.25677758,-109.3567255
31158,9,28,15,20,4,14,90,38.25677758,-109.356456
31159,19,33,13,10,7,7,89,38.25677758,-109.3561865
31160,17,30,13,12,11,6,89,38.25677758,-109.355917
31161,7,25,13,22,15,8,90,38.25677758,-109.3556475
31162,7,23,16,17,13,12,88,38.25677758,-109.355378
31163,4,25,15,19,13,13,89,38.25677758,-109.3551086
31164,7,20,16,20,13,9,85,38.25677758,-109.3548391
31165,4,22,14,25,17,4,86,38.25677758,-109.3545696
31166,3,21,13,20,18,5,80,38.25677758,-109.3543001
31167,5,17,10,13,14,7,66,38.25677758,-109.3540306
31168,3,8,11,11,10,12,55,38.25677758,-109.3537611
31169,2,5,5,6,7,2,27,38.25677758,-109.3534916
31170,9,13,11,12,17,5,67,38.25677758,-109.3532221
31171,7,15,12,18,13,9,74,38.25677758,-109.3529526
31172,5,16,13,13,10,19,76,38.25677758,-109.3526831
31173,2,25,17,2,5,30,81,38.25677758,-109.3524136
31174,2,20,18,0,2,33,75,38.25677758,-109.3521441
31175,2,16,19,0,1,34,72,38.25677758,-109.3518746
31176,2,16,19,0,0,35,72,38.25677758,-109.3516051
31177,2,17,19,0,1,34,73,38.25677758,-109.3513356
31178,1,19,19,0,2,32,73,38.25677758,-109.3510661
31179,2,20,18,1,3,29,73,38.25677758,-109.3507966
31180,2,24,16,3,4,25,74,38.25677758,-109.3505271
31181,3,29,14,2,6,21,75,38.25677758,-109.3502577
31182,1,27,12,1,3,21,65,38.25677758,-109.3499882
31183,1,31,10,2,9,11,64,38.25677758,-109.3497187
31184,3,33,7,3,8,5,59,38.25677758,-109.3494492
31185,3,35,6,3,9,3,59,38.25677758,-109.3491797
31186,1,35,8,3,9,8,64,38.25677758,-109.3489102
31187,2,26,9,4,7,10,58,38.25677758,-109.3486407
31188,1,25,13,6,7,13,65,38.25677758,-109.3483712
31189,1,20,14,2,6,19,62,38.25677758,-109.3481017
31190,3,20,16,1,5,22,67,38.25677758,-109.3478322
31191,3,21,13,2,7,18,64,38.25677758,-109.3475627
31192,9,28,13,7,5,15,77,38.25677758,-109.3472932
31193,7,28,14,9,6,14,78,38.25677758,-109.3470237
31194,3,28,14,6,9,14,74,38.25677758,-109.3467542
31195,4,21,14,5,10,15,69,38.25677758,-109.3464847
31196,2,23,13,7,13,14,72,38.25677758,-109.3462152
31197,1,26,15,5,12,19,78,38.25677758,-109.3459457
31198,1,22,18,1,4,31,77,38.25677758,-109.3456762
31199,0,20,19,0,3,35,77,38.25677758,-109.3454068
31200,1,21,19,0,4,35,80,38.25677758,-109.3451373
31201,1,21,19,0,4,34,79,38.25677758,-109.3448678
31202,1,20,21,0,5,34,81,38.25677758,-109.3445983
31203,1,18,21,0,5,35,80,38.25677758,-109.3443288
31204,2,17,21,0,3,36,79,38.25677758,-109.3440593
31205,1,14,19,0,1,34,69,38.25677758,-109.3437898
31206,1,16,18,0,1,32,68,38.25677758,-109.3435203
31207,1,18,19,0,3,34,75,38.25677758,-109.3432508
31208,0,19,21,0,4,37,81,38.25677758,-109.3429813
31209,1,18,21,0,4,37,81,38.25677758,-109.3427118
31210,1,19,19,0,2,33,74,38.25677758,-109.3424423
31211,1,18,18,0,1,30,68,38.25677758,-109.3421728
31212,0,17,18,0,0,30,65,38.25677758,-109.3419033
31213,1,17,18,0,0,29,65,38.25677758,-109.3416338
31214,1,18,17,0,1,27,64,38.25677758,-109.3413643
31215,1,18,15,0,0,27,61,38.25677758,-109.3410948
31216,3,23,13,0,6,16,61,38.25677758,-109.3408253
31217,3,26,11,0,7,13,60,38.25677758,-109.3405558
31218,0,29,11,0,4,19,63,38.25677758,-109.3402864
31219,1,21,13,1,3,23,62,38.25677758,-109.3400169
31220,1,20,15,0,2,26,64,38.25677758,-109.3397474
31221,1,19,15,0,1,27,63,38.25677758,-109.3394779
31222,1,18,15,0,1,26,61,38.25677758,-109.3392084
31223,2,21,15,2,3,24,67,38.25677758,-109.3389389
31224,1,21,13,1,3,24,63,38.25677758,-109.3386694
31225,1,26,11,1,5,20,64,38.25677758,-109.3383999
31226,1,29,10,0,6,17,63,38.25677758,-109.3381304
31227,0,30,9,0,6,16,61,38.25677758,-109.3378609
31228,2,23,14,5,8,15,67,38.25677758,-109.3375914
31229,1,20,13,3,4,21,62,38.25677758,-109.3373219
31230,1,25,12,2,5,19,64,38.25677758,-109.3370524
31231,1,27,12,2,8,16,66,38.25677758,-109.3367829
31232,2,22,14,5,7,17,67,38.25677758,-109.3365134
31233,1,15,18,2,5,29,70,38.25677758,-109.3362439
31234,1,15,18,0,2,31,67,38.25677758,-109.3359744
31235,1,17,16,0,2,28,64,38.25677758,-109.3357049
31236,1,19,14,1,2,24,61,38.25677758,-109.3354355
31237,1,28,12,1,6,18,66,38.25677758,-109.335166
31238,1,39,11,1,12,10,74,38.25677758,-109.3348965
31239,0,35,9,1,11,8,64,38.25677758,-109.334627
31240,2,32,8,4,9,5,60,38.25677758,-109.3343575
31241,5,31,9,6,8,4,63,38.25677758,-109.334088
31242,1,21,11,2,9,12,56,38.25677758,-109.3338185
31243,1,24,10,1,11,10,57,38.25677758,-109.333549
31244,0,24,11,0,8,17,60,38.25677758,-109.3332795
31245,0,22,14,0,6,23,65,38.25677758,-109.33301
31246,1,23,14,0,3,25,66,38.25677758,-109.3327405
31247,1,25,12,0,3,21,62,38.25677758,-109.332471
31248,1,27,10,0,6,16,60,38.25677758,-109.3322015
31249,4,49,13,6,18,1,91,38.256508089033865,-109.4443113
31250,5,47,13,7,18,0,90,38.256508089033865,-109.4440418
31251,5,48,12,7,19,0,91,38.256508089033865,-109.4437723
31252,4,52,11,5,18,0,90,38.256508089033865,-109.4435028
31253,4,55,11,4,17,1,92,38.256508089033865,-109.4432333
31254,4,54,11,4,18,1,92,38.256508089033865,-109.4429638
31255,4,52,12,5,19,1,93,38.256508089033865,-109.4426943
31256,4,51,13,6,19,1,94,38.256508089033865,-109.4424248
31257,4,54,12,4,18,1,93,38.256508089033865,-109.4421553
31258,4,54,12,5,18,1,94,38.256508089033865,-109.4418858
31259,4,53,12,5,17,1,92,38.256508089033865,-109.4416163
31260,5,52,12,5,17,1,92,38.256508089033865,-109.4413468
31261,4,50,12,5,17,1,89,38.256508089033865,-109.4410773
31262,4,52,12,5,17,2,92,38.256508089033865,-109.4408078
31263,3,53,10,6,13,3,88,38.256508089033865,-109.4405383
31264,3,51,9,6,13,3,85,38.256508089033865,-109.4402688
31265,2,54,8,4,13,4,85,38.256508089033865,-109.4399993
31266,3,55,9,6,13,3,89,38.256508089033865,-109.4397299
31267,4,51,11,7,13,2,88,38.256508089033865,-109.4394604
31268,5,50,11,8,14,2,90,38.256508089033865,-109.4391909
31269,4,50,11,6,14,2,87,38.256508089033865,-109.4389214
31270,3,50,10,3,14,4,84,38.256508089033865,-109.4386519
31271,3,50,9,2,12,5,81,38.256508089033865,-109.4383824
31272,2,51,9,1,12,5,80,38.256508089033865,-109.4381129
31273,2,49,9,1,13,5,79,38.256508089033865,-109.4378434
31274,3,49,10,1,14,6,83,38.256508089033865,-109.4375739
31275,3,47,10,1,14,7,82,38.256508089033865,-109.4373044
31276,1,33,10,1,12,10,67,38.256508089033865,-109.4370349
31277,1,30,10,0,11,12,64,38.256508089033865,-109.4367654
31278,2,32,10,0,11,11,66,38.256508089033865,-109.4364959
31279,3,37,10,1,11,7,69,38.256508089033865,-109.4362264
31280,4,42,9,4,10,4,73,38.256508089033865,-109.4359569
31281,2,46,9,0,13,6,76,38.256508089033865,-109.4356874
31282,3,41,10,1,12,6,73,38.256508089033865,-109.4354179
31283,3,37,10,0,11,8,69,38.256508089033865,-109.4351484
31284,2,36,10,0,12,8,68,38.256508089033865,-109.434879
31285,1,42,9,0,16,7,75,38.256508089033865,-109.4346095
31286,2,42,9,0,14,8,75,38.256508089033865,-109.43434
31287,5,45,11,4,17,3,85,38.256508089033865,-109.4340705
31288,13,40,14,11,14,0,92,38.256508089033865,-109.433801
31289,14,38,15,12,14,0,93,38.256508089033865,-109.4335315
31290,13,37,15,12,13,1,91,38.256508089033865,-109.433262
31291,15,36,15,13,13,0,92,38.256508089033865,-109.4329925
31292,14,36,15,13,14,0,92,38.256508089033865,-109.432723
31293,14,38,14,12,14,0,92,38.256508089033865,-109.4324535
31294,13,39,14,13,14,1,94,38.256508089033865,-109.432184
31295,12,39,14,13,14,0,92,38.256508089033865,-109.4319145
31296,11,39,14,13,13,1,91,38.256508089033865,-109.431645
31297,10,40,14,14,13,1,92,38.256508089033865,-109.4313755
31298,10,40,14,14,12,1,91,38.256508089033865,-109.431106
31299,12,40,14,13,12,1,92,38.256508089033865,-109.4308365
31300,11,41,14,12,13,1,92,38.256508089033865,-109.430567
31301,11,41,14,12,13,1,92,38.256508089033865,-109.4302975
31302,14,36,14,13,14,1,92,38.256508089033865,-109.430028
31303,20,32,14,11,12,1,90,38.256508089033865,-109.4297586
31304,22,33,14,11,12,0,92,38.256508089033865,-109.4294891
31305,14,39,14,11,13,0,91,38.256508089033865,-109.4292196
31306,11,44,13,11,14,0,93,38.256508089033865,-109.4289501
31307,10,45,13,11,14,1,94,38.256508089033865,-109.4286806
31308,12,44,13,9,14,0,92,38.256508089033865,-109.4284111
31309,14,40,13,11,14,0,92,38.256508089033865,-109.4281416
31310,18,36,13,11,14,0,92,38.256508089033865,-109.4278721
31311,19,34,13,11,14,0,91,38.256508089033865,-109.4276026
31312,18,33,13,12,13,0,89,38.256508089033865,-109.4273331
31313,22,31,13,11,12,0,89,38.256508089033865,-109.4270636
31314,21,31,13,11,13,0,89,38.256508089033865,-109.4267941
31315,18,32,13,12,13,0,88,38.256508089033865,-109.4265246
31316,17,32,13,13,14,0,89,38.256508089033865,-109.4262551
31317,19,32,13,13,13,0,90,38.256508089033865,-109.4259856
31318,19,32,14,13,12,0,90,38.256508089033865,-109.4257161
31319,19,33,14,12,13,0,91,38.256508089033865,-109.4254466
31320,18,34,14,12,13,0,91,38.256508089033865,-109.4251771
31321,15,36,13,12,14,0,90,38.256508089033865,-109.4249077
31322,10,42,13,11,15,0,91,38.256508089033865,-109.4246382
31323,7,46,13,11,14,1,92,38.256508089033865,-109.4243687
31324,9,42,13,13,13,1,91,38.256508089033865,-109.4240992
31325,11,42,13,13,13,0,92,38.256508089033865,-109.4238297
31326,11,41,13,13,14,0,92,38.256508089033865,-109.4235602
31327,11,39,13,12,14,0,89,38.256508089033865,-109.4232907
31328,17,33,13,12,14,0,89,38.256508089033865,-109.4230212
31329,18,33,13,11,14,0,89,38.256508089033865,-109.4227517
31330,15,34,13,11,14,1,88,38.256508089033865,-109.4224822
31331,12,35,14,12,15,1,89,38.256508089033865,-109.4222127
31332,12,37,14,13,14,1,91,38.256508089033865,-109.4219432
31333,10,38,13,10,14,2,87,38.256508089033865,-109.4216737
31334,8,39,12,9,15,1,84,38.256508089033865,-109.4214042
31335,7,42,11,9,15,1,85,38.256508089033865,-109.4211347
31336,9,45,10,8,13,1,86,38.256508089033865,-109.4208652
31337,9,36,12,11,15,1,84,38.256508089033865,-109.4205957
31338,11,36,13,13,15,0,88,38.256508089033865,-109.4203262
31339,12,36,13,12,16,0,89,38.256508089033865,-109.4200568
31340,14,36,13,11,15,0,89,38.256508089033865,-109.4197873
31341,16,35,14,11,15,0,91,38.256508089033865,-109.4195178
31342,16,34,14,11,15,0,90,38.256508089033865,-109.4192483
31343,19,32,14,11,14,0,90,38.256508089033865,-109.4189788
31344,21,31,14,11,13,0,90,38.256508089033865,-109.4187093
31345,19,31,14,12,13,0,89,38.256508089033865,-109.4184398
31346,18,33,14,12,14,0,91,38.256508089033865,-109.4181703
31347,19,32,14,12,13,0,90,38.256508089033865,-109.4179008
31348,18,32,14,12,14,0,90,38.256508089033865,-109.4176313
31349,18,31,14,12,14,0,89,38.256508089033865,-109.4173618
31350,19,29,13,11,13,1,86,38.256508089033865,-109.4170923
31351,18,29,13,13,14,1,88,38.256508089033865,-109.4168228
31352,19,30,14,13,14,0,90,38.256508089033865,-109.4165533
31353,22,29,14,12,13,0,90,38.256508089033865,-109.4162838
31354,23,29,14,12,13,0,91,38.256508089033865,-109.4160143
31355,22,30,14,12,13,0,91,38.256508089033865,-109.4157448
31356,16,32,14,13,13,1,89,38.256508089033865,-109.4154753
31357,16,34,14,12,13,0,89,38.256508089033865,-109.4152058
31358,17,33,14,12,13,0,89,38.256508089033865,-109.4149364
31359,18,33,14,13,14,0,92,38.256508089033865,-109.4146669
31360,17,35,14,13,13,0,92,38.256508089033865,-109.4143974
31361,20,33,14,12,14,0,93,38.256508089033865,-109.4141279
31362,19,33,14,12,14,0,92,38.256508089033865,-109.4138584
31363,17,35,14,13,14,0,93,38.256508089033865,-109.4135889
31364,17,35,14,12,14,0,92,38.256508089033865,-109.4133194
31365,17,36,14,13,14,0,94,38.256508089033865,-109.4130499
31366,18,36,14,12,14,0,94,38.256508089033865,-109.4127804
31367,16,36,14,12,15,0,93,38.256508089033865,-109.4125109
31368,14,36,14,13,16,0,93,38.256508089033865,-109.4122414
31369,14,37,15,13,16,0,95,38.256508089033865,-109.4119719
31370,13,38,15,15,15,0,96,38.256508089033865,-109.4117024
31371,12,38,15,16,15,0,96,38.256508089033865,-109.4114329
31372,13,38,15,16,14,0,96,38.256508089033865,-109.4111634
31373,15,37,15,15,13,0,95,38.256508089033865,-109.4108939
31374,14,35,15,15,14,0,93,38.256508089033865,-109.4106244
31375,13,36,15,16,13,0,93,38.256508089033865,-109.4103549
31376,13,36,15,15,14,0,93,38.256508089033865,-109.4100855
31377,14,37,14,15,14,0,94,38.256508089033865,-109.409816
31378,12,39,15,14,14,0,94,38.256508089033865,-109.4095465
31379,13,38,15,13,14,0,93,38.256508089033865,-109.409277
31380,10,39,14,13,14,0,90,38.256508089033865,-109.4090075
31381,5,44,12,10,14,1,86,38.256508089033865,-109.408738
31382,2,49,10,4,14,4,83,38.256508089033865,-109.4084685
31383,1,51,9,1,14,5,81,38.256508089033865,-109.408199
31384,0,53,9,0,14,4,80,38.256508089033865,-109.4079295
31385,1,47,8,1,11,5,73,38.256508089033865,-109.40766
31386,1,40,9,1,9,7,67,38.256508089033865,-109.4073905
31387,1,37,9,1,9,8,65,38.256508089033865,-109.407121
31388,1,38,9,2,9,7,66,38.256508089033865,-109.4068515
31389,1,40,8,2,9,5,65,38.256508089033865,-109.406582
31390,1,40,8,3,10,5,67,38.256508089033865,-109.4063125
31391,2,38,9,3,10,6,68,38.256508089033865,-109.406043
31392,2,36,11,3,10,6,68,38.256508089033865,-109.4057735
31393,3,33,11,4,8,6,65,38.256508089033865,-109.405504
31394,2,33,12,6,9,6,68,38.256508089033865,-109.4052345
31395,2,35,13,5,10,6,71,38.256508089033865,-109.4049651
31396,2,38,12,4,10,6,72,38.256508089033865,-109.4046956
31397,2,41,11,4,12,5,75,38.256508089033865,-109.4044261
31398,3,45,11,3,16,4,82,38.256508089033865,-109.4041566
31399,1,35,12,0,12,14,74,38.256508089033865,-109.4038871
31400,0,33,13,0,10,19,75,38.256508089033865,-109.4036176
31401,2,36,12,0,11,14,75,38.256508089033865,-109.4033481
31402,3,44,11,3,15,6,82,38.256508089033865,-109.4030786
31403,2,40,11,1,15,8,77,38.256508089033865,-109.4028091
31404,1,36,11,0,12,13,73,38.256508089033865,-109.4025396
31405,1,35,11,0,10,15,72,38.256508089033865,-109.4022701
31406,2,38,12,0,14,11,77,38.256508089033865,-109.4020006
31407,2,39,12,2,15,9,79,38.256508089033865,-109.4017311
31408,4,42,12,2,16,8,84,38.256508089033865,-109.4014616
31409,4,45,13,4,17,6,89,38.256508089033865,-109.4011921
31410,4,48,13,4,18,4,91,38.256508089033865,-109.4009226
31411,3,50,12,3,16,5,89,38.256508089033865,-109.4006531
31412,2,48,11,4,17,4,86,38.256508089033865,-109.4003836
31413,1,48,10,1,15,6,81,38.256508089033865,-109.4001142
31414,1,46,10,0,14,7,78,38.256508089033865,-109.3998447
31415,2,45,10,1,14,6,78,38.256508089033865,-109.3995752
31416,3,41,12,5,17,6,84,38.256508089033865,-109.3993057
31417,2,43,11,1,15,8,80,38.256508089033865,-109.3990362
31418,2,44,10,0,13,9,78,38.256508089033865,-109.3987667
31419,1,45,9,0,13,7,75,38.256508089033865,-109.3984972
31420,2,49,10,1,16,4,82,38.256508089033865,-109.3982277
31421,2,45,11,2,16,5,81,38.256508089033865,-109.3979582
31422,1,41,11,0,14,8,75,38.256508089033865,-109.3976887
31423,2,42,11,1,15,7,78,38.256508089033865,-109.3974192
31424,2,43,11,3,16,5,80,38.256508089033865,-109.3971497
31425,3,41,11,3,15,6,79,38.256508089033865,-109.3968802
31426,2,40,10,1,12,10,75,38.256508089033865,-109.3966107
31427,2,37,10,0,10,13,72,38.256508089033865,-109.3963412
31428,2,38,11,0,11,12,74,38.256508089033865,-109.3960717
31429,2,37,11,2,12,10,74,38.256508089033865,-109.3958022
31430,3,35,12,3,13,9,75,38.256508089033865,-109.3955327
31431,2,32,11,1,8,15,69,38.256508089033865,-109.3952632
31432,2,31,11,1,8,15,68,38.256508089033865,-109.3949938
31433,3,35,11,1,11,12,73,38.256508089033865,-109.3947243
31434,3,43,11,2,14,7,80,38.256508089033865,-109.3944548
31435,2,42,10,2,13,8,77,38.256508089033865,-109.3941853
31436,2,44,10,2,14,6,78,38.256508089033865,-109.3939158
31437,2,48,10,3,14,4,81,38.256508089033865,-109.3936463
31438,2,49,9,3,13,4,80,38.256508089033865,-109.3933768
31439,1,46,9,2,12,5,75,38.256508089033865,-109.3931073
31440,3,40,11,6,11,4,75,38.256508089033865,-109.3928378
31441,2,30,10,5,9,6,62,38.256508089033865,-109.3925683
31442,3,30,10,5,8,7,63,38.256508089033865,-109.3922988
31443,4,31,12,5,10,8,70,38.256508089033865,-109.3920293
31444,3,31,12,7,11,9,73,38.256508089033865,-109.3917598
31445,2,31,11,5,10,10,69,38.256508089033865,-109.3914903
31446,3,33,11,5,10,7,69,38.256508089033865,-109.3912208
31447,4,32,11,7,12,5,71,38.256508089033865,-109.3909513
31448,1,29,12,5,12,11,70,38.256508089033865,-109.3906818
31449,0,28,13,1,8,20,70,38.256508089033865,-109.3904123
31450,1,29,11,1,7,17,66,38.256508089033865,-109.3901429
31451,3,32,11,2,10,11,69,38.256508089033865,-109.3898734
31452,1,29,10,0,8,13,61,38.256508089033865,-109.3896039
31453,1,27,10,2,8,12,60,38.256508089033865,-109.3893344
31454,3,35,10,2,12,9,71,38.256508089033865,-109.3890649
31455,4,31,10,4,10,7,66,38.256508089033865,-109.3887954
31456,5,28,10,6,10,6,65,38.256508089033865,-109.3885259
31457,4,31,11,6,12,6,70,38.256508089033865,-109.3882564
31458,3,42,11,2,12,7,77,38.256508089033865,-109.3879869
31459,5,39,10,7,10,2,73,38.256508089033865,-109.3877174
31460,4,38,9,6,10,2,69,38.256508089033865,-109.3874479
31461,3,38,9,5,9,5,69,38.256508089033865,-109.3871784
31462,5,37,11,7,10,5,75,38.256508089033865,-109.3869089
31463,7,36,10,10,11,2,76,38.256508089033865,-109.3866394
31464,5,38,11,8,15,3,80,38.256508089033865,-109.3863699
31465,5,38,11,6,13,5,78,38.256508089033865,-109.3861004
31466,5,37,10,6,12,5,75,38.256508089033865,-109.3858309
31467,7,39,10,6,13,2,77,38.256508089033865,-109.3855614
31468,3,35,10,3,12,6,69,38.256508089033865,-109.3852919
31469,11,41,12,7,15,0,86,38.256508089033865,-109.3850225
31470,17,39,14,10,13,0,93,38.256508089033865,-109.384753
31471,14,41,13,9,13,1,91,38.256508089033865,-109.3844835
31472,17,40,14,10,11,0,92,38.256508089033865,-109.384214
31473,16,39,14,11,12,0,92,38.256508089033865,-109.3839445
31474,15,39,12,11,12,0,89,38.256508089033865,-109.383675
31475,12,41,11,9,12,0,85,38.256508089033865,-109.3834055
31476,8,42,10,7,12,1,80,38.256508089033865,-109.383136
31477,4,44,8,5,11,2,74,38.256508089033865,-109.3828665
31478,1,52,8,3,11,3,78,38.256508089033865,-109.382597
31479,0,53,7,1,12,3,76,38.256508089033865,-109.3823275
31480,1,49,8,1,14,4,77,38.256508089033865,-109.382058
31481,3,43,11,3,15,4,79,38.256508089033865,-109.3817885
31482,7,44,13,8,14,1,87,38.256508089033865,-109.381519
31483,0,33,10,3,11,9,66,38.256508089033865,-109.3812495
31484,1,21,10,6,9,11,58,38.256508089033865,-109.38098
31485,21,23,12,11,11,2,80,38.256508089033865,-109.3807105
31486,6,23,11,10,12,9,71,38.256508089033865,-109.380441
31487,7,28,12,9,12,9,77,38.256508089033865,-109.3801716
31488,2,32,12,3,13,12,74,38.256508089033865,-109.3799021
31489,1,31,13,0,11,17,73,38.256508089033865,-109.3796326
31490,2,29,15,0,10,18,74,38.256508089033865,-109.3793631
31491,2,29,15,0,6,23,75,38.256508089033865,-109.3790936
31492,2,33,12,0,9,18,74,38.256508089033865,-109.3788241
31493,3,35,12,0,12,13,75,38.256508089033865,-109.3785546
31494,7,38,12,5,14,5,81,38.256508089033865,-109.3782851
31495,15,36,13,10,14,1,89,38.256508089033865,-109.3780156
31496,12,37,13,9,15,3,89,38.256508089033865,-109.3777461
31497,11,37,13,6,14,6,87,38.256508089033865,-109.3774766
31498,10,39,13,5,14,7,88,38.256508089033865,-109.3772071
31499,8,41,13,5,15,5,87,38.256508089033865,-109.3769376
31500,7,41,13,7,17,3,88,38.256508089033865,-109.3766681
31501,8,42,13,8,15,3,89,38.256508089033865,-109.3763986
31502,9,41,13,8,16,2,89,38.256508089033865,-109.3761291
31503,8,42,13,7,16,3,89,38.256508089033865,-109.3758596
31504,8,42,13,5,16,4,88,38.256508089033865,-109.3755901
31505,10,43,13,5,15,4,90,38.256508089033865,-109.3753206
31506,8,40,13,7,15,4,87,38.256508089033865,-109.3750512
31507,7,41,13,8,15,2,86,38.256508089033865,-109.3747817
31508,8,43,13,9,15,1,89,38.256508089033865,-109.3745122
31509,8,45,13,7,15,2,90,38.256508089033865,-109.3742427
31510,9,42,14,10,14,1,90,38.256508089033865,-109.3739732
31511,10,43,13,10,14,1,91,38.256508089033865,-109.3737037
31512,9,44,13,9,14,2,91,38.256508089033865,-109.3734342
31513,8,41,13,8,14,3,87,38.256508089033865,-109.3731647
31514,10,41,13,8,14,3,89,38.256508089033865,-109.3728952
31515,10,42,14,8,14,3,91,38.256508089033865,-109.3726257
31516,11,42,13,8,14,2,90,38.256508089033865,-109.3723562
31517,9,44,13,7,14,3,90,38.256508089033865,-109.3720867
31518,8,45,13,7,13,4,90,38.256508089033865,-109.3718172
31519,15,41,13,7,12,3,91,38.256508089033865,-109.3715477
31520,12,39,13,8,12,5,89,38.256508089033865,-109.3712782
31521,11,39,14,9,12,5,90,38.256508089033865,-109.3710087
31522,11,39,14,9,12,5,90,38.256508089033865,-109.3707392
31523,10,40,15,9,12,5,91,38.256508089033865,-109.3704697
31524,9,40,15,8,11,7,90,38.256508089033865,-109.3702003
31525,11,37,16,9,9,8,90,38.256508089033865,-109.3699308
31526,13,34,16,10,8,8,89,38.256508089033865,-109.3696613
31527,13,33,16,10,9,9,90,38.256508089033865,-109.3693918
31528,9,35,15,8,10,11,88,38.256508089033865,-109.3691223
31529,8,38,13,4,12,10,85,38.256508089033865,-109.3688528
31530,5,37,13,0,10,14,79,38.256508089033865,-109.3685833
31531,2,34,13,0,9,17,75,38.256508089033865,-109.3683138
31532,1,31,13,0,6,22,73,38.256508089033865,-109.3680443
31533,3,30,13,2,5,21,74,38.256508089033865,-109.3677748
31534,2,31,12,1,6,21,73,38.256508089033865,-109.3675053
31535,3,31,12,2,8,17,73,38.256508089033865,-109.3672358
31536,4,31,11,10,9,9,74,38.256508089033865,-109.3669663
31537,19,24,15,16,8,5,87,38.256508089033865,-109.3666968
31538,14,23,14,14,9,6,80,38.256508089033865,-109.3664273
31539,6,23,13,12,9,10,73,38.256508089033865,-109.3661578
31540,11,25,14,18,16,3,87,38.256508089033865,-109.3658883
31541,15,23,13,15,20,1,87,38.256508089033865,-109.3656188
31542,11,21,12,21,19,3,87,38.256508089033865,-109.3653493
31543,12,13,10,17,18,5,75,38.256508089033865,-109.3650799
31544,2,5,7,18,9,4,45,38.256508089033865,-109.3648104
31545,0,7,10,24,12,1,54,38.256508089033865,-109.3645409
31546,2,16,12,19,15,4,68,38.256508089033865,-109.3642714
31547,1,21,15,11,15,12,75,38.256508089033865,-109.3640019
31548,3,24,15,14,13,9,78,38.256508089033865,-109.3637324
31549,3,30,18,11,14,8,84,38.256508089033865,-109.3634629
31550,5,25,17,13,14,8,82,38.256508089033865,-109.3631934
31551,5,23,16,11,13,10,78,38.256508089033865,-109.3629239
31552,5,23,14,9,12,10,73,38.256508089033865,-109.3626544
31553,3,24,16,2,9,22,76,38.256508089033865,-109.3623849
31554,2,24,17,2,4,28,77,38.256508089033865,-109.3621154
31555,1,20,17,0,2,33,73,38.256508089033865,-109.3618459
31556,0,22,17,0,2,30,71,38.256508089033865,-109.3615764
31557,0,24,15,0,8,22,69,38.256508089033865,-109.3613069
31558,2,25,16,7,11,14,75,38.256508089033865,-109.3610374
31559,4,27,14,12,13,8,78,38.256508089033865,-109.3607679
31560,7,30,12,16,13,3,81,38.256508089033865,-109.3604984
31561,9,25,12,17,17,3,83,38.256508089033865,-109.360229
31562,8,19,15,18,10,11,81,38.256508089033865,-109.3599595
31563,10,21,15,16,8,11,81,38.256508089033865,-109.35969
31564,14,21,12,22,8,5,82,38.256508089033865,-109.3594205
31565,11,16,14,27,13,3,84,38.256508089033865,-109.359151
31566,5,17,15,19,18,12,86,38.256508089033865,-109.3588815
31567,6,19,14,17,20,11,87,38.256508089033865,-109.358612
31568,6,18,16,17,14,12,83,38.256508089033865,-109.3583425
31569,3,26,16,14,14,10,83,38.256508089033865,-109.358073
31570,5,36,12,8,12,7,80,38.256508089033865,-109.3578035
31571,5,32,10,6,8,6,67,38.256508089033865,-109.357534
31572,10,29,12,12,10,7,80,38.256508089033865,-109.3572645
31573,9,24,13,21,9,10,86,38.256508089033865,-109.356995
31574,6,24,15,24,12,14,95,38.256508089033865,-109.3567255
31575,12,23,15,22,12,7,91,38.256508089033865,-109.356456
31576,12,25,17,16,13,8,91,38.256508089033865,-109.3561865
31577,8,25,16,15,17,10,91,38.256508089033865,-109.355917
31578,2,22,16,18,18,12,88,38.256508089033865,-109.3556475
31579,1,20,17,14,19,15,86,38.256508089033865,-109.355378
31580,1,18,17,16,17,16,85,38.256508089033865,-109.3551086
31581,5,14,12,16,16,11,74,38.256508089033865,-109.3548391
31582,3,16,11,17,18,8,73,38.256508089033865,-109.3545696
31583,3,11,7,13,11,2,47,38.256508089033865,-109.3543001
31584,2,10,8,7,10,4,41,38.256508089033865,-109.3540306
31585,0,3,4,4,6,3,20,38.256508089033865,-109.3537611
31586,0,6,8,15,14,5,48,38.256508089033865,-109.3534916
31587,0,16,13,14,18,7,68,38.256508089033865,-109.3532221
31588,1,20,12,6,11,17,67,38.256508089033865,-109.3529526
31589,1,22,15,3,7,25,73,38.256508089033865,-109.3526831
31590,2,21,18,1,3,34,79,38.256508089033865,-109.3524136
31591,2,18,18,1,2,34,75,38.256508089033865,-109.3521441
31592,1,18,19,1,2,34,75,38.256508089033865,-109.3518746
31593,2,19,19,0,2,34,76,38.256508089033865,-109.3516051
31594,1,18,19,0,2,34,74,38.256508089033865,-109.3513356
31595,1,20,18,1,2,30,72,38.256508089033865,-109.3510661
31596,2,20,16,2,3,27,70,38.256508089033865,-109.3507966
31597,2,21,15,3,3,25,69,38.256508089033865,-109.3505271
31598,2,24,13,1,3,22,65,38.256508089033865,-109.3502577
31599,1,25,11,3,4,16,60,38.256508089033865,-109.3499882
31600,2,36,7,4,8,6,63,38.256508089033865,-109.3497187
31601,2,39,6,4,9,4,64,38.256508089033865,-109.3494492
31602,3,34,7,4,8,4,60,38.256508089033865,-109.3491797
31603,3,31,9,4,8,9,64,38.256508089033865,-109.3489102
31604,1,16,11,4,3,17,52,38.256508089033865,-109.3486407
31605,1,17,15,4,4,20,61,38.256508089033865,-109.3483712
31606,2,18,15,2,5,22,64,38.256508089033865,-109.3481017
31607,2,23,14,1,6,19,65,38.256508089033865,-109.3478322
31608,4,25,13,1,9,16,68,38.256508089033865,-109.3475627
31609,8,27,13,5,5,16,74,38.256508089033865,-109.3472932
31610,8,24,12,10,8,12,74,38.256508089033865,-109.3470237
31611,7,24,12,9,10,11,73,38.256508089033865,-109.3467542
31612,4,21,14,5,10,14,68,38.256508089033865,-109.3464847
31613,0,22,12,4,18,11,67,38.256508089033865,-109.3462152
31614,1,23,15,5,11,18,73,38.256508089033865,-109.3459457
31615,0,21,18,0,4,32,75,38.256508089033865,-109.3456762
31616,0,19,19,0,3,35,76,38.256508089033865,-109.3454068
31617,1,19,20,0,3,35,78,38.256508089033865,-109.3451373
31618,1,18,20,0,3,36,78,38.256508089033865,-109.3448678
31619,1,18,19,0,3,34,75,38.256508089033865,-109.3445983
31620,1,16,19,0,1,33,70,38.256508089033865,-109.3443288
31621,1,15,18,0,0,33,67,38.256508089033865,-109.3440593
31622,2,16,19,0,0,34,71,38.256508089033865,-109.3437898
31623,1,17,19,0,2,34,73,38.256508089033865,-109.3435203
31624,0,18,20,0,4,34,76,38.256508089033865,-109.3432508
31625,0,19,19,0,4,34,76,38.256508089033865,-109.3429813
31626,1,20,19,0,3,33,76,38.256508089033865,-109.3427118
31627,1,19,18,0,1,31,70,38.256508089033865,-109.3424423
31628,1,16,17,0,0,30,64,38.256508089033865,-109.3421728
31629,1,15,17,0,0,30,63,38.256508089033865,-109.3419033
31630,1,13,18,0,0,30,62,38.256508089033865,-109.3416338
31631,1,13,16,1,1,26,58,38.256508089033865,-109.3413643
31632,2,26,10,0,4,15,57,38.256508089033865,-109.3410948
31633,5,30,10,2,8,6,61,38.256508089033865,-109.3408253
31634,7,27,11,3,9,6,63,38.256508089033865,-109.3405558
31635,3,26,13,1,3,22,68,38.256508089033865,-109.3402864
31636,2,19,14,1,3,26,65,38.256508089033865,-109.3400169
31637,3,23,15,1,3,24,69,38.256508089033865,-109.3397474
31638,2,21,15,1,2,24,65,38.256508089033865,-109.3394779
31639,1,19,15,1,2,24,62,38.256508089033865,-109.3392084
31640,1,26,13,0,2,22,64,38.256508089033865,-109.3389389
31641,3,28,10,4,10,9,64,38.256508089033865,-109.3386694
31642,1,31,9,3,9,10,63,38.256508089033865,-109.3383999
31643,1,40,8,0,9,9,67,38.256508089033865,-109.3381304
31644,0,44,8,0,11,7,70,38.256508089033865,-109.3378609
31645,2,39,8,5,11,4,69,38.256508089033865,-109.3375914
31646,1,38,8,4,12,6,69,38.256508089033865,-109.3373219
31647,2,35,10,5,13,6,71,38.256508089033865,-109.3370524
31648,2,29,12,5,11,11,70,38.256508089033865,-109.3367829
31649,2,23,13,3,5,19,65,38.256508089033865,-109.3365134
31650,1,15,16,1,4,28,65,38.256508089033865,-109.3362439
31651,0,14,17,0,2,30,63,38.256508089033865,-109.3359744
31652,0,16,16,0,2,28,62,38.256508089033865,-109.3357049
31653,1,18,14,0,3,24,60,38.256508089033865,-109.3354355
31654,1,22,12,1,4,20,60,38.256508089033865,-109.335166
31655,1,31,11,0,8,15,66,38.256508089033865,-109.3348965
31656,2,31,9,4,8,7,61,38.256508089033865,-109.334627
31657,4,33,8,5,8,4,62,38.256508089033865,-109.3343575
31658,6,28,9,7,8,4,62,38.256508089033865,-109.334088
31659,1,24,8,6,5,10,54,38.256508089033865,-109.3338185
31660,1,25,10,3,13,7,59,38.256508089033865,-109.333549
31661,0,23,11,0,7,17,58,38.256508089033865,-109.3332795
31662,1,21,13,0,4,22,61,38.256508089033865,-109.33301
31663,1,23,12,0,3,21,60,38.256508089033865,-109.3327405
31664,1,26,11,1,6,16,61,38.256508089033865,-109.332471
31665,1,29,10,0,8,14,62,38.256508089033865,-109.3322015
31666,4,50,13,6,18,1,92,38.25623859444863,-109.4443113
31667,4,49,13,6,19,1,92,38.25623859444863,-109.4440418
31668,4,48,13,8,18,0,91,38.25623859444863,-109.4437723
31669,3,50,12,6,18,0,89,38.25623859444863,-109.4435028
31670,3,52,11,4,18,1,89,38.25623859444863,-109.4432333
31671,3,51,12,5,18,1,90,38.25623859444863,-109.4429638
31672,3,50,12,7,18,1,91,38.25623859444863,-109.4426943
31673,3,51,12,6,18,1,91,38.25623859444863,-109.4424248
31674,4,52,12,5,18,1,92,38.25623859444863,-109.4421553
31675,4,53,12,5,18,1,93,38.25623859444863,-109.4418858
31676,4,51,12,6,18,1,92,38.25623859444863,-109.4416163
31677,5,48,12,6,17,1,89,38.25623859444863,-109.4413468
31678,6,48,12,7,17,1,91,38.25623859444863,-109.4410773
31679,5,53,12,6,16,1,93,38.25623859444863,-109.4408078
31680,3,51,9,6,13,3,85,38.25623859444863,-109.4405383
31681,2,51,9,5,12,4,83,38.25623859444863,-109.4402688
31682,1,55,8,4,13,3,84,38.25623859444863,-109.4399993
31683,3,55,10,6,13,2,89,38.25623859444863,-109.4397299
31684,5,52,11,8,13,2,91,38.25623859444863,-109.4394604
31685,5,48,12,9,14,2,90,38.25623859444863,-109.4391909
31686,4,48,11,8,15,2,88,38.25623859444863,-109.4389214
31687,3,49,11,4,14,4,85,38.25623859444863,-109.4386519
31688,3,48,10,1,12,6,80,38.25623859444863,-109.4383824
31689,2,42,10,1,12,7,74,38.25623859444863,-109.4381129
31690,2,41,10,1,13,7,74,38.25623859444863,-109.4378434
31691,2,44,9,2,13,5,75,38.25623859444863,-109.4375739
31692,3,45,10,2,14,5,79,38.25623859444863,-109.4373044
31693,3,39,11,1,13,6,73,38.25623859444863,-109.4370349
31694,3,34,11,2,12,8,70,38.25623859444863,-109.4367654
31695,3,37,10,0,11,9,70,38.25623859444863,-109.4364959
31696,3,36,10,0,11,9,69,38.25623859444863,-109.4362264
31697,3,37,10,2,11,7,70,38.25623859444863,-109.4359569
31698,3,45,10,0,15,6,79,38.25623859444863,-109.4356874
31699,3,41,10,1,12,7,74,38.25623859444863,-109.4354179
31700,3,37,10,1,11,7,69,38.25623859444863,-109.4351484
31701,3,37,10,1,11,7,69,38.25623859444863,-109.434879
31702,1,44,9,0,14,9,77,38.25623859444863,-109.4346095
31703,1,41,9,0,14,9,74,38.25623859444863,-109.43434
31704,4,44,11,4,17,3,83,38.25623859444863,-109.4340705
31705,12,40,13,10,15,0,90,38.25623859444863,-109.433801
31706,14,39,14,12,13,0,92,38.25623859444863,-109.4335315
31707,16,37,15,12,13,0,93,38.25623859444863,-109.433262
31708,17,35,15,12,13,0,92,38.25623859444863,-109.4329925
31709,19,34,15,12,12,0,92,38.25623859444863,-109.432723
31710,18,33,15,13,12,0,91,38.25623859444863,-109.4324535
31711,15,36,14,13,13,0,91,38.25623859444863,-109.432184
31712,15,36,14,12,13,0,90,38.25623859444863,-109.4319145
31713,14,37,14,13,13,1,92,38.25623859444863,-109.431645
31714,12,39,14,13,13,1,92,38.25623859444863,-109.4313755
31715,11,40,14,13,13,1,92,38.25623859444863,-109.431106
31716,11,40,14,13,12,1,91,38.25623859444863,-109.4308365
31717,10,40,14,13,13,1,91,38.25623859444863,-109.430567
31718,11,38,14,14,14,1,92,38.25623859444863,-109.4302975
31719,15,33,14,14,13,1,90,38.25623859444863,-109.430028
31720,20,30,14,12,12,1,89,38.25623859444863,-109.4297586
31721,18,33,14,12,12,0,89,38.25623859444863,-109.4294891
31722,12,40,14,12,14,0,92,38.25623859444863,-109.4292196
31723,11,42,13,12,14,0,92,38.25623859444863,-109.4289501
31724,11,43,13,12,14,0,93,38.25623859444863,-109.4286806
31725,13,42,13,11,14,0,93,38.25623859444863,-109.4284111
31726,13,40,13,11,15,0,92,38.25623859444863,-109.4281416
31727,16,36,13,11,14,0,90,38.25623859444863,-109.4278721
31728,18,34,13,12,13,0,90,38.25623859444863,-109.4276026
31729,18,32,14,13,13,0,90,38.25623859444863,-109.4273331
31730,19,31,14,12,13,0,89,38.25623859444863,-109.4270636
31731,20,31,13,12,13,0,89,38.25623859444863,-109.4267941
31732,19,32,14,13,13,0,91,38.25623859444863,-109.4265246
31733,19,31,13,13,13,0,89,38.25623859444863,-109.4262551
31734,20,30,13,12,13,0,88,38.25623859444863,-109.4259856
31735,21,30,13,12,12,0,88,38.25623859444863,-109.4257161
31736,21,34,13,11,11,0,90,38.25623859444863,-109.4254466
31737,22,32,14,12,12,0,92,38.25623859444863,-109.4251771
31738,20,33,14,12,12,0,91,38.25623859444863,-109.4249077
31739,15,36,14,13,13,0,91,38.25623859444863,-109.4246382
31740,11,40,14,13,13,0,91,38.25623859444863,-109.4243687
31741,12,40,14,14,12,0,92,38.25623859444863,-109.4240992
31742,13,40,14,14,12,0,93,38.25623859444863,-109.4238297
31743,14,38,13,13,13,0,91,38.25623859444863,-109.4235602
31744,18,33,13,11,13,0,88,38.25623859444863,-109.4232907
31745,22,30,13,11,13,0,89,38.25623859444863,-109.4230212
31746,22,30,13,11,14,0,90,38.25623859444863,-109.4227517
31747,19,32,13,10,14,1,89,38.25623859444863,-109.4224822
31748,15,34,13,11,14,1,88,38.25623859444863,-109.4222127
31749,13,35,14,13,14,1,90,38.25623859444863,-109.4219432
31750,11,37,12,10,14,1,85,38.25623859444863,-109.4216737
31751,6,40,11,9,15,1,82,38.25623859444863,-109.4214042
31752,5,43,10,9,15,1,83,38.25623859444863,-109.4211347
31753,10,43,11,9,14,1,88,38.25623859444863,-109.4208652
31754,13,36,12,10,14,1,86,38.25623859444863,-109.4205957
31755,13,37,13,11,14,0,88,38.25623859444863,-109.4203262
31756,12,36,13,12,14,0,87,38.25623859444863,-109.4200568
31757,11,35,13,11,15,1,86,38.25623859444863,-109.4197873
31758,12,33,13,11,14,1,84,38.25623859444863,-109.4195178
31759,16,32,13,11,14,0,86,38.25623859444863,-109.4192483
31760,19,33,14,12,13,0,91,38.25623859444863,-109.4189788
31761,20,32,14,12,13,0,91,38.25623859444863,-109.4187093
31762,18,33,14,12,13,0,90,38.25623859444863,-109.4184398
31763,16,34,13,12,14,0,89,38.25623859444863,-109.4181703
31764,18,31,14,12,14,0,89,38.25623859444863,-109.4179008
31765,18,31,14,12,13,0,88,38.25623859444863,-109.4176313
31766,19,31,14,12,13,1,90,38.25623859444863,-109.4173618
31767,21,29,14,12,12,0,88,38.25623859444863,-109.4170923
31768,22,29,14,12,13,0,90,38.25623859444863,-109.4168228
31769,24,28,14,11,12,0,89,38.25623859444863,-109.4165533
31770,23,29,14,11,12,0,89,38.25623859444863,-109.4162838
31771,22,30,14,12,12,0,90,38.25623859444863,-109.4160143
31772,21,31,14,12,12,0,90,38.25623859444863,-109.4157448
31773,15,34,14,14,13,0,90,38.25623859444863,-109.4154753
31774,16,34,14,13,13,0,90,38.25623859444863,-109.4152058
31775,17,33,14,12,14,0,90,38.25623859444863,-109.4149364
31776,16,33,14,12,14,0,89,38.25623859444863,-109.4146669
31777,17,35,13,11,14,0,90,38.25623859444863,-109.4143974
31778,18,33,14,12,14,0,91,38.25623859444863,-109.4141279
31779,19,32,14,13,14,0,92,38.25623859444863,-109.4138584
31780,20,33,14,12,14,0,93,38.25623859444863,-109.4135889
31781,18,35,14,11,14,0,92,38.25623859444863,-109.4133194
31782,17,36,14,12,13,0,92,38.25623859444863,-109.4130499
31783,17,36,14,13,14,0,94,38.25623859444863,-109.4127804
31784,15,36,14,13,15,0,93,38.25623859444863,-109.4125109
31785,14,36,14,13,15,0,92,38.25623859444863,-109.4122414
31786,15,36,14,14,15,0,94,38.25623859444863,-109.4119719
31787,13,37,14,15,15,0,94,38.25623859444863,-109.4117024
31788,11,38,15,15,16,0,95,38.25623859444863,-109.4114329
31789,10,39,15,14,16,0,94,38.25623859444863,-109.4111634
31790,11,40,15,13,15,0,94,38.25623859444863,-109.4108939
31791,10,40,15,13,14,0,92,38.25623859444863,-109.4106244
31792,10,38,15,15,14,0,92,38.25623859444863,-109.4103549
31793,13,36,15,15,15,0,94,38.25623859444863,-109.4100855
31794,15,35,14,14,14,0,92,38.25623859444863,-109.409816
31795,14,37,14,13,14,0,92,38.25623859444863,-109.4095465
31796,11,42,14,12,14,0,93,38.25623859444863,-109.409277
31797,6,42,12,10,14,1,85,38.25623859444863,-109.4090075
31798,3,46,11,6,14,3,83,38.25623859444863,-109.408738
31799,1,50,10,2,14,5,82,38.25623859444863,-109.4084685
31800,0,52,9,0,14,5,80,38.25623859444863,-109.408199
31801,1,45,8,2,11,4,71,38.25623859444863,-109.4079295
31802,2,39,8,4,9,4,66,38.25623859444863,-109.40766
31803,1,36,8,3,8,6,62,38.25623859444863,-109.4073905
31804,1,34,9,1,7,10,62,38.25623859444863,-109.407121
31805,1,37,9,2,9,7,65,38.25623859444863,-109.4068515
31806,1,38,8,2,9,6,64,38.25623859444863,-109.406582
31807,2,37,9,3,9,5,65,38.25623859444863,-109.4063125
31808,3,35,10,4,9,5,66,38.25623859444863,-109.406043
31809,3,34,11,4,9,6,67,38.25623859444863,-109.4057735
31810,3,32,12,6,9,6,68,38.25623859444863,-109.405504
31811,3,37,12,6,11,5,74,38.25623859444863,-109.4052345
31812,3,40,13,5,12,5,78,38.25623859444863,-109.4049651
31813,2,42,12,4,13,5,78,38.25623859444863,-109.4046956
31814,2,45,10,3,12,5,77,38.25623859444863,-109.4044261
31815,2,42,11,1,17,6,79,38.25623859444863,-109.4041566
31816,1,36,11,0,12,13,73,38.25623859444863,-109.4038871
31817,0,31,12,0,8,18,69,38.25623859444863,-109.4036176
31818,1,30,13,0,9,15,68,38.25623859444863,-109.4033481
31819,1,36,11,0,11,10,69,38.25623859444863,-109.4030786
31820,2,35,12,2,14,6,71,38.25623859444863,-109.4028091
31821,1,36,10,0,14,8,69,38.25623859444863,-109.4025396
31822,1,40,10,0,14,8,73,38.25623859444863,-109.4022701
31823,2,45,10,0,17,5,79,38.25623859444863,-109.4020006
31824,2,40,10,0,12,9,73,38.25623859444863,-109.4017311
31825,3,47,11,3,16,4,84,38.25623859444863,-109.4014616
31826,3,47,11,2,16,6,85,38.25623859444863,-109.4011921
31827,2,45,11,0,14,9,81,38.25623859444863,-109.4009226
31828,1,46,10,0,13,11,81,38.25623859444863,-109.4006531
31829,1,48,9,0,13,7,78,38.25623859444863,-109.4003836
31830,1,50,9,0,14,6,80,38.25623859444863,-109.4001142
31831,2,49,10,0,14,7,82,38.25623859444863,-109.3998447
31832,2,46,10,0,14,8,80,38.25623859444863,-109.3995752
31833,3,45,12,5,17,4,86,38.25623859444863,-109.3993057
31834,2,44,11,2,15,7,81,38.25623859444863,-109.3990362
31835,2,44,11,1,15,7,80,38.25623859444863,-109.3987667
31836,2,42,11,2,15,6,78,38.25623859444863,-109.3984972
31837,2,43,10,2,15,6,78,38.25623859444863,-109.3982277
31838,3,45,12,3,16,5,84,38.25623859444863,-109.3979582
31839,3,43,12,3,16,6,83,38.25623859444863,-109.3976887
31840,3,48,12,5,18,3,89,38.25623859444863,-109.3974192
31841,3,50,12,5,17,2,89,38.25623859444863,-109.3971497
31842,3,46,12,6,17,2,86,38.25623859444863,-109.3968802
31843,3,46,12,4,17,3,85,38.25623859444863,-109.3966107
31844,2,42,11,1,14,8,78,38.25623859444863,-109.3963412
31845,1,41,10,0,12,10,74,38.25623859444863,-109.3960717
31846,1,40,10,0,11,12,74,38.25623859444863,-109.3958022
31847,1,37,11,0,9,14,72,38.25623859444863,-109.3955327
31848,1,35,11,0,9,16,72,38.25623859444863,-109.3952632
31849,2,35,11,1,11,13,73,38.25623859444863,-109.3949938
31850,3,37,11,2,14,9,76,38.25623859444863,-109.3947243
31851,3,41,11,3,14,7,79,38.25623859444863,-109.3944548
31852,3,41,11,3,15,6,79,38.25623859444863,-109.3941853
31853,2,45,10,2,15,6,80,38.25623859444863,-109.3939158
31854,2,49,10,2,15,5,83,38.25623859444863,-109.3936463
31855,2,49,10,4,15,3,83,38.25623859444863,-109.3933768
31856,2,45,10,3,13,4,77,38.25623859444863,-109.3931073
31857,4,34,10,6,10,3,67,38.25623859444863,-109.3928378
31858,3,28,10,6,8,6,61,38.25623859444863,-109.3925683
31859,3,28,11,5,8,9,64,38.25623859444863,-109.3922988
31860,3,34,12,4,11,10,74,38.25623859444863,-109.3920293
31861,3,35,11,3,11,11,74,38.25623859444863,-109.3917598
31862,2,34,11,4,11,11,73,38.25623859444863,-109.3914903
31863,2,35,11,4,12,8,72,38.25623859444863,-109.3912208
31864,2,28,11,4,10,10,65,38.25623859444863,-109.3909513
31865,0,28,12,1,9,17,67,38.25623859444863,-109.3906818
31866,0,27,12,0,4,20,63,38.25623859444863,-109.3904123
31867,1,29,10,2,7,14,63,38.25623859444863,-109.3901429
31868,1,29,11,1,9,12,63,38.25623859444863,-109.3898734
31869,1,29,11,1,8,13,63,38.25623859444863,-109.3896039
31870,1,31,10,3,10,10,65,38.25623859444863,-109.3893344
31871,3,33,10,3,11,7,67,38.25623859444863,-109.3890649
31872,2,30,11,5,9,9,66,38.25623859444863,-109.3887954
31873,3,31,11,7,10,7,69,38.25623859444863,-109.3885259
31874,4,35,12,6,13,5,75,38.25623859444863,-109.3882564
31875,2,40,10,3,11,7,73,38.25623859444863,-109.3879869
31876,6,38,10,5,10,3,72,38.25623859444863,-109.3877174
31877,4,36,9,5,9,4,67,38.25623859444863,-109.3874479
31878,3,37,9,6,9,5,69,38.25623859444863,-109.3871784
31879,6,42,9,7,10,2,76,38.25623859444863,-109.3869089
31880,6,38,10,7,11,3,75,38.25623859444863,-109.3866394
31881,6,35,10,7,13,3,74,38.25623859444863,-109.3863699
31882,7,40,11,7,14,2,81,38.25623859444863,-109.3861004
31883,8,44,10,7,14,1,84,38.25623859444863,-109.3858309
31884,3,45,8,6,13,2,77,38.25623859444863,-109.3855614
31885,5,44,9,4,14,2,78,38.25623859444863,-109.3852919
31886,12,43,12,7,14,0,88,38.25623859444863,-109.3850225
31887,18,38,13,10,12,0,91,38.25623859444863,-109.384753
31888,18,35,14,11,12,0,90,38.25623859444863,-109.3844835
31889,17,36,14,11,11,0,89,38.25623859444863,-109.384214
31890,16,37,12,10,11,0,86,38.25623859444863,-109.3839445
31891,13,39,10,8,11,1,82,38.25623859444863,-109.383675
31892,8,42,9,6,10,1,76,38.25623859444863,-109.3834055
31893,2,48,7,4,11,2,74,38.25623859444863,-109.383136
31894,1,57,7,2,11,2,80,38.25623859444863,-109.3828665
31895,1,56,8,3,10,2,80,38.25623859444863,-109.382597
31896,2,46,8,4,11,3,74,38.25623859444863,-109.3823275
31897,4,40,10,6,13,3,76,38.25623859444863,-109.382058
31898,7,47,11,5,13,2,85,38.25623859444863,-109.3817885
31899,7,44,12,6,12,2,83,38.25623859444863,-109.381519
31900,1,28,11,3,10,11,64,38.25623859444863,-109.3812495
31901,2,18,11,6,8,13,58,38.25623859444863,-109.38098
31902,11,25,11,13,15,3,78,38.25623859444863,-109.3807105
31903,2,25,12,5,10,11,65,38.25623859444863,-109.380441
31904,0,27,11,0,7,17,62,38.25623859444863,-109.3801716
31905,1,32,10,0,9,16,68,38.25623859444863,-109.3799021
31906,1,32,11,0,9,16,69,38.25623859444863,-109.3796326
31907,1,33,11,0,7,16,68,38.25623859444863,-109.3793631
31908,1,28,12,0,4,20,65,38.25623859444863,-109.3790936
31909,3,32,11,4,11,10,71,38.25623859444863,-109.3788241
31910,9,38,12,9,15,2,85,38.25623859444863,-109.3785546
31911,16,37,13,10,14,0,90,38.25623859444863,-109.3782851
31912,20,33,13,11,13,0,90,38.25623859444863,-109.3780156
31913,17,33,13,11,13,2,89,38.25623859444863,-109.3777461
31914,16,34,14,10,15,1,90,38.25623859444863,-109.3774766
31915,15,35,14,10,15,1,90,38.25623859444863,-109.3772071
31916,14,37,14,10,15,1,91,38.25623859444863,-109.3769376
31917,14,39,13,9,14,1,90,38.25623859444863,-109.3766681
31918,13,39,13,10,14,1,90,38.25623859444863,-109.3763986
31919,11,39,13,10,15,1,89,38.25623859444863,-109.3761291
31920,7,42,13,8,15,2,87,38.25623859444863,-109.3758596
31921,7,45,13,5,15,3,88,38.25623859444863,-109.3755901
31922,9,48,14,5,15,3,94,38.25623859444863,-109.3753206
31923,9,44,13,6,15,3,90,38.25623859444863,-109.3750512
31924,8,44,13,6,15,2,88,38.25623859444863,-109.3747817
31925,8,45,14,7,15,1,90,38.25623859444863,-109.3745122
31926,8,44,13,7,15,1,88,38.25623859444863,-109.3742427
31927,10,39,12,8,14,2,85,38.25623859444863,-109.3739732
31928,11,39,13,9,14,2,88,38.25623859444863,-109.3737037
31929,12,40,13,8,14,2,89,38.25623859444863,-109.3734342
31930,12,40,13,7,13,3,88,38.25623859444863,-109.3731647
31931,11,41,13,7,13,4,89,38.25623859444863,-109.3728952
31932,9,40,13,8,14,4,88,38.25623859444863,-109.3726257
31933,11,42,13,7,15,2,90,38.25623859444863,-109.3723562
31934,10,44,13,5,14,4,90,38.25623859444863,-109.3720867
31935,8,44,12,5,14,5,88,38.25623859444863,-109.3718172
31936,11,42,13,6,13,5,90,38.25623859444863,-109.3715477
31937,11,39,13,7,12,7,89,38.25623859444863,-109.3712782
31938,12,39,14,8,12,5,90,38.25623859444863,-109.3710087
31939,12,40,14,8,12,4,90,38.25623859444863,-109.3707392
31940,11,40,14,8,12,6,91,38.25623859444863,-109.3704697
31941,10,38,15,8,10,8,89,38.25623859444863,-109.3702003
31942,12,32,16,10,8,10,88,38.25623859444863,-109.3699308
31943,13,31,16,10,7,10,87,38.25623859444863,-109.3696613
31944,11,34,16,9,8,10,88,38.25623859444863,-109.3693918
31945,9,37,15,7,9,11,88,38.25623859444863,-109.3691223
31946,8,38,14,5,11,10,86,38.25623859444863,-109.3688528
31947,6,36,13,2,11,12,80,38.25623859444863,-109.3685833
31948,4,34,13,0,10,16,77,38.25623859444863,-109.3683138
31949,3,27,13,1,9,20,73,38.25623859444863,-109.3680443
31950,3,25,17,2,10,22,79,38.25623859444863,-109.3677748
31951,8,24,16,9,10,13,80,38.25623859444863,-109.3675053
31952,5,31,13,12,10,7,78,38.25623859444863,-109.3672358
31953,6,31,13,16,10,6,82,38.25623859444863,-109.3669663
31954,6,27,13,20,12,3,81,38.25623859444863,-109.3666968
31955,9,22,14,19,12,4,80,38.25623859444863,-109.3664273
31956,6,22,14,19,12,8,81,38.25623859444863,-109.3661578
31957,5,23,13,12,15,11,79,38.25623859444863,-109.3658883
31958,4,19,12,13,17,10,75,38.25623859444863,-109.3656188
31959,2,16,11,11,19,10,69,38.25623859444863,-109.3653493
31960,3,5,6,12,10,5,41,38.25623859444863,-109.3650799
31961,2,3,6,16,13,1,41,38.25623859444863,-109.3648104
31962,5,16,12,12,19,1,65,38.25623859444863,-109.3645409
31963,4,24,14,3,11,14,70,38.25623859444863,-109.3642714
31964,1,25,17,2,5,25,75,38.25623859444863,-109.3640019
31965,2,28,18,1,6,24,79,38.25623859444863,-109.3637324
31966,3,26,17,2,8,20,76,38.25623859444863,-109.3634629
31967,4,27,18,4,9,21,83,38.25623859444863,-109.3631934
31968,4,26,19,7,7,19,82,38.25623859444863,-109.3629239
31969,3,26,17,4,8,20,78,38.25623859444863,-109.3626544
31970,2,24,17,2,5,26,76,38.25623859444863,-109.3623849
31971,2,23,18,0,3,31,77,38.25623859444863,-109.3621154
31972,3,23,17,0,2,30,75,38.25623859444863,-109.3618459
31973,2,25,16,0,4,27,74,38.25623859444863,-109.3615764
31974,1,25,16,0,5,27,74,38.25623859444863,-109.3613069
31975,0,26,17,0,7,25,75,38.25623859444863,-109.3610374
31976,2,29,18,4,9,19,81,38.25623859444863,-109.3607679
31977,4,28,18,9,11,9,79,38.25623859444863,-109.3604984
31978,7,22,18,14,13,8,82,38.25623859444863,-109.360229
31979,5,27,18,13,11,9,83,38.25623859444863,-109.3599595
31980,8,25,14,15,17,4,83,38.25623859444863,-109.35969
31981,10,23,11,20,17,2,83,38.25623859444863,-109.3594205
31982,5,16,13,24,12,3,73,38.25623859444863,-109.359151
31983,8,15,12,26,16,4,81,38.25623859444863,-109.3588815
31984,7,15,12,22,21,3,80,38.25623859444863,-109.358612
31985,7,13,13,24,18,3,78,38.25623859444863,-109.3583425
31986,6,17,18,20,18,1,80,38.25623859444863,-109.358073
31987,3,29,17,18,13,1,81,38.25623859444863,-109.3578035
31988,3,33,12,10,12,7,77,38.25623859444863,-109.357534
31989,3,29,12,12,11,9,76,38.25623859444863,-109.3572645
31990,9,28,12,15,13,6,83,38.25623859444863,-109.356995
31991,13,20,11,25,16,4,89,38.25623859444863,-109.3567255
31992,13,11,10,27,18,7,86,38.25623859444863,-109.356456
31993,5,16,14,23,19,8,85,38.25623859444863,-109.3561865
31994,7,15,13,24,26,5,90,38.25623859444863,-109.355917
31995,6,16,15,17,23,8,85,38.25623859444863,-109.3556475
31996,1,14,18,14,13,19,79,38.25623859444863,-109.355378
31997,0,16,19,13,16,20,84,38.25623859444863,-109.3551086
31998,2,11,16,15,15,19,78,38.25623859444863,-109.3548391
31999,3,8,7,14,12,3,47,38.25623859444863,-109.3545696
32000,4,7,7,12,11,1,42,38.25623859444863,-109.3543001
32001,1,11,13,11,13,8,57,38.25623859444863,-109.3540306
32002,5,14,13,16,21,6,75,38.25623859444863,-109.3537611
32003,3,19,14,12,21,9,78,38.25623859444863,-109.3534916
32004,2,22,15,8,16,15,78,38.25623859444863,-109.3532221
32005,2,25,16,4,9,23,79,38.25623859444863,-109.3529526
32006,1,24,18,1,5,31,80,38.25623859444863,-109.3526831
32007,1,19,18,0,2,34,74,38.25623859444863,-109.3524136
32008,1,18,18,0,2,32,71,38.25623859444863,-109.3521441
32009,1,19,18,1,2,32,73,38.25623859444863,-109.3518746
32010,2,20,19,1,2,33,77,38.25623859444863,-109.3516051
32011,1,19,17,1,1,30,69,38.25623859444863,-109.3513356
32012,1,19,16,1,2,28,67,38.25623859444863,-109.3510661
32013,1,19,15,1,2,25,63,38.25623859444863,-109.3507966
32014,2,19,13,2,2,22,60,38.25623859444863,-109.3505271
32015,3,22,12,2,3,18,60,38.25623859444863,-109.3502577
32016,1,25,9,2,6,12,55,38.25623859444863,-109.3499882
32017,2,33,7,4,9,6,61,38.25623859444863,-109.3497187
32018,2,35,7,5,9,5,63,38.25623859444863,-109.3494492
32019,3,34,8,7,9,5,66,38.25623859444863,-109.3491797
32020,4,29,9,8,9,6,65,38.25623859444863,-109.3489102
32021,2,16,13,5,5,18,59,38.25623859444863,-109.3486407
32022,2,17,15,3,3,23,63,38.25623859444863,-109.3483712
32023,1,24,16,1,5,23,70,38.25623859444863,-109.3481017
32024,8,33,13,0,5,16,75,38.25623859444863,-109.3478322
32025,6,29,12,0,6,15,68,38.25623859444863,-109.3475627
32026,3,24,12,2,8,15,64,38.25623859444863,-109.3472932
32027,1,22,11,0,14,11,59,38.25623859444863,-109.3470237
32028,1,27,13,1,17,10,69,38.25623859444863,-109.3467542
32029,1,22,15,1,14,16,69,38.25623859444863,-109.3464847
32030,0,19,12,4,14,15,64,38.25623859444863,-109.3462152
32031,0,24,15,4,9,20,72,38.25623859444863,-109.3459457
32032,0,19,18,0,3,32,72,38.25623859444863,-109.3456762
32033,1,17,19,0,2,34,73,38.25623859444863,-109.3454068
32034,1,16,20,0,2,35,74,38.25623859444863,-109.3451373
32035,1,17,18,0,1,33,70,38.25623859444863,-109.3448678
32036,1,17,17,0,1,28,64,38.25623859444863,-109.3445983
32037,2,16,17,0,1,28,64,38.25623859444863,-109.3443288
32038,1,14,18,0,0,32,65,38.25623859444863,-109.3440593
32039,1,16,20,0,2,34,73,38.25623859444863,-109.3437898
32040,1,16,21,0,3,36,77,38.25623859444863,-109.3435203
32041,0,17,21,0,4,36,78,38.25623859444863,-109.3432508
32042,0,17,21,0,3,36,77,38.25623859444863,-109.3429813
32043,1,18,21,0,2,36,78,38.25623859444863,-109.3427118
32044,1,19,19,0,0,32,71,38.25623859444863,-109.3424423
32045,0,18,18,0,0,32,68,38.25623859444863,-109.3421728
32046,0,16,17,0,0,32,65,38.25623859444863,-109.3419033
32047,1,16,18,0,0,30,65,38.25623859444863,-109.3416338
32048,1,19,13,1,2,21,57,38.25623859444863,-109.3413643
32049,2,27,9,1,6,10,55,38.25623859444863,-109.3410948
32050,5,28,10,3,8,7,61,38.25623859444863,-109.3408253
32051,5,22,13,5,7,14,66,38.25623859444863,-109.3405558
32052,1,18,17,1,3,31,71,38.25623859444863,-109.3402864
32053,0,17,17,1,3,32,70,38.25623859444863,-109.3400169
32054,1,18,16,3,4,27,69,38.25623859444863,-109.3397474
32055,1,15,15,2,3,26,62,38.25623859444863,-109.3394779
32056,1,15,15,0,2,26,59,38.25623859444863,-109.3392084
32057,0,24,11,1,3,19,58,38.25623859444863,-109.3389389
32058,4,36,8,3,10,6,67,38.25623859444863,-109.3386694
32059,0,41,7,1,10,6,65,38.25623859444863,-109.3383999
32060,0,46,6,0,10,5,67,38.25623859444863,-109.3381304
32061,0,49,6,0,10,4,69,38.25623859444863,-109.3378609
32062,0,48,6,0,10,4,68,38.25623859444863,-109.3375914
32063,0,55,6,1,9,4,75,38.25623859444863,-109.3373219
32064,0,55,7,2,11,3,78,38.25623859444863,-109.3370524
32065,0,52,8,3,12,3,78,38.25623859444863,-109.3367829
32066,1,49,8,2,12,5,77,38.25623859444863,-109.3365134
32067,3,32,12,4,11,11,73,38.25623859444863,-109.3362439
32068,1,18,16,1,4,24,64,38.25623859444863,-109.3359744
32069,0,17,15,0,3,26,61,38.25623859444863,-109.3357049
32070,0,19,13,0,3,23,58,38.25623859444863,-109.3354355
32071,1,21,12,1,4,20,59,38.25623859444863,-109.335166
32072,2,30,11,0,8,16,67,38.25623859444863,-109.3348965
32073,1,28,9,3,7,10,58,38.25623859444863,-109.334627
32074,5,23,10,5,10,6,59,38.25623859444863,-109.3343575
32075,21,21,15,17,8,0,82,38.25623859444863,-109.334088
32076,0,20,11,5,6,15,57,38.25623859444863,-109.3338185
32077,1,32,9,1,14,6,63,38.25623859444863,-109.333549
32078,1,37,9,0,12,9,68,38.25623859444863,-109.3332795
32079,1,35,9,0,10,11,66,38.25623859444863,-109.33301
32080,1,31,10,1,9,12,64,38.25623859444863,-109.3327405
32081,1,26,11,1,6,15,60,38.25623859444863,-109.332471
32082,1,24,11,0,6,19,61,38.25623859444863,-109.3322015
32083,4,48,13,8,19,1,93,38.25596909986339,-109.4443113
32084,4,50,13,6,19,1,93,38.25596909986339,-109.4440418
32085,3,52,13,6,19,1,94,38.25596909986339,-109.4437723
32086,3,51,12,5,18,1,90,38.25596909986339,-109.4435028
32087,3,50,12,5,19,1,90,38.25596909986339,-109.4432333
32088,3,50,13,6,19,2,93,38.25596909986339,-109.4429638
32089,3,50,13,7,18,2,93,38.25596909986339,-109.4426943
32090,3,50,12,5,17,3,90,38.25596909986339,-109.4424248
32091,3,51,12,6,17,2,91,38.25596909986339,-109.4421553
32092,3,51,12,6,18,1,91,38.25596909986339,-109.4418858
32093,4,50,12,6,18,1,91,38.25596909986339,-109.4416163
32094,6,51,11,6,16,1,91,38.25596909986339,-109.4413468
32095,6,52,11,7,16,1,93,38.25596909986339,-109.4410773
32096,4,54,11,6,14,2,91,38.25596909986339,-109.4408078
32097,3,52,9,5,12,3,84,38.25596909986339,-109.4405383
32098,1,54,8,3,12,3,81,38.25596909986339,-109.4402688
32099,1,53,8,3,12,3,80,38.25596909986339,-109.4399993
32100,2,55,9,4,13,3,86,38.25596909986339,-109.4397299
32101,3,53,10,6,13,3,88,38.25596909986339,-109.4394604
32102,4,51,11,8,12,3,89,38.25596909986339,-109.4391909
32103,5,50,11,8,12,2,88,38.25596909986339,-109.4389214
32104,4,50,10,8,12,3,87,38.25596909986339,-109.4386519
32105,3,48,9,6,12,4,82,38.25596909986339,-109.4383824
32106,3,48,10,3,14,5,83,38.25596909986339,-109.4381129
32107,1,39,10,2,14,7,73,38.25596909986339,-109.4378434
32108,1,37,10,2,14,7,71,38.25596909986339,-109.4375739
32109,2,41,10,2,14,5,74,38.25596909986339,-109.4373044
32110,4,39,9,4,12,3,71,38.25596909986339,-109.4370349
32111,5,36,10,6,11,3,71,38.25596909986339,-109.4367654
32112,3,35,10,5,13,6,72,38.25596909986339,-109.4364959
32113,1,34,10,3,13,9,70,38.25596909986339,-109.4362264
32114,2,37,10,2,11,10,72,38.25596909986339,-109.4359569
32115,2,43,11,0,15,8,79,38.25596909986339,-109.4356874
32116,3,48,10,0,13,7,81,38.25596909986339,-109.4354179
32117,3,44,9,0,10,8,74,38.25596909986339,-109.4351484
32118,3,40,9,2,9,7,70,38.25596909986339,-109.434879
32119,2,41,9,0,11,8,71,38.25596909986339,-109.4346095
32120,2,47,9,0,15,5,78,38.25596909986339,-109.43434
32121,3,45,10,2,15,4,79,38.25596909986339,-109.4340705
32122,6,47,11,6,16,1,87,38.25596909986339,-109.433801
32123,11,43,13,10,14,0,91,38.25596909986339,-109.4335315
32124,15,39,15,12,13,0,94,38.25596909986339,-109.433262
32125,19,33,14,13,13,0,92,38.25596909986339,-109.4329925
32126,22,31,15,13,12,0,93,38.25596909986339,-109.432723
32127,22,31,15,13,11,0,92,38.25596909986339,-109.4324535
32128,19,33,14,13,12,0,91,38.25596909986339,-109.432184
32129,16,35,14,13,13,0,91,38.25596909986339,-109.4319145
32130,15,36,14,12,12,0,89,38.25596909986339,-109.431645
32131,14,37,15,13,12,1,92,38.25596909986339,-109.4313755
32132,13,38,14,13,12,1,91,38.25596909986339,-109.431106
32133,13,38,15,13,13,1,93,38.25596909986339,-109.4308365
32134,13,37,14,13,13,1,91,38.25596909986339,-109.430567
32135,13,36,14,13,14,1,91,38.25596909986339,-109.4302975
32136,14,34,14,14,13,1,90,38.25596909986339,-109.430028
32137,15,33,15,13,13,1,90,38.25596909986339,-109.4297586
32138,12,35,14,12,13,1,87,38.25596909986339,-109.4294891
32139,9,41,13,12,14,1,90,38.25596909986339,-109.4292196
32140,9,40,14,13,14,1,91,38.25596909986339,-109.4289501
32141,11,40,14,12,14,0,91,38.25596909986339,-109.4286806
32142,12,41,13,11,15,0,92,38.25596909986339,-109.4284111
32143,11,41,13,11,15,0,91,38.25596909986339,-109.4281416
32144,13,38,13,12,14,0,90,38.25596909986339,-109.4278721
32145,14,35,13,13,14,0,89,38.25596909986339,-109.4276026
32146,14,34,14,14,14,0,90,38.25596909986339,-109.4273331
32147,14,35,14,13,14,0,90,38.25596909986339,-109.4270636
32148,18,34,13,12,14,0,91,38.25596909986339,-109.4267941
32149,17,32,14,13,14,0,90,38.25596909986339,-109.4265246
32150,18,32,14,13,13,0,90,38.25596909986339,-109.4262551
32151,20,30,14,13,13,0,90,38.25596909986339,-109.4259856
32152,23,30,14,12,11,0,90,38.25596909986339,-109.4257161
32153,22,32,13,12,12,0,91,38.25596909986339,-109.4254466
32154,21,32,13,12,12,0,90,38.25596909986339,-109.4251771
32155,20,31,14,13,12,0,90,38.25596909986339,-109.4249077
32156,20,32,14,13,12,0,91,38.25596909986339,-109.4246382
32157,14,38,14,14,12,0,92,38.25596909986339,-109.4243687
32158,13,40,14,14,12,0,93,38.25596909986339,-109.4240992
32159,13,39,14,14,12,0,92,38.25596909986339,-109.4238297
32160,18,34,13,12,12,0,89,38.25596909986339,-109.4235602
32161,22,29,14,11,12,1,89,38.25596909986339,-109.4232907
32162,24,28,14,10,12,1,89,38.25596909986339,-109.4230212
32163,23,29,14,11,12,0,89,38.25596909986339,-109.4227517
32164,20,32,13,11,13,0,89,38.25596909986339,-109.4224822
32165,15,35,13,11,14,1,89,38.25596909986339,-109.4222127
32166,14,36,13,12,14,1,90,38.25596909986339,-109.4219432
32167,12,39,11,8,14,1,85,38.25596909986339,-109.4216737
32168,8,43,10,9,14,1,85,38.25596909986339,-109.4214042
32169,7,43,11,10,15,1,87,38.25596909986339,-109.4211347
32170,11,40,12,10,14,1,88,38.25596909986339,-109.4208652
32171,14,36,13,12,14,1,90,38.25596909986339,-109.4205957
32172,15,35,13,11,14,0,88,38.25596909986339,-109.4203262
32173,14,34,13,11,14,1,87,38.25596909986339,-109.4200568
32174,14,33,13,11,14,1,86,38.25596909986339,-109.4197873
32175,13,33,13,11,14,1,85,38.25596909986339,-109.4195178
32176,13,34,13,11,14,1,86,38.25596909986339,-109.4192483
32177,13,35,13,13,13,1,88,38.25596909986339,-109.4189788
32178,14,34,14,14,13,1,90,38.25596909986339,-109.4187093
32179,14,35,14,13,13,1,90,38.25596909986339,-109.4184398
32180,12,35,13,12,14,1,87,38.25596909986339,-109.4181703
32181,14,35,14,13,14,0,90,38.25596909986339,-109.4179008
32182,17,33,14,13,13,0,90,38.25596909986339,-109.4176313
32183,18,32,14,13,12,0,89,38.25596909986339,-109.4173618
32184,21,31,14,13,12,0,91,38.25596909986339,-109.4170923
32185,20,30,14,13,12,1,90,38.25596909986339,-109.4168228
32186,20,31,14,12,12,0,89,38.25596909986339,-109.4165533
32187,19,33,13,12,13,0,90,38.25596909986339,-109.4162838
32188,15,34,13,11,14,0,87,38.25596909986339,-109.4160143
32189,14,36,13,11,14,0,88,38.25596909986339,-109.4157448
32190,17,33,14,12,14,0,90,38.25596909986339,-109.4154753
32191,17,34,14,13,13,0,91,38.25596909986339,-109.4152058
32192,18,33,14,13,13,0,91,38.25596909986339,-109.4149364
32193,19,33,14,12,13,0,91,38.25596909986339,-109.4146669
32194,19,34,14,11,13,0,91,38.25596909986339,-109.4143974
32195,18,34,14,12,14,0,92,38.25596909986339,-109.4141279
32196,19,33,14,12,13,0,91,38.25596909986339,-109.4138584
32197,17,34,14,13,13,0,91,38.25596909986339,-109.4135889
32198,13,37,14,14,14,0,92,38.25596909986339,-109.4133194
32199,14,36,15,15,13,0,93,38.25596909986339,-109.4130499
32200,14,36,14,14,14,0,92,38.25596909986339,-109.4127804
32201,13,36,14,14,15,0,92,38.25596909986339,-109.4125109
32202,12,36,14,12,16,0,90,38.25596909986339,-109.4122414
32203,12,37,14,13,16,0,92,38.25596909986339,-109.4119719
32204,9,40,14,13,16,0,92,38.25596909986339,-109.4117024
32205,9,42,14,12,16,0,93,38.25596909986339,-109.4114329
32206,9,43,14,12,16,0,94,38.25596909986339,-109.4111634
32207,10,42,14,11,16,1,94,38.25596909986339,-109.4108939
32208,11,41,14,11,15,1,93,38.25596909986339,-109.4106244
32209,9,41,14,12,16,0,92,38.25596909986339,-109.4103549
32210,10,40,14,13,16,0,93,38.25596909986339,-109.4100855
32211,11,40,14,12,16,0,93,38.25596909986339,-109.409816
32212,9,41,14,11,16,0,91,38.25596909986339,-109.4095465
32213,7,43,13,9,15,1,88,38.25596909986339,-109.409277
32214,2,45,11,4,14,4,80,38.25596909986339,-109.4090075
32215,1,48,10,2,14,5,80,38.25596909986339,-109.408738
32216,1,49,9,0,13,6,78,38.25596909986339,-109.4084685
32217,1,47,9,1,12,5,75,38.25596909986339,-109.408199
32218,2,43,7,3,8,3,66,38.25596909986339,-109.4079295
32219,2,39,7,4,8,3,63,38.25596909986339,-109.40766
32220,2,35,8,4,9,5,63,38.25596909986339,-109.4073905
32221,1,34,10,3,9,9,66,38.25596909986339,-109.407121
32222,2,38,11,4,11,5,71,38.25596909986339,-109.4068515
32223,1,36,10,3,10,7,67,38.25596909986339,-109.406582
32224,2,36,11,4,10,6,69,38.25596909986339,-109.4063125
32225,3,37,12,5,9,5,71,38.25596909986339,-109.406043
32226,3,40,12,6,10,4,75,38.25596909986339,-109.4057735
32227,3,43,13,6,14,4,83,38.25596909986339,-109.405504
32228,3,45,12,4,14,5,83,38.25596909986339,-109.4052345
32229,2,46,11,1,13,7,80,38.25596909986339,-109.4049651
32230,2,46,11,1,14,6,80,38.25596909986339,-109.4046956
32231,2,44,11,2,15,6,80,38.25596909986339,-109.4044261
32232,2,39,11,1,16,9,78,38.25596909986339,-109.4041566
32233,2,39,11,0,14,11,77,38.25596909986339,-109.4038871
32234,1,37,12,0,11,15,76,38.25596909986339,-109.4036176
32235,2,32,12,0,9,16,71,38.25596909986339,-109.4033481
32236,2,32,12,0,9,12,67,38.25596909986339,-109.4030786
32237,2,34,10,5,13,5,69,38.25596909986339,-109.4028091
32238,1,37,10,0,14,6,68,38.25596909986339,-109.4025396
32239,1,51,9,0,15,2,78,38.25596909986339,-109.4022701
32240,1,58,8,1,15,1,84,38.25596909986339,-109.4020006
32241,1,57,7,0,13,2,80,38.25596909986339,-109.4017311
32242,1,54,8,0,14,4,81,38.25596909986339,-109.4014616
32243,1,47,9,0,14,6,77,38.25596909986339,-109.4011921
32244,1,42,10,0,12,10,75,38.25596909986339,-109.4009226
32245,1,42,10,0,12,11,76,38.25596909986339,-109.4006531
32246,1,49,10,0,14,7,81,38.25596909986339,-109.4003836
32247,1,47,10,0,14,7,79,38.25596909986339,-109.4001142
32248,1,44,10,0,12,9,76,38.25596909986339,-109.3998447
32249,2,39,10,1,11,9,72,38.25596909986339,-109.3995752
32250,2,37,10,3,12,6,70,38.25596909986339,-109.3993057
32251,2,40,10,2,12,6,72,38.25596909986339,-109.3990362
32252,1,39,10,1,12,8,71,38.25596909986339,-109.3987667
32253,1,37,11,1,12,9,71,38.25596909986339,-109.3984972
32254,1,37,9,0,11,10,68,38.25596909986339,-109.3982277
32255,3,41,10,1,13,7,75,38.25596909986339,-109.3979582
32256,3,42,12,3,16,6,82,38.25596909986339,-109.3976887
32257,3,47,12,3,16,5,86,38.25596909986339,-109.3974192
32258,2,49,11,2,14,5,83,38.25596909986339,-109.3971497
32259,2,40,10,2,14,7,75,38.25596909986339,-109.3968802
32260,1,35,10,2,11,8,67,38.25596909986339,-109.3966107
32261,1,34,11,3,11,9,69,38.25596909986339,-109.3963412
32262,1,34,11,2,11,10,69,38.25596909986339,-109.3960717
32263,1,33,10,1,10,12,67,38.25596909986339,-109.3958022
32264,1,33,10,0,8,14,66,38.25596909986339,-109.3955327
32265,1,37,10,0,11,12,71,38.25596909986339,-109.3952632
32266,1,41,11,1,14,9,77,38.25596909986339,-109.3949938
32267,2,44,12,3,16,6,83,38.25596909986339,-109.3947243
32268,3,44,12,5,17,5,86,38.25596909986339,-109.3944548
32269,3,47,12,4,17,4,87,38.25596909986339,-109.3941853
32270,3,46,12,4,16,5,86,38.25596909986339,-109.3939158
32271,3,46,12,4,17,4,86,38.25596909986339,-109.3936463
32272,3,47,12,7,17,1,87,38.25596909986339,-109.3933768
32273,3,43,11,8,15,2,82,38.25596909986339,-109.3931073
32274,2,34,10,6,10,5,67,38.25596909986339,-109.3928378
32275,2,30,11,5,9,8,65,38.25596909986339,-109.3925683
32276,2,32,11,4,10,10,69,38.25596909986339,-109.3922988
32277,2,37,12,2,13,10,76,38.25596909986339,-109.3920293
32278,2,36,12,3,13,10,76,38.25596909986339,-109.3917598
32279,2,37,12,3,12,9,75,38.25596909986339,-109.3914903
32280,2,33,11,5,11,7,69,38.25596909986339,-109.3912208
32281,2,28,11,6,11,8,66,38.25596909986339,-109.3909513
32282,0,26,12,4,10,13,65,38.25596909986339,-109.3906818
32283,1,27,11,1,7,16,63,38.25596909986339,-109.3904123
32284,1,30,11,2,8,13,65,38.25596909986339,-109.3901429
32285,1,31,11,2,9,11,65,38.25596909986339,-109.3898734
32286,1,32,11,2,10,10,66,38.25596909986339,-109.3896039
32287,1,33,11,4,10,8,67,38.25596909986339,-109.3893344
32288,2,34,11,4,11,8,70,38.25596909986339,-109.3890649
32289,2,33,11,5,10,8,69,38.25596909986339,-109.3887954
32290,3,33,11,6,10,6,69,38.25596909986339,-109.3885259
32291,4,34,11,6,11,5,71,38.25596909986339,-109.3882564
32292,2,35,10,4,11,6,68,38.25596909986339,-109.3879869
32293,3,36,10,5,10,5,69,38.25596909986339,-109.3877174
32294,3,33,10,5,9,6,66,38.25596909986339,-109.3874479
32295,3,34,10,4,10,6,67,38.25596909986339,-109.3871784
32296,3,39,9,5,11,5,72,38.25596909986339,-109.3869089
32297,4,41,9,6,11,2,73,38.25596909986339,-109.3866394
32298,3,36,9,6,11,4,69,38.25596909986339,-109.3863699
32299,3,39,10,4,12,5,73,38.25596909986339,-109.3861004
32300,4,42,9,3,13,4,75,38.25596909986339,-109.3858309
32301,3,44,9,9,12,1,78,38.25596909986339,-109.3855614
32302,5,43,10,6,14,1,79,38.25596909986339,-109.3852919
32303,9,36,12,9,14,1,81,38.25596909986339,-109.3850225
32304,19,33,14,13,11,0,90,38.25596909986339,-109.384753
32305,25,31,15,12,9,0,92,38.25596909986339,-109.3844835
32306,21,35,13,10,10,0,89,38.25596909986339,-109.384214
32307,16,36,11,9,9,1,82,38.25596909986339,-109.3839445
32308,10,42,9,7,10,1,79,38.25596909986339,-109.383675
32309,4,47,8,6,11,1,77,38.25596909986339,-109.3834055
32310,3,52,8,4,11,2,80,38.25596909986339,-109.383136
32311,2,53,8,4,11,2,80,38.25596909986339,-109.3828665
32312,2,47,8,2,10,3,72,38.25596909986339,-109.382597
32313,3,40,10,5,11,3,72,38.25596909986339,-109.3823275
32314,7,38,11,7,11,2,76,38.25596909986339,-109.382058
32315,4,47,10,5,12,4,82,38.25596909986339,-109.3817885
32316,5,46,11,7,12,2,83,38.25596909986339,-109.381519
32317,1,24,10,7,10,9,61,38.25596909986339,-109.3812495
32318,2,17,10,8,9,11,57,38.25596909986339,-109.38098
32319,11,26,12,10,12,5,76,38.25596909986339,-109.3807105
32320,1,30,11,2,10,13,67,38.25596909986339,-109.380441
32321,1,34,11,0,11,12,69,38.25596909986339,-109.3801716
32322,1,33,10,0,11,13,68,38.25596909986339,-109.3799021
32323,2,34,10,0,10,12,68,38.25596909986339,-109.3796326
32324,3,41,9,0,11,8,72,38.25596909986339,-109.3793631
32325,4,44,10,3,13,5,79,38.25596909986339,-109.3790936
32326,6,45,11,6,15,2,85,38.25596909986339,-109.3788241
32327,7,44,12,7,15,2,87,38.25596909986339,-109.3785546
32328,9,42,13,10,14,1,89,38.25596909986339,-109.3782851
32329,10,38,14,10,14,2,88,38.25596909986339,-109.3780156
32330,12,36,13,8,14,3,86,38.25596909986339,-109.3777461
32331,8,39,12,7,14,4,84,38.25596909986339,-109.3774766
32332,7,41,12,6,13,5,84,38.25596909986339,-109.3772071
32333,6,43,12,5,13,6,85,38.25596909986339,-109.3769376
32334,5,43,12,5,14,5,84,38.25596909986339,-109.3766681
32335,6,41,11,7,13,4,82,38.25596909986339,-109.3763986
32336,6,43,12,7,14,3,85,38.25596909986339,-109.3761291
32337,6,44,12,6,14,3,85,38.25596909986339,-109.3758596
32338,6,46,12,5,14,4,87,38.25596909986339,-109.3755901
32339,7,47,12,6,14,3,89,38.25596909986339,-109.3753206
32340,8,46,12,5,14,2,87,38.25596909986339,-109.3750512
32341,8,46,12,5,14,3,88,38.25596909986339,-109.3747817
32342,7,46,12,5,14,3,87,38.25596909986339,-109.3745122
32343,6,46,12,5,15,3,87,38.25596909986339,-109.3742427
32344,4,43,12,6,15,3,83,38.25596909986339,-109.3739732
32345,6,45,13,6,15,3,88,38.25596909986339,-109.3737037
32346,6,44,13,5,14,4,86,38.25596909986339,-109.3734342
32347,7,42,12,5,13,5,84,38.25596909986339,-109.3731647
32348,12,40,12,6,13,3,86,38.25596909986339,-109.3728952
32349,12,41,13,5,14,3,88,38.25596909986339,-109.3726257
32350,9,43,13,4,13,4,86,38.25596909986339,-109.3723562
32351,6,44,12,4,14,5,85,38.25596909986339,-109.3720867
32352,5,46,11,3,15,5,85,38.25596909986339,-109.3718172
32353,5,43,12,3,14,7,84,38.25596909986339,-109.3715477
32354,8,42,13,4,12,8,87,38.25596909986339,-109.3712782
32355,8,43,13,4,11,8,87,38.25596909986339,-109.3710087
32356,9,43,13,3,12,7,87,38.25596909986339,-109.3707392
32357,10,41,14,4,12,7,88,38.25596909986339,-109.3704697
32358,8,37,14,4,10,12,85,38.25596909986339,-109.3702003
32359,10,31,16,6,7,14,84,38.25596909986339,-109.3699308
32360,11,29,16,8,7,13,84,38.25596909986339,-109.3696613
32361,12,29,16,9,8,12,86,38.25596909986339,-109.3693918
32362,10,32,16,7,8,13,86,38.25596909986339,-109.3691223
32363,9,34,15,4,9,13,84,38.25596909986339,-109.3688528
32364,6,33,12,2,10,13,76,38.25596909986339,-109.3685833
32365,5,33,12,1,9,15,75,38.25596909986339,-109.3683138
32366,5,29,13,1,11,17,76,38.25596909986339,-109.3680443
32367,7,25,16,7,11,15,81,38.25596909986339,-109.3677748
32368,11,22,15,15,14,8,85,38.25596909986339,-109.3675053
32369,7,26,15,14,16,8,86,38.25596909986339,-109.3672358
32370,6,23,13,13,16,8,79,38.25596909986339,-109.3669663
32371,7,20,11,16,17,6,77,38.25596909986339,-109.3666968
32372,6,19,10,13,17,3,68,38.25596909986339,-109.3664273
32373,7,18,11,16,17,4,73,38.25596909986339,-109.3661578
32374,4,20,12,23,16,4,79,38.25596909986339,-109.3658883
32375,4,13,12,23,16,7,75,38.25596909986339,-109.3656188
32376,4,7,9,21,16,6,63,38.25596909986339,-109.3653493
32377,0,3,6,12,10,3,34,38.25596909986339,-109.3650799
32378,1,17,14,4,17,10,63,38.25596909986339,-109.3648104
32379,3,28,16,0,13,15,75,38.25596909986339,-109.3645409
32380,5,28,18,0,7,22,80,38.25596909986339,-109.3642714
32381,3,23,15,0,3,25,69,38.25596909986339,-109.3640019
32382,3,24,14,0,2,24,67,38.25596909986339,-109.3637324
32383,2,25,15,0,3,25,70,38.25596909986339,-109.3634629
32384,1,24,17,0,4,28,74,38.25596909986339,-109.3631934
32385,1,26,19,0,4,30,80,38.25596909986339,-109.3629239
32386,1,24,18,0,3,29,75,38.25596909986339,-109.3626544
32387,2,23,17,1,3,28,74,38.25596909986339,-109.3623849
32388,2,22,17,1,2,30,74,38.25596909986339,-109.3621154
32389,2,22,17,0,2,30,73,38.25596909986339,-109.3618459
32390,1,22,17,0,2,30,72,38.25596909986339,-109.3615764
32391,2,24,16,0,3,28,73,38.25596909986339,-109.3613069
32392,1,24,16,0,5,26,72,38.25596909986339,-109.3610374
32393,1,27,16,1,7,24,76,38.25596909986339,-109.3607679
32394,2,28,17,5,8,20,80,38.25596909986339,-109.3604984
32395,4,27,19,7,7,20,84,38.25596909986339,-109.360229
32396,4,27,18,10,9,15,83,38.25596909986339,-109.3599595
32397,3,25,18,7,9,16,78,38.25596909986339,-109.35969
32398,3,24,17,9,12,12,77,38.25596909986339,-109.3594205
32399,4,24,14,13,21,3,79,38.25596909986339,-109.359151
32400,5,20,14,21,24,4,88,38.25596909986339,-109.3588815
32401,2,17,17,21,8,16,81,38.25596909986339,-109.358612
32402,2,20,17,17,7,17,80,38.25596909986339,-109.3583425
32403,6,19,15,24,11,8,83,38.25596909986339,-109.358073
32404,5,24,15,12,15,9,80,38.25596909986339,-109.3578035
32405,2,30,16,2,9,18,77,38.25596909986339,-109.357534
32406,3,29,15,6,13,12,78,38.25596909986339,-109.3572645
32407,7,24,13,17,12,5,78,38.25596909986339,-109.356995
32408,4,24,16,19,15,8,86,38.25596909986339,-109.3567255
32409,8,11,13,28,19,6,85,38.25596909986339,-109.356456
32410,5,19,14,24,16,6,84,38.25596909986339,-109.3561865
32411,8,16,12,27,18,4,85,38.25596909986339,-109.355917
32412,10,13,11,31,17,4,86,38.25596909986339,-109.3556475
32413,4,17,14,14,16,12,77,38.25596909986339,-109.355378
32414,5,14,13,16,13,14,75,38.25596909986339,-109.3551086
32415,4,11,14,14,9,18,70,38.25596909986339,-109.3548391
32416,0,9,14,21,16,8,68,38.25596909986339,-109.3545696
32417,2,13,11,15,19,2,62,38.25596909986339,-109.3543001
32418,0,17,14,11,14,11,67,38.25596909986339,-109.3540306
32419,2,26,13,12,15,11,79,38.25596909986339,-109.3537611
32420,2,24,16,3,13,18,76,38.25596909986339,-109.3534916
32421,1,26,18,0,11,24,80,38.25596909986339,-109.3532221
32422,3,23,18,0,3,29,76,38.25596909986339,-109.3529526
32423,1,21,16,1,3,29,71,38.25596909986339,-109.3526831
32424,1,19,17,1,2,30,70,38.25596909986339,-109.3524136
32425,1,19,17,1,2,30,70,38.25596909986339,-109.3521441
32426,1,19,17,1,1,30,69,38.25596909986339,-109.3518746
32427,1,20,17,1,1,29,69,38.25596909986339,-109.3516051
32428,1,23,15,1,2,26,68,38.25596909986339,-109.3513356
32429,1,19,14,1,2,25,62,38.25596909986339,-109.3510661
32430,2,17,13,2,3,22,59,38.25596909986339,-109.3507966
32431,1,18,11,4,4,17,55,38.25596909986339,-109.3505271
32432,6,35,7,3,9,6,66,38.25596909986339,-109.3502577
32433,3,29,7,3,8,6,56,38.25596909986339,-109.3499882
32434,2,30,7,3,10,6,58,38.25596909986339,-109.3497187
32435,2,26,8,4,9,6,55,38.25596909986339,-109.3494492
32436,3,29,9,6,9,8,64,38.25596909986339,-109.3491797
32437,3,27,11,5,8,11,65,38.25596909986339,-109.3489102
32438,1,17,14,4,4,19,59,38.25596909986339,-109.3486407
32439,3,15,15,2,3,25,63,38.25596909986339,-109.3483712
32440,2,19,14,0,5,23,63,38.25596909986339,-109.3481017
32441,2,33,11,0,16,9,71,38.25596909986339,-109.3478322
32442,3,28,10,4,8,11,64,38.25596909986339,-109.3475627
32443,3,27,11,5,7,13,66,38.25596909986339,-109.3472932
32444,4,29,12,5,9,11,70,38.25596909986339,-109.3470237
32445,8,31,12,8,7,9,75,38.25596909986339,-109.3467542
32446,2,24,14,4,13,13,70,38.25596909986339,-109.3464847
32447,0,22,13,4,14,15,68,38.25596909986339,-109.3462152
32448,1,25,15,3,7,21,72,38.25596909986339,-109.3459457
32449,1,16,17,0,2,32,68,38.25596909986339,-109.3456762
32450,1,15,18,0,2,31,67,38.25596909986339,-109.3454068
32451,2,16,17,0,1,30,66,38.25596909986339,-109.3451373
32452,1,16,15,0,1,27,60,38.25596909986339,-109.3448678
32453,1,15,15,1,2,25,59,38.25596909986339,-109.3445983
32454,1,12,16,0,1,28,58,38.25596909986339,-109.3443288
32455,1,10,18,0,0,31,60,38.25596909986339,-109.3440593
32456,2,15,19,0,1,32,69,38.25596909986339,-109.3437898
32457,1,15,20,0,1,35,72,38.25596909986339,-109.3435203
32458,0,16,21,0,2,36,75,38.25596909986339,-109.3432508
32459,0,17,21,0,2,36,76,38.25596909986339,-109.3429813
32460,1,19,20,0,2,35,77,38.25596909986339,-109.3427118
32461,0,19,19,0,1,34,73,38.25596909986339,-109.3424423
32462,0,19,18,0,0,31,68,38.25596909986339,-109.3421728
32463,0,18,18,0,0,30,66,38.25596909986339,-109.3419033
32464,0,16,17,0,0,29,62,38.25596909986339,-109.3416338
32465,1,20,14,0,2,22,59,38.25596909986339,-109.3413643
32466,1,19,14,3,6,15,58,38.25596909986339,-109.3410948
32467,1,20,13,3,6,16,59,38.25596909986339,-109.3408253
32468,0,21,13,2,4,20,60,38.25596909986339,-109.3405558
32469,0,21,18,2,4,29,74,38.25596909986339,-109.3402864
32470,0,18,20,0,3,34,75,38.25596909986339,-109.3400169
32471,1,15,18,0,2,31,67,38.25596909986339,-109.3397474
32472,1,15,16,0,2,27,61,38.25596909986339,-109.3394779
32473,0,18,13,2,3,21,57,38.25596909986339,-109.3392084
32474,1,28,11,3,6,13,62,38.25596909986339,-109.3389389
32475,2,41,9,2,11,6,71,38.25596909986339,-109.3386694
32476,0,43,8,1,11,5,68,38.25596909986339,-109.3383999
32477,0,47,7,1,11,4,70,38.25596909986339,-109.3381304
32478,1,53,6,3,11,2,76,38.25596909986339,-109.3378609
32479,0,50,6,2,10,4,72,38.25596909986339,-109.3375914
32480,1,51,7,3,10,3,75,38.25596909986339,-109.3373219
32481,0,48,7,3,10,4,72,38.25596909986339,-109.3370524
32482,1,48,7,2,11,4,73,38.25596909986339,-109.3367829
32483,0,47,8,2,11,5,73,38.25596909986339,-109.3365134
32484,2,32,11,2,10,13,70,38.25596909986339,-109.3362439
32485,1,20,15,2,5,22,65,38.25596909986339,-109.3359744
32486,0,19,16,0,4,26,65,38.25596909986339,-109.3357049
32487,0,19,15,0,3,25,62,38.25596909986339,-109.3354355
32488,1,23,12,4,7,16,63,38.25596909986339,-109.335166
32489,2,31,12,5,14,8,72,38.25596909986339,-109.3348965
32490,0,19,12,5,7,14,57,38.25596909986339,-109.334627
32491,5,14,13,12,10,9,63,38.25596909986339,-109.3343575
32492,16,17,12,17,14,4,80,38.25596909986339,-109.334088
32493,0,22,12,2,4,20,60,38.25596909986339,-109.3338185
32494,1,34,10,3,12,7,67,38.25596909986339,-109.333549
32495,1,42,8,1,12,6,70,38.25596909986339,-109.3332795
32496,0,43,8,0,11,7,69,38.25596909986339,-109.33301
32497,2,32,9,1,14,7,65,38.25596909986339,-109.3327405
32498,1,26,11,1,6,16,61,38.25596909986339,-109.332471
32499,1,24,12,0,5,19,61,38.25596909986339,-109.3322015
32500,5,46,13,9,19,0,92,38.25569960527815,-109.4445808
32501,6,47,13,8,19,0,93,38.25569960527815,-109.4443113
32502,4,50,13,7,19,1,94,38.25569960527815,-109.4440418
32503,4,52,12,4,18,2,92,38.25569960527815,-109.4437723
32504,4,53,12,4,17,2,92,38.25569960527815,-109.4435028
32505,4,54,12,4,17,2,93,38.25569960527815,-109.4432333
32506,3,54,12,5,17,2,93,38.25569960527815,-109.4429638
32507,4,52,13,7,16,2,94,38.25569960527815,-109.4426943
32508,3,52,12,6,16,3,92,38.25569960527815,-109.4424248
32509,3,51,12,5,16,4,91,38.25569960527815,-109.4421553
32510,3,50,12,5,17,3,90,38.25569960527815,-109.4418858
32511,3,50,11,4,17,2,87,38.25569960527815,-109.4416163
32512,3,50,10,4,15,2,84,38.25569960527815,-109.4413468
32513,3,49,10,4,14,3,83,38.25569960527815,-109.4410773
32514,3,50,10,3,12,4,82,38.25569960527815,-109.4408078
32515,2,47,9,3,10,6,77,38.25569960527815,-109.4405383
32516,2,47,9,2,10,6,76,38.25569960527815,-109.4402688
32517,2,50,9,1,12,7,81,38.25569960527815,-109.4399993
32518,1,54,9,1,14,5,84,38.25569960527815,-109.4397299
32519,2,53,9,4,13,4,85,38.25569960527815,-109.4394604
32520,2,51,9,5,12,4,83,38.25569960527815,-109.4391909
32521,2,52,9,4,12,4,83,38.25569960527815,-109.4389214
32522,2,56,8,4,13,4,87,38.25569960527815,-109.4386519
32523,2,54,10,4,14,4,88,38.25569960527815,-109.4383824
32524,3,45,11,2,14,8,83,38.25569960527815,-109.4381129
32525,2,33,11,0,10,13,69,38.25569960527815,-109.4378434
32526,1,32,10,0,11,12,66,38.25569960527815,-109.4375739
32527,1,38,9,0,12,9,69,38.25569960527815,-109.4373044
32528,1,33,9,0,11,10,64,38.25569960527815,-109.4370349
32529,2,32,9,2,10,9,64,38.25569960527815,-109.4367654
32530,2,32,10,0,10,10,64,38.25569960527815,-109.4364959
32531,1,34,10,0,12,12,69,38.25569960527815,-109.4362264
32532,1,38,11,0,14,9,73,38.25569960527815,-109.4359569
32533,2,44,11,2,16,7,82,38.25569960527815,-109.4356874
32534,2,44,11,2,16,6,81,38.25569960527815,-109.4354179
32535,2,40,10,1,13,7,73,38.25569960527815,-109.4351484
32536,3,36,9,2,9,8,67,38.25569960527815,-109.434879
32537,4,38,9,3,9,6,69,38.25569960527815,-109.4346095
32538,2,46,8,0,14,5,75,38.25569960527815,-109.43434
32539,4,48,10,0,16,3,81,38.25569960527815,-109.4340705
32540,7,46,11,5,17,1,87,38.25569960527815,-109.433801
32541,11,43,13,9,15,0,91,38.25569960527815,-109.4335315
32542,12,41,14,12,14,0,93,38.25569960527815,-109.433262
32543,15,37,15,13,14,0,94,38.25569960527815,-109.4329925
32544,18,34,15,14,13,0,94,38.25569960527815,-109.432723
32545,20,32,15,14,12,0,93,38.25569960527815,-109.4324535
32546,18,33,14,14,12,0,91,38.25569960527815,-109.432184
32547,15,36,14,13,13,0,91,38.25569960527815,-109.4319145
32548,13,39,14,13,13,0,92,38.25569960527815,-109.431645
32549,13,39,15,13,12,0,92,38.25569960527815,-109.4313755
32550,14,37,15,13,12,0,91,38.25569960527815,-109.431106
32551,15,36,15,13,12,1,92,38.25569960527815,-109.4308365
32552,13,38,14,13,13,1,92,38.25569960527815,-109.430567
32553,13,38,14,13,13,1,92,38.25569960527815,-109.4302975
32554,14,36,14,13,14,1,92,38.25569960527815,-109.430028
32555,14,36,14,12,14,1,91,38.25569960527815,-109.4297586
32556,9,38,13,12,14,1,87,38.25569960527815,-109.4294891
32557,9,42,13,11,14,0,89,38.25569960527815,-109.4292196
32558,9,43,13,12,14,1,92,38.25569960527815,-109.4289501
32559,10,43,13,12,14,0,92,38.25569960527815,-109.4286806
32560,10,43,13,12,15,0,93,38.25569960527815,-109.4284111
32561,10,43,13,11,16,0,93,38.25569960527815,-109.4281416
32562,10,40,12,11,15,0,88,38.25569960527815,-109.4278721
32563,11,38,13,12,15,0,89,38.25569960527815,-109.4276026
32564,11,38,13,12,15,0,89,38.25569960527815,-109.4273331
32565,10,40,13,12,15,0,90,38.25569960527815,-109.4270636
32566,13,38,13,11,15,0,90,38.25569960527815,-109.4267941
32567,14,34,13,13,15,0,89,38.25569960527815,-109.4265246
32568,16,32,14,14,14,0,90,38.25569960527815,-109.4262551
32569,19,31,14,13,13,0,90,38.25569960527815,-109.4259856
32570,20,30,14,13,12,0,89,38.25569960527815,-109.4257161
32571,19,33,13,13,13,0,91,38.25569960527815,-109.4254466
32572,19,33,13,13,12,0,90,38.25569960527815,-109.4251771
32573,20,32,14,13,12,0,91,38.25569960527815,-109.4249077
32574,21,32,14,13,12,0,92,38.25569960527815,-109.4246382
32575,16,35,14,14,12,0,91,38.25569960527815,-109.4243687
32576,14,38,14,13,12,0,91,38.25569960527815,-109.4240992
32577,14,37,14,14,12,0,91,38.25569960527815,-109.4238297
32578,17,34,13,12,13,0,89,38.25569960527815,-109.4235602
32579,22,30,13,10,12,1,88,38.25569960527815,-109.4232907
32580,25,28,14,10,12,1,90,38.25569960527815,-109.4230212
32581,22,30,14,11,12,1,90,38.25569960527815,-109.4227517
32582,17,33,13,12,13,1,89,38.25569960527815,-109.4224822
32583,12,36,13,11,14,1,87,38.25569960527815,-109.4222127
32584,11,36,12,11,14,1,85,38.25569960527815,-109.4219432
32585,9,44,11,8,13,1,86,38.25569960527815,-109.4216737
32586,11,45,11,8,14,0,89,38.25569960527815,-109.4214042
32587,11,42,12,10,14,0,89,38.25569960527815,-109.4211347
32588,10,39,13,10,13,1,86,38.25569960527815,-109.4208652
32589,16,35,13,12,13,0,89,38.25569960527815,-109.4205957
32590,18,33,13,11,13,0,88,38.25569960527815,-109.4203262
32591,17,34,13,11,14,0,89,38.25569960527815,-109.4200568
32592,16,34,13,11,14,0,88,38.25569960527815,-109.4197873
32593,14,34,13,12,14,0,87,38.25569960527815,-109.4195178
32594,15,34,13,12,13,1,88,38.25569960527815,-109.4192483
32595,15,34,14,13,13,1,90,38.25569960527815,-109.4189788
32596,15,34,14,12,13,1,89,38.25569960527815,-109.4187093
32597,14,35,13,11,13,1,87,38.25569960527815,-109.4184398
32598,12,36,13,11,14,1,87,38.25569960527815,-109.4181703
32599,10,41,12,9,14,1,87,38.25569960527815,-109.4179008
32600,14,35,13,11,14,1,88,38.25569960527815,-109.4176313
32601,21,30,14,12,12,1,90,38.25569960527815,-109.4173618
32602,25,29,15,11,11,1,92,38.25569960527815,-109.4170923
32603,20,32,14,11,12,0,89,38.25569960527815,-109.4168228
32604,16,36,13,11,13,0,89,38.25569960527815,-109.4165533
32605,12,38,12,10,14,0,86,38.25569960527815,-109.4162838
32606,9,40,12,10,14,1,86,38.25569960527815,-109.4160143
32607,9,42,13,10,15,0,89,38.25569960527815,-109.4157448
32608,15,36,13,11,14,0,89,38.25569960527815,-109.4154753
32609,18,33,13,11,13,1,89,38.25569960527815,-109.4152058
32610,19,32,13,11,13,0,88,38.25569960527815,-109.4149364
32611,19,31,14,12,14,0,90,38.25569960527815,-109.4146669
32612,19,31,14,13,14,0,91,38.25569960527815,-109.4143974
32613,20,32,14,12,13,0,91,38.25569960527815,-109.4141279
32614,17,34,14,13,13,0,91,38.25569960527815,-109.4138584
32615,12,37,14,14,14,0,91,38.25569960527815,-109.4135889
32616,10,39,15,14,14,0,92,38.25569960527815,-109.4133194
32617,11,39,15,14,14,0,93,38.25569960527815,-109.4130499
32618,12,36,15,15,14,0,92,38.25569960527815,-109.4127804
32619,14,34,14,14,15,0,91,38.25569960527815,-109.4125109
32620,14,35,14,13,15,0,91,38.25569960527815,-109.4122414
32621,11,38,14,12,16,0,91,38.25569960527815,-109.4119719
32622,11,40,14,12,16,0,93,38.25569960527815,-109.4117024
32623,10,43,14,11,16,0,94,38.25569960527815,-109.4114329
32624,9,44,14,11,16,0,94,38.25569960527815,-109.4111634
32625,9,42,14,11,16,0,92,38.25569960527815,-109.4108939
32626,8,43,13,10,16,1,91,38.25569960527815,-109.4106244
32627,4,45,12,6,17,2,86,38.25569960527815,-109.4103549
32628,4,46,12,7,17,1,87,38.25569960527815,-109.4100855
32629,4,45,12,7,17,1,86,38.25569960527815,-109.409816
32630,3,44,11,5,16,3,82,38.25569960527815,-109.4095465
32631,2,43,11,4,14,5,79,38.25569960527815,-109.409277
32632,1,45,9,1,13,6,75,38.25569960527815,-109.4090075
32633,0,44,8,1,11,6,70,38.25569960527815,-109.408738
32634,0,40,8,1,9,6,64,38.25569960527815,-109.4084685
32635,1,40,8,2,8,5,64,38.25569960527815,-109.408199
32636,2,42,7,4,8,3,66,38.25569960527815,-109.4079295
32637,2,37,8,4,9,4,64,38.25569960527815,-109.40766
32638,2,34,10,3,10,7,66,38.25569960527815,-109.4073905
32639,2,37,12,4,12,8,75,38.25569960527815,-109.407121
32640,3,38,13,6,13,5,78,38.25569960527815,-109.4068515
32641,3,38,12,5,13,6,77,38.25569960527815,-109.406582
32642,3,41,13,6,13,5,81,38.25569960527815,-109.4063125
32643,4,43,13,6,13,4,83,38.25569960527815,-109.406043
32644,4,46,14,7,15,3,89,38.25569960527815,-109.4057735
32645,3,50,13,5,17,3,91,38.25569960527815,-109.405504
32646,2,47,11,2,14,7,83,38.25569960527815,-109.4052345
32647,2,48,10,0,13,10,83,38.25569960527815,-109.4049651
32648,1,45,11,0,14,10,81,38.25569960527815,-109.4046956
32649,1,38,12,0,14,12,77,38.25569960527815,-109.4044261
32650,2,41,12,1,17,9,82,38.25569960527815,-109.4041566
32651,3,40,12,2,16,7,80,38.25569960527815,-109.4038871
32652,2,39,12,1,14,9,77,38.25569960527815,-109.4036176
32653,1,37,11,0,12,11,72,38.25569960527815,-109.4033481
32654,1,39,11,0,14,9,74,38.25569960527815,-109.4030786
32655,0,34,11,0,12,12,69,38.25569960527815,-109.4028091
32656,1,40,10,0,14,8,73,38.25569960527815,-109.4025396
32657,1,56,8,0,15,3,83,38.25569960527815,-109.4022701
32658,1,66,8,3,12,1,91,38.25569960527815,-109.4020006
32659,1,65,8,2,13,1,90,38.25569960527815,-109.4017311
32660,0,61,8,0,15,2,86,38.25569960527815,-109.4014616
32661,1,56,9,0,15,4,85,38.25569960527815,-109.4011921
32662,1,49,9,0,13,9,81,38.25569960527815,-109.4009226
32663,0,45,10,0,12,12,79,38.25569960527815,-109.4006531
32664,1,45,10,0,13,10,79,38.25569960527815,-109.4003836
32665,1,43,9,0,11,8,72,38.25569960527815,-109.4001142
32666,2,38,8,2,9,5,64,38.25569960527815,-109.3998447
32667,3,37,8,4,8,4,64,38.25569960527815,-109.3995752
32668,4,38,8,4,7,4,65,38.25569960527815,-109.3993057
32669,4,41,8,4,8,4,69,38.25569960527815,-109.3990362
32670,2,38,10,2,8,8,68,38.25569960527815,-109.3987667
32671,1,34,10,1,8,11,65,38.25569960527815,-109.3984972
32672,2,35,10,1,7,10,65,38.25569960527815,-109.3982277
32673,2,38,9,2,7,8,66,38.25569960527815,-109.3979582
32674,2,38,10,2,12,7,71,38.25569960527815,-109.3976887
32675,3,44,11,1,13,7,79,38.25569960527815,-109.3974192
32676,2,44,11,2,14,5,78,38.25569960527815,-109.3971497
32677,2,40,11,2,13,6,74,38.25569960527815,-109.3968802
32678,2,32,10,3,9,9,65,38.25569960527815,-109.3966107
32679,3,31,11,4,10,10,69,38.25569960527815,-109.3963412
32680,2,31,11,3,11,10,68,38.25569960527815,-109.3960717
32681,2,32,11,1,10,11,67,38.25569960527815,-109.3958022
32682,3,32,12,1,9,12,69,38.25569960527815,-109.3955327
32683,1,31,10,1,8,13,64,38.25569960527815,-109.3952632
32684,1,36,9,0,10,11,67,38.25569960527815,-109.3949938
32685,1,42,10,0,13,8,74,38.25569960527815,-109.3947243
32686,2,44,11,2,14,6,79,38.25569960527815,-109.3944548
32687,3,47,12,4,16,4,86,38.25569960527815,-109.3941853
32688,4,47,12,7,17,2,89,38.25569960527815,-109.3939158
32689,4,47,12,8,16,1,88,38.25569960527815,-109.3936463
32690,3,45,12,6,16,2,84,38.25569960527815,-109.3933768
32691,2,42,11,4,15,5,79,38.25569960527815,-109.3931073
32692,2,40,11,3,14,6,76,38.25569960527815,-109.3928378
32693,3,42,12,5,16,4,82,38.25569960527815,-109.3925683
32694,3,44,13,6,18,4,88,38.25569960527815,-109.3922988
32695,2,40,12,4,17,6,81,38.25569960527815,-109.3920293
32696,2,34,12,5,13,8,74,38.25569960527815,-109.3917598
32697,2,34,11,4,13,7,71,38.25569960527815,-109.3914903
32698,1,30,11,5,9,9,65,38.25569960527815,-109.3912208
32699,2,28,11,7,11,7,66,38.25569960527815,-109.3909513
32700,5,28,12,5,15,5,70,38.25569960527815,-109.3906818
32701,1,29,11,5,11,11,68,38.25569960527815,-109.3904123
32702,1,31,11,3,9,11,66,38.25569960527815,-109.3901429
32703,1,32,11,2,8,10,64,38.25569960527815,-109.3898734
32704,1,32,11,2,8,10,64,38.25569960527815,-109.3896039
32705,1,32,10,2,9,10,64,38.25569960527815,-109.3893344
32706,2,37,10,2,11,9,71,38.25569960527815,-109.3890649
32707,2,34,11,3,10,8,68,38.25569960527815,-109.3887954
32708,2,32,10,4,9,7,64,38.25569960527815,-109.3885259
32709,2,30,10,4,8,7,61,38.25569960527815,-109.3882564
32710,2,30,10,5,9,6,62,38.25569960527815,-109.3879869
32711,3,29,9,5,9,6,61,38.25569960527815,-109.3877174
32712,2,29,10,5,8,7,61,38.25569960527815,-109.3874479
32713,2,30,11,5,11,7,66,38.25569960527815,-109.3871784
32714,2,40,9,4,12,5,72,38.25569960527815,-109.3869089
32715,3,46,9,5,11,2,76,38.25569960527815,-109.3866394
32716,3,42,9,6,12,3,75,38.25569960527815,-109.3863699
32717,2,36,10,5,12,6,71,38.25569960527815,-109.3861004
32718,2,34,10,3,11,9,69,38.25569960527815,-109.3858309
32719,3,40,10,8,13,3,77,38.25569960527815,-109.3855614
32720,2,37,10,4,13,5,71,38.25569960527815,-109.3852919
32721,8,33,11,6,13,4,75,38.25569960527815,-109.3850225
32722,21,33,13,10,12,1,90,38.25569960527815,-109.384753
32723,25,32,14,11,9,0,91,38.25569960527815,-109.3844835
32724,16,36,12,9,9,1,83,38.25569960527815,-109.384214
32725,10,39,9,8,9,1,76,38.25569960527815,-109.3839445
32726,7,44,10,8,10,1,80,38.25569960527815,-109.383675
32727,7,46,11,8,12,2,86,38.25569960527815,-109.3834055
32728,7,44,13,9,13,1,87,38.25569960527815,-109.383136
32729,5,44,10,6,13,2,80,38.25569960527815,-109.3828665
32730,4,39,10,5,11,4,73,38.25569960527815,-109.382597
32731,6,37,11,6,11,3,74,38.25569960527815,-109.3823275
32732,8,38,12,8,12,2,80,38.25569960527815,-109.382058
32733,2,40,10,3,14,6,75,38.25569960527815,-109.3817885
32734,7,41,11,8,13,2,82,38.25569960527815,-109.381519
32735,2,23,10,11,13,5,64,38.25569960527815,-109.3812495
32736,1,20,10,9,12,8,60,38.25569960527815,-109.38098
32737,4,29,10,4,12,6,65,38.25569960527815,-109.3807105
32738,1,34,10,0,11,14,70,38.25569960527815,-109.380441
32739,2,30,11,0,8,18,69,38.25569960527815,-109.3801716
32740,3,34,11,0,10,15,73,38.25569960527815,-109.3799021
32741,4,38,11,1,11,10,75,38.25569960527815,-109.3796326
32742,5,40,11,6,14,4,80,38.25569960527815,-109.3793631
32743,5,42,11,7,15,2,82,38.25569960527815,-109.3790936
32744,5,42,11,6,13,3,80,38.25569960527815,-109.3788241
32745,6,40,11,7,13,4,81,38.25569960527815,-109.3785546
32746,6,39,11,5,11,6,78,38.25569960527815,-109.3782851
32747,5,41,11,4,11,7,79,38.25569960527815,-109.3780156
32748,4,44,11,3,12,6,80,38.25569960527815,-109.3777461
32749,6,43,11,4,11,6,81,38.25569960527815,-109.3774766
32750,6,41,12,5,12,5,81,38.25569960527815,-109.3772071
32751,5,41,11,3,13,7,80,38.25569960527815,-109.3769376
32752,6,44,11,4,12,5,82,38.25569960527815,-109.3766681
32753,6,37,12,7,12,6,80,38.25569960527815,-109.3763986
32754,9,36,13,10,14,3,85,38.25569960527815,-109.3761291
32755,8,38,13,9,15,2,85,38.25569960527815,-109.3758596
32756,7,41,13,8,14,3,86,38.25569960527815,-109.3755901
32757,10,41,13,9,14,2,89,38.25569960527815,-109.3753206
32758,8,42,12,7,14,3,86,38.25569960527815,-109.3750512
32759,6,42,12,5,14,4,83,38.25569960527815,-109.3747817
32760,5,41,12,4,14,5,81,38.25569960527815,-109.3745122
32761,6,42,12,5,13,5,83,38.25569960527815,-109.3742427
32762,4,42,12,3,13,7,81,38.25569960527815,-109.3739732
32763,7,45,12,4,13,5,86,38.25569960527815,-109.3737037
32764,7,44,12,5,14,4,86,38.25569960527815,-109.3734342
32765,7,43,12,5,14,4,85,38.25569960527815,-109.3731647
32766,8,46,12,3,14,4,87,38.25569960527815,-109.3728952
32767,6,46,13,2,13,8,88,38.25569960527815,-109.3726257
32768,4,46,13,1,12,9,85,38.25569960527815,-109.3723562
32769,4,47,12,1,13,8,85,38.25569960527815,-109.3720867
32770,4,45,12,1,13,9,84,38.25569960527815,-109.3718172
32771,4,34,14,1,6,18,77,38.25569960527815,-109.3715477
32772,7,33,15,2,5,18,80,38.25569960527815,-109.3712782
32773,5,36,14,2,7,15,79,38.25569960527815,-109.3710087
32774,5,40,13,2,10,11,81,38.25569960527815,-109.3707392
32775,6,42,12,2,13,8,83,38.25569960527815,-109.3704697
32776,4,38,12,1,10,12,77,38.25569960527815,-109.3702003
32777,6,32,13,2,8,15,76,38.25569960527815,-109.3699308
32778,7,29,14,3,7,14,74,38.25569960527815,-109.3696613
32779,8,28,14,5,7,15,77,38.25569960527815,-109.3693918
32780,8,28,15,5,6,16,78,38.25569960527815,-109.3691223
32781,7,30,14,2,6,15,74,38.25569960527815,-109.3688528
32782,4,31,12,1,8,14,70,38.25569960527815,-109.3685833
32783,4,34,12,2,11,11,74,38.25569960527815,-109.3683138
32784,4,35,11,2,14,7,73,38.25569960527815,-109.3680443
32785,2,29,11,9,11,7,69,38.25569960527815,-109.3677748
32786,0,23,10,16,17,2,68,38.25569960527815,-109.3675053
32787,2,16,10,18,16,1,63,38.25569960527815,-109.3672358
32788,4,14,11,20,13,2,64,38.25569960527815,-109.3669663
32789,6,14,11,22,15,2,70,38.25569960527815,-109.3666968
32790,7,16,10,26,16,3,78,38.25569960527815,-109.3664273
32791,7,15,11,18,15,5,71,38.25569960527815,-109.3661578
32792,5,15,11,14,13,8,66,38.25569960527815,-109.3658883
32793,5,15,12,13,12,11,68,38.25569960527815,-109.3656188
32794,4,12,13,14,12,13,68,38.25569960527815,-109.3653493
32795,4,15,14,13,10,11,67,38.25569960527815,-109.3650799
32796,3,21,17,6,8,19,74,38.25569960527815,-109.3648104
32797,2,24,18,2,6,26,78,38.25569960527815,-109.3645409
32798,2,25,18,1,4,28,78,38.25569960527815,-109.3642714
32799,2,22,16,0,1,28,69,38.25569960527815,-109.3640019
32800,2,21,14,0,1,25,63,38.25569960527815,-109.3637324
32801,2,22,15,0,1,25,65,38.25569960527815,-109.3634629
32802,1,21,15,0,1,28,66,38.25569960527815,-109.3631934
32803,1,22,17,0,1,31,72,38.25569960527815,-109.3629239
32804,1,25,17,0,2,30,75,38.25569960527815,-109.3626544
32805,0,23,16,0,1,29,69,38.25569960527815,-109.3623849
32806,1,21,15,0,1,29,67,38.25569960527815,-109.3621154
32807,1,20,14,0,0,27,62,38.25569960527815,-109.3618459
32808,1,21,14,0,1,26,63,38.25569960527815,-109.3615764
32809,1,22,14,0,2,25,64,38.25569960527815,-109.3613069
32810,1,24,13,0,2,24,64,38.25569960527815,-109.3610374
32811,0,25,14,0,3,25,67,38.25569960527815,-109.3607679
32812,0,24,16,0,3,28,71,38.25569960527815,-109.3604984
32813,0,26,18,0,5,28,77,38.25569960527815,-109.360229
32814,0,28,20,0,5,29,82,38.25569960527815,-109.3599595
32815,1,26,19,3,6,26,81,38.25569960527815,-109.35969
32816,4,22,15,15,5,20,81,38.25569960527815,-109.3594205
32817,3,22,15,16,6,21,83,38.25569960527815,-109.359151
32818,2,26,17,10,10,18,83,38.25569960527815,-109.3588815
32819,5,19,16,8,13,15,76,38.25569960527815,-109.358612
32820,4,18,15,12,10,18,77,38.25569960527815,-109.3583425
32821,5,19,15,14,10,16,79,38.25569960527815,-109.358073
32822,1,27,17,2,8,25,80,38.25569960527815,-109.3578035
32823,0,30,18,1,8,24,81,38.25569960527815,-109.357534
32824,4,28,18,4,12,17,83,38.25569960527815,-109.3572645
32825,6,23,17,10,10,13,79,38.25569960527815,-109.356995
32826,5,24,18,8,10,11,76,38.25569960527815,-109.3567255
32827,6,26,17,10,18,3,80,38.25569960527815,-109.356456
32828,1,22,16,16,16,8,79,38.25569960527815,-109.3561865
32829,7,19,13,23,21,1,84,38.25569960527815,-109.355917
32830,8,14,12,28,20,2,84,38.25569960527815,-109.3556475
32831,6,14,14,27,17,5,83,38.25569960527815,-109.355378
32832,5,14,11,25,17,6,78,38.25569960527815,-109.3551086
32833,4,12,14,18,11,11,70,38.25569960527815,-109.3548391
32834,1,13,14,23,14,9,74,38.25569960527815,-109.3545696
32835,0,15,13,13,15,10,66,38.25569960527815,-109.3543001
32836,1,26,14,5,15,15,76,38.25569960527815,-109.3540306
32837,2,27,17,2,6,26,80,38.25569960527815,-109.3537611
32838,1,22,17,0,3,32,75,38.25569960527815,-109.3534916
32839,1,20,17,0,2,31,71,38.25569960527815,-109.3532221
32840,1,19,17,1,2,31,71,38.25569960527815,-109.3529526
32841,1,21,17,2,2,29,72,38.25569960527815,-109.3526831
32842,1,21,16,3,2,28,71,38.25569960527815,-109.3524136
32843,1,20,16,2,2,28,69,38.25569960527815,-109.3521441
32844,1,19,15,1,1,27,64,38.25569960527815,-109.3518746
32845,1,21,14,0,2,24,62,38.25569960527815,-109.3516051
32846,3,20,13,0,2,21,59,38.25569960527815,-109.3513356
32847,4,18,12,2,4,16,56,38.25569960527815,-109.3510661
32848,2,18,11,4,5,15,55,38.25569960527815,-109.3507966
32849,3,24,9,2,6,11,55,38.25569960527815,-109.3505271
32850,4,28,8,5,8,5,58,38.25569960527815,-109.3502577
32851,3,30,6,2,8,7,56,38.25569960527815,-109.3499882
32852,3,24,8,3,8,7,53,38.25569960527815,-109.3497187
32853,2,25,8,4,8,8,55,38.25569960527815,-109.3494492
32854,2,29,10,5,8,11,65,38.25569960527815,-109.3491797
32855,2,23,12,3,5,19,64,38.25569960527815,-109.3489102
32856,1,16,15,1,3,25,61,38.25569960527815,-109.3486407
32857,2,16,15,1,3,23,60,38.25569960527815,-109.3483712
32858,2,19,13,2,5,19,60,38.25569960527815,-109.3481017
32859,4,30,12,7,8,11,72,38.25569960527815,-109.3478322
32860,0,22,9,1,7,14,53,38.25569960527815,-109.3475627
32861,2,25,11,4,7,14,63,38.25569960527815,-109.3472932
32862,5,30,11,8,8,10,72,38.25569960527815,-109.3470237
32863,9,25,10,13,11,5,73,38.25569960527815,-109.3467542
32864,6,21,12,10,11,9,69,38.25569960527815,-109.3464847
32865,1,24,14,5,12,16,72,38.25569960527815,-109.3462152
32866,1,17,13,5,6,22,64,38.25569960527815,-109.3459457
32867,1,14,15,1,3,25,59,38.25569960527815,-109.3456762
32868,1,16,14,3,3,21,58,38.25569960527815,-109.3454068
32869,1,18,11,4,4,17,55,38.25569960527815,-109.3451373
32870,1,15,11,5,4,16,52,38.25569960527815,-109.3448678
32871,2,11,13,5,4,17,52,38.25569960527815,-109.3445983
32872,2,10,14,3,3,21,53,38.25569960527815,-109.3443288
32873,1,10,15,0,2,26,54,38.25569960527815,-109.3440593
32874,1,14,17,0,1,30,63,38.25569960527815,-109.3437898
32875,1,18,19,0,1,33,72,38.25569960527815,-109.3435203
32876,1,18,19,0,1,33,72,38.25569960527815,-109.3432508
32877,1,16,20,0,2,34,73,38.25569960527815,-109.3429813
32878,0,17,21,0,1,35,74,38.25569960527815,-109.3427118
32879,2,17,20,0,1,33,73,38.25569960527815,-109.3424423
32880,1,17,19,0,0,30,67,38.25569960527815,-109.3421728
32881,1,18,17,0,0,28,64,38.25569960527815,-109.3419033
32882,0,19,17,0,2,27,65,38.25569960527815,-109.3416338
32883,0,18,16,0,2,29,65,38.25569960527815,-109.3413643
32884,3,25,16,1,5,22,72,38.25569960527815,-109.3410948
32885,0,25,12,0,4,22,63,38.25569960527815,-109.3408253
32886,0,26,13,1,5,20,65,38.25569960527815,-109.3405558
32887,1,23,17,1,5,23,70,38.25569960527815,-109.3402864
32888,0,17,17,0,1,31,66,38.25569960527815,-109.3400169
32889,0,15,16,0,1,31,63,38.25569960527815,-109.3397474
32890,1,15,15,0,1,28,60,38.25569960527815,-109.3394779
32891,2,19,13,3,3,19,59,38.25569960527815,-109.3392084
32892,2,32,9,3,9,8,63,38.25569960527815,-109.3389389
32893,1,40,7,1,11,5,65,38.25569960527815,-109.3386694
32894,0,49,7,0,11,5,72,38.25569960527815,-109.3383999
32895,0,50,7,1,10,4,72,38.25569960527815,-109.3381304
32896,1,49,7,2,10,4,73,38.25569960527815,-109.3378609
32897,2,44,9,4,12,5,76,38.25569960527815,-109.3375914
32898,0,47,7,1,11,5,71,38.25569960527815,-109.3373219
32899,0,43,9,2,12,6,72,38.25569960527815,-109.3370524
32900,2,41,11,5,14,5,78,38.25569960527815,-109.3367829
32901,1,34,10,1,10,13,69,38.25569960527815,-109.3365134
32902,1,23,12,2,5,19,62,38.25569960527815,-109.3362439
32903,1,17,15,2,3,25,63,38.25569960527815,-109.3359744
32904,1,18,17,0,3,29,68,38.25569960527815,-109.3357049
32905,1,20,16,0,3,27,67,38.25569960527815,-109.3354355
32906,1,22,13,0,4,22,62,38.25569960527815,-109.335166
32907,1,22,13,4,9,14,63,38.25569960527815,-109.3348965
32908,2,13,14,9,7,16,61,38.25569960527815,-109.334627
32909,4,15,14,16,11,13,73,38.25569960527815,-109.3343575
32910,8,17,13,17,13,10,78,38.25569960527815,-109.334088
32911,3,15,12,2,3,23,58,38.25569960527815,-109.3338185
32912,3,22,13,4,11,13,66,38.25569960527815,-109.333549
32913,1,24,12,3,11,12,63,38.25569960527815,-109.3332795
32914,1,29,10,2,13,9,64,38.25569960527815,-109.33301
32915,2,33,10,2,15,6,68,38.25569960527815,-109.3327405
32916,2,29,11,2,8,12,64,38.25569960527815,-109.332471
32917,1,33,11,1,11,12,69,38.25569960527815,-109.3322015
32918,1,34,10,2,12,10,69,38.25569960527815,-109.331932
32919,4,47,13,6,19,1,90,38.25543011069292,-109.4445808
32920,5,49,13,7,18,1,93,38.25543011069292,-109.4443113
32921,4,50,13,6,18,1,92,38.25543011069292,-109.4440418
32922,3,50,12,5,18,2,90,38.25543011069292,-109.4437723
32923,4,51,12,6,17,2,92,38.25543011069292,-109.4435028
32924,4,53,12,6,17,2,94,38.25543011069292,-109.4432333
32925,4,53,12,5,16,2,92,38.25543011069292,-109.4429638
32926,4,53,12,6,15,2,92,38.25543011069292,-109.4426943
32927,3,53,11,5,14,4,90,38.25543011069292,-109.4424248
32928,2,52,11,4,14,5,88,38.25543011069292,-109.4421553
32929,3,52,11,4,15,5,90,38.25543011069292,-109.4418858
32930,2,47,10,2,14,5,80,38.25543011069292,-109.4416163
32931,2,41,9,2,12,5,71,38.25543011069292,-109.4413468
32932,2,40,9,3,11,5,70,38.25543011069292,-109.4410773
32933,3,49,9,4,10,4,79,38.25543011069292,-109.4408078
32934,3,44,10,4,11,6,78,38.25543011069292,-109.4405383
32935,3,46,10,2,12,8,81,38.25543011069292,-109.4402688
32936,2,50,11,3,13,6,85,38.25543011069292,-109.4399993
32937,1,53,9,3,13,5,84,38.25543011069292,-109.4397299
32938,1,50,9,3,12,6,81,38.25543011069292,-109.4394604
32939,1,48,9,2,12,7,79,38.25543011069292,-109.4391909
32940,2,42,9,2,10,8,73,38.25543011069292,-109.4389214
32941,2,43,9,1,11,9,75,38.25543011069292,-109.4386519
32942,2,48,10,0,12,9,81,38.25543011069292,-109.4383824
32943,2,47,11,3,15,7,85,38.25543011069292,-109.4381129
32944,2,45,11,3,15,8,84,38.25543011069292,-109.4378434
32945,3,43,11,3,14,8,82,38.25543011069292,-109.4375739
32946,2,38,11,3,13,8,75,38.25543011069292,-109.4373044
32947,2,38,9,0,10,10,69,38.25543011069292,-109.4370349
32948,1,29,9,2,9,9,59,38.25543011069292,-109.4367654
32949,3,32,9,3,11,7,65,38.25543011069292,-109.4364959
32950,5,34,10,1,11,8,69,38.25543011069292,-109.4362264
32951,4,38,11,2,13,7,75,38.25543011069292,-109.4359569
32952,2,43,11,1,16,6,79,38.25543011069292,-109.4356874
32953,2,47,10,1,14,7,81,38.25543011069292,-109.4354179
32954,2,43,10,1,15,6,77,38.25543011069292,-109.4351484
32955,2,37,10,2,12,7,70,38.25543011069292,-109.434879
32956,4,34,10,3,11,6,68,38.25543011069292,-109.4346095
32957,2,39,9,1,14,6,71,38.25543011069292,-109.43434
32958,2,47,9,0,17,3,78,38.25543011069292,-109.4340705
32959,3,47,9,2,17,2,80,38.25543011069292,-109.433801
32960,7,45,11,7,16,0,86,38.25543011069292,-109.4335315
32961,11,42,14,11,14,0,92,38.25543011069292,-109.433262
32962,12,40,15,12,14,0,93,38.25543011069292,-109.4329925
32963,15,37,16,13,13,0,94,38.25543011069292,-109.432723
32964,18,35,15,14,12,0,94,38.25543011069292,-109.4324535
32965,16,35,14,13,13,0,91,38.25543011069292,-109.432184
32966,13,38,14,12,13,0,90,38.25543011069292,-109.4319145
32967,11,42,14,12,13,0,92,38.25543011069292,-109.431645
32968,12,42,14,12,12,0,92,38.25543011069292,-109.4313755
32969,13,39,14,13,12,0,91,38.25543011069292,-109.431106
32970,14,37,14,14,13,0,92,38.25543011069292,-109.4308365
32971,11,40,14,13,13,0,91,38.25543011069292,-109.430567
32972,12,39,14,13,13,0,91,38.25543011069292,-109.4302975
32973,14,37,14,13,14,0,92,38.25543011069292,-109.430028
32974,13,38,14,12,14,0,91,38.25543011069292,-109.4297586
32975,10,40,13,11,15,0,89,38.25543011069292,-109.4294891
32976,10,43,14,11,15,0,93,38.25543011069292,-109.4292196
32977,10,45,13,11,14,0,93,38.25543011069292,-109.4289501
32978,9,47,13,10,14,0,93,38.25543011069292,-109.4286806
32979,8,49,12,9,15,0,93,38.25543011069292,-109.4284111
32980,9,46,13,10,16,0,94,38.25543011069292,-109.4281416
32981,9,44,13,9,16,0,91,38.25543011069292,-109.4278721
32982,11,43,12,10,15,0,91,38.25543011069292,-109.4276026
32983,10,43,12,10,15,0,90,38.25543011069292,-109.4273331
32984,8,45,12,10,15,0,90,38.25543011069292,-109.4270636
32985,11,42,12,11,15,0,91,38.25543011069292,-109.4267941
32986,14,35,13,12,15,0,89,38.25543011069292,-109.4265246
32987,17,32,14,13,14,0,90,38.25543011069292,-109.4262551
32988,18,31,14,14,13,0,90,38.25543011069292,-109.4259856
32989,18,31,14,14,12,0,89,38.25543011069292,-109.4257161
32990,17,34,14,14,13,0,92,38.25543011069292,-109.4254466
32991,18,33,14,14,12,0,91,38.25543011069292,-109.4251771
32992,19,32,15,14,12,0,92,38.25543011069292,-109.4249077
32993,19,32,15,14,12,0,92,38.25543011069292,-109.4246382
32994,17,35,14,13,12,0,91,38.25543011069292,-109.4243687
32995,16,36,14,12,13,0,91,38.25543011069292,-109.4240992
32996,17,34,13,12,13,0,89,38.25543011069292,-109.4238297
32997,19,32,13,11,12,0,87,38.25543011069292,-109.4235602
32998,19,32,13,12,13,0,89,38.25543011069292,-109.4232907
32999,22,30,14,12,12,1,91,38.25543011069292,-109.4230212
33000,20,31,14,12,12,1,90,38.25543011069292,-109.4227517
33001,16,34,14,13,13,1,91,38.25543011069292,-109.4224822
33002,13,37,13,12,14,1,90,38.25543011069292,-109.4222127
33003,12,39,12,10,15,1,89,38.25543011069292,-109.4219432
33004,8,46,10,8,14,1,87,38.25543011069292,-109.4216737
33005,11,45,12,9,14,0,91,38.25543011069292,-109.4214042
33006,13,39,13,11,14,0,90,38.25543011069292,-109.4211347
33007,14,37,13,12,13,1,90,38.25543011069292,-109.4208652
33008,18,34,13,11,12,0,88,38.25543011069292,-109.4205957
33009,21,32,13,10,12,0,88,38.25543011069292,-109.4203262
33010,19,33,13,10,13,0,88,38.25543011069292,-109.4200568
33011,16,35,13,11,14,0,89,38.25543011069292,-109.4197873
33012,15,36,13,12,14,0,90,38.25543011069292,-109.4195178
33013,15,35,13,13,13,0,89,38.25543011069292,-109.4192483
33014,15,34,14,14,13,0,90,38.25543011069292,-109.4189788
33015,15,34,14,14,12,1,90,38.25543011069292,-109.4187093
33016,16,35,14,11,13,1,90,38.25543011069292,-109.4184398
33017,14,38,13,11,14,0,90,38.25543011069292,-109.4181703
33018,12,40,13,10,14,0,89,38.25543011069292,-109.4179008
33019,13,38,13,10,14,1,89,38.25543011069292,-109.4176313
33020,13,39,14,10,14,1,91,38.25543011069292,-109.4173618
33021,13,39,14,10,13,0,89,38.25543011069292,-109.4170923
33022,9,41,12,8,14,1,85,38.25543011069292,-109.4168228
33023,4,44,11,6,14,2,81,38.25543011069292,-109.4165533
33024,4,46,10,5,14,2,81,38.25543011069292,-109.4162838
33025,4,47,11,5,14,2,83,38.25543011069292,-109.4160143
33026,4,46,11,5,16,2,84,38.25543011069292,-109.4157448
33027,8,40,12,8,16,1,85,38.25543011069292,-109.4154753
33028,14,34,13,11,15,1,88,38.25543011069292,-109.4152058
33029,17,32,13,12,14,0,88,38.25543011069292,-109.4149364
33030,18,32,14,13,14,0,91,38.25543011069292,-109.4146669
33031,17,32,14,13,14,0,90,38.25543011069292,-109.4143974
33032,18,32,14,13,13,1,91,38.25543011069292,-109.4141279
33033,15,33,14,14,14,1,91,38.25543011069292,-109.4138584
33034,12,36,14,13,13,1,89,38.25543011069292,-109.4135889
33035,9,39,14,13,13,1,89,38.25543011069292,-109.4133194
33036,11,38,15,13,14,0,91,38.25543011069292,-109.4130499
33037,11,36,15,15,15,0,92,38.25543011069292,-109.4127804
33038,12,35,15,14,15,0,91,38.25543011069292,-109.4125109
33039,13,36,14,12,16,0,91,38.25543011069292,-109.4122414
33040,10,39,13,11,16,1,90,38.25543011069292,-109.4119719
33041,11,38,14,12,15,1,91,38.25543011069292,-109.4117024
33042,12,40,14,12,15,0,93,38.25543011069292,-109.4114329
33043,9,44,13,9,16,1,92,38.25543011069292,-109.4111634
33044,5,45,12,6,16,2,86,38.25543011069292,-109.4108939
33045,3,44,12,5,17,3,84,38.25543011069292,-109.4106244
33046,2,50,10,2,16,3,83,38.25543011069292,-109.4103549
33047,2,50,10,2,16,4,84,38.25543011069292,-109.4100855
33048,2,48,10,2,15,4,81,38.25543011069292,-109.409816
33049,1,47,9,2,14,4,77,38.25543011069292,-109.4095465
33050,1,41,9,3,12,5,71,38.25543011069292,-109.409277
33051,1,38,7,2,10,5,63,38.25543011069292,-109.4090075
33052,2,39,7,3,9,4,64,38.25543011069292,-109.408738
33053,2,39,7,3,8,4,63,38.25543011069292,-109.4084685
33054,1,38,7,3,7,5,61,38.25543011069292,-109.408199
33055,3,37,8,4,9,4,65,38.25543011069292,-109.4079295
33056,2,34,10,4,10,6,66,38.25543011069292,-109.40766
33057,2,36,11,4,12,7,72,38.25543011069292,-109.4073905
33058,3,41,12,4,15,5,80,38.25543011069292,-109.407121
33059,3,42,13,6,15,3,82,38.25543011069292,-109.4068515
33060,3,41,12,5,15,5,81,38.25543011069292,-109.406582
33061,3,43,13,5,15,5,84,38.25543011069292,-109.4063125
33062,4,46,13,7,16,3,89,38.25543011069292,-109.406043
33063,4,48,14,8,16,2,92,38.25543011069292,-109.4057735
33064,4,50,13,7,17,2,93,38.25543011069292,-109.405504
33065,2,50,11,2,15,6,86,38.25543011069292,-109.4052345
33066,2,50,11,0,14,8,85,38.25543011069292,-109.4049651
33067,2,48,11,1,17,7,86,38.25543011069292,-109.4046956
33068,2,42,12,1,15,10,82,38.25543011069292,-109.4044261
33069,2,41,13,3,16,9,84,38.25543011069292,-109.4041566
33070,2,36,12,2,14,11,77,38.25543011069292,-109.4038871
33071,2,36,12,2,13,10,75,38.25543011069292,-109.4036176
33072,3,42,11,1,16,7,80,38.25543011069292,-109.4033481
33073,2,45,12,0,16,9,84,38.25543011069292,-109.4030786
33074,1,45,12,0,13,12,83,38.25543011069292,-109.4028091
33075,1,45,10,0,13,11,80,38.25543011069292,-109.4025396
33076,1,47,9,0,13,7,77,38.25543011069292,-109.4022701
33077,1,50,8,0,12,6,77,38.25543011069292,-109.4020006
33078,1,55,8,0,13,5,82,38.25543011069292,-109.4017311
33079,0,46,9,0,12,7,74,38.25543011069292,-109.4014616
33080,0,42,9,0,11,9,71,38.25543011069292,-109.4011921
33081,1,43,9,0,12,9,74,38.25543011069292,-109.4009226
33082,1,42,10,0,13,7,73,38.25543011069292,-109.4006531
33083,1,39,10,1,11,8,70,38.25543011069292,-109.4003836
33084,2,36,9,2,8,6,63,38.25543011069292,-109.4001142
33085,2,36,9,3,8,6,64,38.25543011069292,-109.3998447
33086,2,38,9,4,8,6,67,38.25543011069292,-109.3995752
33087,1,38,9,1,7,10,66,38.25543011069292,-109.3993057
33088,3,40,9,4,9,5,70,38.25543011069292,-109.3990362
33089,1,40,9,1,7,9,67,38.25543011069292,-109.3987667
33090,0,37,9,1,7,10,64,38.25543011069292,-109.3984972
33091,2,36,8,3,7,8,64,38.25543011069292,-109.3982277
33092,4,37,8,6,9,3,67,38.25543011069292,-109.3979582
33093,3,32,10,4,9,7,65,38.25543011069292,-109.3976887
33094,3,38,10,3,12,7,73,38.25543011069292,-109.3974192
33095,3,44,11,4,14,5,81,38.25543011069292,-109.3971497
33096,3,43,12,4,15,5,82,38.25543011069292,-109.3968802
33097,4,41,12,2,13,9,81,38.25543011069292,-109.3966107
33098,3,38,11,2,13,8,75,38.25543011069292,-109.3963412
33099,4,38,12,2,13,8,77,38.25543011069292,-109.3960717
33100,4,38,12,2,13,8,77,38.25543011069292,-109.3958022
33101,2,34,11,2,11,10,70,38.25543011069292,-109.3955327
33102,1,29,11,1,8,12,62,38.25543011069292,-109.3952632
33103,3,31,10,2,9,10,65,38.25543011069292,-109.3949938
33104,2,32,10,3,9,9,65,38.25543011069292,-109.3947243
33105,1,33,10,3,9,10,66,38.25543011069292,-109.3944548
33106,3,40,11,3,13,6,76,38.25543011069292,-109.3941853
33107,2,39,11,4,14,5,75,38.25543011069292,-109.3939158
33108,2,41,11,4,14,5,77,38.25543011069292,-109.3936463
33109,2,43,11,3,14,5,78,38.25543011069292,-109.3933768
33110,2,45,11,1,14,6,79,38.25543011069292,-109.3931073
33111,3,47,12,2,15,7,86,38.25543011069292,-109.3928378
33112,3,49,13,4,18,4,91,38.25543011069292,-109.3925683
33113,3,48,13,5,19,3,91,38.25543011069292,-109.3922988
33114,3,43,12,2,16,6,82,38.25543011069292,-109.3920293
33115,2,38,11,2,14,7,74,38.25543011069292,-109.3917598
33116,1,33,11,3,10,9,67,38.25543011069292,-109.3914903
33117,2,33,11,4,9,8,67,38.25543011069292,-109.3912208
33118,3,28,11,8,10,6,66,38.25543011069292,-109.3909513
33119,4,23,10,7,10,6,60,38.25543011069292,-109.3906818
33120,1,35,10,2,11,9,68,38.25543011069292,-109.3904123
33121,1,33,10,2,8,10,64,38.25543011069292,-109.3901429
33122,2,32,11,2,7,10,64,38.25543011069292,-109.3898734
33123,2,32,11,2,7,9,63,38.25543011069292,-109.3896039
33124,2,34,10,3,8,8,65,38.25543011069292,-109.3893344
33125,2,35,9,3,10,7,66,38.25543011069292,-109.3890649
33126,2,32,10,3,10,7,64,38.25543011069292,-109.3887954
33127,2,30,9,4,8,6,59,38.25543011069292,-109.3885259
33128,2,30,9,4,8,6,59,38.25543011069292,-109.3882564
33129,2,28,9,4,9,6,58,38.25543011069292,-109.3879869
33130,6,34,8,7,8,4,67,38.25543011069292,-109.3877174
33131,5,32,9,9,5,6,66,38.25543011069292,-109.3874479
33132,9,35,11,9,5,4,73,38.25543011069292,-109.3871784
33133,3,37,9,6,10,4,69,38.25543011069292,-109.3869089
33134,3,43,9,7,10,2,74,38.25543011069292,-109.3866394
33135,3,45,10,8,12,2,80,38.25543011069292,-109.3863699
33136,2,40,10,5,14,4,75,38.25543011069292,-109.3861004
33137,3,34,11,5,12,7,72,38.25543011069292,-109.3858309
33138,6,38,11,9,13,3,80,38.25543011069292,-109.3855614
33139,6,35,11,9,12,5,78,38.25543011069292,-109.3852919
33140,11,34,12,9,12,3,81,38.25543011069292,-109.3850225
33141,10,35,12,8,11,4,80,38.25543011069292,-109.384753
33142,8,36,11,9,11,3,78,38.25543011069292,-109.3844835
33143,7,39,9,7,10,3,75,38.25543011069292,-109.384214
33144,4,42,8,6,11,3,74,38.25543011069292,-109.3839445
33145,10,43,11,8,11,1,84,38.25543011069292,-109.383675
33146,12,44,13,9,11,1,90,38.25543011069292,-109.3834055
33147,9,45,13,9,10,2,88,38.25543011069292,-109.383136
33148,5,43,10,6,11,3,78,38.25543011069292,-109.3828665
33149,8,40,10,6,10,3,77,38.25543011069292,-109.382597
33150,8,38,12,8,13,2,81,38.25543011069292,-109.3823275
33151,9,39,13,10,15,1,87,38.25543011069292,-109.382058
33152,5,36,12,6,14,5,78,38.25543011069292,-109.3817885
33153,6,30,11,7,10,8,72,38.25543011069292,-109.381519
33154,5,25,10,15,15,2,72,38.25543011069292,-109.3812495
33155,3,26,10,10,16,3,68,38.25543011069292,-109.38098
33156,3,30,10,4,15,6,68,38.25543011069292,-109.3807105
33157,3,35,11,0,13,11,73,38.25543011069292,-109.380441
33158,7,36,12,3,12,7,77,38.25543011069292,-109.3801716
33159,12,36,13,9,14,2,86,38.25543011069292,-109.3799021
33160,12,36,13,10,15,2,88,38.25543011069292,-109.3796326
33161,15,35,13,11,15,1,90,38.25543011069292,-109.3793631
33162,17,34,13,13,13,0,90,38.25543011069292,-109.3790936
33163,14,35,13,12,13,1,88,38.25543011069292,-109.3788241
33164,11,36,13,11,13,2,86,38.25543011069292,-109.3785546
33165,10,37,13,10,14,2,86,38.25543011069292,-109.3782851
33166,8,37,12,8,14,3,82,38.25543011069292,-109.3780156
33167,9,36,12,9,13,3,82,38.25543011069292,-109.3777461
33168,13,33,12,11,13,2,84,38.25543011069292,-109.3774766
33169,16,33,13,12,12,1,87,38.25543011069292,-109.3772071
33170,15,36,13,12,12,1,89,38.25543011069292,-109.3769376
33171,11,36,12,11,13,1,84,38.25543011069292,-109.3766681
33172,13,36,13,12,13,1,88,38.25543011069292,-109.3763986
33173,12,36,13,10,14,2,87,38.25543011069292,-109.3761291
33174,12,37,13,10,14,2,88,38.25543011069292,-109.3758596
33175,12,41,13,9,13,2,90,38.25543011069292,-109.3755901
33176,10,43,13,8,14,1,89,38.25543011069292,-109.3753206
33177,9,44,12,6,14,3,88,38.25543011069292,-109.3750512
33178,9,43,12,5,13,4,86,38.25543011069292,-109.3747817
33179,8,42,12,4,13,5,84,38.25543011069292,-109.3745122
33180,7,41,12,5,13,6,84,38.25543011069292,-109.3742427
33181,6,40,12,4,13,7,82,38.25543011069292,-109.3739732
33182,7,40,12,5,13,6,83,38.25543011069292,-109.3737037
33183,7,37,13,6,13,6,82,38.25543011069292,-109.3734342
33184,7,37,13,5,13,7,82,38.25543011069292,-109.3731647
33185,7,41,13,3,12,8,84,38.25543011069292,-109.3728952
33186,8,35,14,1,7,16,81,38.25543011069292,-109.3726257
33187,6,32,14,1,5,19,77,38.25543011069292,-109.3723562
33188,4,32,14,0,5,20,75,38.25543011069292,-109.3720867
33189,3,31,14,0,5,21,74,38.25543011069292,-109.3718172
33190,4,28,16,0,3,25,76,38.25543011069292,-109.3715477
33191,7,29,17,2,2,25,82,38.25543011069292,-109.3712782
33192,4,27,16,1,3,25,76,38.25543011069292,-109.3710087
33193,3,27,15,0,3,24,72,38.25543011069292,-109.3707392
33194,3,27,14,0,4,21,69,38.25543011069292,-109.3704697
33195,3,29,12,0,7,16,67,38.25543011069292,-109.3702003
33196,4,34,12,1,10,12,73,38.25543011069292,-109.3699308
33197,3,34,12,2,10,11,72,38.25543011069292,-109.3696613
33198,4,31,12,3,8,12,70,38.25543011069292,-109.3693918
33199,5,31,12,2,7,13,70,38.25543011069292,-109.3691223
33200,3,31,11,2,7,13,67,38.25543011069292,-109.3688528
33201,2,34,12,1,8,13,70,38.25543011069292,-109.3685833
33202,2,37,10,1,11,9,70,38.25543011069292,-109.3683138
33203,2,43,9,2,13,4,73,38.25543011069292,-109.3680443
33204,1,40,10,3,13,5,72,38.25543011069292,-109.3677748
33205,1,32,9,6,11,5,64,38.25543011069292,-109.3675053
33206,1,22,10,10,12,4,59,38.25543011069292,-109.3672358
33207,3,16,9,14,13,2,57,38.25543011069292,-109.3669663
33208,3,14,10,15,12,3,57,38.25543011069292,-109.3666968
33209,4,19,10,15,16,2,66,38.25543011069292,-109.3664273
33210,2,23,12,11,14,9,71,38.25543011069292,-109.3661578
33211,1,25,14,6,11,15,72,38.25543011069292,-109.3658883
33212,1,24,15,5,9,20,74,38.25543011069292,-109.3656188
33213,1,27,16,2,8,23,77,38.25543011069292,-109.3653493
33214,0,27,18,0,7,25,77,38.25543011069292,-109.3650799
33215,0,28,19,0,5,27,79,38.25543011069292,-109.3648104
33216,1,27,19,0,5,28,80,38.25543011069292,-109.3645409
33217,1,26,19,0,4,31,81,38.25543011069292,-109.3642714
33218,1,23,17,0,2,31,74,38.25543011069292,-109.3640019
33219,1,23,15,0,1,29,69,38.25543011069292,-109.3637324
33220,1,22,13,0,1,25,62,38.25543011069292,-109.3634629
33221,1,22,13,0,2,23,61,38.25543011069292,-109.3631934
33222,1,22,14,0,2,24,63,38.25543011069292,-109.3629239
33223,1,22,16,0,1,28,68,38.25543011069292,-109.3626544
33224,1,21,16,0,2,28,68,38.25543011069292,-109.3623849
33225,1,22,15,0,2,27,67,38.25543011069292,-109.3621154
33226,1,23,13,0,2,24,63,38.25543011069292,-109.3618459
33227,0,23,12,0,3,22,60,38.25543011069292,-109.3615764
33228,0,22,13,0,2,26,63,38.25543011069292,-109.3613069
33229,0,22,13,0,1,27,63,38.25543011069292,-109.3610374
33230,1,22,14,0,0,28,65,38.25543011069292,-109.3607679
33231,1,23,16,0,0,29,69,38.25543011069292,-109.3604984
33232,1,24,17,0,0,30,72,38.25543011069292,-109.360229
33233,1,22,18,0,1,32,74,38.25543011069292,-109.3599595
33234,0,23,18,0,2,33,76,38.25543011069292,-109.35969
33235,0,25,18,0,3,32,78,38.25543011069292,-109.3594205
33236,1,27,18,1,7,28,82,38.25543011069292,-109.359151
33237,1,31,18,6,7,23,86,38.25543011069292,-109.3588815
33238,2,26,20,3,5,27,83,38.25543011069292,-109.358612
33239,1,28,19,0,9,26,83,38.25543011069292,-109.3583425
33240,0,28,19,0,7,29,83,38.25543011069292,-109.358073
33241,1,29,18,1,7,27,83,38.25543011069292,-109.3578035
33242,1,30,18,1,7,26,83,38.25543011069292,-109.357534
33243,2,28,18,2,9,24,83,38.25543011069292,-109.3572645
33244,2,25,18,3,6,26,80,38.25543011069292,-109.356995
33245,1,25,19,3,7,24,79,38.25543011069292,-109.3567255
33246,2,23,19,4,7,22,77,38.25543011069292,-109.356456
33247,2,31,15,13,7,13,81,38.25543011069292,-109.3561865
33248,1,31,15,14,8,15,84,38.25543011069292,-109.355917
33249,1,27,17,11,15,9,80,38.25543011069292,-109.3556475
33250,5,24,15,17,20,5,86,38.25543011069292,-109.355378
33251,6,18,14,23,20,4,85,38.25543011069292,-109.3551086
33252,2,19,15,14,15,12,77,38.25543011069292,-109.3548391
33253,1,17,16,13,12,15,74,38.25543011069292,-109.3545696
33254,1,22,15,9,15,14,76,38.25543011069292,-109.3543001
33255,2,23,16,5,6,25,77,38.25543011069292,-109.3540306
33256,3,22,18,0,1,32,76,38.25543011069292,-109.3537611
33257,1,18,18,0,2,34,73,38.25543011069292,-109.3534916
33258,1,18,18,0,1,33,71,38.25543011069292,-109.3532221
33259,2,19,17,0,1,31,70,38.25543011069292,-109.3529526
33260,1,20,15,1,1,28,66,38.25543011069292,-109.3526831
33261,1,23,14,2,2,25,67,38.25543011069292,-109.3524136
33262,1,22,14,1,2,25,65,38.25543011069292,-109.3521441
33263,1,19,13,0,1,24,58,38.25543011069292,-109.3518746
33264,3,18,11,0,2,20,54,38.25543011069292,-109.3516051
33265,3,25,10,1,2,17,58,38.25543011069292,-109.3513356
33266,1,23,10,4,6,13,57,38.25543011069292,-109.3510661
33267,2,27,8,3,7,10,57,38.25543011069292,-109.3507966
33268,4,33,7,3,9,6,62,38.25543011069292,-109.3505271
33269,4,32,7,6,8,3,60,38.25543011069292,-109.3502577
33270,3,25,8,3,8,7,54,38.25543011069292,-109.3499882
33271,4,27,8,2,8,8,57,38.25543011069292,-109.3497187
33272,2,24,9,4,7,9,55,38.25543011069292,-109.3494492
33273,1,19,11,3,4,16,54,38.25543011069292,-109.3491797
33274,4,11,13,2,3,19,52,38.25543011069292,-109.3489102
33275,0,15,14,1,3,23,56,38.25543011069292,-109.3486407
33276,1,16,14,2,4,21,58,38.25543011069292,-109.3483712
33277,1,16,13,4,6,17,57,38.25543011069292,-109.3481017
33278,4,26,13,5,7,15,70,38.25543011069292,-109.3478322
33279,2,24,15,1,7,20,69,38.25543011069292,-109.3475627
33280,3,23,11,2,16,8,63,38.25543011069292,-109.3472932
33281,1,23,10,4,13,12,63,38.25543011069292,-109.3470237
33282,5,30,10,5,12,9,71,38.25543011069292,-109.3467542
33283,3,25,12,7,14,9,70,38.25543011069292,-109.3464847
33284,3,27,13,3,18,7,71,38.25543011069292,-109.3462152
33285,4,15,12,9,7,12,59,38.25543011069292,-109.3459457
33286,6,23,10,4,7,9,59,38.25543011069292,-109.3456762
33287,4,23,8,5,8,7,55,38.25543011069292,-109.3454068
33288,4,26,7,4,8,6,55,38.25543011069292,-109.3451373
33289,3,33,7,4,10,5,62,38.25543011069292,-109.3448678
33290,4,31,9,5,9,7,65,38.25543011069292,-109.3445983
33291,4,22,10,4,6,10,56,38.25543011069292,-109.3443288
33292,5,12,13,3,5,15,53,38.25543011069292,-109.3440593
33293,2,7,13,4,4,21,51,38.25543011069292,-109.3437898
33294,1,13,16,0,2,29,61,38.25543011069292,-109.3435203
33295,1,14,18,0,1,33,67,38.25543011069292,-109.3432508
33296,1,12,20,0,0,35,68,38.25543011069292,-109.3429813
33297,0,14,21,0,1,36,72,38.25543011069292,-109.3427118
33298,1,16,19,0,0,34,70,38.25543011069292,-109.3424423
33299,0,17,18,0,0,32,67,38.25543011069292,-109.3421728
33300,0,17,17,0,0,31,65,38.25543011069292,-109.3419033
33301,1,20,18,0,1,32,72,38.25543011069292,-109.3416338
33302,1,22,20,2,4,31,80,38.25543011069292,-109.3413643
33303,1,22,18,0,3,32,76,38.25543011069292,-109.3410948
33304,0,23,18,0,2,31,74,38.25543011069292,-109.3408253
33305,1,26,18,0,1,29,75,38.25543011069292,-109.3405558
33306,1,22,17,1,4,21,66,38.25543011069292,-109.3402864
33307,1,20,14,1,2,18,56,38.25543011069292,-109.3400169
33308,1,14,15,3,3,23,59,38.25543011069292,-109.3397474
33309,0,15,15,0,2,26,58,38.25543011069292,-109.3394779
33310,0,19,14,0,2,24,59,38.25543011069292,-109.3392084
33311,1,27,9,2,6,12,57,38.25543011069292,-109.3389389
33312,0,38,8,1,11,6,64,38.25543011069292,-109.3386694
33313,0,43,7,0,11,5,66,38.25543011069292,-109.3383999
33314,1,47,7,2,11,4,72,38.25543011069292,-109.3381304
33315,1,44,7,2,10,5,69,38.25543011069292,-109.3378609
33316,0,41,8,1,10,8,68,38.25543011069292,-109.3375914
33317,1,38,9,4,12,6,70,38.25543011069292,-109.3373219
33318,2,37,11,3,14,8,75,38.25543011069292,-109.3370524
33319,1,29,12,3,10,14,69,38.25543011069292,-109.3367829
33320,1,20,14,1,3,23,62,38.25543011069292,-109.3365134
33321,2,20,14,1,3,23,63,38.25543011069292,-109.3362439
33322,1,18,15,1,3,26,64,38.25543011069292,-109.3359744
33323,1,17,16,1,2,27,64,38.25543011069292,-109.3357049
33324,1,18,15,1,2,26,63,38.25543011069292,-109.3354355
33325,1,23,13,1,4,20,62,38.25543011069292,-109.335166
33326,5,27,11,7,10,7,67,38.25543011069292,-109.3348965
33327,2,16,12,7,9,11,57,38.25543011069292,-109.334627
33328,3,12,14,10,8,15,62,38.25543011069292,-109.3343575
33329,4,15,13,10,10,16,68,38.25543011069292,-109.334088
33330,6,14,13,9,10,15,67,38.25543011069292,-109.3338185
33331,5,22,12,8,15,8,70,38.25543011069292,-109.333549
33332,1,27,12,0,7,17,64,38.25543011069292,-109.3332795
33333,1,29,10,0,9,13,62,38.25543011069292,-109.33301
33334,1,40,9,0,15,7,72,38.25543011069292,-109.3327405
33335,1,44,8,0,15,6,74,38.25543011069292,-109.332471
33336,0,37,9,1,11,10,68,38.25543011069292,-109.3322015
33337,0,36,9,1,10,9,65,38.25543011069292,-109.331932
33338,4,52,13,5,19,1,94,38.25516061610769,-109.4445808
33339,4,52,12,5,18,2,93,38.25516061610769,-109.4443113
33340,4,52,12,5,17,2,92,38.25516061610769,-109.4440418
33341,4,51,12,6,16,2,91,38.25516061610769,-109.4437723
33342,4,52,11,6,16,3,92,38.25516061610769,-109.4435028
33343,4,52,11,6,15,3,91,38.25516061610769,-109.4432333
33344,5,50,11,6,14,3,89,38.25516061610769,-109.4429638
33345,4,52,11,7,14,3,91,38.25516061610769,-109.4426943
33346,3,53,11,5,14,4,90,38.25516061610769,-109.4424248
33347,2,52,10,3,14,5,86,38.25516061610769,-109.4421553
33348,3,49,11,3,14,6,86,38.25516061610769,-109.4418858
33349,2,45,10,0,10,10,77,38.25516061610769,-109.4416163
33350,2,43,10,0,11,9,75,38.25516061610769,-109.4413468
33351,2,45,9,2,14,5,77,38.25516061610769,-109.4410773
33352,2,53,10,4,14,3,86,38.25516061610769,-109.4408078
33353,3,50,10,6,12,4,85,38.25516061610769,-109.4405383
33354,3,46,11,7,13,4,84,38.25516061610769,-109.4402688
33355,3,48,11,6,12,5,85,38.25516061610769,-109.4399993
33356,2,51,9,3,12,6,83,38.25516061610769,-109.4397299
33357,1,50,8,2,11,7,79,38.25516061610769,-109.4394604
33358,1,51,9,1,13,7,82,38.25516061610769,-109.4391909
33359,1,46,9,0,13,7,76,38.25516061610769,-109.4389214
33360,1,44,9,0,12,7,73,38.25516061610769,-109.4386519
33361,1,46,8,0,11,6,72,38.25516061610769,-109.4383824
33362,2,46,8,1,11,6,74,38.25516061610769,-109.4381129
33363,3,47,9,4,12,4,79,38.25516061610769,-109.4378434
33364,3,48,9,4,13,4,81,38.25516061610769,-109.4375739
33365,2,47,9,0,13,6,77,38.25516061610769,-109.4373044
33366,2,38,10,0,11,10,71,38.25516061610769,-109.4370349
33367,2,28,9,2,8,10,59,38.25516061610769,-109.4367654
33368,3,31,9,3,8,8,62,38.25516061610769,-109.4364959
33369,2,31,10,1,9,10,63,38.25516061610769,-109.4362264
33370,1,35,10,0,10,12,68,38.25516061610769,-109.4359569
33371,3,44,10,2,13,6,78,38.25516061610769,-109.4356874
33372,3,46,10,3,15,3,80,38.25516061610769,-109.4354179
33373,3,45,10,2,14,5,79,38.25516061610769,-109.4351484
33374,3,41,10,0,12,7,73,38.25516061610769,-109.434879
33375,2,35,9,0,10,9,65,38.25516061610769,-109.4346095
33376,3,35,9,3,10,7,67,38.25516061610769,-109.43434
33377,2,44,9,1,15,4,75,38.25516061610769,-109.4340705
33378,2,45,10,1,17,4,79,38.25516061610769,-109.433801
33379,5,42,11,6,17,2,83,38.25516061610769,-109.4335315
33380,13,39,14,12,14,0,92,38.25516061610769,-109.433262
33381,13,40,15,12,14,0,94,38.25516061610769,-109.4329925
33382,14,38,15,12,14,0,93,38.25516061610769,-109.432723
33383,16,36,15,13,13,0,93,38.25516061610769,-109.4324535
33384,19,34,15,13,12,0,93,38.25516061610769,-109.432184
33385,17,35,15,13,13,0,93,38.25516061610769,-109.4319145
33386,16,37,15,12,13,0,93,38.25516061610769,-109.431645
33387,15,38,15,12,13,0,93,38.25516061610769,-109.4313755
33388,14,38,15,13,12,0,92,38.25516061610769,-109.431106
33389,14,38,15,13,12,0,92,38.25516061610769,-109.4308365
33390,11,40,15,14,13,0,93,38.25516061610769,-109.430567
33391,11,41,14,13,13,0,92,38.25516061610769,-109.4302975
33392,12,41,14,12,13,0,92,38.25516061610769,-109.430028
33393,10,40,13,11,14,0,88,38.25516061610769,-109.4297586
33394,7,42,13,10,15,1,88,38.25516061610769,-109.4294891
33395,7,44,13,9,15,1,89,38.25516061610769,-109.4292196
33396,8,46,13,10,14,0,91,38.25516061610769,-109.4289501
33397,6,52,12,8,15,0,93,38.25516061610769,-109.4286806
33398,4,55,11,7,16,0,93,38.25516061610769,-109.4284111
33399,8,49,12,9,16,0,94,38.25516061610769,-109.4281416
33400,10,45,13,10,16,0,94,38.25516061610769,-109.4278721
33401,8,47,12,9,16,0,92,38.25516061610769,-109.4276026
33402,5,50,11,8,15,0,89,38.25516061610769,-109.4273331
33403,6,52,11,8,14,0,91,38.25516061610769,-109.4270636
33404,14,39,13,11,14,0,91,38.25516061610769,-109.4267941
33405,17,34,13,11,14,0,89,38.25516061610769,-109.4265246
33406,18,33,14,13,14,0,92,38.25516061610769,-109.4262551
33407,18,32,14,14,13,0,91,38.25516061610769,-109.4259856
33408,18,32,14,15,12,0,91,38.25516061610769,-109.4257161
33409,17,34,14,15,12,0,92,38.25516061610769,-109.4254466
33410,17,34,14,14,12,0,91,38.25516061610769,-109.4251771
33411,16,35,14,14,12,0,91,38.25516061610769,-109.4249077
33412,16,35,14,14,12,0,91,38.25516061610769,-109.4246382
33413,21,33,14,12,12,0,92,38.25516061610769,-109.4243687
33414,21,33,14,12,12,0,92,38.25516061610769,-109.4240992
33415,22,32,13,11,12,0,90,38.25516061610769,-109.4238297
33416,20,32,13,12,13,0,90,38.25516061610769,-109.4235602
33417,17,32,14,13,13,0,89,38.25516061610769,-109.4232907
33418,16,31,14,15,13,1,90,38.25516061610769,-109.4230212
33419,15,34,14,14,13,1,91,38.25516061610769,-109.4227517
33420,14,36,14,13,13,1,91,38.25516061610769,-109.4224822
33421,11,38,13,12,14,1,89,38.25516061610769,-109.4222127
33422,8,42,11,10,15,1,87,38.25516061610769,-109.4219432
33423,8,45,10,9,14,1,87,38.25516061610769,-109.4216737
33424,10,42,13,11,14,0,90,38.25516061610769,-109.4214042
33425,10,40,14,13,13,0,90,38.25516061610769,-109.4211347
33426,10,41,14,12,13,0,90,38.25516061610769,-109.4208652
33427,18,34,13,12,13,0,90,38.25516061610769,-109.4205957
33428,20,33,14,11,12,0,90,38.25516061610769,-109.4203262
33429,18,35,14,10,13,0,90,38.25516061610769,-109.4200568
33430,14,38,13,10,14,1,90,38.25516061610769,-109.4197873
33431,11,39,13,10,15,1,89,38.25516061610769,-109.4195178
33432,13,38,13,10,13,1,88,38.25516061610769,-109.4192483
33433,14,38,14,13,13,0,92,38.25516061610769,-109.4189788
33434,13,38,14,12,13,1,91,38.25516061610769,-109.4187093
33435,11,40,13,8,14,1,87,38.25516061610769,-109.4184398
33436,8,41,12,7,15,2,85,38.25516061610769,-109.4181703
33437,6,44,12,6,15,2,85,38.25516061610769,-109.4179008
33438,5,48,11,6,15,2,87,38.25516061610769,-109.4176313
33439,3,50,10,4,14,3,84,38.25516061610769,-109.4173618
33440,3,48,10,3,14,3,81,38.25516061610769,-109.4170923
33441,3,47,10,2,14,4,80,38.25516061610769,-109.4168228
33442,3,51,10,2,14,3,83,38.25516061610769,-109.4165533
33443,3,52,10,2,15,3,85,38.25516061610769,-109.4162838
33444,3,49,10,2,15,3,82,38.25516061610769,-109.4160143
33445,3,41,10,1,14,6,75,38.25516061610769,-109.4157448
33446,7,36,11,3,16,5,78,38.25516061610769,-109.4154753
33447,11,34,12,8,16,2,83,38.25516061610769,-109.4152058
33448,16,34,13,11,14,1,89,38.25516061610769,-109.4149364
33449,17,33,14,12,14,1,91,38.25516061610769,-109.4146669
33450,15,33,14,14,14,1,91,38.25516061610769,-109.4143974
33451,13,34,14,14,14,1,90,38.25516061610769,-109.4141279
33452,12,34,14,15,14,1,90,38.25516061610769,-109.4138584
33453,11,36,14,13,14,1,89,38.25516061610769,-109.4135889
33454,11,37,14,12,14,1,89,38.25516061610769,-109.4133194
33455,15,32,14,13,14,1,89,38.25516061610769,-109.4130499
33456,18,31,14,13,14,1,91,38.25516061610769,-109.4127804
33457,18,32,14,13,14,0,91,38.25516061610769,-109.4125109
33458,15,34,14,13,15,1,92,38.25516061610769,-109.4122414
33459,10,38,14,12,15,1,90,38.25516061610769,-109.4119719
33460,7,39,13,9,15,2,85,38.25516061610769,-109.4117024
33461,6,42,13,8,15,2,86,38.25516061610769,-109.4114329
33462,3,44,12,6,15,3,83,38.25516061610769,-109.4111634
33463,2,44,11,4,16,4,81,38.25516061610769,-109.4108939
33464,2,43,11,3,16,5,80,38.25516061610769,-109.4106244
33465,2,48,10,1,16,4,81,38.25516061610769,-109.4103549
33466,1,45,9,0,14,6,75,38.25516061610769,-109.4100855
33467,1,42,8,3,12,4,70,38.25516061610769,-109.409816
33468,3,42,7,4,9,2,67,38.25516061610769,-109.4095465
33469,3,39,6,4,8,3,63,38.25516061610769,-109.409277
33470,2,40,6,4,8,3,63,38.25516061610769,-109.4090075
33471,2,35,8,4,9,4,62,38.25516061610769,-109.408738
33472,2,31,9,4,9,6,61,38.25516061610769,-109.4084685
33473,2,32,10,4,8,7,63,38.25516061610769,-109.408199
33474,3,33,11,4,10,7,68,38.25516061610769,-109.4079295
33475,2,34,11,3,10,8,68,38.25516061610769,-109.40766
33476,2,36,11,3,12,7,71,38.25516061610769,-109.4073905
33477,3,39,11,4,12,4,73,38.25516061610769,-109.407121
33478,4,44,11,6,13,3,81,38.25516061610769,-109.4068515
33479,4,46,13,6,15,3,87,38.25516061610769,-109.406582
33480,3,44,13,6,17,4,87,38.25516061610769,-109.4063125
33481,4,45,14,7,18,3,91,38.25516061610769,-109.406043
33482,4,48,13,7,17,2,91,38.25516061610769,-109.4057735
33483,3,50,13,5,16,3,90,38.25516061610769,-109.405504
33484,3,51,12,4,15,3,88,38.25516061610769,-109.4052345
33485,3,49,11,2,16,4,85,38.25516061610769,-109.4049651
33486,3,45,11,1,16,6,82,38.25516061610769,-109.4046956
33487,2,43,12,1,17,8,83,38.25516061610769,-109.4044261
33488,3,44,12,3,18,6,86,38.25516061610769,-109.4041566
33489,2,40,12,1,16,9,80,38.25516061610769,-109.4038871
33490,2,40,12,2,16,7,79,38.25516061610769,-109.4036176
33491,4,45,12,4,18,3,86,38.25516061610769,-109.4033481
33492,4,49,12,3,17,3,88,38.25516061610769,-109.4030786
33493,2,49,11,0,16,7,85,38.25516061610769,-109.4028091
33494,2,46,10,0,13,8,79,38.25516061610769,-109.4025396
33495,3,40,9,3,11,5,71,38.25516061610769,-109.4022701
33496,3,38,9,4,10,5,69,38.25516061610769,-109.4020006
33497,4,39,9,6,10,3,71,38.25516061610769,-109.4017311
33498,2,37,9,3,9,7,67,38.25516061610769,-109.4014616
33499,2,38,8,2,7,7,64,38.25516061610769,-109.4011921
33500,2,42,7,3,6,5,65,38.25516061610769,-109.4009226
33501,2,43,7,4,6,4,66,38.25516061610769,-109.4006531
33502,1,41,7,4,7,4,64,38.25516061610769,-109.4003836
33503,1,38,7,3,5,6,60,38.25516061610769,-109.4001142
33504,2,37,9,4,8,6,66,38.25516061610769,-109.3998447
33505,2,40,11,1,10,9,73,38.25516061610769,-109.3995752
33506,0,35,10,0,7,15,67,38.25516061610769,-109.3993057
33507,2,36,11,1,10,9,69,38.25516061610769,-109.3990362
33508,1,35,9,1,7,11,64,38.25516061610769,-109.3987667
33509,1,38,8,0,7,10,64,38.25516061610769,-109.3984972
33510,1,42,8,1,6,8,66,38.25516061610769,-109.3982277
33511,4,46,7,3,7,4,71,38.25516061610769,-109.3979582
33512,2,38,9,3,10,7,69,38.25516061610769,-109.3976887
33513,1,37,10,2,11,9,70,38.25516061610769,-109.3974192
33514,2,40,11,3,13,7,76,38.25516061610769,-109.3971497
33515,4,42,12,6,15,4,83,38.25516061610769,-109.3968802
33516,4,41,12,1,12,10,80,38.25516061610769,-109.3966107
33517,2,39,11,0,12,11,75,38.25516061610769,-109.3963412
33518,3,37,11,0,11,12,74,38.25516061610769,-109.3960717
33519,3,36,11,0,10,13,73,38.25516061610769,-109.3958022
33520,2,34,11,0,10,13,70,38.25516061610769,-109.3955327
33521,1,31,11,2,9,14,68,38.25516061610769,-109.3952632
33522,1,30,11,2,10,13,67,38.25516061610769,-109.3949938
33523,1,30,11,2,10,11,65,38.25516061610769,-109.3947243
33524,1,34,11,2,11,10,69,38.25516061610769,-109.3944548
33525,3,40,11,3,13,7,77,38.25516061610769,-109.3941853
33526,1,37,10,0,11,9,68,38.25516061610769,-109.3939158
33527,2,39,11,2,12,8,74,38.25516061610769,-109.3936463
33528,2,43,11,2,14,6,78,38.25516061610769,-109.3933768
33529,3,48,11,1,14,6,83,38.25516061610769,-109.3931073
33530,3,50,12,1,15,7,88,38.25516061610769,-109.3928378
33531,3,51,12,2,17,4,89,38.25516061610769,-109.3925683
33532,2,49,11,1,14,6,83,38.25516061610769,-109.3922988
33533,2,46,10,1,14,5,78,38.25516061610769,-109.3920293
33534,4,42,10,3,13,4,76,38.25516061610769,-109.3917598
33535,1,35,10,2,8,9,65,38.25516061610769,-109.3914903
33536,3,35,10,5,10,5,68,38.25516061610769,-109.3912208
33537,2,29,10,8,10,6,65,38.25516061610769,-109.3909513
33538,2,24,10,10,11,6,63,38.25516061610769,-109.3906818
33539,2,31,9,7,12,4,65,38.25516061610769,-109.3904123
33540,2,30,9,5,9,6,61,38.25516061610769,-109.3901429
33541,3,29,8,5,8,7,60,38.25516061610769,-109.3898734
33542,3,29,7,5,8,7,59,38.25516061610769,-109.3896039
33543,2,32,6,5,8,6,59,38.25516061610769,-109.3893344
33544,2,32,8,4,8,5,59,38.25516061610769,-109.3890649
33545,2,34,8,4,8,4,60,38.25516061610769,-109.3887954
33546,2,34,8,5,8,4,61,38.25516061610769,-109.3885259
33547,2,31,8,5,7,5,58,38.25516061610769,-109.3882564
33548,2,29,10,5,9,6,61,38.25516061610769,-109.3879869
33549,6,31,12,12,6,6,73,38.25516061610769,-109.3877174
33550,4,31,11,10,6,7,69,38.25516061610769,-109.3874479
33551,5,35,10,8,5,5,68,38.25516061610769,-109.3871784
33552,3,32,8,5,9,6,63,38.25516061610769,-109.3869089
33553,3,35,8,4,10,5,65,38.25516061610769,-109.3866394
33554,4,41,10,7,13,2,77,38.25516061610769,-109.3863699
33555,3,42,10,6,14,3,78,38.25516061610769,-109.3861004
33556,3,41,10,7,15,3,79,38.25516061610769,-109.3858309
33557,6,41,11,9,14,2,83,38.25516061610769,-109.3855614
33558,7,38,12,10,13,3,83,38.25516061610769,-109.3852919
33559,13,37,13,13,11,1,88,38.25516061610769,-109.3850225
33560,6,43,11,10,11,2,83,38.25516061610769,-109.384753
33561,2,48,8,5,12,3,78,38.25516061610769,-109.3844835
33562,4,45,8,6,11,3,77,38.25516061610769,-109.384214
33563,7,40,9,9,11,3,79,38.25516061610769,-109.3839445
33564,10,41,12,11,11,1,86,38.25516061610769,-109.383675
33565,7,49,11,8,11,2,88,38.25516061610769,-109.3834055
33566,4,55,10,5,11,2,87,38.25516061610769,-109.383136
33567,2,49,9,3,11,4,78,38.25516061610769,-109.3828665
33568,6,44,11,6,14,2,83,38.25516061610769,-109.382597
33569,5,38,12,7,15,4,81,38.25516061610769,-109.3823275
33570,6,39,12,8,14,4,83,38.25516061610769,-109.382058
33571,8,36,12,7,14,4,81,38.25516061610769,-109.3817885
33572,4,25,10,8,11,4,62,38.25516061610769,-109.381519
33573,4,25,10,13,14,1,67,38.25516061610769,-109.3812495
33574,2,27,10,6,15,5,65,38.25516061610769,-109.38098
33575,3,33,12,6,14,6,74,38.25516061610769,-109.3807105
33576,8,35,12,10,16,2,83,38.25516061610769,-109.380441
33577,14,37,13,11,14,0,89,38.25516061610769,-109.3801716
33578,17,35,14,12,13,0,91,38.25516061610769,-109.3799021
33579,17,35,14,13,13,0,92,38.25516061610769,-109.3796326
33580,16,35,13,13,12,0,89,38.25516061610769,-109.3793631
33581,15,36,13,12,12,0,88,38.25516061610769,-109.3790936
33582,15,37,13,12,12,0,89,38.25516061610769,-109.3788241
33583,13,38,13,12,13,0,89,38.25516061610769,-109.3785546
33584,12,37,13,13,13,1,89,38.25516061610769,-109.3782851
33585,11,38,14,13,13,1,90,38.25516061610769,-109.3780156
33586,13,38,13,11,13,0,88,38.25516061610769,-109.3777461
33587,15,36,13,14,11,0,89,38.25516061610769,-109.3774766
33588,16,35,13,14,11,1,90,38.25516061610769,-109.3772071
33589,13,36,13,14,11,1,88,38.25516061610769,-109.3769376
33590,9,36,13,14,12,1,85,38.25516061610769,-109.3766681
33591,10,37,13,14,12,1,87,38.25516061610769,-109.3763986
33592,12,38,14,14,12,1,91,38.25516061610769,-109.3761291
33593,14,37,14,13,12,1,91,38.25516061610769,-109.3758596
33594,13,38,13,13,12,1,90,38.25516061610769,-109.3755901
33595,10,41,13,10,13,3,90,38.25516061610769,-109.3753206
33596,11,43,12,8,12,3,89,38.25516061610769,-109.3750512
33597,12,44,13,8,12,2,91,38.25516061610769,-109.3747817
33598,11,43,13,7,12,3,89,38.25516061610769,-109.3745122
33599,9,43,13,6,13,4,88,38.25516061610769,-109.3742427
33600,8,43,12,5,13,5,86,38.25516061610769,-109.3739732
33601,8,42,13,5,13,5,86,38.25516061610769,-109.3737037
33602,7,40,13,7,14,5,86,38.25516061610769,-109.3734342
33603,7,38,13,6,15,6,85,38.25516061610769,-109.3731647
33604,7,37,14,4,13,10,85,38.25516061610769,-109.3728952
33605,6,31,16,2,8,18,81,38.25516061610769,-109.3726257
33606,4,29,16,0,5,24,78,38.25516061610769,-109.3723562
33607,3,26,16,0,3,26,74,38.25516061610769,-109.3720867
33608,3,24,16,0,2,28,73,38.25516061610769,-109.3718172
33609,3,25,17,1,3,27,76,38.25516061610769,-109.3715477
33610,2,28,17,0,3,27,77,38.25516061610769,-109.3712782
33611,2,28,17,0,2,28,77,38.25516061610769,-109.3710087
33612,2,26,17,0,1,31,77,38.25516061610769,-109.3707392
33613,2,24,17,0,1,32,76,38.25516061610769,-109.3704697
33614,2,24,16,0,2,27,71,38.25516061610769,-109.3702003
33615,2,24,13,0,3,24,66,38.25516061610769,-109.3699308
33616,2,22,13,0,3,23,63,38.25516061610769,-109.3696613
33617,2,22,13,0,2,24,63,38.25516061610769,-109.3693918
33618,4,24,13,0,3,21,65,38.25516061610769,-109.3691223
33619,2,23,13,0,4,21,63,38.25516061610769,-109.3688528
33620,1,23,12,0,4,20,60,38.25516061610769,-109.3685833
33621,1,25,10,0,6,16,58,38.25516061610769,-109.3683138
33622,0,28,10,2,11,11,62,38.25516061610769,-109.3680443
33623,0,32,10,3,12,8,65,38.25516061610769,-109.3677748
33624,2,31,10,4,12,6,65,38.25516061610769,-109.3675053
33625,2,22,9,6,8,7,54,38.25516061610769,-109.3672358
33626,2,20,10,7,10,7,56,38.25516061610769,-109.3669663
33627,2,17,10,10,13,6,58,38.25516061610769,-109.3666968
33628,3,16,11,7,11,8,56,38.25516061610769,-109.3664273
33629,3,27,13,1,11,15,70,38.25516061610769,-109.3661578
33630,2,28,14,0,5,24,73,38.25516061610769,-109.3658883
33631,3,25,14,0,4,25,71,38.25516061610769,-109.3656188
33632,3,27,14,1,4,23,72,38.25516061610769,-109.3653493
33633,3,24,14,2,3,24,70,38.25516061610769,-109.3650799
33634,2,22,14,0,2,25,65,38.25516061610769,-109.3648104
33635,2,22,15,0,2,26,67,38.25516061610769,-109.3645409
33636,2,22,16,0,4,27,71,38.25516061610769,-109.3642714
33637,2,23,16,1,3,27,72,38.25516061610769,-109.3640019
33638,1,23,16,0,3,28,71,38.25516061610769,-109.3637324
33639,1,23,14,0,2,26,66,38.25516061610769,-109.3634629
33640,1,23,13,0,1,23,61,38.25516061610769,-109.3631934
33641,2,21,13,0,1,23,60,38.25516061610769,-109.3629239
33642,2,21,15,0,2,26,66,38.25516061610769,-109.3626544
33643,2,22,15,0,1,27,67,38.25516061610769,-109.3623849
33644,1,23,16,0,1,28,69,38.25516061610769,-109.3621154
33645,2,24,15,0,3,26,70,38.25516061610769,-109.3618459
33646,2,25,15,0,4,24,70,38.25516061610769,-109.3615764
33647,1,23,14,0,3,26,67,38.25516061610769,-109.3613069
33648,0,23,14,0,1,27,65,38.25516061610769,-109.3610374
33649,0,24,14,0,1,27,66,38.25516061610769,-109.3607679
33650,0,22,15,0,0,29,66,38.25516061610769,-109.3604984
33651,1,20,18,0,1,32,72,38.25516061610769,-109.360229
33652,1,21,18,0,1,33,74,38.25516061610769,-109.3599595
33653,1,22,17,0,1,32,73,38.25516061610769,-109.35969
33654,0,21,16,0,1,31,69,38.25516061610769,-109.3594205
33655,0,20,17,0,1,33,71,38.25516061610769,-109.359151
33656,1,21,17,0,1,30,70,38.25516061610769,-109.3588815
33657,1,22,17,0,1,32,73,38.25516061610769,-109.358612
33658,1,21,17,0,1,31,71,38.25516061610769,-109.3583425
33659,1,21,17,1,3,30,73,38.25516061610769,-109.358073
33660,1,21,17,0,3,31,73,38.25516061610769,-109.3578035
33661,1,23,19,0,3,33,79,38.25516061610769,-109.357534
33662,0,23,18,0,2,32,75,38.25516061610769,-109.3572645
33663,0,25,16,0,3,31,75,38.25516061610769,-109.356995
33664,0,25,16,0,4,31,76,38.25516061610769,-109.3567255
33665,0,25,18,0,4,31,78,38.25516061610769,-109.356456
33666,0,26,18,0,5,31,80,38.25516061610769,-109.3561865
33667,0,27,18,0,7,29,81,38.25516061610769,-109.355917
33668,3,24,18,5,6,24,80,38.25516061610769,-109.3556475
33669,3,26,17,8,7,20,81,38.25516061610769,-109.355378
33670,1,29,15,5,13,18,81,38.25516061610769,-109.3551086
33671,1,29,17,2,10,24,83,38.25516061610769,-109.3548391
33672,1,27,17,1,9,26,81,38.25516061610769,-109.3545696
33673,0,27,18,0,6,31,82,38.25516061610769,-109.3543001
33674,0,23,18,0,3,34,78,38.25516061610769,-109.3540306
33675,1,21,19,0,2,34,77,38.25516061610769,-109.3537611
33676,1,18,19,0,1,35,74,38.25516061610769,-109.3534916
33677,1,18,18,0,1,32,70,38.25516061610769,-109.3532221
33678,2,20,16,0,1,28,67,38.25516061610769,-109.3529526
33679,1,25,14,0,1,26,67,38.25516061610769,-109.3526831
33680,1,25,14,0,2,24,66,38.25516061610769,-109.3524136
33681,1,21,12,0,2,22,58,38.25516061610769,-109.3521441
33682,3,20,12,0,3,19,57,38.25516061610769,-109.3518746
33683,4,19,11,2,5,15,56,38.25516061610769,-109.3516051
33684,2,26,9,3,7,10,57,38.25516061610769,-109.3513356
33685,2,30,6,5,8,6,57,38.25516061610769,-109.3510661
33686,1,37,6,4,8,4,60,38.25516061610769,-109.3507966
33687,2,37,6,4,10,4,63,38.25516061610769,-109.3505271
33688,3,29,7,5,9,4,57,38.25516061610769,-109.3502577
33689,3,25,8,4,8,7,55,38.25516061610769,-109.3499882
33690,8,28,9,3,6,8,62,38.25516061610769,-109.3497187
33691,2,14,10,4,6,12,48,38.25516061610769,-109.3494492
33692,2,12,9,4,6,12,45,38.25516061610769,-109.3491797
33693,6,14,10,7,8,6,51,38.25516061610769,-109.3489102
33694,4,13,11,6,8,11,53,38.25516061610769,-109.3486407
33695,1,14,13,4,5,18,55,38.25516061610769,-109.3483712
33696,1,15,13,1,3,21,54,38.25516061610769,-109.3481017
33697,2,15,12,2,4,18,53,38.25516061610769,-109.3478322
33698,3,23,14,3,5,19,67,38.25516061610769,-109.3475627
33699,3,22,11,2,13,9,60,38.25516061610769,-109.3472932
33700,0,21,8,0,12,11,52,38.25516061610769,-109.3470237
33701,1,25,12,1,12,13,64,38.25516061610769,-109.3467542
33702,7,20,12,2,14,7,62,38.25516061610769,-109.3464847
33703,9,17,12,12,8,2,60,38.25516061610769,-109.3462152
33704,5,28,8,6,8,4,59,38.25516061610769,-109.3459457
33705,3,32,6,4,8,4,57,38.25516061610769,-109.3456762
33706,2,32,6,4,8,4,56,38.25516061610769,-109.3454068
33707,2,37,6,4,9,5,63,38.25516061610769,-109.3451373
33708,2,40,6,4,9,5,66,38.25516061610769,-109.3448678
33709,3,39,8,6,8,5,69,38.25516061610769,-109.3445983
33710,3,35,7,7,9,5,66,38.25516061610769,-109.3443288
33711,3,28,8,5,9,6,59,38.25516061610769,-109.3440593
33712,3,14,10,8,10,9,54,38.25516061610769,-109.3437898
33713,3,7,14,5,3,21,53,38.25516061610769,-109.3435203
33714,2,11,17,1,1,30,62,38.25516061610769,-109.3432508
33715,1,12,19,0,1,34,67,38.25516061610769,-109.3429813
33716,1,14,20,0,1,35,71,38.25516061610769,-109.3427118
33717,2,15,20,0,0,35,72,38.25516061610769,-109.3424423
33718,2,16,20,0,0,35,73,38.25516061610769,-109.3421728
33719,2,17,20,0,1,36,76,38.25516061610769,-109.3419033
33720,1,19,21,0,3,36,80,38.25516061610769,-109.3416338
33721,1,22,21,0,4,34,82,38.25516061610769,-109.3413643
33722,1,22,20,0,4,33,80,38.25516061610769,-109.3410948
33723,1,20,19,0,3,33,76,38.25516061610769,-109.3408253
33724,0,20,20,0,0,33,73,38.25516061610769,-109.3405558
33725,0,15,17,0,0,29,61,38.25516061610769,-109.3402864
33726,3,27,12,2,4,15,63,38.25516061610769,-109.3400169
33727,1,16,15,3,3,21,59,38.25516061610769,-109.3397474
33728,0,13,16,0,1,29,59,38.25516061610769,-109.3394779
33729,2,18,15,2,3,21,61,38.25516061610769,-109.3392084
33730,1,24,10,3,8,11,57,38.25516061610769,-109.3389389
33731,0,34,8,1,10,7,60,38.25516061610769,-109.3386694
33732,1,37,8,1,11,6,64,38.25516061610769,-109.3383999
33733,1,40,8,2,11,5,67,38.25516061610769,-109.3381304
33734,1,42,9,2,11,5,70,38.25516061610769,-109.3378609
33735,1,36,10,4,10,9,70,38.25516061610769,-109.3375914
33736,2,31,12,4,13,9,71,38.25516061610769,-109.3373219
33737,1,26,12,3,8,15,65,38.25516061610769,-109.3370524
33738,1,22,12,1,5,20,61,38.25516061610769,-109.3367829
33739,2,22,13,1,4,22,64,38.25516061610769,-109.3365134
33740,2,22,13,2,4,21,64,38.25516061610769,-109.3362439
33741,1,19,14,1,3,23,61,38.25516061610769,-109.3359744
33742,1,20,13,2,3,22,61,38.25516061610769,-109.3357049
33743,1,27,12,2,7,17,66,38.25516061610769,-109.3354355
33744,0,30,10,1,8,15,64,38.25516061610769,-109.335166
33745,1,34,9,4,7,7,62,38.25516061610769,-109.3348965
33746,6,23,12,8,10,6,65,38.25516061610769,-109.334627
33747,8,20,13,16,12,6,75,38.25516061610769,-109.3343575
33748,2,17,13,7,9,21,69,38.25516061610769,-109.334088
33749,4,16,13,8,8,17,66,38.25516061610769,-109.3338185
33750,3,23,11,5,16,9,67,38.25516061610769,-109.333549
33751,1,29,10,0,10,12,62,38.25516061610769,-109.3332795
33752,1,34,9,0,12,10,66,38.25516061610769,-109.33301
33753,0,39,9,0,13,8,69,38.25516061610769,-109.3327405
33754,0,38,8,0,10,9,65,38.25516061610769,-109.332471
33755,0,29,8,1,8,12,58,38.25516061610769,-109.3322015
33756,1,28,9,2,7,12,59,38.25516061610769,-109.331932
33757,5,53,12,5,17,2,94,38.25489112152245,-109.4445808
33758,4,53,12,5,17,2,93,38.25489112152245,-109.4443113
33759,4,53,12,7,15,2,93,38.25489112152245,-109.4440418
33760,3,53,11,7,14,3,91,38.25489112152245,-109.4437723
33761,3,51,10,6,13,3,86,38.25489112152245,-109.4435028
33762,2,51,10,6,13,4,86,38.25489112152245,-109.4432333
33763,3,51,10,7,13,3,87,38.25489112152245,-109.4429638
33764,3,53,10,6,13,4,89,38.25489112152245,-109.4426943
33765,2,53,10,5,13,4,87,38.25489112152245,-109.4424248
33766,2,55,10,4,14,4,89,38.25489112152245,-109.4421553
33767,2,55,9,3,13,5,87,38.25489112152245,-109.4418858
33768,3,49,11,3,14,6,86,38.25489112152245,-109.4416163
33769,3,49,11,3,14,7,87,38.25489112152245,-109.4413468
33770,2,53,10,4,14,5,88,38.25489112152245,-109.4410773
33771,3,53,9,7,13,2,87,38.25489112152245,-109.4408078
33772,4,47,9,8,13,3,84,38.25489112152245,-109.4405383
33773,4,44,9,8,12,3,80,38.25489112152245,-109.4402688
33774,3,49,9,6,12,3,82,38.25489112152245,-109.4399993
33775,2,54,9,4,12,4,85,38.25489112152245,-109.4397299
33776,1,53,9,1,13,5,82,38.25489112152245,-109.4394604
33777,1,53,9,0,14,5,82,38.25489112152245,-109.4391909
33778,1,49,8,0,12,6,76,38.25489112152245,-109.4389214
33779,1,43,8,0,9,7,68,38.25489112152245,-109.4386519
33780,1,41,8,0,10,7,67,38.25489112152245,-109.4383824
33781,1,40,9,0,10,10,70,38.25489112152245,-109.4381129
33782,2,46,10,1,11,9,79,38.25489112152245,-109.4378434
33783,3,46,11,2,14,8,84,38.25489112152245,-109.4375739
33784,3,43,11,5,15,6,83,38.25489112152245,-109.4373044
33785,2,43,11,1,14,8,79,38.25489112152245,-109.4370349
33786,2,40,10,2,13,5,72,38.25489112152245,-109.4367654
33787,3,36,8,3,9,5,64,38.25489112152245,-109.4364959
33788,3,33,8,3,8,6,61,38.25489112152245,-109.4362264
33789,3,35,8,2,9,7,64,38.25489112152245,-109.4359569
33790,2,42,8,1,11,6,70,38.25489112152245,-109.4356874
33791,2,44,9,2,13,4,74,38.25489112152245,-109.4354179
33792,2,42,9,0,12,7,72,38.25489112152245,-109.4351484
33793,1,36,9,0,10,10,66,38.25489112152245,-109.434879
33794,2,33,10,1,8,10,64,38.25489112152245,-109.4346095
33795,4,33,9,2,8,8,64,38.25489112152245,-109.43434
33796,1,41,9,0,12,8,71,38.25489112152245,-109.4340705
33797,2,40,9,0,13,8,72,38.25489112152245,-109.433801
33798,4,38,11,5,16,4,78,38.25489112152245,-109.4335315
33799,16,36,13,12,14,0,91,38.25489112152245,-109.433262
33800,15,39,15,12,14,0,95,38.25489112152245,-109.4329925
33801,12,42,13,11,13,0,91,38.25489112152245,-109.432723
33802,14,40,13,10,13,0,90,38.25489112152245,-109.4324535
33803,20,34,14,11,13,0,92,38.25489112152245,-109.432184
33804,21,30,14,14,13,0,92,38.25489112152245,-109.4319145
33805,21,31,15,13,12,0,92,38.25489112152245,-109.431645
33806,21,31,15,13,12,0,92,38.25489112152245,-109.4313755
33807,17,33,15,13,12,0,90,38.25489112152245,-109.431106
33808,15,36,15,13,13,0,92,38.25489112152245,-109.4308365
33809,12,39,15,14,13,0,93,38.25489112152245,-109.430567
33810,11,41,14,13,13,0,92,38.25489112152245,-109.4302975
33811,11,42,14,12,14,0,93,38.25489112152245,-109.430028
33812,9,42,13,10,14,0,88,38.25489112152245,-109.4297586
33813,7,43,12,9,15,0,86,38.25489112152245,-109.4294891
33814,5,45,12,9,14,1,86,38.25489112152245,-109.4292196
33815,5,47,12,10,13,1,88,38.25489112152245,-109.4289501
33816,4,51,11,7,15,1,89,38.25489112152245,-109.4286806
33817,3,55,10,5,16,0,89,38.25489112152245,-109.4284111
33818,7,50,11,7,16,0,91,38.25489112152245,-109.4281416
33819,9,44,12,10,15,1,91,38.25489112152245,-109.4278721
33820,5,48,11,9,14,1,88,38.25489112152245,-109.4276026
33821,4,51,10,7,15,1,88,38.25489112152245,-109.4273331
33822,6,51,11,7,16,0,91,38.25489112152245,-109.4270636
33823,19,37,13,9,13,0,91,38.25489112152245,-109.4267941
33824,19,35,13,11,13,0,91,38.25489112152245,-109.4265246
33825,19,33,14,12,13,0,91,38.25489112152245,-109.4262551
33826,20,32,14,13,12,0,91,38.25489112152245,-109.4259856
33827,21,32,15,13,11,0,92,38.25489112152245,-109.4257161
33828,21,32,14,13,11,0,91,38.25489112152245,-109.4254466
33829,20,32,15,14,12,0,93,38.25489112152245,-109.4251771
33830,18,33,14,14,12,0,91,38.25489112152245,-109.4249077
33831,18,35,14,13,12,0,92,38.25489112152245,-109.4246382
33832,21,33,14,12,12,0,92,38.25489112152245,-109.4243687
33833,23,33,14,11,11,0,92,38.25489112152245,-109.4240992
33834,21,32,13,11,12,0,89,38.25489112152245,-109.4238297
33835,20,33,14,12,13,0,92,38.25489112152245,-109.4235602
33836,18,33,14,13,13,0,91,38.25489112152245,-109.4232907
33837,12,38,14,12,14,0,90,38.25489112152245,-109.4230212
33838,10,42,14,12,14,1,93,38.25489112152245,-109.4227517
33839,9,43,13,11,14,0,90,38.25489112152245,-109.4224822
33840,9,43,12,10,15,0,89,38.25489112152245,-109.4222127
33841,7,44,11,10,14,1,87,38.25489112152245,-109.4219432
33842,10,40,12,11,15,0,88,38.25489112152245,-109.4216737
33843,9,38,13,11,14,1,86,38.25489112152245,-109.4214042
33844,10,40,14,12,13,1,90,38.25489112152245,-109.4211347
33845,10,40,15,13,13,1,92,38.25489112152245,-109.4208652
33846,12,36,14,13,14,1,90,38.25489112152245,-109.4205957
33847,14,35,14,13,14,0,90,38.25489112152245,-109.4203262
33848,11,38,14,12,15,0,90,38.25489112152245,-109.4200568
33849,6,42,12,8,15,1,84,38.25489112152245,-109.4197873
33850,3,43,11,5,15,3,80,38.25489112152245,-109.4195178
33851,8,46,12,7,16,1,90,38.25489112152245,-109.4192483
33852,11,43,12,9,13,1,89,38.25489112152245,-109.4189788
33853,8,43,12,7,13,2,85,38.25489112152245,-109.4187093
33854,5,45,11,5,13,3,82,38.25489112152245,-109.4184398
33855,4,47,10,2,14,5,82,38.25489112152245,-109.4181703
33856,4,50,10,3,14,4,85,38.25489112152245,-109.4179008
33857,4,50,10,3,13,4,84,38.25489112152245,-109.4176313
33858,6,46,11,4,13,4,84,38.25489112152245,-109.4173618
33859,9,41,12,6,14,4,86,38.25489112152245,-109.4170923
33860,7,43,12,5,14,3,84,38.25489112152245,-109.4168228
33861,4,50,11,3,15,3,86,38.25489112152245,-109.4165533
33862,3,52,11,4,16,2,88,38.25489112152245,-109.4162838
33863,4,48,11,5,17,2,87,38.25489112152245,-109.4160143
33864,7,38,11,3,15,5,79,38.25489112152245,-109.4157448
33865,10,36,12,2,14,7,81,38.25489112152245,-109.4154753
33866,16,33,13,9,14,2,87,38.25489112152245,-109.4152058
33867,16,34,13,11,13,1,88,38.25489112152245,-109.4149364
33868,15,35,13,12,13,1,89,38.25489112152245,-109.4146669
33869,16,33,14,13,13,1,90,38.25489112152245,-109.4143974
33870,16,32,14,14,12,1,89,38.25489112152245,-109.4141279
33871,16,32,14,14,12,1,89,38.25489112152245,-109.4138584
33872,13,35,14,13,13,1,89,38.25489112152245,-109.4135889
33873,11,37,14,12,14,1,89,38.25489112152245,-109.4133194
33874,13,35,14,12,15,1,90,38.25489112152245,-109.4130499
33875,17,32,14,13,14,1,91,38.25489112152245,-109.4127804
33876,17,33,14,11,14,1,90,38.25489112152245,-109.4125109
33877,11,36,13,11,15,1,87,38.25489112152245,-109.4122414
33878,5,41,12,7,15,3,83,38.25489112152245,-109.4119719
33879,2,42,10,2,14,6,76,38.25489112152245,-109.4117024
33880,2,44,10,3,14,5,78,38.25489112152245,-109.4114329
33881,1,44,9,1,13,5,73,38.25489112152245,-109.4111634
33882,1,41,9,1,12,6,70,38.25489112152245,-109.4108939
33883,1,37,9,3,11,6,67,38.25489112152245,-109.4106244
33884,1,38,8,4,10,4,65,38.25489112152245,-109.4103549
33885,2,37,7,3,8,4,61,38.25489112152245,-109.4100855
33886,1,40,6,4,7,3,61,38.25489112152245,-109.409816
33887,2,46,5,4,7,2,66,38.25489112152245,-109.4095465
33888,3,43,5,4,7,2,64,38.25489112152245,-109.409277
33889,3,36,8,5,10,3,65,38.25489112152245,-109.4090075
33890,4,32,10,6,12,4,68,38.25489112152245,-109.408738
33891,3,33,11,5,11,7,70,38.25489112152245,-109.4084685
33892,1,35,11,2,10,9,68,38.25489112152245,-109.408199
33893,1,33,10,2,9,11,66,38.25489112152245,-109.4079295
33894,2,35,11,3,10,8,69,38.25489112152245,-109.40766
33895,2,35,10,3,10,6,66,38.25489112152245,-109.4073905
33896,3,35,10,5,11,5,69,38.25489112152245,-109.407121
33897,3,39,10,8,13,3,76,38.25489112152245,-109.4068515
33898,3,46,12,9,15,2,87,38.25489112152245,-109.406582
33899,4,46,13,9,17,1,90,38.25489112152245,-109.4063125
33900,4,46,13,7,18,2,90,38.25489112152245,-109.406043
33901,3,47,13,5,17,3,88,38.25489112152245,-109.4057735
33902,3,50,13,6,16,2,90,38.25489112152245,-109.405504
33903,4,49,13,10,16,1,93,38.25489112152245,-109.4052345
33904,4,45,12,7,18,2,88,38.25489112152245,-109.4049651
33905,4,43,12,4,17,4,84,38.25489112152245,-109.4046956
33906,4,46,12,4,18,3,87,38.25489112152245,-109.4044261
33907,4,45,12,6,18,2,87,38.25489112152245,-109.4041566
33908,3,43,12,3,16,5,82,38.25489112152245,-109.4038871
33909,3,41,12,4,16,6,82,38.25489112152245,-109.4036176
33910,3,42,12,4,17,4,82,38.25489112152245,-109.4033481
33911,3,45,11,4,17,4,84,38.25489112152245,-109.4030786
33912,2,45,10,0,13,8,78,38.25489112152245,-109.4028091
33913,2,39,9,1,9,9,69,38.25489112152245,-109.4025396
33914,3,38,9,1,9,8,68,38.25489112152245,-109.4022701
33915,4,39,9,3,9,5,69,38.25489112152245,-109.4020006
33916,4,41,9,5,9,3,71,38.25489112152245,-109.4017311
33917,1,41,8,3,9,6,68,38.25489112152245,-109.4014616
33918,2,44,7,4,6,4,67,38.25489112152245,-109.4011921
33919,2,47,6,5,5,3,68,38.25489112152245,-109.4009226
33920,2,48,5,5,6,2,68,38.25489112152245,-109.4006531
33921,2,46,6,6,6,3,69,38.25489112152245,-109.4003836
33922,1,38,7,5,7,4,62,38.25489112152245,-109.4001142
33923,2,33,9,3,8,7,62,38.25489112152245,-109.3998447
33924,1,36,11,1,8,11,68,38.25489112152245,-109.3995752
33925,3,37,10,1,7,11,69,38.25489112152245,-109.3993057
33926,1,33,11,3,9,11,68,38.25489112152245,-109.3990362
33927,1,32,11,0,8,13,65,38.25489112152245,-109.3987667
33928,1,32,11,1,8,12,65,38.25489112152245,-109.3984972
33929,2,31,10,1,7,11,62,38.25489112152245,-109.3982277
33930,3,30,10,2,8,10,63,38.25489112152245,-109.3979582
33931,2,34,11,1,9,10,67,38.25489112152245,-109.3976887
33932,1,33,10,2,8,11,65,38.25489112152245,-109.3974192
33933,1,36,10,2,10,9,68,38.25489112152245,-109.3971497
33934,2,40,11,3,13,6,75,38.25489112152245,-109.3968802
33935,2,43,11,1,13,8,78,38.25489112152245,-109.3966107
33936,2,38,10,0,10,11,71,38.25489112152245,-109.3963412
33937,2,33,11,0,10,13,69,38.25489112152245,-109.3960717
33938,2,32,11,0,9,15,69,38.25489112152245,-109.3958022
33939,2,34,11,0,10,14,71,38.25489112152245,-109.3955327
33940,1,31,12,1,10,14,69,38.25489112152245,-109.3952632
33941,1,34,11,2,12,11,71,38.25489112152245,-109.3949938
33942,2,36,11,2,13,9,73,38.25489112152245,-109.3947243
33943,2,37,11,2,12,9,73,38.25489112152245,-109.3944548
33944,3,45,11,2,14,6,81,38.25489112152245,-109.3941853
33945,2,41,10,0,12,8,73,38.25489112152245,-109.3939158
33946,2,39,11,2,14,7,75,38.25489112152245,-109.3936463
33947,2,39,11,3,14,7,76,38.25489112152245,-109.3933768
33948,2,40,11,1,13,8,75,38.25489112152245,-109.3931073
33949,2,44,10,1,13,7,77,38.25489112152245,-109.3928378
33950,3,42,10,2,11,6,74,38.25489112152245,-109.3925683
33951,3,39,10,3,9,7,71,38.25489112152245,-109.3922988
33952,3,38,10,3,10,6,70,38.25489112152245,-109.3920293
33953,4,37,10,3,9,5,68,38.25489112152245,-109.3917598
33954,2,38,10,1,7,7,65,38.25489112152245,-109.3914903
33955,6,37,10,6,11,2,72,38.25489112152245,-109.3912208
33956,3,32,11,8,11,6,71,38.25489112152245,-109.3909513
33957,2,29,10,15,13,7,76,38.25489112152245,-109.3906818
33958,3,26,11,18,15,2,75,38.25489112152245,-109.3904123
33959,2,32,9,11,10,4,68,38.25489112152245,-109.3901429
33960,1,29,8,7,9,7,61,38.25489112152245,-109.3898734
33961,2,32,7,5,6,7,59,38.25489112152245,-109.3896039
33962,2,39,6,5,5,6,63,38.25489112152245,-109.3893344
33963,3,47,7,10,7,2,76,38.25489112152245,-109.3890649
33964,2,44,8,12,7,2,75,38.25489112152245,-109.3887954
33965,2,39,9,14,8,3,75,38.25489112152245,-109.3885259
33966,1,29,9,14,10,4,67,38.25489112152245,-109.3882564
33967,0,24,11,13,14,7,69,38.25489112152245,-109.3879869
33968,0,27,12,7,17,9,72,38.25489112152245,-109.3877174
33969,0,25,10,9,12,8,64,38.25489112152245,-109.3874479
33970,2,28,9,9,11,5,64,38.25489112152245,-109.3871784
33971,2,26,9,8,9,6,60,38.25489112152245,-109.3869089
33972,1,25,10,7,11,8,62,38.25489112152245,-109.3866394
33973,2,38,11,3,15,7,76,38.25489112152245,-109.3863699
33974,3,41,11,8,14,3,80,38.25489112152245,-109.3861004
33975,3,43,11,8,14,2,81,38.25489112152245,-109.3858309
33976,4,45,11,9,13,2,84,38.25489112152245,-109.3855614
33977,4,44,11,9,13,2,83,38.25489112152245,-109.3852919
33978,7,46,12,11,11,1,88,38.25489112152245,-109.3850225
33979,5,47,10,7,12,2,83,38.25489112152245,-109.384753
33980,4,48,9,7,12,2,82,38.25489112152245,-109.3844835
33981,5,45,8,7,11,2,78,38.25489112152245,-109.384214
33982,9,45,11,9,10,1,85,38.25489112152245,-109.3839445
33983,6,48,11,8,11,1,85,38.25489112152245,-109.383675
33984,5,52,10,7,12,1,87,38.25489112152245,-109.3834055
33985,4,54,10,6,12,1,87,38.25489112152245,-109.383136
33986,3,48,9,3,11,4,78,38.25489112152245,-109.3828665
33987,7,42,11,9,15,1,85,38.25489112152245,-109.382597
33988,7,39,12,9,17,1,85,38.25489112152245,-109.3823275
33989,6,36,12,9,16,3,82,38.25489112152245,-109.382058
33990,9,31,12,9,13,4,78,38.25489112152245,-109.3817885
33991,3,20,9,10,12,6,60,38.25489112152245,-109.381519
33992,3,22,10,7,10,7,59,38.25489112152245,-109.3812495
33993,4,28,10,6,13,7,68,38.25489112152245,-109.38098
33994,8,34,11,10,15,2,80,38.25489112152245,-109.3807105
33995,9,41,13,12,15,0,90,38.25489112152245,-109.380441
33996,9,42,13,12,15,0,91,38.25489112152245,-109.3801716
33997,11,40,14,14,13,0,92,38.25489112152245,-109.3799021
33998,14,37,14,14,12,0,91,38.25489112152245,-109.3796326
33999,15,37,14,14,12,0,92,38.25489112152245,-109.3793631
34000,14,39,14,13,12,0,92,38.25489112152245,-109.3790936
34001,10,41,14,13,13,0,91,38.25489112152245,-109.3788241
34002,11,40,14,13,13,0,91,38.25489112152245,-109.3785546
34003,11,40,14,13,12,0,90,38.25489112152245,-109.3782851
34004,11,41,14,13,13,0,92,38.25489112152245,-109.3780156
34005,12,39,14,14,12,0,91,38.25489112152245,-109.3777461
34006,15,37,14,15,10,1,92,38.25489112152245,-109.3774766
34007,17,35,14,16,9,0,91,38.25489112152245,-109.3772071
34008,16,35,13,16,10,0,90,38.25489112152245,-109.3769376
34009,13,36,14,16,11,1,91,38.25489112152245,-109.3766681
34010,12,38,14,14,12,1,91,38.25489112152245,-109.3763986
34011,12,38,14,13,12,1,90,38.25489112152245,-109.3761291
34012,14,38,14,14,11,1,92,38.25489112152245,-109.3758596
34013,18,37,13,13,10,1,92,38.25489112152245,-109.3755901
34014,18,36,13,11,9,3,90,38.25489112152245,-109.3753206
34015,14,38,12,8,11,5,88,38.25489112152245,-109.3750512
34016,13,39,13,8,11,5,89,38.25489112152245,-109.3747817
34017,12,39,13,8,11,4,87,38.25489112152245,-109.3745122
34018,10,39,12,8,12,5,86,38.25489112152245,-109.3742427
34019,10,42,13,6,12,5,88,38.25489112152245,-109.3739732
34020,6,40,12,3,12,9,82,38.25489112152245,-109.3737037
34021,6,39,13,2,11,12,83,38.25489112152245,-109.3734342
34022,5,38,13,1,12,13,82,38.25489112152245,-109.3731647
34023,6,38,13,2,11,13,83,38.25489112152245,-109.3728952
34024,6,36,14,2,10,15,83,38.25489112152245,-109.3726257
34025,4,33,15,0,7,20,79,38.25489112152245,-109.3723562
34026,3,31,15,0,5,22,76,38.25489112152245,-109.3720867
34027,2,27,16,0,3,27,75,38.25489112152245,-109.3718172
34028,1,24,17,0,2,31,75,38.25489112152245,-109.3715477
34029,2,26,17,0,2,29,76,38.25489112152245,-109.3712782
34030,2,28,17,0,4,27,78,38.25489112152245,-109.3710087
34031,3,28,18,0,3,27,79,38.25489112152245,-109.3707392
34032,3,26,18,0,2,30,79,38.25489112152245,-109.3704697
34033,3,25,18,0,2,30,78,38.25489112152245,-109.3702003
34034,1,23,16,0,2,30,72,38.25489112152245,-109.3699308
34035,1,21,17,0,2,31,72,38.25489112152245,-109.3696613
34036,1,22,17,0,2,31,73,38.25489112152245,-109.3693918
34037,2,24,18,0,2,31,77,38.25489112152245,-109.3691223
34038,1,21,17,0,2,32,73,38.25489112152245,-109.3688528
34039,1,23,16,0,4,29,73,38.25489112152245,-109.3685833
34040,0,24,14,0,4,27,69,38.25489112152245,-109.3683138
34041,0,21,12,1,4,23,61,38.25489112152245,-109.3680443
34042,1,22,12,6,9,14,64,38.25489112152245,-109.3677748
34043,1,20,11,5,7,14,58,38.25489112152245,-109.3675053
34044,2,22,10,7,11,7,59,38.25489112152245,-109.3672358
34045,1,21,10,7,15,6,60,38.25489112152245,-109.3669663
34046,2,17,9,10,14,4,56,38.25489112152245,-109.3666968
34047,5,17,10,8,13,4,57,38.25489112152245,-109.3664273
34048,4,22,13,3,9,16,67,38.25489112152245,-109.3661578
34049,2,22,13,0,3,24,64,38.25489112152245,-109.3658883
34050,2,23,13,0,2,24,64,38.25489112152245,-109.3656188
34051,2,27,13,0,4,21,67,38.25489112152245,-109.3653493
34052,1,24,13,0,2,23,63,38.25489112152245,-109.3650799
34053,1,24,12,0,3,21,61,38.25489112152245,-109.3648104
34054,1,25,11,0,4,19,60,38.25489112152245,-109.3645409
34055,1,25,12,0,4,19,61,38.25489112152245,-109.3642714
34056,2,24,13,2,3,22,66,38.25489112152245,-109.3640019
34057,1,21,13,1,2,24,62,38.25489112152245,-109.3637324
34058,2,23,15,0,3,26,69,38.25489112152245,-109.3634629
34059,2,24,15,0,3,26,70,38.25489112152245,-109.3631934
34060,2,22,15,0,2,27,68,38.25489112152245,-109.3629239
34061,3,21,16,0,2,28,70,38.25489112152245,-109.3626544
34062,1,21,16,0,1,29,68,38.25489112152245,-109.3623849
34063,1,21,16,0,1,31,70,38.25489112152245,-109.3621154
34064,1,21,17,0,1,31,71,38.25489112152245,-109.3618459
34065,1,22,16,0,2,30,71,38.25489112152245,-109.3615764
34066,1,24,16,0,3,29,73,38.25489112152245,-109.3613069
34067,1,24,16,0,2,29,72,38.25489112152245,-109.3610374
34068,1,23,16,0,2,29,71,38.25489112152245,-109.3607679
34069,1,21,16,0,1,30,69,38.25489112152245,-109.3604984
34070,1,21,18,0,1,32,73,38.25489112152245,-109.360229
34071,1,22,17,0,1,32,73,38.25489112152245,-109.3599595
34072,1,23,17,0,1,32,74,38.25489112152245,-109.35969
34073,1,21,18,0,1,33,74,38.25489112152245,-109.3594205
34074,1,20,18,0,0,33,72,38.25489112152245,-109.359151
34075,1,23,16,2,1,30,73,38.25489112152245,-109.3588815
34076,1,23,16,2,1,29,72,38.25489112152245,-109.358612
34077,1,23,16,2,1,29,72,38.25489112152245,-109.3583425
34078,1,22,16,1,1,30,71,38.25489112152245,-109.358073
34079,1,20,17,1,0,31,70,38.25489112152245,-109.3578035
34080,1,20,17,0,0,31,69,38.25489112152245,-109.357534
34081,0,20,17,0,0,32,69,38.25489112152245,-109.3572645
34082,0,20,17,0,1,32,70,38.25489112152245,-109.356995
34083,0,21,18,0,1,33,73,38.25489112152245,-109.3567255
34084,1,22,17,0,1,33,74,38.25489112152245,-109.356456
34085,0,22,18,0,3,35,78,38.25489112152245,-109.3561865
34086,0,26,18,0,4,33,81,38.25489112152245,-109.355917
34087,0,28,19,0,4,32,83,38.25489112152245,-109.3556475
34088,0,27,19,0,4,33,83,38.25489112152245,-109.355378
34089,0,26,19,0,4,34,83,38.25489112152245,-109.3551086
34090,0,24,17,0,4,31,76,38.25489112152245,-109.3548391
34091,0,23,17,0,4,31,75,38.25489112152245,-109.3545696
34092,1,22,17,1,2,30,73,38.25489112152245,-109.3543001
34093,1,22,16,1,1,30,71,38.25489112152245,-109.3540306
34094,1,20,18,0,1,33,73,38.25489112152245,-109.3537611
34095,1,19,18,0,0,32,70,38.25489112152245,-109.3534916
34096,1,20,16,0,0,30,67,38.25489112152245,-109.3532221
34097,2,22,15,0,1,27,67,38.25489112152245,-109.3529526
34098,3,25,15,0,1,26,70,38.25489112152245,-109.3526831
34099,3,22,13,0,2,21,61,38.25489112152245,-109.3524136
34100,2,19,12,1,3,19,56,38.25489112152245,-109.3521441
34101,3,19,10,3,7,12,54,38.25489112152245,-109.3518746
34102,7,24,7,3,9,5,55,38.25489112152245,-109.3516051
34103,2,33,6,4,8,5,58,38.25489112152245,-109.3513356
34104,2,38,6,4,8,4,62,38.25489112152245,-109.3510661
34105,2,40,6,4,9,4,65,38.25489112152245,-109.3507966
34106,2,35,6,4,10,4,61,38.25489112152245,-109.3505271
34107,2,30,8,4,9,4,57,38.25489112152245,-109.3502577
34108,3,28,9,4,8,7,59,38.25489112152245,-109.3499882
34109,4,23,9,4,8,6,54,38.25489112152245,-109.3497187
34110,3,18,9,6,6,7,49,38.25489112152245,-109.3494492
34111,2,18,9,5,5,7,46,38.25489112152245,-109.3491797
34112,6,26,12,11,9,4,68,38.25489112152245,-109.3489102
34113,7,21,8,7,7,5,55,38.25489112152245,-109.3486407
34114,3,15,11,4,7,13,53,38.25489112152245,-109.3483712
34115,2,16,13,1,4,20,56,38.25489112152245,-109.3481017
34116,1,17,10,0,4,16,48,38.25489112152245,-109.3478322
34117,1,21,10,3,8,13,56,38.25489112152245,-109.3475627
34118,0,23,8,5,9,10,55,38.25489112152245,-109.3472932
34119,0,19,7,4,9,10,49,38.25489112152245,-109.3470237
34120,0,24,8,7,4,8,51,38.25489112152245,-109.3467542
34121,5,37,8,7,6,4,67,38.25489112152245,-109.3464847
34122,4,41,6,7,8,2,68,38.25489112152245,-109.3462152
34123,2,35,6,4,8,4,59,38.25489112152245,-109.3459457
34124,2,32,6,3,9,4,56,38.25489112152245,-109.3456762
34125,2,39,6,2,10,4,63,38.25489112152245,-109.3454068
34126,2,40,7,3,9,5,66,38.25489112152245,-109.3451373
34127,2,35,8,5,9,7,66,38.25489112152245,-109.3448678
34128,3,27,9,6,8,9,62,38.25489112152245,-109.3445983
34129,4,24,9,8,8,9,62,38.25489112152245,-109.3443288
34130,4,24,10,9,10,6,63,38.25489112152245,-109.3440593
34131,4,25,7,7,10,3,56,38.25489112152245,-109.3437898
34132,4,20,11,4,9,10,58,38.25489112152245,-109.3435203
34133,3,12,15,3,2,26,61,38.25489112152245,-109.3432508
34134,2,14,18,0,1,33,68,38.25489112152245,-109.3429813
34135,2,13,19,0,1,35,70,38.25489112152245,-109.3427118
34136,2,14,20,0,0,36,72,38.25489112152245,-109.3424423
34137,1,14,20,0,0,37,72,38.25489112152245,-109.3421728
34138,1,14,19,0,1,37,72,38.25489112152245,-109.3419033
34139,1,15,19,0,1,36,72,38.25489112152245,-109.3416338
34140,1,16,19,0,2,34,72,38.25489112152245,-109.3413643
34141,0,16,19,0,2,35,72,38.25489112152245,-109.3410948
34142,0,15,19,0,1,34,69,38.25489112152245,-109.3408253
34143,0,15,19,0,0,34,68,38.25489112152245,-109.3405558
34144,0,16,18,0,0,32,66,38.25489112152245,-109.3402864
34145,0,18,15,0,0,27,60,38.25489112152245,-109.3400169
34146,0,18,14,0,2,24,58,38.25489112152245,-109.3397474
34147,1,16,16,1,3,26,63,38.25489112152245,-109.3394779
34148,0,17,15,0,2,27,61,38.25489112152245,-109.3392084
34149,0,22,12,1,3,21,59,38.25489112152245,-109.3389389
34150,0,30,9,1,9,10,59,38.25489112152245,-109.3386694
34151,1,31,10,3,9,12,66,38.25489112152245,-109.3383999
34152,2,27,11,3,8,15,66,38.25489112152245,-109.3381304
34153,2,21,13,4,7,18,65,38.25489112152245,-109.3378609
34154,1,18,16,4,5,22,66,38.25489112152245,-109.3375914
34155,1,15,15,4,4,23,62,38.25489112152245,-109.3373219
34156,1,16,13,4,4,19,57,38.25489112152245,-109.3370524
34157,1,20,12,3,5,19,60,38.25489112152245,-109.3367829
34158,1,24,13,2,6,18,64,38.25489112152245,-109.3365134
34159,1,22,12,2,5,20,62,38.25489112152245,-109.3362439
34160,1,26,12,2,6,18,65,38.25489112152245,-109.3359744
34161,1,32,11,1,9,14,68,38.25489112152245,-109.3357049
34162,0,38,10,0,13,9,70,38.25489112152245,-109.3354355
34163,0,36,8,1,11,8,64,38.25489112152245,-109.335166
34164,1,31,8,3,6,7,56,38.25489112152245,-109.3348965
34165,5,23,11,6,9,5,59,38.25489112152245,-109.334627
34166,4,17,13,12,13,10,69,38.25489112152245,-109.3343575
34167,2,17,13,6,9,22,69,38.25489112152245,-109.334088
34168,4,17,12,8,8,18,67,38.25489112152245,-109.3338185
34169,3,22,10,3,12,10,60,38.25489112152245,-109.333549
34170,1,28,10,1,10,10,60,38.25489112152245,-109.3332795
34171,1,32,10,2,10,9,64,38.25489112152245,-109.33301
34172,1,30,9,2,9,10,61,38.25489112152245,-109.3327405
34173,2,26,9,2,7,11,57,38.25489112152245,-109.332471
34174,3,24,10,3,8,10,58,38.25489112152245,-109.3322015
34175,2,23,11,3,7,12,58,38.25489112152245,-109.331932
34176,4,47,9,8,12,3,83,38.254621626937215,-109.4405383
34177,4,45,8,6,12,3,78,38.254621626937215,-109.4402688
34178,3,49,9,6,12,3,82,38.254621626937215,-109.4399993
34179,2,53,9,5,12,4,85,38.254621626937215,-109.4397299
34180,2,57,9,4,12,3,87,38.254621626937215,-109.4394604
34181,2,55,9,0,12,7,85,38.254621626937215,-109.4391909
34182,2,52,10,0,11,9,84,38.254621626937215,-109.4389214
34183,1,48,9,0,11,9,78,38.254621626937215,-109.4386519
34184,1,42,9,1,12,7,72,38.254621626937215,-109.4383824
34185,0,40,9,0,13,10,72,38.254621626937215,-109.4381129
34186,1,46,9,0,15,7,78,38.254621626937215,-109.4378434
34187,2,49,10,3,14,5,83,38.254621626937215,-109.4375739
34188,3,48,10,4,13,5,83,38.254621626937215,-109.4373044
34189,3,45,10,4,13,6,81,38.254621626937215,-109.4370349
34190,3,42,11,4,13,6,79,38.254621626937215,-109.4367654
34191,3,32,9,5,10,7,66,38.254621626937215,-109.4364959
34192,3,29,8,4,8,7,59,38.254621626937215,-109.4362264
34193,3,33,8,4,9,6,63,38.254621626937215,-109.4359569
34194,1,37,8,2,9,8,65,38.254621626937215,-109.4356874
34195,2,43,8,1,10,6,70,38.254621626937215,-109.4354179
34196,1,39,8,0,10,10,68,38.254621626937215,-109.4351484
34197,0,37,9,0,9,11,66,38.254621626937215,-109.434879
34198,1,35,10,0,9,10,65,38.254621626937215,-109.4346095
34199,1,36,9,1,7,10,64,38.254621626937215,-109.43434
34200,1,36,9,1,11,8,66,38.254621626937215,-109.4340705
34201,1,36,10,1,13,7,68,38.254621626937215,-109.433801
34202,3,38,11,3,15,4,74,38.254621626937215,-109.4335315
34203,15,38,12,9,14,0,88,38.254621626937215,-109.433262
34204,11,41,13,10,13,1,89,38.254621626937215,-109.4329925
34205,9,42,11,9,12,1,84,38.254621626937215,-109.432723
34206,9,42,11,8,12,1,83,38.254621626937215,-109.4324535
34207,12,37,11,9,13,1,83,38.254621626937215,-109.432184
34208,16,30,13,12,13,1,85,38.254621626937215,-109.4319145
34209,18,31,13,12,13,0,87,38.254621626937215,-109.431645
34210,19,32,14,13,12,0,90,38.254621626937215,-109.4313755
34211,19,33,14,13,12,0,91,38.254621626937215,-109.431106
34212,17,36,15,12,13,0,93,38.254621626937215,-109.4308365
34213,12,40,15,13,13,0,93,38.254621626937215,-109.430567
34214,11,42,14,12,13,0,92,38.254621626937215,-109.4302975
34215,11,43,13,11,14,0,92,38.254621626937215,-109.430028
34216,8,43,13,11,14,0,89,38.254621626937215,-109.4297586
34217,6,44,12,9,14,1,86,38.254621626937215,-109.4294891
34218,6,45,12,10,13,1,87,38.254621626937215,-109.4292196
34219,6,45,12,11,13,1,88,38.254621626937215,-109.4289501
34220,4,50,11,9,14,1,89,38.254621626937215,-109.4286806
34221,3,55,10,6,16,0,90,38.254621626937215,-109.4284111
34222,6,51,11,8,16,0,92,38.254621626937215,-109.4281416
34223,8,45,12,10,15,0,90,38.254621626937215,-109.4278721
34224,7,47,12,10,14,0,90,38.254621626937215,-109.4276026
34225,8,47,12,10,15,0,92,38.254621626937215,-109.4273331
34226,11,42,13,11,15,0,92,38.254621626937215,-109.4270636
34227,15,38,13,11,14,0,91,38.254621626937215,-109.4267941
34228,18,35,14,12,13,0,92,38.254621626937215,-109.4265246
34229,20,33,14,12,12,0,91,38.254621626937215,-109.4262551
34230,23,32,15,12,11,0,93,38.254621626937215,-109.4259856
34231,24,31,15,12,10,0,92,38.254621626937215,-109.4257161
34232,22,32,14,13,11,0,92,38.254621626937215,-109.4254466
34233,19,34,14,13,12,0,92,38.254621626937215,-109.4251771
34234,17,35,14,13,13,0,92,38.254621626937215,-109.4249077
34235,17,35,14,13,13,0,92,38.254621626937215,-109.4246382
34236,20,33,13,12,13,0,91,38.254621626937215,-109.4243687
34237,21,33,13,11,13,0,91,38.254621626937215,-109.4240992
34238,19,33,13,11,13,0,89,38.254621626937215,-109.4238297
34239,19,33,14,13,12,0,91,38.254621626937215,-109.4235602
34240,19,32,15,14,12,0,92,38.254621626937215,-109.4232907
34241,12,40,14,13,13,0,92,38.254621626937215,-109.4230212
34242,9,43,14,11,14,1,92,38.254621626937215,-109.4227517
34243,8,46,13,9,14,1,91,38.254621626937215,-109.4224822
34244,7,46,12,10,14,0,89,38.254621626937215,-109.4222127
34245,10,42,12,10,14,0,88,38.254621626937215,-109.4219432
34246,15,39,13,11,14,0,92,38.254621626937215,-109.4216737
34247,9,41,13,11,14,1,89,38.254621626937215,-109.4214042
34248,8,42,13,9,13,2,87,38.254621626937215,-109.4211347
34249,10,41,14,11,13,2,91,38.254621626937215,-109.4208652
34250,9,43,14,11,14,1,92,38.254621626937215,-109.4205957
34251,6,43,12,10,15,1,87,38.254621626937215,-109.4203262
34252,4,46,11,6,15,2,84,38.254621626937215,-109.4200568
34253,3,48,11,4,15,3,84,38.254621626937215,-109.4197873
34254,3,49,11,4,15,4,86,38.254621626937215,-109.4195178
34255,8,42,13,8,15,2,88,38.254621626937215,-109.4192483
34256,10,39,13,10,13,2,87,38.254621626937215,-109.4189788
34257,10,38,13,11,12,2,86,38.254621626937215,-109.4187093
34258,7,41,13,10,13,3,87,38.254621626937215,-109.4184398
34259,5,44,12,6,15,3,85,38.254621626937215,-109.4181703
34260,7,42,13,8,16,3,89,38.254621626937215,-109.4179008
34261,9,42,12,10,13,2,88,38.254621626937215,-109.4176313
34262,13,40,13,11,13,1,91,38.254621626937215,-109.4173618
34263,16,38,14,11,13,1,93,38.254621626937215,-109.4170923
34264,11,39,14,12,13,1,90,38.254621626937215,-109.4168228
34265,6,45,12,10,14,2,89,38.254621626937215,-109.4165533
34266,7,47,12,10,15,1,92,38.254621626937215,-109.4162838
34267,10,45,12,9,15,0,91,38.254621626937215,-109.4160143
34268,11,41,13,9,14,1,89,38.254621626937215,-109.4157448
34269,11,38,12,5,14,4,84,38.254621626937215,-109.4154753
34270,17,35,12,7,13,2,86,38.254621626937215,-109.4152058
34271,19,35,13,9,13,1,90,38.254621626937215,-109.4149364
34272,18,33,14,11,12,1,89,38.254621626937215,-109.4146669
34273,17,33,14,13,12,1,90,38.254621626937215,-109.4143974
34274,16,33,14,14,12,1,90,38.254621626937215,-109.4141279
34275,15,33,14,14,12,1,89,38.254621626937215,-109.4138584
34276,13,34,14,13,13,1,88,38.254621626937215,-109.4135889
34277,12,34,14,12,14,2,88,38.254621626937215,-109.4133194
34278,13,34,14,13,14,1,89,38.254621626937215,-109.4130499
34279,14,33,13,12,14,1,87,38.254621626937215,-109.4127804
34280,11,37,13,11,14,1,87,38.254621626937215,-109.4125109
34281,6,43,11,6,15,2,83,38.254621626937215,-109.4122414
34282,3,45,10,3,14,4,79,38.254621626937215,-109.4119719
34283,1,43,9,0,12,8,73,38.254621626937215,-109.4117024
34284,1,39,9,0,10,7,66,38.254621626937215,-109.4114329
34285,3,35,8,2,9,6,63,38.254621626937215,-109.4111634
34286,3,34,8,3,8,5,61,38.254621626937215,-109.4108939
34287,2,34,7,4,7,5,59,38.254621626937215,-109.4106244
34288,2,37,7,5,7,4,62,38.254621626937215,-109.4103549
34289,2,38,6,5,6,4,61,38.254621626937215,-109.4100855
34290,2,40,6,4,6,3,61,38.254621626937215,-109.409816
34291,2,40,7,5,7,3,64,38.254621626937215,-109.4095465
34292,5,32,8,5,9,4,63,38.254621626937215,-109.409277
34293,3,32,10,5,11,6,67,38.254621626937215,-109.4090075
34294,4,36,11,8,12,4,75,38.254621626937215,-109.408738
34295,4,38,12,8,13,4,79,38.254621626937215,-109.4084685
34296,3,38,11,5,12,6,75,38.254621626937215,-109.408199
34297,2,39,10,3,11,8,73,38.254621626937215,-109.4079295
34298,3,35,10,4,10,6,68,38.254621626937215,-109.40766
34299,3,36,10,4,10,5,68,38.254621626937215,-109.4073905
34300,3,36,10,6,12,5,72,38.254621626937215,-109.407121
34301,4,36,11,7,15,4,77,38.254621626937215,-109.4068515
34302,4,42,12,9,15,3,85,38.254621626937215,-109.406582
34303,4,46,13,9,16,2,90,38.254621626937215,-109.4063125
34304,4,46,13,7,16,2,88,38.254621626937215,-109.406043
34305,4,46,13,7,17,3,90,38.254621626937215,-109.4057735
34306,4,48,13,8,17,1,91,38.254621626937215,-109.405504
34307,6,39,13,10,18,3,89,38.254621626937215,-109.4052345
34308,3,40,12,9,19,3,86,38.254621626937215,-109.4049651
34309,3,43,12,6,19,3,86,38.254621626937215,-109.4046956
34310,4,47,12,4,18,3,88,38.254621626937215,-109.4044261
34311,4,49,12,6,18,1,90,38.254621626937215,-109.4041566
34312,3,46,12,5,17,3,86,38.254621626937215,-109.4038871
34313,3,43,12,4,17,4,83,38.254621626937215,-109.4036176
34314,3,44,11,2,16,6,82,38.254621626937215,-109.4033481
34315,2,46,11,1,14,7,81,38.254621626937215,-109.4030786
34316,2,42,9,1,10,8,72,38.254621626937215,-109.4028091
34317,4,41,8,1,8,6,68,38.254621626937215,-109.4025396
34318,3,42,7,4,7,4,67,38.254621626937215,-109.4022701
34319,3,43,7,5,8,4,70,38.254621626937215,-109.4020006
34320,2,45,7,6,8,3,71,38.254621626937215,-109.4017311
34321,2,41,7,6,8,3,67,38.254621626937215,-109.4014616
34322,2,43,7,6,6,3,67,38.254621626937215,-109.4011921
34323,2,41,7,6,6,3,65,38.254621626937215,-109.4009226
34324,1,36,7,7,7,4,62,38.254621626937215,-109.4006531
34325,2,34,8,5,9,5,63,38.254621626937215,-109.4003836
34326,2,34,10,2,8,9,65,38.254621626937215,-109.4001142
34327,1,37,12,0,9,11,70,38.254621626937215,-109.3998447
34328,1,39,11,1,10,10,72,38.254621626937215,-109.3995752
34329,1,35,11,1,10,10,68,38.254621626937215,-109.3993057
34330,1,33,11,2,9,10,66,38.254621626937215,-109.3990362
34331,2,36,10,1,7,10,66,38.254621626937215,-109.3987667
34332,2,38,10,1,7,10,68,38.254621626937215,-109.3984972
34333,2,36,10,2,8,9,67,38.254621626937215,-109.3982277
34334,3,31,10,3,10,7,64,38.254621626937215,-109.3979582
34335,2,31,9,2,8,9,61,38.254621626937215,-109.3976887
34336,1,32,10,1,8,10,62,38.254621626937215,-109.3974192
34337,2,34,10,1,8,10,65,38.254621626937215,-109.3971497
34338,2,35,9,2,8,8,64,38.254621626937215,-109.3968802
34339,2,36,9,2,9,8,66,38.254621626937215,-109.3966107
34340,1,29,11,2,7,14,64,38.254621626937215,-109.3963412
34341,1,28,11,0,7,16,63,38.254621626937215,-109.3960717
34342,1,31,11,0,9,15,67,38.254621626937215,-109.3958022
34343,2,36,12,1,13,11,75,38.254621626937215,-109.3955327
34344,2,35,12,2,13,10,74,38.254621626937215,-109.3952632
34345,2,37,11,1,12,11,74,38.254621626937215,-109.3949938
34346,2,39,11,1,14,9,76,38.254621626937215,-109.3947243
34347,2,41,11,1,14,8,77,38.254621626937215,-109.3944548
34348,2,46,11,2,14,6,81,38.254621626937215,-109.3941853
34349,2,46,10,0,13,7,78,38.254621626937215,-109.3939158
34350,2,42,11,2,15,5,77,38.254621626937215,-109.3936463
34351,2,39,11,2,13,7,74,38.254621626937215,-109.3933768
34352,2,38,10,2,10,8,70,38.254621626937215,-109.3931073
34353,3,35,10,2,9,7,66,38.254621626937215,-109.3928378
34354,2,33,10,2,8,7,62,38.254621626937215,-109.3925683
34355,2,30,10,4,8,7,61,38.254621626937215,-109.3922988
34356,3,29,10,6,9,6,63,38.254621626937215,-109.3920293
34357,4,33,10,8,11,3,69,38.254621626937215,-109.3917598
34358,2,35,10,5,11,5,68,38.254621626937215,-109.3914903
34359,3,34,12,13,14,3,79,38.254621626937215,-109.3912208
34360,2,35,12,15,21,2,87,38.254621626937215,-109.3909513
34361,2,32,12,13,22,3,84,38.254621626937215,-109.3906818
34362,3,29,12,11,19,5,79,38.254621626937215,-109.3904123
34363,1,29,11,11,18,4,74,38.254621626937215,-109.3901429
34364,1,27,11,17,14,3,73,38.254621626937215,-109.3898734
34365,2,29,10,14,12,3,70,38.254621626937215,-109.3896039
34366,2,34,9,15,10,2,72,38.254621626937215,-109.3893344
34367,1,37,8,19,12,0,77,38.254621626937215,-109.3890649
34368,0,30,8,14,16,4,72,38.254621626937215,-109.3887954
34369,0,28,11,10,17,7,73,38.254621626937215,-109.3885259
34370,0,30,12,3,17,11,73,38.254621626937215,-109.3882564
34371,0,30,11,2,15,13,71,38.254621626937215,-109.3879869
34372,0,32,10,0,12,16,70,38.254621626937215,-109.3877174
34373,2,40,10,0,12,10,74,38.254621626937215,-109.3874479
34374,1,38,9,3,8,9,68,38.254621626937215,-109.3871784
34375,1,33,9,5,8,8,64,38.254621626937215,-109.3869089
34376,6,31,11,7,16,4,75,38.254621626937215,-109.3866394
34377,1,34,11,2,12,11,71,38.254621626937215,-109.3863699
34378,2,38,11,5,13,7,76,38.254621626937215,-109.3861004
34379,3,42,11,7,13,3,79,38.254621626937215,-109.3858309
34380,3,48,10,7,12,3,83,38.254621626937215,-109.3855614
34381,4,48,11,8,12,3,86,38.254621626937215,-109.3852919
34382,5,49,11,7,11,3,86,38.254621626937215,-109.3850225
34383,5,43,10,8,11,3,80,38.254621626937215,-109.384753
34384,6,41,9,10,11,2,79,38.254621626937215,-109.3844835
34385,4,48,9,8,10,1,80,38.254621626937215,-109.384214
34386,3,56,8,6,11,1,85,38.254621626937215,-109.3839445
34387,3,52,9,7,11,1,83,38.254621626937215,-109.383675
34388,4,46,10,8,13,2,83,38.254621626937215,-109.3834055
34389,4,44,10,7,14,3,82,38.254621626937215,-109.383136
34390,8,43,11,6,12,4,84,38.254621626937215,-109.3828665
34391,7,41,11,9,14,2,84,38.254621626937215,-109.382597
34392,5,37,11,7,17,3,80,38.254621626937215,-109.3823275
34393,4,33,11,4,13,7,72,38.254621626937215,-109.382058
34394,7,31,11,7,12,5,73,38.254621626937215,-109.3817885
34395,2,17,9,10,12,5,55,38.254621626937215,-109.381519
34396,3,23,10,8,10,8,62,38.254621626937215,-109.3812495
34397,4,29,10,8,12,6,69,38.254621626937215,-109.38098
34398,7,38,11,10,14,2,82,38.254621626937215,-109.3807105
34399,9,43,13,11,15,0,91,38.254621626937215,-109.380441
34400,7,47,12,9,16,0,91,38.254621626937215,-109.3801716
34401,7,46,13,9,15,0,90,38.254621626937215,-109.3799021
34402,10,42,14,12,14,0,92,38.254621626937215,-109.3796326
34403,11,39,14,14,13,0,91,38.254621626937215,-109.3793631
34404,10,39,15,14,13,1,92,38.254621626937215,-109.3790936
34405,8,39,14,14,13,1,89,38.254621626937215,-109.3788241
34406,8,40,14,15,12,1,90,38.254621626937215,-109.3785546
34407,8,41,14,15,11,1,90,38.254621626937215,-109.3782851
34408,9,40,14,15,11,1,90,38.254621626937215,-109.3780156
34409,12,38,14,15,11,1,91,38.254621626937215,-109.3777461
34410,18,35,14,16,10,0,93,38.254621626937215,-109.3774766
34411,20,33,14,16,9,0,92,38.254621626937215,-109.3772071
34412,22,32,13,16,9,0,92,38.254621626937215,-109.3769376
34413,23,31,13,14,9,0,90,38.254621626937215,-109.3766681
34414,15,33,13,14,12,1,88,38.254621626937215,-109.3763986
34415,13,35,13,14,12,1,88,38.254621626937215,-109.3761291
34416,19,33,13,14,10,1,90,38.254621626937215,-109.3758596
34417,23,31,13,15,9,0,91,38.254621626937215,-109.3755901
34418,19,33,13,13,9,2,89,38.254621626937215,-109.3753206
34419,15,34,13,12,11,3,88,38.254621626937215,-109.3750512
34420,13,35,13,12,11,3,87,38.254621626937215,-109.3747817
34421,12,35,14,12,12,3,88,38.254621626937215,-109.3745122
34422,11,36,14,11,12,4,88,38.254621626937215,-109.3742427
34423,7,39,13,7,11,6,83,38.254621626937215,-109.3739732
34424,6,38,13,3,10,11,81,38.254621626937215,-109.3737037
34425,5,36,13,1,8,16,79,38.254621626937215,-109.3734342
34426,5,36,13,1,7,17,79,38.254621626937215,-109.3731647
34427,6,36,14,1,8,16,81,38.254621626937215,-109.3728952
34428,8,38,15,4,9,13,87,38.254621626937215,-109.3726257
34429,6,37,15,2,8,15,83,38.254621626937215,-109.3723562
34430,5,35,16,1,7,18,82,38.254621626937215,-109.3720867
34431,3,30,16,0,4,23,76,38.254621626937215,-109.3718172
34432,3,25,18,0,2,28,76,38.254621626937215,-109.3715477
34433,5,26,18,0,2,27,78,38.254621626937215,-109.3712782
34434,4,28,18,0,4,24,78,38.254621626937215,-109.3710087
34435,3,30,16,0,5,21,75,38.254621626937215,-109.3707392
34436,4,29,16,1,5,22,77,38.254621626937215,-109.3704697
34437,2,26,16,0,2,27,73,38.254621626937215,-109.3702003
34438,3,29,15,0,5,23,75,38.254621626937215,-109.3699308
34439,1,26,15,0,3,26,71,38.254621626937215,-109.3696613
34440,2,22,15,0,5,26,70,38.254621626937215,-109.3693918
34441,2,23,16,0,6,25,72,38.254621626937215,-109.3691223
34442,2,26,17,2,6,25,78,38.254621626937215,-109.3688528
34443,3,32,17,0,10,24,86,38.254621626937215,-109.3685833
34444,2,29,18,0,9,26,84,38.254621626937215,-109.3683138
34445,2,26,19,0,10,26,83,38.254621626937215,-109.3680443
34446,4,28,18,1,15,20,86,38.254621626937215,-109.3677748
34447,2,23,15,10,13,14,77,38.254621626937215,-109.3675053
34448,3,24,13,12,15,8,75,38.254621626937215,-109.3672358
34449,1,19,12,12,16,6,66,38.254621626937215,-109.3669663
34450,0,14,10,11,15,3,53,38.254621626937215,-109.3666968
34451,3,15,9,10,16,2,55,38.254621626937215,-109.3664273
34452,0,20,12,6,8,16,62,38.254621626937215,-109.3661578
34453,2,22,14,0,3,24,65,38.254621626937215,-109.3658883
34454,2,23,14,0,2,25,66,38.254621626937215,-109.3656188
34455,2,25,13,0,3,23,66,38.254621626937215,-109.3653493
34456,1,25,13,0,3,23,65,38.254621626937215,-109.3650799
34457,1,26,12,0,4,21,64,38.254621626937215,-109.3648104
34458,1,26,12,0,5,20,64,38.254621626937215,-109.3645409
34459,1,26,12,0,4,21,64,38.254621626937215,-109.3642714
34460,1,26,12,0,3,21,63,38.254621626937215,-109.3640019
34461,1,24,12,0,4,19,60,38.254621626937215,-109.3637324
34462,2,25,13,0,4,21,65,38.254621626937215,-109.3634629
34463,2,24,14,0,4,25,69,38.254621626937215,-109.3631934
34464,1,22,15,0,3,28,69,38.254621626937215,-109.3629239
34465,2,21,15,0,1,27,66,38.254621626937215,-109.3626544
34466,3,24,16,0,2,25,70,38.254621626937215,-109.3623849
34467,2,24,16,0,2,27,71,38.254621626937215,-109.3621154
34468,1,23,16,0,2,30,72,38.254621626937215,-109.3618459
34469,1,22,17,0,2,31,73,38.254621626937215,-109.3615764
34470,1,21,18,0,2,34,76,38.254621626937215,-109.3613069
34471,1,22,17,0,2,33,75,38.254621626937215,-109.3610374
34472,0,22,16,0,3,31,72,38.254621626937215,-109.3607679
34473,1,22,16,0,2,31,72,38.254621626937215,-109.3604984
34474,1,22,16,1,1,30,71,38.254621626937215,-109.360229
34475,2,23,17,1,1,31,75,38.254621626937215,-109.3599595
34476,1,21,17,0,2,32,73,38.254621626937215,-109.35969
34477,1,21,16,0,1,31,70,38.254621626937215,-109.3594205
34478,1,21,16,1,0,30,69,38.254621626937215,-109.359151
34479,1,22,15,2,1,27,68,38.254621626937215,-109.3588815
34480,1,22,14,1,1,26,65,38.254621626937215,-109.358612
34481,1,22,14,1,1,26,65,38.254621626937215,-109.3583425
34482,1,22,14,1,1,26,65,38.254621626937215,-109.358073
34483,1,23,14,1,1,26,66,38.254621626937215,-109.3578035
34484,1,25,14,0,2,25,67,38.254621626937215,-109.357534
34485,0,23,14,0,1,27,65,38.254621626937215,-109.3572645
34486,0,21,15,0,0,28,64,38.254621626937215,-109.356995
34487,1,21,15,0,0,28,65,38.254621626937215,-109.3567255
34488,2,21,15,0,1,28,67,38.254621626937215,-109.356456
34489,1,18,16,0,1,32,68,38.254621626937215,-109.3561865
34490,0,20,17,0,1,33,71,38.254621626937215,-109.355917
34491,0,19,18,0,1,34,72,38.254621626937215,-109.3556475
34492,1,18,18,0,1,34,72,38.254621626937215,-109.355378
34493,1,19,18,0,0,33,71,38.254621626937215,-109.3551086
34494,1,19,16,0,0,29,65,38.254621626937215,-109.3548391
34495,1,19,15,0,1,29,65,38.254621626937215,-109.3545696
34496,1,20,15,1,1,28,66,38.254621626937215,-109.3543001
34497,1,24,14,3,2,26,70,38.254621626937215,-109.3540306
34498,1,21,16,1,1,29,69,38.254621626937215,-109.3537611
34499,1,20,16,0,1,29,67,38.254621626937215,-109.3534916
34500,1,21,15,0,1,28,66,38.254621626937215,-109.3532221
34501,1,21,14,0,1,25,62,38.254621626937215,-109.3529526
34502,6,23,13,0,2,21,65,38.254621626937215,-109.3526831
34503,2,24,11,1,6,16,60,38.254621626937215,-109.3524136
34504,6,24,8,3,4,10,55,38.254621626937215,-109.3521441
34505,5,25,7,3,7,6,53,38.254621626937215,-109.3518746
34506,3,31,7,4,8,5,58,38.254621626937215,-109.3516051
34507,2,30,7,4,8,6,57,38.254621626937215,-109.3513356
34508,2,26,6,2,8,6,50,38.254621626937215,-109.3510661
34509,1,31,7,4,9,6,58,38.254621626937215,-109.3507966
34510,1,31,8,3,9,6,58,38.254621626937215,-109.3505271
34511,1,35,9,3,9,6,63,38.254621626937215,-109.3502577
34512,5,26,8,4,8,7,58,38.254621626937215,-109.3499882
34513,5,29,9,6,8,3,60,38.254621626937215,-109.3497187
34514,3,34,8,7,8,5,65,38.254621626937215,-109.3494492
34515,3,23,11,7,6,8,58,38.254621626937215,-109.3491797
34516,4,24,11,13,11,2,65,38.254621626937215,-109.3489102
34517,5,32,9,9,7,3,65,38.254621626937215,-109.3486407
34518,4,21,11,4,10,9,59,38.254621626937215,-109.3483712
34519,1,21,12,2,7,16,59,38.254621626937215,-109.3481017
34520,0,20,9,0,8,13,50,38.254621626937215,-109.3478322
34521,0,24,8,1,11,6,50,38.254621626937215,-109.3475627
34522,0,24,7,3,11,4,49,38.254621626937215,-109.3472932
34523,1,42,7,5,8,3,66,38.254621626937215,-109.3470237
34524,3,52,6,3,9,2,75,38.254621626937215,-109.3467542
34525,3,54,6,3,9,2,77,38.254621626937215,-109.3464847
34526,2,49,6,3,9,3,72,38.254621626937215,-109.3462152
34527,2,39,7,2,9,5,64,38.254621626937215,-109.3459457
34528,1,31,7,2,10,6,57,38.254621626937215,-109.3456762
34529,1,34,7,2,9,7,60,38.254621626937215,-109.3454068
34530,2,35,9,4,9,8,67,38.254621626937215,-109.3451373
34531,2,26,10,4,6,13,61,38.254621626937215,-109.3448678
34532,2,19,14,2,4,20,61,38.254621626937215,-109.3445983
34533,0,17,12,1,3,19,52,38.254621626937215,-109.3443288
34534,0,13,7,4,8,8,40,38.254621626937215,-109.3440593
34535,1,15,6,5,10,3,40,38.254621626937215,-109.3437898
34536,6,18,9,7,12,4,56,38.254621626937215,-109.3435203
34537,3,15,12,5,5,16,56,38.254621626937215,-109.3432508
34538,2,14,16,4,3,29,68,38.254621626937215,-109.3429813
34539,2,15,18,1,2,34,72,38.254621626937215,-109.3427118
34540,2,15,20,0,1,35,73,38.254621626937215,-109.3424423
34541,2,14,19,1,2,33,71,38.254621626937215,-109.3421728
34542,3,12,17,2,2,29,65,38.254621626937215,-109.3419033
34543,3,11,17,1,2,28,62,38.254621626937215,-109.3416338
34544,0,14,14,2,1,24,55,38.254621626937215,-109.3413643
34545,0,16,12,3,2,20,53,38.254621626937215,-109.3410948
34546,0,13,11,5,2,19,50,38.254621626937215,-109.3408253
34547,2,14,10,6,4,14,50,38.254621626937215,-109.3405558
34548,2,15,10,6,4,14,51,38.254621626937215,-109.3402864
34549,1,19,10,4,4,14,52,38.254621626937215,-109.3400169
34550,1,20,10,4,5,16,56,38.254621626937215,-109.3397474
34551,0,17,13,3,6,18,57,38.254621626937215,-109.3394779
34552,0,16,12,0,3,20,51,38.254621626937215,-109.3392084
34553,0,22,13,0,4,18,57,38.254621626937215,-109.3389389
34554,0,33,11,0,9,14,67,38.254621626937215,-109.3386694
34555,0,28,12,2,9,17,68,38.254621626937215,-109.3383999
34556,0,25,12,1,8,19,65,38.254621626937215,-109.3381304
34557,0,22,12,1,7,19,61,38.254621626937215,-109.3378609
34558,1,20,14,4,6,20,65,38.254621626937215,-109.3375914
34559,1,18,15,3,4,23,64,38.254621626937215,-109.3373219
34560,1,23,12,4,6,17,63,38.254621626937215,-109.3370524
34561,1,29,10,3,11,11,65,38.254621626937215,-109.3367829
34562,1,34,10,2,13,9,69,38.254621626937215,-109.3365134
34563,1,35,10,1,11,11,69,38.254621626937215,-109.3362439
34564,1,40,10,1,14,8,74,38.254621626937215,-109.3359744
34565,1,36,10,2,13,8,70,38.254621626937215,-109.3357049
34566,0,35,9,2,11,8,65,38.254621626937215,-109.3354355
34567,3,33,9,4,9,5,63,38.254621626937215,-109.335166
34568,2,31,7,4,9,4,57,38.254621626937215,-109.3348965
34569,2,20,10,6,9,6,53,38.254621626937215,-109.334627
34570,5,16,13,10,12,11,67,38.254621626937215,-109.3343575
34571,3,16,13,6,10,20,68,38.254621626937215,-109.334088
34572,2,14,13,2,6,24,61,38.254621626937215,-109.3338185
34573,2,23,10,6,8,9,58,38.254621626937215,-109.333549
34574,2,26,10,5,7,7,57,38.254621626937215,-109.3332795
34575,4,26,10,4,8,7,59,38.254621626937215,-109.33301
34576,5,25,11,4,9,8,62,38.254621626937215,-109.3327405
34577,1,19,12,4,6,15,57,38.254621626937215,-109.332471
34578,7,25,13,6,10,8,69,38.254621626937215,-109.3322015
34579,3,22,11,3,8,12,59,38.254621626937215,-109.331932
34580,3,47,8,5,11,4,78,38.254352132351976,-109.4405383
34581,2,47,8,4,11,4,76,38.254352132351976,-109.4402688
34582,2,46,9,4,11,4,76,38.254352132351976,-109.4399993
34583,3,51,9,5,12,4,84,38.254352132351976,-109.4397299
34584,6,54,11,8,13,1,93,38.254352132351976,-109.4394604
34585,5,47,12,6,15,4,89,38.254352132351976,-109.4391909
34586,5,48,12,5,14,5,89,38.254352132351976,-109.4389214
34587,5,50,11,5,15,3,89,38.254352132351976,-109.4386519
34588,4,44,11,6,14,3,82,38.254352132351976,-109.4383824
34589,2,39,10,2,12,10,75,38.254352132351976,-109.4381129
34590,2,42,9,1,12,8,74,38.254352132351976,-109.4378434
34591,2,45,9,2,13,6,77,38.254352132351976,-109.4375739
34592,3,45,10,3,14,5,80,38.254352132351976,-109.4373044
34593,4,40,11,5,13,6,79,38.254352132351976,-109.4370349
34594,6,37,12,2,9,12,78,38.254352132351976,-109.4367654
34595,5,35,12,0,8,13,73,38.254352132351976,-109.4364959
34596,4,32,11,1,10,10,68,38.254352132351976,-109.4362264
34597,2,32,9,3,8,8,62,38.254352132351976,-109.4359569
34598,1,32,8,3,7,9,60,38.254352132351976,-109.4356874
34599,1,37,8,0,8,9,63,38.254352132351976,-109.4354179
34600,2,40,9,2,10,7,70,38.254352132351976,-109.4351484
34601,3,41,9,2,10,6,71,38.254352132351976,-109.434879
34602,2,42,9,2,10,6,71,38.254352132351976,-109.4346095
34603,1,39,9,1,8,9,67,38.254352132351976,-109.43434
34604,2,38,9,1,11,8,69,38.254352132351976,-109.4340705
34605,2,35,10,2,12,8,69,38.254352132351976,-109.433801
34606,3,38,10,3,14,6,74,38.254352132351976,-109.4335315
34607,9,42,10,5,14,2,82,38.254352132351976,-109.433262
34608,6,44,10,6,11,2,79,38.254352132351976,-109.4329925
34609,5,46,9,6,11,2,79,38.254352132351976,-109.432723
34610,5,47,10,7,12,1,82,38.254352132351976,-109.4324535
34611,7,45,11,8,14,1,86,38.254352132351976,-109.432184
34612,10,40,12,10,15,1,88,38.254352132351976,-109.4319145
34613,13,38,13,11,14,0,89,38.254352132351976,-109.431645
34614,15,36,14,13,13,0,91,38.254352132351976,-109.4313755
34615,18,36,14,12,13,0,93,38.254352132351976,-109.431106
34616,18,37,14,11,13,0,93,38.254352132351976,-109.4308365
34617,11,42,13,11,14,0,91,38.254352132351976,-109.430567
34618,10,44,12,10,14,0,90,38.254352132351976,-109.4302975
34619,10,43,12,11,14,0,90,38.254352132351976,-109.430028
34620,9,43,13,11,14,0,90,38.254352132351976,-109.4297586
34621,6,44,12,10,14,1,87,38.254352132351976,-109.4294891
34622,7,43,13,11,13,1,88,38.254352132351976,-109.4292196
34623,6,44,12,11,13,1,87,38.254352132351976,-109.4289501
34624,4,51,11,8,14,1,89,38.254352132351976,-109.4286806
34625,3,56,10,6,16,1,92,38.254352132351976,-109.4284111
34626,4,54,10,7,15,0,90,38.254352132351976,-109.4281416
34627,5,49,12,9,15,1,91,38.254352132351976,-109.4278721
34628,9,44,13,11,15,0,92,38.254352132351976,-109.4276026
34629,12,41,13,12,15,0,93,38.254352132351976,-109.4273331
34630,13,40,14,12,15,0,94,38.254352132351976,-109.4270636
34631,11,40,13,12,15,0,91,38.254352132351976,-109.4267941
34632,13,38,14,13,14,0,92,38.254352132351976,-109.4265246
34633,17,35,14,13,13,0,92,38.254352132351976,-109.4262551
34634,23,32,15,12,12,0,94,38.254352132351976,-109.4259856
34635,24,31,15,12,11,0,93,38.254352132351976,-109.4257161
34636,20,33,14,14,12,0,93,38.254352132351976,-109.4254466
34637,20,33,14,14,12,0,93,38.254352132351976,-109.4251771
34638,18,34,14,13,13,0,92,38.254352132351976,-109.4249077
34639,19,33,13,13,13,0,91,38.254352132351976,-109.4246382
34640,21,32,14,12,13,0,92,38.254352132351976,-109.4243687
34641,17,34,13,12,14,0,90,38.254352132351976,-109.4240992
34642,16,34,14,13,14,0,91,38.254352132351976,-109.4238297
34643,15,35,14,14,13,0,91,38.254352132351976,-109.4235602
34644,14,37,14,14,12,0,91,38.254352132351976,-109.4232907
34645,13,39,14,13,12,0,91,38.254352132351976,-109.4230212
34646,8,44,13,10,14,1,90,38.254352132351976,-109.4227517
34647,5,48,11,9,14,1,88,38.254352132351976,-109.4224822
34648,7,47,11,10,14,1,90,38.254352132351976,-109.4222127
34649,14,40,13,10,14,0,91,38.254352132351976,-109.4219432
34650,9,41,13,11,15,0,89,38.254352132351976,-109.4216737
34651,5,45,11,8,15,1,85,38.254352132351976,-109.4214042
34652,4,46,11,6,15,3,85,38.254352132351976,-109.4211347
34653,5,47,11,6,14,3,86,38.254352132351976,-109.4208652
34654,5,47,11,8,14,2,87,38.254352132351976,-109.4205957
34655,4,49,11,6,14,3,87,38.254352132351976,-109.4203262
34656,3,51,10,3,15,3,85,38.254352132351976,-109.4200568
34657,4,50,11,4,14,4,87,38.254352132351976,-109.4197873
34658,6,45,12,8,13,3,87,38.254352132351976,-109.4195178
34659,10,42,14,12,14,1,93,38.254352132351976,-109.4192483
34660,11,38,14,13,12,1,89,38.254352132351976,-109.4189788
34661,12,36,15,14,12,1,90,38.254352132351976,-109.4187093
34662,11,36,14,14,12,1,88,38.254352132351976,-109.4184398
34663,9,39,13,12,12,1,86,38.254352132351976,-109.4181703
34664,9,42,12,10,13,2,88,38.254352132351976,-109.4179008
34665,7,42,11,9,12,2,83,38.254352132351976,-109.4176313
34666,8,39,13,11,13,2,86,38.254352132351976,-109.4173618
34667,11,36,14,13,12,1,87,38.254352132351976,-109.4170923
34668,10,38,13,13,12,1,87,38.254352132351976,-109.4168228
34669,6,42,13,11,13,1,86,38.254352132351976,-109.4165533
34670,9,39,13,13,14,1,89,38.254352132351976,-109.4162838
34671,12,38,13,13,13,0,89,38.254352132351976,-109.4160143
34672,10,39,13,12,13,1,88,38.254352132351976,-109.4157448
34673,7,43,12,6,14,3,85,38.254352132351976,-109.4154753
34674,5,38,11,6,15,3,78,38.254352132351976,-109.4152058
34675,9,34,12,8,15,2,80,38.254352132351976,-109.4149364
34676,14,33,13,11,13,2,86,38.254352132351976,-109.4146669
34677,14,35,13,11,13,1,87,38.254352132351976,-109.4143974
34678,18,34,14,12,12,1,91,38.254352132351976,-109.4141279
34679,17,33,14,13,12,1,90,38.254352132351976,-109.4138584
34680,15,33,14,13,13,1,89,38.254352132351976,-109.4135889
34681,15,34,13,12,13,1,88,38.254352132351976,-109.4133194
34682,15,34,13,13,13,1,89,38.254352132351976,-109.4130499
34683,12,37,13,12,14,1,89,38.254352132351976,-109.4127804
34684,6,43,12,8,14,2,85,38.254352132351976,-109.4125109
34685,3,46,10,3,14,3,79,38.254352132351976,-109.4122414
34686,1,46,9,1,13,5,75,38.254352132351976,-109.4119719
34687,2,40,8,2,9,5,66,38.254352132351976,-109.4117024
34688,2,35,7,1,7,8,60,38.254352132351976,-109.4114329
34689,3,35,8,2,7,7,62,38.254352132351976,-109.4111634
34690,3,35,8,3,7,6,62,38.254352132351976,-109.4108939
34691,2,38,7,3,6,5,61,38.254352132351976,-109.4106244
34692,2,32,7,4,7,6,58,38.254352132351976,-109.4103549
34693,2,31,8,4,7,6,58,38.254352132351976,-109.4100855
34694,2,31,8,4,8,6,59,38.254352132351976,-109.409816
34695,3,29,10,4,8,7,61,38.254352132351976,-109.4095465
34696,5,29,12,4,9,9,68,38.254352132351976,-109.409277
34697,2,34,11,4,11,8,70,38.254352132351976,-109.4090075
34698,4,38,12,8,12,4,78,38.254352132351976,-109.408738
34699,5,40,12,12,12,2,83,38.254352132351976,-109.4084685
34700,5,41,12,12,11,2,83,38.254352132351976,-109.408199
34701,4,43,12,9,10,3,81,38.254352132351976,-109.4079295
34702,4,39,11,9,11,3,77,38.254352132351976,-109.40766
34703,3,38,11,7,12,4,75,38.254352132351976,-109.4073905
34704,3,36,11,5,13,7,75,38.254352132351976,-109.407121
34705,6,35,12,6,13,8,80,38.254352132351976,-109.4068515
34706,4,39,12,8,15,4,82,38.254352132351976,-109.406582
34707,4,45,12,10,14,2,87,38.254352132351976,-109.4063125
34708,5,45,13,11,14,1,89,38.254352132351976,-109.406043
34709,4,43,13,11,16,2,89,38.254352132351976,-109.4057735
34710,5,42,13,11,18,2,91,38.254352132351976,-109.405504
34711,4,37,13,7,17,7,85,38.254352132351976,-109.4052345
34712,4,42,12,9,19,2,88,38.254352132351976,-109.4049651
34713,4,46,12,7,18,1,88,38.254352132351976,-109.4046956
34714,4,47,12,5,18,2,88,38.254352132351976,-109.4044261
34715,4,47,13,7,18,1,90,38.254352132351976,-109.4041566
34716,4,45,12,9,17,2,89,38.254352132351976,-109.4038871
34717,4,45,12,8,17,2,88,38.254352132351976,-109.4036176
34718,4,47,11,4,16,2,84,38.254352132351976,-109.4033481
34719,3,48,10,2,14,3,80,38.254352132351976,-109.4030786
34720,2,40,9,2,9,5,67,38.254352132351976,-109.4028091
34721,4,43,7,3,6,5,68,38.254352132351976,-109.4025396
34722,4,46,7,3,5,4,69,38.254352132351976,-109.4022701
34723,3,46,6,4,6,4,69,38.254352132351976,-109.4020006
34724,2,45,6,4,5,4,66,38.254352132351976,-109.4017311
34725,2,46,6,4,5,3,66,38.254352132351976,-109.4014616
34726,3,47,6,5,6,2,69,38.254352132351976,-109.4011921
34727,2,43,7,3,7,4,66,38.254352132351976,-109.4009226
34728,2,42,10,2,7,7,70,38.254352132351976,-109.4006531
34729,1,39,11,4,12,7,74,38.254352132351976,-109.4003836
34730,1,37,11,2,11,10,72,38.254352132351976,-109.4001142
34731,1,34,11,1,11,11,69,38.254352132351976,-109.3998447
34732,1,34,11,1,10,12,69,38.254352132351976,-109.3995752
34733,1,34,11,2,10,11,69,38.254352132351976,-109.3993057
34734,2,39,10,3,10,7,71,38.254352132351976,-109.3990362
34735,2,42,9,4,8,6,71,38.254352132351976,-109.3987667
34736,2,41,9,4,9,5,70,38.254352132351976,-109.3984972
34737,2,39,10,3,9,6,69,38.254352132351976,-109.3982277
34738,2,35,9,2,9,7,64,38.254352132351976,-109.3979582
34739,2,31,9,1,7,10,60,38.254352132351976,-109.3976887
34740,1,31,9,0,7,11,59,38.254352132351976,-109.3974192
34741,1,35,8,0,6,10,60,38.254352132351976,-109.3971497
34742,2,34,8,2,7,8,61,38.254352132351976,-109.3968802
34743,2,29,10,3,8,11,63,38.254352132351976,-109.3966107
34744,1,29,12,0,7,17,66,38.254352132351976,-109.3963412
34745,1,30,11,0,7,19,68,38.254352132351976,-109.3960717
34746,2,36,11,0,11,14,74,38.254352132351976,-109.3958022
34747,2,39,11,1,14,11,78,38.254352132351976,-109.3955327
34748,2,34,10,0,7,17,70,38.254352132351976,-109.3952632
34749,1,32,10,0,9,14,66,38.254352132351976,-109.3949938
34750,1,35,10,0,11,13,70,38.254352132351976,-109.3947243
34751,1,40,10,0,12,12,75,38.254352132351976,-109.3944548
34752,2,44,10,0,12,11,79,38.254352132351976,-109.3941853
34753,2,41,10,1,12,9,75,38.254352132351976,-109.3939158
34754,1,36,10,2,10,9,68,38.254352132351976,-109.3936463
34755,1,33,10,3,8,9,64,38.254352132351976,-109.3933768
34756,2,33,10,3,8,7,63,38.254352132351976,-109.3931073
34757,2,33,9,2,8,6,60,38.254352132351976,-109.3928378
34758,3,32,10,8,13,4,70,38.254352132351976,-109.3925683
34759,5,29,12,17,14,3,80,38.254352132351976,-109.3922988
34760,4,28,12,21,15,3,83,38.254352132351976,-109.3920293
34761,2,30,12,16,22,2,84,38.254352132351976,-109.3917598
34762,1,28,12,23,21,1,86,38.254352132351976,-109.3914903
34763,1,29,12,19,24,0,85,38.254352132351976,-109.3912208
34764,0,28,12,18,25,0,83,38.254352132351976,-109.3909513
34765,1,27,12,19,23,1,83,38.254352132351976,-109.3906818
34766,1,26,13,12,16,8,76,38.254352132351976,-109.3904123
34767,1,29,12,11,18,5,76,38.254352132351976,-109.3901429
34768,1,28,11,13,14,4,71,38.254352132351976,-109.3898734
34769,1,30,10,14,13,2,70,38.254352132351976,-109.3896039
34770,2,31,10,15,15,1,74,38.254352132351976,-109.3893344
34771,0,27,11,10,16,6,70,38.254352132351976,-109.3890649
34772,0,31,13,4,17,10,75,38.254352132351976,-109.3887954
34773,0,34,11,0,14,12,71,38.254352132351976,-109.3885259
34774,2,36,11,0,12,13,74,38.254352132351976,-109.3882564
34775,2,36,11,0,11,14,74,38.254352132351976,-109.3879869
34776,1,36,10,0,11,16,74,38.254352132351976,-109.3877174
34777,3,40,10,0,12,11,76,38.254352132351976,-109.3874479
34778,0,40,9,1,8,10,68,38.254352132351976,-109.3871784
34779,2,37,9,5,8,5,66,38.254352132351976,-109.3869089
34780,12,34,11,9,11,0,77,38.254352132351976,-109.3866394
34781,3,43,8,6,8,4,72,38.254352132351976,-109.3863699
34782,4,40,10,6,12,2,74,38.254352132351976,-109.3861004
34783,4,41,10,6,13,3,77,38.254352132351976,-109.3858309
34784,3,48,10,5,13,3,82,38.254352132351976,-109.3855614
34785,5,52,12,8,12,2,91,38.254352132351976,-109.3852919
34786,3,50,10,7,11,2,83,38.254352132351976,-109.3850225
34787,4,48,9,8,10,1,80,38.254352132351976,-109.384753
34788,4,48,9,9,10,1,81,38.254352132351976,-109.3844835
34789,3,50,9,9,10,1,82,38.254352132351976,-109.384214
34790,4,46,9,9,11,1,80,38.254352132351976,-109.3839445
34791,6,42,11,14,13,1,87,38.254352132351976,-109.383675
34792,13,37,13,13,13,1,90,38.254352132351976,-109.3834055
34793,18,35,12,10,12,1,88,38.254352132351976,-109.383136
34794,19,34,12,10,11,1,87,38.254352132351976,-109.3828665
34795,15,35,12,10,14,1,87,38.254352132351976,-109.382597
34796,8,34,12,11,17,2,84,38.254352132351976,-109.3823275
34797,6,30,11,8,14,5,74,38.254352132351976,-109.382058
34798,8,24,11,9,13,3,68,38.254352132351976,-109.3817885
34799,8,23,12,15,13,1,72,38.254352132351976,-109.381519
34800,8,32,12,10,14,3,79,38.254352132351976,-109.3812495
34801,7,38,11,5,14,5,80,38.254352132351976,-109.38098
34802,8,43,11,6,16,2,86,38.254352132351976,-109.3807105
34803,10,45,13,8,15,0,91,38.254352132351976,-109.380441
34804,12,41,14,11,14,0,92,38.254352132351976,-109.3801716
34805,10,43,14,11,15,0,93,38.254352132351976,-109.3799021
34806,9,42,13,12,14,1,91,38.254352132351976,-109.3796326
34807,10,40,14,14,13,1,92,38.254352132351976,-109.3793631
34808,11,38,14,15,11,1,90,38.254352132351976,-109.3790936
34809,11,38,14,15,11,1,90,38.254352132351976,-109.3788241
34810,11,38,14,16,11,1,91,38.254352132351976,-109.3785546
34811,12,37,14,17,11,1,92,38.254352132351976,-109.3782851
34812,15,37,14,15,11,1,93,38.254352132351976,-109.3780156
34813,17,35,14,15,11,1,93,38.254352132351976,-109.3777461
34814,19,33,13,14,10,1,90,38.254352132351976,-109.3774766
34815,20,33,13,15,10,1,92,38.254352132351976,-109.3772071
34816,19,32,13,16,10,1,91,38.254352132351976,-109.3769376
34817,20,30,13,16,9,1,89,38.254352132351976,-109.3766681
34818,23,28,13,16,9,0,89,38.254352132351976,-109.3763986
34819,23,26,14,18,8,1,90,38.254352132351976,-109.3761291
34820,24,26,14,19,7,1,91,38.254352132351976,-109.3758596
34821,23,28,14,20,7,0,92,38.254352132351976,-109.3755901
34822,19,29,13,19,8,2,90,38.254352132351976,-109.3753206
34823,16,30,14,17,9,2,88,38.254352132351976,-109.3750512
34824,13,32,14,17,10,2,88,38.254352132351976,-109.3747817
34825,12,33,15,15,11,3,89,38.254352132351976,-109.3745122
34826,13,33,16,14,11,3,90,38.254352132351976,-109.3742427
34827,13,34,17,12,9,4,89,38.254352132351976,-109.3739732
34828,9,38,13,7,11,7,85,38.254352132351976,-109.3737037
34829,7,38,13,4,10,10,82,38.254352132351976,-109.3734342
34830,6,37,13,2,9,14,81,38.254352132351976,-109.3731647
34831,6,36,14,1,8,15,80,38.254352132351976,-109.3728952
34832,7,36,16,3,8,16,86,38.254352132351976,-109.3726257
34833,6,35,17,2,7,18,85,38.254352132351976,-109.3723562
34834,5,34,17,1,6,19,82,38.254352132351976,-109.3720867
34835,3,29,16,0,5,24,77,38.254352132351976,-109.3718172
34836,2,22,17,0,2,29,72,38.254352132351976,-109.3715477
34837,3,25,17,1,3,28,77,38.254352132351976,-109.3712782
34838,3,26,16,0,4,24,73,38.254352132351976,-109.3710087
34839,3,29,15,0,6,21,74,38.254352132351976,-109.3707392
34840,3,29,16,1,6,21,76,38.254352132351976,-109.3704697
34841,1,26,16,0,4,24,71,38.254352132351976,-109.3702003
34842,3,32,13,0,6,19,73,38.254352132351976,-109.3699308
34843,1,27,13,0,4,22,67,38.254352132351976,-109.3696613
34844,2,22,14,0,4,25,67,38.254352132351976,-109.3693918
34845,3,24,16,2,3,25,73,38.254352132351976,-109.3691223
34846,1,29,16,2,5,24,77,38.254352132351976,-109.3688528
34847,1,30,16,0,10,23,80,38.254352132351976,-109.3685833
34848,1,30,16,1,10,23,81,38.254352132351976,-109.3683138
34849,2,30,17,0,10,24,83,38.254352132351976,-109.3680443
34850,3,30,16,2,13,20,84,38.254352132351976,-109.3677748
34851,2,30,17,5,12,18,84,38.254352132351976,-109.3675053
34852,2,26,14,10,15,11,78,38.254352132351976,-109.3672358
34853,3,17,14,15,16,5,70,38.254352132351976,-109.3669663
34854,3,12,9,13,11,4,52,38.254352132351976,-109.3666968
34855,2,12,10,12,13,6,55,38.254352132351976,-109.3664273
34856,0,21,12,6,9,13,61,38.254352132351976,-109.3661578
34857,1,20,14,0,3,24,62,38.254352132351976,-109.3658883
34858,2,22,15,0,2,27,68,38.254352132351976,-109.3656188
34859,2,24,15,0,3,25,69,38.254352132351976,-109.3653493
34860,2,26,14,0,4,23,69,38.254352132351976,-109.3650799
34861,2,25,14,0,3,24,68,38.254352132351976,-109.3648104
34862,1,24,13,0,2,24,64,38.254352132351976,-109.3645409
34863,1,26,13,0,3,24,67,38.254352132351976,-109.3642714
34864,1,27,14,0,3,24,69,38.254352132351976,-109.3640019
34865,0,26,13,0,3,25,67,38.254352132351976,-109.3637324
34866,0,26,14,0,3,25,68,38.254352132351976,-109.3634629
34867,0,24,15,0,2,28,69,38.254352132351976,-109.3631934
34868,0,23,15,0,2,29,69,38.254352132351976,-109.3629239
34869,1,22,14,0,1,26,64,38.254352132351976,-109.3626544
34870,2,22,15,0,0,26,65,38.254352132351976,-109.3623849
34871,1,21,15,0,1,27,65,38.254352132351976,-109.3621154
34872,1,21,15,0,1,28,66,38.254352132351976,-109.3618459
34873,1,21,16,0,1,30,69,38.254352132351976,-109.3615764
34874,1,20,18,0,2,32,73,38.254352132351976,-109.3613069
34875,1,21,17,0,1,33,73,38.254352132351976,-109.3610374
34876,0,22,17,0,2,34,75,38.254352132351976,-109.3607679
34877,0,22,17,0,1,34,74,38.254352132351976,-109.3604984
34878,1,22,17,0,1,32,73,38.254352132351976,-109.360229
34879,1,23,17,0,2,31,74,38.254352132351976,-109.3599595
34880,0,23,17,0,2,32,74,38.254352132351976,-109.35969
34881,0,24,17,0,3,31,75,38.254352132351976,-109.3594205
34882,0,23,16,0,3,30,72,38.254352132351976,-109.359151
34883,0,22,15,0,2,29,68,38.254352132351976,-109.3588815
34884,0,23,15,0,2,29,69,38.254352132351976,-109.358612
34885,1,24,15,0,2,28,70,38.254352132351976,-109.3583425
34886,0,23,15,0,2,28,68,38.254352132351976,-109.358073
34887,0,21,15,1,1,28,66,38.254352132351976,-109.3578035
34888,0,22,15,1,1,28,67,38.254352132351976,-109.357534
34889,1,23,15,1,2,27,69,38.254352132351976,-109.3572645
34890,0,24,14,0,2,26,66,38.254352132351976,-109.356995
34891,0,24,13,0,3,24,64,38.254352132351976,-109.3567255
34892,1,23,12,0,3,23,62,38.254352132351976,-109.356456
34893,2,22,14,0,1,26,65,38.254352132351976,-109.3561865
34894,1,21,15,0,1,28,66,38.254352132351976,-109.355917
34895,2,21,15,0,1,28,67,38.254352132351976,-109.3556475
34896,2,20,16,0,0,29,67,38.254352132351976,-109.355378
34897,1,19,16,0,0,29,65,38.254352132351976,-109.3551086
34898,2,22,14,0,2,24,64,38.254352132351976,-109.3548391
34899,1,25,13,1,3,23,66,38.254352132351976,-109.3545696
34900,1,24,13,2,2,24,66,38.254352132351976,-109.3543001
34901,1,22,15,1,1,26,66,38.254352132351976,-109.3540306
34902,2,23,15,0,1,27,68,38.254352132351976,-109.3537611
34903,1,24,14,0,1,26,66,38.254352132351976,-109.3534916
34904,1,26,14,0,1,24,66,38.254352132351976,-109.3532221
34905,1,22,13,0,2,21,59,38.254352132351976,-109.3529526
34906,4,25,12,1,4,16,62,38.254352132351976,-109.3526831
34907,3,24,9,2,7,12,57,38.254352132351976,-109.3524136
34908,5,31,7,3,8,6,60,38.254352132351976,-109.3521441
34909,4,33,7,2,8,6,60,38.254352132351976,-109.3518746
34910,2,27,7,3,8,8,55,38.254352132351976,-109.3516051
34911,3,25,8,5,8,7,56,38.254352132351976,-109.3513356
34912,4,21,8,3,6,9,51,38.254352132351976,-109.3510661
34913,2,26,8,3,7,9,55,38.254352132351976,-109.3507966
34914,3,26,9,4,8,9,59,38.254352132351976,-109.3505271
34915,1,26,9,3,10,7,56,38.254352132351976,-109.3502577
34916,2,26,8,4,8,5,53,38.254352132351976,-109.3499882
34917,5,25,8,5,7,3,53,38.254352132351976,-109.3497187
34918,3,28,9,9,8,5,62,38.254352132351976,-109.3494492
34919,0,22,11,10,7,8,58,38.254352132351976,-109.3491797
34920,8,25,12,14,12,2,73,38.254352132351976,-109.3489102
34921,3,30,9,13,9,3,67,38.254352132351976,-109.3486407
34922,2,30,11,4,9,12,68,38.254352132351976,-109.3483712
34923,0,24,11,0,7,17,59,38.254352132351976,-109.3481017
34924,0,23,9,0,8,15,55,38.254352132351976,-109.3478322
34925,0,27,7,0,12,9,55,38.254352132351976,-109.3475627
34926,0,29,7,0,12,6,54,38.254352132351976,-109.3472932
34927,2,48,8,4,10,2,74,38.254352132351976,-109.3470237
34928,2,60,5,3,9,1,80,38.254352132351976,-109.3467542
34929,3,51,6,4,9,3,76,38.254352132351976,-109.3464847
34930,3,49,7,5,10,3,77,38.254352132351976,-109.3462152
34931,3,40,8,3,9,6,69,38.254352132351976,-109.3459457
34932,2,28,8,4,8,8,58,38.254352132351976,-109.3456762
34933,1,28,11,2,6,16,64,38.254352132351976,-109.3454068
34934,4,26,15,2,3,15,65,38.254352132351976,-109.3451373
34935,10,24,16,9,4,14,77,38.254352132351976,-109.3448678
34936,1,17,11,2,5,16,52,38.254352132351976,-109.3445983
34937,0,16,8,2,5,13,44,38.254352132351976,-109.3443288
34938,0,15,7,3,10,9,44,38.254352132351976,-109.3440593
34939,0,14,7,7,11,3,42,38.254352132351976,-109.3437898
34940,4,20,12,2,16,5,59,38.254352132351976,-109.3435203
34941,3,19,13,6,12,11,64,38.254352132351976,-109.3432508
34942,2,18,16,4,5,27,72,38.254352132351976,-109.3429813
34943,2,14,18,1,2,32,69,38.254352132351976,-109.3427118
34944,3,14,19,1,1,31,69,38.254352132351976,-109.3424423
34945,2,11,15,2,3,24,57,38.254352132351976,-109.3421728
34946,1,18,11,4,2,17,53,38.254352132351976,-109.3419033
34947,2,22,9,5,6,11,55,38.254352132351976,-109.3416338
34948,2,23,8,5,7,11,56,38.254352132351976,-109.3413643
34949,2,33,7,5,9,8,64,38.254352132351976,-109.3410948
34950,2,39,7,5,9,6,68,38.254352132351976,-109.3408253
34951,2,35,6,5,8,5,61,38.254352132351976,-109.3405558
34952,3,36,7,6,9,5,66,38.254352132351976,-109.3402864
34953,3,40,7,6,10,4,70,38.254352132351976,-109.3400169
34954,2,47,6,4,8,4,71,38.254352132351976,-109.3397474
34955,2,38,5,4,7,5,61,38.254352132351976,-109.3394779
34956,5,34,4,4,6,3,56,38.254352132351976,-109.3392084
34957,9,32,5,6,7,2,61,38.254352132351976,-109.3389389
34958,10,28,8,8,9,1,64,38.254352132351976,-109.3386694
34959,5,26,11,14,13,4,73,38.254352132351976,-109.3383999
34960,1,31,11,6,14,7,70,38.254352132351976,-109.3381304
34961,0,37,10,1,13,9,70,38.254352132351976,-109.3378609
34962,1,31,11,3,10,11,67,38.254352132351976,-109.3375914
34963,1,19,14,3,4,22,63,38.254352132351976,-109.3373219
34964,1,24,13,2,4,20,64,38.254352132351976,-109.3370524
34965,1,31,10,3,13,9,67,38.254352132351976,-109.3367829
34966,3,36,8,4,12,4,67,38.254352132351976,-109.3365134
34967,3,36,8,4,11,4,66,38.254352132351976,-109.3362439
34968,3,34,8,3,11,5,64,38.254352132351976,-109.3359744
34969,2,28,8,4,8,7,57,38.254352132351976,-109.3357049
34970,2,30,8,4,6,7,57,38.254352132351976,-109.3354355
34971,2,28,8,4,6,6,54,38.254352132351976,-109.335166
34972,1,24,8,4,8,5,50,38.254352132351976,-109.3348965
34973,4,18,12,7,8,8,57,38.254352132351976,-109.334627
34974,3,20,13,9,12,11,68,38.254352132351976,-109.3343575
34975,3,17,12,6,10,16,64,38.254352132351976,-109.334088
34976,1,17,12,4,8,17,59,38.254352132351976,-109.3338185
34977,3,20,11,6,9,12,61,38.254352132351976,-109.333549
34978,2,22,10,5,8,9,56,38.254352132351976,-109.3332795
34979,3,23,10,4,9,7,56,38.254352132351976,-109.33301
34980,5,25,11,4,9,7,61,38.254352132351976,-109.3327405
34981,1,20,12,3,5,15,56,38.254352132351976,-109.332471
34982,7,26,13,7,11,7,71,38.254352132351976,-109.3322015
34983,2,23,12,3,9,12,61,38.254352132351976,-109.331932
34984,1,23,11,2,7,13,57,38.254352132351976,-109.3316625
34985,1,53,8,2,12,5,81,38.25408263776674,-109.4405383
34986,1,55,9,4,12,3,84,38.25408263776674,-109.4402688
34987,2,55,9,6,12,3,87,38.25408263776674,-109.4399993
34988,3,54,11,7,13,3,91,38.25408263776674,-109.4397299
34989,5,52,11,6,14,3,91,38.25408263776674,-109.4394604
34990,6,46,12,6,13,5,88,38.25408263776674,-109.4391909
34991,6,47,12,5,14,5,89,38.25408263776674,-109.4389214
34992,6,49,12,5,15,4,91,38.25408263776674,-109.4386519
34993,6,50,12,4,15,3,90,38.25408263776674,-109.4383824
34994,5,46,12,4,16,4,87,38.25408263776674,-109.4381129
34995,5,45,11,3,14,6,84,38.25408263776674,-109.4378434
34996,5,43,12,5,15,4,84,38.25408263776674,-109.4375739
34997,4,42,12,5,14,6,83,38.25408263776674,-109.4373044
34998,4,42,12,4,11,9,82,38.25408263776674,-109.4370349
34999,5,44,12,9,14,1,85,38.25408263776674,-109.4367654
35000,3,45,11,5,15,4,83,38.25408263776674,-109.4364959
35001,2,40,10,2,13,8,75,38.25408263776674,-109.4362264
35002,1,33,10,1,10,10,65,38.25408263776674,-109.4359569
35003,2,35,9,6,8,6,66,38.25408263776674,-109.4356874
35004,1,34,8,5,8,6,62,38.25408263776674,-109.4354179
35005,3,39,8,5,8,4,67,38.25408263776674,-109.4351484
35006,4,41,8,5,9,3,70,38.25408263776674,-109.434879
35007,3,41,8,4,10,4,70,38.25408263776674,-109.4346095
35008,3,38,9,2,9,7,68,38.25408263776674,-109.43434
35009,1,37,9,1,11,8,67,38.25408263776674,-109.4340705
35010,1,40,9,0,13,7,70,38.25408263776674,-109.433801
35011,1,44,9,1,15,4,74,38.25408263776674,-109.4335315
35012,2,45,8,4,14,3,76,38.25408263776674,-109.433262
35013,2,51,9,4,13,2,81,38.25408263776674,-109.4329925
35014,3,52,9,5,13,2,84,38.25408263776674,-109.432723
35015,5,50,11,7,14,1,88,38.25408263776674,-109.4324535
35016,6,48,12,9,16,0,91,38.25408263776674,-109.432184
35017,7,49,12,9,16,0,93,38.25408263776674,-109.4319145
35018,9,45,13,9,15,0,91,38.25408263776674,-109.431645
35019,14,40,14,12,14,0,94,38.25408263776674,-109.4313755
35020,17,37,14,12,13,0,93,38.25408263776674,-109.431106
35021,18,37,13,10,13,0,91,38.25408263776674,-109.4308365
35022,12,43,12,10,13,0,90,38.25408263776674,-109.430567
35023,7,47,11,8,15,0,88,38.25408263776674,-109.4302975
35024,6,48,11,7,15,0,87,38.25408263776674,-109.430028
35025,5,47,11,8,14,1,86,38.25408263776674,-109.4297586
35026,5,44,11,9,13,1,83,38.25408263776674,-109.4294891
35027,8,43,12,11,13,1,88,38.25408263776674,-109.4292196
35028,5,46,12,11,13,1,88,38.25408263776674,-109.4289501
35029,4,49,11,9,14,1,88,38.25408263776674,-109.4286806
35030,4,54,10,7,15,1,91,38.25408263776674,-109.4284111
35031,4,55,10,6,16,0,91,38.25408263776674,-109.4281416
35032,4,53,11,6,16,1,91,38.25408263776674,-109.4278721
35033,7,48,12,10,15,0,92,38.25408263776674,-109.4276026
35034,11,43,13,11,15,0,93,38.25408263776674,-109.4273331
35035,12,42,13,12,15,0,94,38.25408263776674,-109.4270636
35036,9,43,13,11,15,0,91,38.25408263776674,-109.4267941
35037,11,41,13,12,15,0,92,38.25408263776674,-109.4265246
35038,14,38,14,13,14,0,93,38.25408263776674,-109.4262551
35039,18,35,14,13,13,0,93,38.25408263776674,-109.4259856
35040,19,33,14,14,12,0,92,38.25408263776674,-109.4257161
35041,18,33,14,14,13,0,92,38.25408263776674,-109.4254466
35042,20,32,14,13,13,0,92,38.25408263776674,-109.4251771
35043,21,33,14,12,13,0,93,38.25408263776674,-109.4249077
35044,22,33,14,11,13,0,93,38.25408263776674,-109.4246382
35045,22,32,14,12,13,0,93,38.25408263776674,-109.4243687
35046,16,34,14,15,14,0,93,38.25408263776674,-109.4240992
35047,14,35,14,14,14,0,91,38.25408263776674,-109.4238297
35048,13,37,14,14,13,0,91,38.25408263776674,-109.4235602
35049,12,38,15,14,13,0,92,38.25408263776674,-109.4232907
35050,10,41,14,14,13,1,93,38.25408263776674,-109.4230212
35051,4,46,12,10,14,2,88,38.25408263776674,-109.4227517
35052,3,49,10,7,14,2,85,38.25408263776674,-109.4224822
35053,5,48,11,8,13,2,87,38.25408263776674,-109.4222127
35054,8,43,12,9,13,1,86,38.25408263776674,-109.4219432
35055,4,45,11,6,14,3,83,38.25408263776674,-109.4216737
35056,3,49,10,3,14,5,84,38.25408263776674,-109.4214042
35057,3,50,10,2,14,5,84,38.25408263776674,-109.4211347
35058,3,50,10,2,14,5,84,38.25408263776674,-109.4208652
35059,2,50,10,4,14,4,84,38.25408263776674,-109.4205957
35060,5,48,11,9,13,2,88,38.25408263776674,-109.4203262
35061,5,49,11,7,13,3,88,38.25408263776674,-109.4200568
35062,6,47,11,8,12,3,87,38.25408263776674,-109.4197873
35063,8,42,12,11,13,2,88,38.25408263776674,-109.4195178
35064,10,40,12,12,14,1,89,38.25408263776674,-109.4192483
35065,10,35,12,11,12,1,81,38.25408263776674,-109.4189788
35066,11,36,13,11,11,1,83,38.25408263776674,-109.4187093
35067,10,37,13,11,11,1,83,38.25408263776674,-109.4184398
35068,8,38,12,9,12,2,81,38.25408263776674,-109.4181703
35069,5,43,10,6,12,3,79,38.25408263776674,-109.4179008
35070,6,42,10,6,11,3,78,38.25408263776674,-109.4176313
35071,7,42,10,8,12,2,81,38.25408263776674,-109.4173618
35072,7,43,12,10,12,2,86,38.25408263776674,-109.4170923
35073,7,42,12,10,12,2,85,38.25408263776674,-109.4168228
35074,6,44,12,9,13,2,86,38.25408263776674,-109.4165533
35075,10,39,13,12,13,1,88,38.25408263776674,-109.4162838
35076,12,34,14,14,13,1,88,38.25408263776674,-109.4160143
35077,11,36,13,13,13,1,87,38.25408263776674,-109.4157448
35078,7,42,11,9,13,1,83,38.25408263776674,-109.4154753
35079,4,44,10,5,14,3,80,38.25408263776674,-109.4152058
35080,4,42,10,5,14,4,79,38.25408263776674,-109.4149364
35081,6,39,11,6,14,3,79,38.25408263776674,-109.4146669
35082,8,35,11,8,14,3,79,38.25408263776674,-109.4143974
35083,7,37,12,8,14,3,81,38.25408263776674,-109.4141279
35084,10,37,12,10,14,1,84,38.25408263776674,-109.4138584
35085,11,37,12,10,15,1,86,38.25408263776674,-109.4135889
35086,12,37,13,10,14,1,87,38.25408263776674,-109.4133194
35087,15,35,14,13,13,1,91,38.25408263776674,-109.4130499
35088,11,41,13,11,13,1,90,38.25408263776674,-109.4127804
35089,4,47,11,5,14,3,84,38.25408263776674,-109.4125109
35090,2,47,9,2,12,4,76,38.25408263776674,-109.4122414
35091,1,41,8,2,10,5,67,38.25408263776674,-109.4119719
35092,4,38,7,5,7,3,64,38.25408263776674,-109.4117024
35093,2,38,7,3,6,4,60,38.25408263776674,-109.4114329
35094,2,37,7,4,6,5,61,38.25408263776674,-109.4111634
35095,3,38,7,4,7,4,63,38.25408263776674,-109.4108939
35096,2,37,8,2,7,6,62,38.25408263776674,-109.4106244
35097,4,34,9,3,9,7,66,38.25408263776674,-109.4103549
35098,3,35,10,3,10,6,67,38.25408263776674,-109.4100855
35099,4,35,10,5,11,6,71,38.25408263776674,-109.409816
35100,5,32,11,6,10,7,71,38.25408263776674,-109.4095465
35101,6,30,12,3,8,13,72,38.25408263776674,-109.409277
35102,3,36,10,3,11,9,72,38.25408263776674,-109.4090075
35103,5,42,12,7,12,3,81,38.25408263776674,-109.408738
35104,6,43,13,13,11,1,87,38.25408263776674,-109.4084685
35105,6,43,13,14,11,1,88,38.25408263776674,-109.408199
35106,5,44,13,14,11,2,89,38.25408263776674,-109.4079295
35107,5,43,13,13,11,2,87,38.25408263776674,-109.40766
35108,5,44,13,10,14,2,88,38.25408263776674,-109.4073905
35109,4,43,12,7,15,4,85,38.25408263776674,-109.407121
35110,5,43,12,7,14,4,85,38.25408263776674,-109.4068515
35111,4,41,12,7,15,4,83,38.25408263776674,-109.406582
35112,5,42,12,12,15,2,88,38.25408263776674,-109.4063125
35113,5,43,12,12,14,2,88,38.25408263776674,-109.406043
35114,5,43,13,10,16,2,89,38.25408263776674,-109.4057735
35115,4,39,13,8,17,5,86,38.25408263776674,-109.405504
35116,3,39,12,4,17,6,81,38.25408263776674,-109.4052345
35117,4,45,12,5,19,2,87,38.25408263776674,-109.4049651
35118,5,47,12,6,18,1,89,38.25408263776674,-109.4046956
35119,4,47,12,6,18,2,89,38.25408263776674,-109.4044261
35120,4,46,12,5,17,4,88,38.25408263776674,-109.4041566
35121,3,44,11,3,14,7,82,38.25408263776674,-109.4038871
35122,4,45,11,5,16,3,84,38.25408263776674,-109.4036176
35123,4,46,11,5,15,2,83,38.25408263776674,-109.4033481
35124,3,42,10,4,13,4,76,38.25408263776674,-109.4030786
35125,2,34,9,2,9,6,62,38.25408263776674,-109.4028091
35126,4,37,8,4,8,4,65,38.25408263776674,-109.4025396
35127,3,39,7,4,7,5,65,38.25408263776674,-109.4022701
35128,2,39,7,3,7,5,63,38.25408263776674,-109.4020006
35129,3,45,7,3,7,4,69,38.25408263776674,-109.4017311
35130,2,44,7,4,6,4,67,38.25408263776674,-109.4014616
35131,2,38,8,5,8,4,65,38.25408263776674,-109.4011921
35132,2,34,8,5,9,5,63,38.25408263776674,-109.4009226
35133,5,36,10,5,10,5,71,38.25408263776674,-109.4006531
35134,4,38,11,4,9,5,71,38.25408263776674,-109.4003836
35135,5,44,11,3,11,5,79,38.25408263776674,-109.4001142
35136,2,39,10,1,8,9,69,38.25408263776674,-109.3998447
35137,2,35,9,2,8,9,65,38.25408263776674,-109.3995752
35138,4,37,9,3,9,6,68,38.25408263776674,-109.3993057
35139,2,37,8,3,10,5,65,38.25408263776674,-109.3990362
35140,3,39,8,4,10,3,67,38.25408263776674,-109.3987667
35141,1,36,8,3,10,6,64,38.25408263776674,-109.3984972
35142,1,34,9,3,8,9,64,38.25408263776674,-109.3982277
35143,1,35,10,2,9,9,66,38.25408263776674,-109.3979582
35144,1,29,10,2,9,11,62,38.25408263776674,-109.3976887
35145,2,32,10,0,10,10,64,38.25408263776674,-109.3974192
35146,2,30,11,1,10,11,65,38.25408263776674,-109.3971497
35147,2,29,12,4,10,12,69,38.25408263776674,-109.3968802
35148,1,31,13,2,11,15,73,38.25408263776674,-109.3966107
35149,0,30,11,0,6,20,67,38.25408263776674,-109.3963412
35150,1,34,12,0,10,15,72,38.25408263776674,-109.3960717
35151,1,37,11,0,13,12,74,38.25408263776674,-109.3958022
35152,1,38,10,0,11,12,72,38.25408263776674,-109.3955327
35153,1,40,9,0,9,13,72,38.25408263776674,-109.3952632
35154,1,38,10,1,13,8,71,38.25408263776674,-109.3949938
35155,1,38,10,1,12,8,70,38.25408263776674,-109.3947243
35156,1,39,9,0,11,9,69,38.25408263776674,-109.3944548
35157,1,39,9,0,11,9,69,38.25408263776674,-109.3941853
35158,2,39,10,3,12,6,72,38.25408263776674,-109.3939158
35159,1,34,9,2,9,8,63,38.25408263776674,-109.3936463
35160,1,30,10,4,9,8,62,38.25408263776674,-109.3933768
35161,3,29,10,6,11,6,65,38.25408263776674,-109.3931073
35162,5,33,11,10,13,4,76,38.25408263776674,-109.3928378
35163,3,27,11,28,17,0,86,38.25408263776674,-109.3925683
35164,0,26,12,21,21,3,83,38.25408263776674,-109.3922988
35165,1,25,13,18,18,6,81,38.25408263776674,-109.3920293
35166,2,28,13,11,20,8,82,38.25408263776674,-109.3917598
35167,2,27,13,15,19,6,82,38.25408263776674,-109.3914903
35168,1,30,12,14,21,5,83,38.25408263776674,-109.3912208
35169,1,31,12,9,20,6,79,38.25408263776674,-109.3909513
35170,3,34,12,7,19,5,80,38.25408263776674,-109.3906818
35171,6,33,12,8,17,4,80,38.25408263776674,-109.3904123
35172,5,37,11,7,15,4,79,38.25408263776674,-109.3901429
35173,3,35,10,6,14,6,74,38.25408263776674,-109.3898734
35174,4,33,10,7,13,5,72,38.25408263776674,-109.3896039
35175,6,33,11,8,14,4,76,38.25408263776674,-109.3893344
35176,3,34,11,5,15,6,74,38.25408263776674,-109.3890649
35177,2,34,11,2,13,9,71,38.25408263776674,-109.3887954
35178,2,35,11,0,11,13,72,38.25408263776674,-109.3885259
35179,2,33,11,0,11,14,71,38.25408263776674,-109.3882564
35180,2,31,12,0,10,16,71,38.25408263776674,-109.3879869
35181,3,36,12,0,9,15,75,38.25408263776674,-109.3877174
35182,1,33,11,0,10,16,71,38.25408263776674,-109.3874479
35183,1,38,10,0,11,13,73,38.25408263776674,-109.3871784
35184,2,34,10,6,12,5,69,38.25408263776674,-109.3869089
35185,4,32,10,12,10,2,70,38.25408263776674,-109.3866394
35186,5,47,8,8,8,1,77,38.25408263776674,-109.3863699
35187,3,41,8,8,8,2,70,38.25408263776674,-109.3861004
35188,4,39,9,7,12,2,73,38.25408263776674,-109.3858309
35189,5,45,10,8,14,1,83,38.25408263776674,-109.3855614
35190,5,50,10,9,11,1,86,38.25408263776674,-109.3852919
35191,4,51,10,9,10,1,85,38.25408263776674,-109.3850225
35192,5,53,10,9,10,1,88,38.25408263776674,-109.384753
35193,4,52,10,7,11,1,85,38.25408263776674,-109.3844835
35194,4,49,10,7,13,1,84,38.25408263776674,-109.384214
35195,10,40,13,14,13,1,91,38.25408263776674,-109.3839445
35196,19,35,14,14,11,0,93,38.25408263776674,-109.383675
35197,21,34,13,12,12,0,92,38.25408263776674,-109.3834055
35198,20,34,13,12,13,0,92,38.25408263776674,-109.383136
35199,17,34,13,13,13,0,90,38.25408263776674,-109.3828665
35200,16,32,12,13,14,1,88,38.25408263776674,-109.382597
35201,9,33,12,12,16,2,84,38.25408263776674,-109.3823275
35202,6,29,11,9,13,5,73,38.25408263776674,-109.382058
35203,6,24,10,12,13,2,67,38.25408263776674,-109.3817885
35204,11,26,12,13,14,2,78,38.25408263776674,-109.381519
35205,12,33,13,12,14,2,86,38.25408263776674,-109.3812495
35206,15,36,13,12,14,1,91,38.25408263776674,-109.38098
35207,16,37,13,12,13,0,91,38.25408263776674,-109.3807105
35208,15,37,13,12,13,1,91,38.25408263776674,-109.380441
35209,11,39,13,12,14,1,90,38.25408263776674,-109.3801716
35210,11,39,14,12,15,1,92,38.25408263776674,-109.3799021
35211,10,39,14,14,14,0,91,38.25408263776674,-109.3796326
35212,10,38,14,14,13,1,90,38.25408263776674,-109.3793631
35213,11,37,14,16,12,1,91,38.25408263776674,-109.3790936
35214,15,36,14,16,11,0,92,38.25408263776674,-109.3788241
35215,14,36,14,16,11,1,92,38.25408263776674,-109.3785546
35216,15,36,14,16,11,1,93,38.25408263776674,-109.3782851
35217,16,36,14,15,11,1,93,38.25408263776674,-109.3780156
35218,14,36,13,14,12,1,90,38.25408263776674,-109.3777461
35219,19,35,13,14,11,1,93,38.25408263776674,-109.3774766
35220,19,35,13,14,11,1,93,38.25408263776674,-109.3772071
35221,19,33,13,14,10,1,90,38.25408263776674,-109.3769376
35222,20,30,13,16,10,1,90,38.25408263776674,-109.3766681
35223,24,26,13,17,9,0,89,38.25408263776674,-109.3763986
35224,23,25,14,20,7,1,90,38.25408263776674,-109.3761291
35225,23,26,14,21,6,1,91,38.25408263776674,-109.3758596
35226,24,26,14,21,6,1,92,38.25408263776674,-109.3755901
35227,24,25,14,21,6,1,91,38.25408263776674,-109.3753206
35228,22,26,14,18,6,3,89,38.25408263776674,-109.3750512
35229,18,29,15,19,7,3,91,38.25408263776674,-109.3747817
35230,14,31,16,16,8,5,90,38.25408263776674,-109.3745122
35231,12,31,17,13,7,7,87,38.25408263776674,-109.3742427
35232,11,32,17,14,8,6,88,38.25408263776674,-109.3739732
35233,10,32,16,14,11,4,87,38.25408263776674,-109.3737037
35234,13,31,16,12,11,5,88,38.25408263776674,-109.3734342
35235,10,31,15,8,13,8,85,38.25408263776674,-109.3731647
35236,6,32,14,1,12,14,79,38.25408263776674,-109.3728952
35237,5,30,15,0,8,21,79,38.25408263776674,-109.3726257
35238,4,28,16,0,6,25,79,38.25408263776674,-109.3723562
35239,5,30,17,0,6,22,80,38.25408263776674,-109.3720867
35240,3,30,16,0,7,23,79,38.25408263776674,-109.3718172
35241,1,25,16,0,4,27,73,38.25408263776674,-109.3715477
35242,6,28,17,4,8,22,85,38.25408263776674,-109.3712782
35243,2,26,14,2,10,18,72,38.25408263776674,-109.3710087
35244,2,26,14,0,7,23,72,38.25408263776674,-109.3707392
35245,3,27,16,0,6,24,76,38.25408263776674,-109.3704697
35246,2,30,17,0,5,25,79,38.25408263776674,-109.3702003
35247,0,24,14,0,3,25,66,38.25408263776674,-109.3699308
35248,0,25,14,0,2,26,67,38.25408263776674,-109.3696613
35249,0,25,14,0,2,27,68,38.25408263776674,-109.3693918
35250,3,21,16,1,0,28,69,38.25408263776674,-109.3691223
35251,3,24,15,1,6,23,72,38.25408263776674,-109.3688528
35252,2,26,15,0,8,24,75,38.25408263776674,-109.3685833
35253,2,31,16,0,8,25,82,38.25408263776674,-109.3683138
35254,3,30,16,0,10,24,83,38.25408263776674,-109.3680443
35255,3,30,16,2,12,20,83,38.25408263776674,-109.3677748
35256,7,29,14,9,17,9,85,38.25408263776674,-109.3675053
35257,4,26,14,10,17,8,79,38.25408263776674,-109.3672358
35258,3,14,12,21,17,2,69,38.25408263776674,-109.3669663
35259,4,12,11,22,17,2,68,38.25408263776674,-109.3666968
35260,2,11,11,15,9,8,56,38.25408263776674,-109.3664273
35261,2,18,11,6,9,13,59,38.25408263776674,-109.3661578
35262,2,16,13,2,2,25,60,38.25408263776674,-109.3658883
35263,1,19,15,0,1,28,64,38.25408263776674,-109.3656188
35264,1,21,16,0,0,29,67,38.25408263776674,-109.3653493
35265,2,23,15,0,3,26,69,38.25408263776674,-109.3650799
35266,2,23,14,0,2,26,67,38.25408263776674,-109.3648104
35267,2,25,12,0,3,22,64,38.25408263776674,-109.3645409
35268,2,27,12,0,4,20,65,38.25408263776674,-109.3642714
35269,2,28,13,0,3,22,68,38.25408263776674,-109.3640019
35270,2,23,16,1,2,27,71,38.25408263776674,-109.3637324
35271,3,22,17,1,2,30,75,38.25408263776674,-109.3634629
35272,1,22,17,0,1,33,74,38.25408263776674,-109.3631934
35273,0,21,17,0,1,32,71,38.25408263776674,-109.3629239
35274,1,22,15,0,0,30,68,38.25408263776674,-109.3626544
35275,2,23,15,0,1,27,68,38.25408263776674,-109.3623849
35276,1,21,14,0,1,25,62,38.25408263776674,-109.3621154
35277,2,21,14,0,2,25,64,38.25408263776674,-109.3618459
35278,2,22,15,0,1,26,66,38.25408263776674,-109.3615764
35279,1,22,14,0,1,27,65,38.25408263776674,-109.3613069
35280,1,22,15,0,0,28,66,38.25408263776674,-109.3610374
35281,1,21,16,0,0,30,68,38.25408263776674,-109.3607679
35282,1,21,17,0,0,32,71,38.25408263776674,-109.3604984
35283,1,22,17,0,1,33,74,38.25408263776674,-109.360229
35284,0,23,17,0,3,32,75,38.25408263776674,-109.3599595
35285,0,22,18,0,3,33,76,38.25408263776674,-109.35969
35286,1,23,17,0,2,33,76,38.25408263776674,-109.3594205
35287,0,24,17,0,3,32,76,38.25408263776674,-109.359151
35288,0,25,16,0,4,30,75,38.25408263776674,-109.3588815
35289,0,23,16,0,4,30,73,38.25408263776674,-109.358612
35290,0,22,17,0,3,32,74,38.25408263776674,-109.3583425
35291,0,22,17,0,2,33,74,38.25408263776674,-109.358073
35292,0,22,17,0,3,31,73,38.25408263776674,-109.3578035
35293,0,21,17,0,2,31,71,38.25408263776674,-109.357534
35294,0,20,17,0,2,31,70,38.25408263776674,-109.3572645
35295,1,22,16,0,1,30,70,38.25408263776674,-109.356995
35296,1,25,15,0,2,26,69,38.25408263776674,-109.3567255
35297,1,26,14,0,3,24,68,38.25408263776674,-109.356456
35298,1,22,14,0,1,27,65,38.25408263776674,-109.3561865
35299,1,20,14,0,1,26,62,38.25408263776674,-109.355917
35300,1,20,14,0,1,25,61,38.25408263776674,-109.3556475
35301,1,23,13,0,1,24,62,38.25408263776674,-109.355378
35302,1,26,12,1,2,23,65,38.25408263776674,-109.3551086
35303,1,29,13,1,4,22,70,38.25408263776674,-109.3548391
35304,2,28,13,2,4,22,71,38.25408263776674,-109.3545696
35305,1,25,14,0,2,24,66,38.25408263776674,-109.3543001
35306,1,23,15,0,1,27,67,38.25408263776674,-109.3540306
35307,2,24,15,0,1,27,69,38.25408263776674,-109.3537611
35308,1,24,14,0,1,26,66,38.25408263776674,-109.3534916
35309,1,28,13,0,2,22,66,38.25408263776674,-109.3532221
35310,1,28,11,0,3,18,61,38.25408263776674,-109.3529526
35311,1,28,11,2,5,14,61,38.25408263776674,-109.3526831
35312,5,27,9,3,10,7,61,38.25408263776674,-109.3524136
35313,1,26,8,2,8,8,53,38.25408263776674,-109.3521441
35314,3,33,7,3,8,7,61,38.25408263776674,-109.3518746
35315,3,27,9,3,8,8,58,38.25408263776674,-109.3516051
35316,2,25,8,4,7,10,56,38.25408263776674,-109.3513356
35317,1,25,10,3,7,12,58,38.25408263776674,-109.3510661
35318,2,28,9,3,10,9,61,38.25408263776674,-109.3507966
35319,2,25,9,4,10,7,57,38.25408263776674,-109.3505271
35320,2,24,8,4,8,6,52,38.25408263776674,-109.3502577
35321,3,25,8,4,6,5,51,38.25408263776674,-109.3499882
35322,4,22,8,6,7,4,51,38.25408263776674,-109.3497187
35323,4,18,11,9,9,4,55,38.25408263776674,-109.3494492
35324,0,20,11,11,12,7,61,38.25408263776674,-109.3491797
35325,4,23,11,14,15,2,69,38.25408263776674,-109.3489102
35326,4,31,9,13,8,1,66,38.25408263776674,-109.3486407
35327,0,30,10,3,13,9,65,38.25408263776674,-109.3483712
35328,1,25,12,0,8,17,63,38.25408263776674,-109.3481017
35329,0,25,11,0,9,16,61,38.25408263776674,-109.3478322
35330,0,26,9,1,13,9,58,38.25408263776674,-109.3475627
35331,0,29,8,4,14,6,61,38.25408263776674,-109.3472932
35332,3,48,8,6,11,2,78,38.25408263776674,-109.3470237
35333,2,52,7,4,11,2,78,38.25408263776674,-109.3467542
35334,2,46,6,5,9,6,74,38.25408263776674,-109.3464847
35335,2,42,7,4,10,5,70,38.25408263776674,-109.3462152
35336,4,35,10,7,10,6,72,38.25408263776674,-109.3459457
35337,3,25,12,5,7,14,66,38.25408263776674,-109.3456762
35338,1,17,13,3,5,19,58,38.25408263776674,-109.3454068
35339,3,19,14,4,5,17,62,38.25408263776674,-109.3451373
35340,9,24,15,9,4,15,76,38.25408263776674,-109.3448678
35341,5,23,15,6,6,14,69,38.25408263776674,-109.3445983
35342,3,21,11,1,11,12,59,38.25408263776674,-109.3443288
35343,4,26,13,6,14,7,70,38.25408263776674,-109.3440593
35344,4,22,11,10,21,4,72,38.25408263776674,-109.3437898
35345,0,15,10,7,15,7,54,38.25408263776674,-109.3435203
35346,2,20,12,2,15,11,62,38.25408263776674,-109.3432508
35347,4,22,15,5,6,21,73,38.25408263776674,-109.3429813
35348,3,17,16,0,1,27,64,38.25408263776674,-109.3427118
35349,3,16,15,0,1,23,58,38.25408263776674,-109.3424423
35350,4,27,9,3,6,10,59,38.25408263776674,-109.3421728
35351,2,24,8,3,7,9,53,38.25408263776674,-109.3419033
35352,2,24,7,4,8,8,53,38.25408263776674,-109.3416338
35353,2,28,7,4,8,8,57,38.25408263776674,-109.3413643
35354,2,39,7,4,10,5,67,38.25408263776674,-109.3410948
35355,2,40,7,4,9,4,66,38.25408263776674,-109.3408253
35356,2,43,7,4,9,4,69,38.25408263776674,-109.3405558
35357,1,49,7,4,10,4,75,38.25408263776674,-109.3402864
35358,1,55,7,4,10,3,80,38.25408263776674,-109.3400169
35359,1,55,7,4,10,2,79,38.25408263776674,-109.3397474
35360,2,53,6,4,10,2,77,38.25408263776674,-109.3394779
35361,3,55,6,5,10,3,82,38.25408263776674,-109.3392084
35362,3,55,6,5,9,3,81,38.25408263776674,-109.3389389
35363,4,47,7,7,9,4,78,38.25408263776674,-109.3386694
35364,2,33,7,8,4,5,59,38.25408263776674,-109.3383999
35365,4,34,8,8,7,4,65,38.25408263776674,-109.3381304
35366,2,35,9,6,9,4,65,38.25408263776674,-109.3378609
35367,1,37,10,2,10,6,66,38.25408263776674,-109.3375914
35368,2,26,13,5,10,14,70,38.25408263776674,-109.3373219
35369,1,27,12,3,9,14,66,38.25408263776674,-109.3370524
35370,1,30,10,2,10,10,63,38.25408263776674,-109.3367829
35371,1,31,8,3,8,7,58,38.25408263776674,-109.3365134
35372,3,25,9,6,9,7,59,38.25408263776674,-109.3362439
35373,2,25,9,4,8,8,56,38.25408263776674,-109.3359744
35374,1,29,7,3,6,6,52,38.25408263776674,-109.3357049
35375,2,29,6,5,8,4,54,38.25408263776674,-109.3354355
35376,2,24,7,6,9,4,52,38.25408263776674,-109.335166
35377,3,20,10,7,8,6,54,38.25408263776674,-109.3348965
35378,3,21,14,9,8,10,65,38.25408263776674,-109.334627
35379,1,18,12,5,7,16,59,38.25408263776674,-109.3343575
35380,1,18,12,4,9,15,59,38.25408263776674,-109.334088
35381,2,24,11,5,12,12,66,38.25408263776674,-109.3338185
35382,2,27,13,5,10,14,71,38.25408263776674,-109.333549
35383,1,19,11,3,8,14,56,38.25408263776674,-109.3332795
35384,2,22,9,4,7,9,53,38.25408263776674,-109.33301
35385,3,26,9,4,7,6,55,38.25408263776674,-109.3327405
35386,3,32,8,4,7,6,60,38.25408263776674,-109.332471
35387,8,30,11,5,11,4,69,38.25408263776674,-109.3322015
35388,2,28,10,5,9,8,62,38.25408263776674,-109.331932
35389,2,25,10,4,7,10,58,38.25408263776674,-109.3316625
35390,1,44,8,3,10,4,70,38.25381314,-109.4405383
35391,2,51,9,5,12,3,82,38.25381314,-109.4402688
35392,1,56,10,3,15,4,89,38.25381314,-109.4399993
35393,2,56,10,2,14,6,90,38.25381314,-109.4397299
35394,2,53,10,4,15,5,89,38.25381314,-109.4394604
35395,3,53,10,6,13,5,90,38.25381314,-109.4391909
35396,4,51,11,8,14,3,91,38.25381314,-109.4389214
35397,6,48,12,9,14,2,91,38.25381314,-109.4386519
35398,8,46,12,11,14,1,92,38.25381314,-109.4383824
35399,10,42,13,12,14,1,92,38.25381314,-109.4381129
35400,8,41,12,14,13,1,89,38.25381314,-109.4378434
35401,9,39,12,14,12,1,87,38.25381314,-109.4375739
35402,10,38,12,12,13,1,86,38.25381314,-109.4373044
35403,9,38,12,11,13,2,85,38.25381314,-109.4370349
35404,8,40,13,13,11,1,86,38.25381314,-109.4367654
35405,4,43,11,5,14,3,80,38.25381314,-109.4364959
35406,2,40,10,1,13,8,74,38.25381314,-109.4362264
35407,0,31,10,1,9,12,63,38.25381314,-109.4359569
35408,1,28,9,2,8,9,57,38.25381314,-109.4356874
35409,0,33,8,1,8,9,59,38.25381314,-109.4354179
35410,2,40,9,3,7,7,68,38.25381314,-109.4351484
35411,3,42,8,3,7,5,68,38.25381314,-109.434879
35412,2,40,7,3,7,6,65,38.25381314,-109.4346095
35413,4,43,7,4,6,4,68,38.25381314,-109.43434
35414,3,39,8,4,8,4,66,38.25381314,-109.4340705
35415,1,47,8,1,12,4,73,38.25381314,-109.433801
35416,0,54,8,1,13,3,79,38.25381314,-109.4335315
35417,1,56,7,2,12,3,81,38.25381314,-109.433262
35418,2,55,9,4,14,2,86,38.25381314,-109.4329925
35419,5,51,10,7,15,1,89,38.25381314,-109.432723
35420,8,47,12,9,15,0,91,38.25381314,-109.4324535
35421,9,46,13,10,15,0,93,38.25381314,-109.432184
35422,7,51,12,8,15,0,93,38.25381314,-109.4319145
35423,9,42,11,8,15,1,86,38.25381314,-109.431645
35424,15,39,13,11,14,0,92,38.25381314,-109.4313755
35425,18,35,14,12,12,0,91,38.25381314,-109.431106
35426,21,35,14,11,12,0,93,38.25381314,-109.4308365
35427,17,39,13,10,12,0,91,38.25381314,-109.430567
35428,11,45,12,10,14,0,92,38.25381314,-109.4302975
35429,6,49,11,7,14,1,88,38.25381314,-109.430028
35430,4,51,10,6,14,1,86,38.25381314,-109.4297586
35431,4,49,10,8,13,1,85,38.25381314,-109.4294891
35432,6,47,11,10,14,1,89,38.25381314,-109.4292196
35433,6,47,11,10,13,1,88,38.25381314,-109.4289501
35434,5,49,11,9,13,1,88,38.25381314,-109.4286806
35435,4,53,10,7,15,1,90,38.25381314,-109.4284111
35436,4,56,10,5,16,1,92,38.25381314,-109.4281416
35437,4,54,10,6,16,0,90,38.25381314,-109.4278721
35438,6,52,11,7,15,0,91,38.25381314,-109.4276026
35439,10,46,12,10,15,0,93,38.25381314,-109.4273331
35440,14,41,13,11,14,0,93,38.25381314,-109.4270636
35441,17,39,13,10,14,0,93,38.25381314,-109.4267941
35442,16,38,13,11,14,0,92,38.25381314,-109.4265246
35443,16,37,13,12,13,0,91,38.25381314,-109.4262551
35444,18,35,14,13,12,0,92,38.25381314,-109.4259856
35445,19,33,14,14,12,0,92,38.25381314,-109.4257161
35446,21,32,14,12,12,0,91,38.25381314,-109.4254466
35447,24,31,14,12,12,0,93,38.25381314,-109.4251771
35448,24,32,14,11,12,0,93,38.25381314,-109.4249077
35449,21,33,13,12,13,0,92,38.25381314,-109.4246382
35450,18,33,14,14,13,0,92,38.25381314,-109.4243687
35451,15,35,14,14,14,0,92,38.25381314,-109.4240992
35452,12,37,14,14,14,0,91,38.25381314,-109.4238297
35453,10,38,14,14,14,1,91,38.25381314,-109.4235602
35454,10,40,14,13,13,1,91,38.25381314,-109.4232907
35455,7,44,13,10,14,1,89,38.25381314,-109.4230212
35456,3,48,11,8,14,2,86,38.25381314,-109.4227517
35457,4,48,11,8,14,2,87,38.25381314,-109.4224822
35458,5,46,11,8,15,2,87,38.25381314,-109.4222127
35459,4,43,11,6,14,3,81,38.25381314,-109.4219432
35460,2,45,10,3,14,5,79,38.25381314,-109.4216737
35461,3,48,10,4,15,4,84,38.25381314,-109.4214042
35462,4,49,11,5,15,3,87,38.25381314,-109.4211347
35463,4,48,11,5,14,4,86,38.25381314,-109.4208652
35464,3,48,10,5,13,4,83,38.25381314,-109.4205957
35465,3,48,9,5,12,5,82,38.25381314,-109.4203262
35466,3,45,10,6,12,5,81,38.25381314,-109.4200568
35467,4,43,10,7,12,4,80,38.25381314,-109.4197873
35468,4,42,11,6,12,4,79,38.25381314,-109.4195178
35469,7,40,11,6,10,5,79,38.25381314,-109.4192483
35470,7,35,10,5,11,3,71,38.25381314,-109.4189788
35471,5,40,10,6,12,3,76,38.25381314,-109.4187093
35472,5,43,10,6,11,3,78,38.25381314,-109.4184398
35473,4,40,10,5,12,4,75,38.25381314,-109.4181703
35474,4,36,9,5,10,4,68,38.25381314,-109.4179008
35475,4,36,8,4,9,4,65,38.25381314,-109.4176313
35476,4,37,8,6,10,3,68,38.25381314,-109.4173618
35477,5,38,9,6,10,3,71,38.25381314,-109.4170923
35478,5,40,9,5,11,4,74,38.25381314,-109.4168228
35479,4,43,10,5,13,3,78,38.25381314,-109.4165533
35480,7,43,11,8,13,2,84,38.25381314,-109.4162838
35481,9,40,12,10,13,1,85,38.25381314,-109.4160143
35482,8,39,12,9,12,2,82,38.25381314,-109.4157448
35483,5,37,10,6,12,3,73,38.25381314,-109.4154753
35484,7,37,9,5,11,3,72,38.25381314,-109.4152058
35485,7,37,9,5,12,3,73,38.25381314,-109.4149364
35486,7,37,9,6,12,3,74,38.25381314,-109.4146669
35487,5,39,10,6,14,3,77,38.25381314,-109.4143974
35488,5,41,10,5,15,3,79,38.25381314,-109.4141279
35489,3,43,11,4,15,4,80,38.25381314,-109.4138584
35490,3,43,11,4,16,4,81,38.25381314,-109.4135889
35491,4,41,12,6,15,4,82,38.25381314,-109.4133194
35492,10,39,12,10,14,1,86,38.25381314,-109.4130499
35493,6,46,11,8,13,2,86,38.25381314,-109.4127804
35494,2,47,9,4,12,4,78,38.25381314,-109.4125109
35495,1,43,8,3,11,4,70,38.25381314,-109.4122414
35496,2,37,7,3,8,4,61,38.25381314,-109.4119719
35497,2,41,5,3,6,3,60,38.25381314,-109.4117024
35498,2,42,5,3,6,3,61,38.25381314,-109.4114329
35499,2,38,6,3,6,4,59,38.25381314,-109.4111634
35500,2,35,7,5,7,4,60,38.25381314,-109.4108939
35501,2,32,9,4,9,6,62,38.25381314,-109.4106244
35502,3,39,10,3,13,6,74,38.25381314,-109.4103549
35503,3,40,11,4,14,5,77,38.25381314,-109.4100855
35504,3,41,11,5,13,4,77,38.25381314,-109.409816
35505,4,42,11,5,12,5,79,38.25381314,-109.4095465
35506,6,38,12,3,10,10,79,38.25381314,-109.409277
35507,4,42,11,3,12,7,79,38.25381314,-109.4090075
35508,6,43,12,8,12,3,84,38.25381314,-109.408738
35509,7,43,13,11,12,2,88,38.25381314,-109.4084685
35510,6,43,13,13,12,2,89,38.25381314,-109.408199
35511,6,44,13,13,12,1,89,38.25381314,-109.4079295
35512,6,46,13,13,12,1,91,38.25381314,-109.40766
35513,6,48,13,10,14,1,92,38.25381314,-109.4073905
35514,5,49,13,7,15,2,91,38.25381314,-109.407121
35515,4,49,12,6,15,3,89,38.25381314,-109.4068515
35516,4,48,12,6,15,4,89,38.25381314,-109.406582
35517,5,44,12,10,14,3,88,38.25381314,-109.4063125
35518,4,44,12,10,14,3,87,38.25381314,-109.406043
35519,3,44,11,6,15,4,83,38.25381314,-109.4057735
35520,3,42,13,3,16,7,84,38.25381314,-109.405504
35521,4,44,12,5,18,4,87,38.25381314,-109.4052345
35522,5,47,12,7,17,1,89,38.25381314,-109.4049651
35523,5,47,12,7,17,1,89,38.25381314,-109.4046956
35524,5,47,12,5,17,3,89,38.25381314,-109.4044261
35525,3,43,11,2,13,8,80,38.25381314,-109.4041566
35526,2,40,9,2,10,8,71,38.25381314,-109.4038871
35527,2,40,9,3,12,6,72,38.25381314,-109.4036176
35528,3,38,9,4,11,5,70,38.25381314,-109.4033481
35529,2,35,9,3,9,7,65,38.25381314,-109.4030786
35530,2,37,8,2,8,5,62,38.25381314,-109.4028091
35531,3,40,8,3,7,4,65,38.25381314,-109.4025396
35532,2,39,8,3,8,5,65,38.25381314,-109.4022701
35533,1,37,7,3,8,5,61,38.25381314,-109.4020006
35534,3,40,7,4,8,4,66,38.25381314,-109.4017311
35535,2,37,8,3,9,4,63,38.25381314,-109.4014616
35536,1,32,8,2,9,7,59,38.25381314,-109.4011921
35537,1,26,10,4,10,8,59,38.25381314,-109.4009226
35538,3,25,10,7,13,6,64,38.25381314,-109.4006531
35539,3,29,10,5,11,6,64,38.25381314,-109.4003836
35540,7,34,10,6,11,3,71,38.25381314,-109.4001142
35541,2,33,8,3,9,6,61,38.25381314,-109.3998447
35542,2,27,9,5,11,6,60,38.25381314,-109.3995752
35543,7,28,11,9,14,3,72,38.25381314,-109.3993057
35544,8,28,11,12,12,3,74,38.25381314,-109.3990362
35545,6,32,11,8,12,4,73,38.25381314,-109.3987667
35546,2,30,10,6,11,7,66,38.25381314,-109.3984972
35547,2,28,10,6,10,8,64,38.25381314,-109.3982277
35548,5,31,12,5,12,5,70,38.25381314,-109.3979582
35549,1,34,11,3,13,9,71,38.25381314,-109.3976887
35550,1,33,12,2,13,11,72,38.25381314,-109.3974192
35551,1,32,11,0,10,16,70,38.25381314,-109.3971497
35552,1,31,12,0,8,20,72,38.25381314,-109.3968802
35553,1,30,12,0,8,18,69,38.25381314,-109.3966107
35554,0,37,9,0,10,12,68,38.25381314,-109.3963412
35555,1,38,9,0,10,9,67,38.25381314,-109.3960717
35556,1,36,9,1,9,8,64,38.25381314,-109.3958022
35557,1,34,9,1,9,9,63,38.25381314,-109.3955327
35558,1,37,9,2,10,7,66,38.25381314,-109.3952632
35559,1,36,9,3,11,6,66,38.25381314,-109.3949938
35560,1,36,9,2,10,7,65,38.25381314,-109.3947243
35561,1,36,9,2,10,7,65,38.25381314,-109.3944548
35562,2,34,9,2,10,7,64,38.25381314,-109.3941853
35563,1,32,9,2,9,7,60,38.25381314,-109.3939158
35564,2,30,9,4,9,7,61,38.25381314,-109.3936463
35565,4,30,10,9,14,4,71,38.25381314,-109.3933768
35566,8,28,13,19,16,2,86,38.25381314,-109.3931073
35567,1,24,13,19,19,6,82,38.25381314,-109.3928378
35568,2,26,13,16,24,4,85,38.25381314,-109.3925683
35569,1,30,13,11,19,8,82,38.25381314,-109.3922988
35570,1,31,13,8,21,6,80,38.25381314,-109.3920293
35571,5,33,13,10,21,2,84,38.25381314,-109.3917598
35572,11,34,12,10,14,3,84,38.25381314,-109.3914903
35573,7,35,13,11,16,3,85,38.25381314,-109.3912208
35574,8,37,13,10,16,3,87,38.25381314,-109.3909513
35575,10,38,13,9,16,3,89,38.25381314,-109.3906818
35576,10,37,13,9,17,1,87,38.25381314,-109.3904123
35577,9,41,13,9,16,1,89,38.25381314,-109.3901429
35578,10,40,13,10,17,0,90,38.25381314,-109.3898734
35579,11,38,13,9,17,1,89,38.25381314,-109.3896039
35580,11,36,12,8,15,3,85,38.25381314,-109.3893344
35581,7,35,12,4,15,7,80,38.25381314,-109.3890649
35582,3,35,11,0,12,13,74,38.25381314,-109.3887954
35583,2,33,11,0,10,16,72,38.25381314,-109.3885259
35584,2,30,11,0,9,17,69,38.25381314,-109.3882564
35585,2,29,12,0,9,17,69,38.25381314,-109.3879869
35586,4,33,13,0,9,16,75,38.25381314,-109.3877174
35587,1,31,12,0,8,17,69,38.25381314,-109.3874479
35588,0,33,11,0,9,18,71,38.25381314,-109.3871784
35589,0,33,11,0,10,18,72,38.25381314,-109.3869089
35590,0,29,11,2,13,11,66,38.25381314,-109.3866394
35591,2,33,11,7,12,6,71,38.25381314,-109.3863699
35592,2,33,10,14,9,3,71,38.25381314,-109.3861004
35593,2,33,9,12,10,3,69,38.25381314,-109.3858309
35594,4,40,9,12,11,1,77,38.25381314,-109.3855614
35595,4,52,9,13,9,1,88,38.25381314,-109.3852919
35596,5,51,10,13,10,1,90,38.25381314,-109.3850225
35597,8,48,11,10,11,1,89,38.25381314,-109.384753
35598,8,48,12,9,13,0,90,38.25381314,-109.3844835
35599,6,49,11,7,14,1,88,38.25381314,-109.384214
35600,7,43,12,12,14,1,89,38.25381314,-109.3839445
35601,15,37,14,14,11,0,91,38.25381314,-109.383675
35602,17,36,13,13,12,0,91,38.25381314,-109.3834055
35603,15,37,13,11,15,0,91,38.25381314,-109.383136
35604,14,35,12,10,15,0,86,38.25381314,-109.3828665
35605,18,31,12,10,11,2,84,38.25381314,-109.382597
35606,10,29,11,7,12,5,74,38.25381314,-109.3823275
35607,6,26,10,5,10,6,63,38.25381314,-109.382058
35608,5,25,9,9,11,4,63,38.25381314,-109.3817885
35609,11,28,11,10,16,1,77,38.25381314,-109.381519
35610,13,35,13,11,15,1,88,38.25381314,-109.3812495
35611,16,37,13,12,14,0,92,38.25381314,-109.38098
35612,15,38,14,13,14,0,94,38.25381314,-109.3807105
35613,12,39,14,13,14,0,92,38.25381314,-109.380441
35614,9,43,14,11,14,1,92,38.25381314,-109.3801716
35615,10,40,14,13,14,0,91,38.25381314,-109.3799021
35616,11,39,15,15,13,0,93,38.25381314,-109.3796326
35617,11,39,15,16,12,0,93,38.25381314,-109.3793631
35618,11,40,15,15,13,0,94,38.25381314,-109.3790936
35619,14,40,15,14,13,0,96,38.25381314,-109.3788241
35620,13,40,15,15,13,0,96,38.25381314,-109.3785546
35621,14,39,14,13,13,1,94,38.25381314,-109.3782851
35622,14,38,13,11,13,1,90,38.25381314,-109.3780156
35623,13,39,13,11,13,1,90,38.25381314,-109.3777461
35624,14,39,13,11,12,1,90,38.25381314,-109.3774766
35625,17,36,13,12,12,1,91,38.25381314,-109.3772071
35626,19,33,13,13,11,1,90,38.25381314,-109.3769376
35627,20,31,13,15,10,1,90,38.25381314,-109.3766681
35628,23,29,14,16,8,1,91,38.25381314,-109.3763986
35629,23,29,14,17,7,1,91,38.25381314,-109.3761291
35630,25,28,14,16,7,1,91,38.25381314,-109.3758596
35631,26,26,14,17,6,1,90,38.25381314,-109.3755901
35632,28,23,14,19,6,1,91,38.25381314,-109.3753206
35633,28,23,14,18,6,1,90,38.25381314,-109.3750512
35634,24,26,16,16,6,3,91,38.25381314,-109.3747817
35635,14,30,16,14,8,6,88,38.25381314,-109.3745122
35636,10,31,15,12,8,8,84,38.25381314,-109.3742427
35637,9,30,15,12,9,8,83,38.25381314,-109.3739732
35638,11,27,15,11,9,10,83,38.25381314,-109.3737037
35639,13,27,15,12,9,9,85,38.25381314,-109.3734342
35640,10,27,14,10,6,11,78,38.25381314,-109.3731647
35641,6,25,15,9,6,17,78,38.25381314,-109.3728952
35642,3,30,14,4,5,20,76,38.25381314,-109.3726257
35643,2,29,14,2,7,22,76,38.25381314,-109.3723562
35644,5,29,13,2,6,20,75,38.25381314,-109.3720867
35645,4,40,13,6,5,17,85,38.25381314,-109.3718172
35646,5,25,12,11,6,18,77,38.25381314,-109.3715477
35647,9,21,12,14,10,11,77,38.25381314,-109.3712782
35648,12,20,11,17,8,10,78,38.25381314,-109.3710087
35649,5,32,13,10,12,12,84,38.25381314,-109.3707392
35650,4,30,14,5,8,19,80,38.25381314,-109.3704697
35651,2,25,16,2,9,24,78,38.25381314,-109.3702003
35652,1,24,16,1,7,24,73,38.25381314,-109.3699308
35653,0,26,15,0,7,25,73,38.25381314,-109.3696613
35654,0,23,15,0,3,28,69,38.25381314,-109.3693918
35655,0,23,16,0,3,30,72,38.25381314,-109.3691223
35656,2,29,16,0,7,23,77,38.25381314,-109.3688528
35657,3,28,14,0,8,23,76,38.25381314,-109.3685833
35658,6,25,15,1,7,21,75,38.25381314,-109.3683138
35659,6,27,14,4,7,19,77,38.25381314,-109.3680443
35660,3,29,14,1,11,19,77,38.25381314,-109.3677748
35661,8,25,13,13,18,6,83,38.25381314,-109.3675053
35662,2,22,13,13,24,4,78,38.25381314,-109.3672358
35663,4,16,11,20,22,1,74,38.25381314,-109.3669663
35664,4,14,10,23,21,2,74,38.25381314,-109.3666968
35665,2,11,11,17,13,6,60,38.25381314,-109.3664273
35666,3,24,12,9,15,9,72,38.25381314,-109.3661578
35667,2,27,14,4,9,19,75,38.25381314,-109.3658883
35668,1,17,14,0,2,27,61,38.25381314,-109.3656188
35669,1,21,15,0,1,27,65,38.25381314,-109.3653493
35670,2,23,15,0,2,26,68,38.25381314,-109.3650799
35671,1,22,14,0,1,27,65,38.25381314,-109.3648104
35672,1,23,14,0,1,26,65,38.25381314,-109.3645409
35673,1,24,14,0,1,25,65,38.25381314,-109.3642714
35674,1,22,15,0,1,27,66,38.25381314,-109.3640019
35675,3,21,16,1,1,29,71,38.25381314,-109.3637324
35676,2,20,17,1,1,29,70,38.25381314,-109.3634629
35677,2,20,17,0,1,30,70,38.25381314,-109.3631934
35678,2,21,17,0,1,30,71,38.25381314,-109.3629239
35679,3,22,17,0,1,29,72,38.25381314,-109.3626544
35680,2,20,16,0,1,29,68,38.25381314,-109.3623849
35681,2,20,16,0,1,28,67,38.25381314,-109.3621154
35682,2,20,15,0,1,27,65,38.25381314,-109.3618459
35683,1,21,14,0,1,25,62,38.25381314,-109.3615764
35684,1,20,14,1,1,25,62,38.25381314,-109.3613069
35685,1,22,13,0,1,24,61,38.25381314,-109.3610374
35686,0,21,13,0,1,24,59,38.25381314,-109.3607679
35687,0,20,14,0,0,27,61,38.25381314,-109.3604984
35688,1,20,16,0,0,29,66,38.25381314,-109.360229
35689,1,21,16,0,1,30,69,38.25381314,-109.3599595
35690,1,20,17,0,2,31,71,38.25381314,-109.35969
35691,1,19,17,0,1,31,69,38.25381314,-109.3594205
35692,1,19,16,0,1,29,66,38.25381314,-109.359151
35693,1,21,15,0,1,28,66,38.25381314,-109.3588815
35694,0,22,16,0,2,30,70,38.25381314,-109.358612
35695,0,22,17,0,2,31,72,38.25381314,-109.3583425
35696,0,21,17,0,2,31,71,38.25381314,-109.358073
35697,0,20,16,0,2,29,67,38.25381314,-109.3578035
35698,0,20,16,0,2,29,67,38.25381314,-109.357534
35699,1,21,16,1,2,28,69,38.25381314,-109.3572645
35700,1,22,15,1,2,26,67,38.25381314,-109.356995
35701,0,21,14,1,1,26,63,38.25381314,-109.3567255
35702,0,20,14,1,1,26,62,38.25381314,-109.356456
35703,0,23,13,1,2,24,63,38.25381314,-109.3561865
35704,0,23,12,0,3,22,60,38.25381314,-109.355917
35705,0,24,11,1,3,20,59,38.25381314,-109.3556475
35706,0,25,11,1,3,20,60,38.25381314,-109.355378
35707,1,25,12,2,3,22,65,38.25381314,-109.3551086
35708,1,26,12,1,3,22,65,38.25381314,-109.3548391
35709,1,25,13,1,3,22,65,38.25381314,-109.3545696
35710,1,24,13,0,2,22,62,38.25381314,-109.3543001
35711,1,24,13,0,2,23,63,38.25381314,-109.3540306
35712,3,21,14,0,2,24,64,38.25381314,-109.3537611
35713,2,21,14,0,1,24,62,38.25381314,-109.3534916
35714,1,26,11,0,3,19,60,38.25381314,-109.3532221
35715,1,30,10,0,5,16,62,38.25381314,-109.3529526
35716,1,31,10,1,5,13,61,38.25381314,-109.3526831
35717,3,32,8,2,9,6,60,38.25381314,-109.3524136
35718,1,28,8,2,9,7,55,38.25381314,-109.3521441
35719,1,24,10,4,7,11,57,38.25381314,-109.3518746
35720,3,26,11,3,5,15,63,38.25381314,-109.3516051
35721,4,24,10,4,7,10,59,38.25381314,-109.3513356
35722,4,23,9,4,10,6,56,38.25381314,-109.3510661
35723,2,23,9,4,9,6,53,38.25381314,-109.3507966
35724,3,23,8,4,8,5,51,38.25381314,-109.3505271
35725,3,24,8,5,8,5,53,38.25381314,-109.3502577
35726,2,22,8,4,7,5,48,38.25381314,-109.3499882
35727,4,17,11,10,10,4,56,38.25381314,-109.3497187
35728,1,19,12,17,13,4,66,38.25381314,-109.3494492
35729,0,21,13,16,12,9,71,38.25381314,-109.3491797
35730,3,26,10,11,13,2,65,38.25381314,-109.3489102
35731,3,33,9,9,8,3,65,38.25381314,-109.3486407
35732,1,34,9,6,9,7,66,38.25381314,-109.3483712
35733,2,26,11,2,10,14,65,38.25381314,-109.3481017
35734,6,28,13,4,11,10,72,38.25381314,-109.3478322
35735,2,30,12,8,14,7,73,38.25381314,-109.3475627
35736,9,35,10,8,11,3,76,38.25381314,-109.3472932
35737,5,31,8,9,11,0,64,38.25381314,-109.3470237
35738,1,48,9,5,11,2,76,38.25381314,-109.3467542
35739,2,40,8,6,10,6,72,38.25381314,-109.3464847
35740,1,32,8,1,8,9,59,38.25381314,-109.3462152
35741,2,30,10,4,7,11,64,38.25381314,-109.3459457
35742,3,17,13,6,6,15,60,38.25381314,-109.3456762
35743,6,15,14,4,5,16,60,38.25381314,-109.3454068
35744,4,16,13,2,5,17,57,38.25381314,-109.3451373
35745,4,20,15,3,7,15,64,38.25381314,-109.3448678
35746,8,22,17,6,10,13,76,38.25381314,-109.3445983
35747,7,19,13,10,10,9,68,38.25381314,-109.3443288
35748,6,18,13,12,12,6,67,38.25381314,-109.3440593
35749,2,21,12,12,16,8,71,38.25381314,-109.3437898
35750,1,13,10,7,17,6,54,38.25381314,-109.3435203
35751,3,20,13,2,15,12,65,38.25381314,-109.3432508
35752,4,27,15,2,8,17,73,38.25381314,-109.3429813
35753,2,17,14,0,2,24,59,38.25381314,-109.3427118
35754,6,18,9,2,2,13,50,38.25381314,-109.3424423
35755,3,23,8,2,6,11,53,38.25381314,-109.3421728
35756,2,20,8,2,6,11,49,38.25381314,-109.3419033
35757,2,21,8,4,6,11,52,38.25381314,-109.3416338
35758,3,26,8,5,7,10,59,38.25381314,-109.3413643
35759,2,38,7,4,9,7,67,38.25381314,-109.3410948
35760,1,37,7,5,10,5,65,38.25381314,-109.3408253
35761,1,34,7,6,10,6,64,38.25381314,-109.3405558
35762,1,39,7,5,10,6,68,38.25381314,-109.3402864
35763,2,50,7,5,10,3,77,38.25381314,-109.3400169
35764,1,53,6,4,9,3,76,38.25381314,-109.3397474
35765,1,44,6,4,9,2,66,38.25381314,-109.3394779
35766,2,37,6,4,9,5,63,38.25381314,-109.3392084
35767,2,40,7,5,9,6,69,38.25381314,-109.3389389
35768,3,41,7,5,8,7,71,38.25381314,-109.3386694
35769,3,45,7,6,9,4,74,38.25381314,-109.3383999
35770,3,45,6,6,8,4,72,38.25381314,-109.3381304
35771,3,39,6,4,9,4,65,38.25381314,-109.3378609
35772,2,28,8,3,10,6,57,38.25381314,-109.3375914
35773,1,26,12,3,6,17,65,38.25381314,-109.3373219
35774,1,32,11,1,8,14,67,38.25381314,-109.3370524
35775,1,26,10,2,8,12,59,38.25381314,-109.3367829
35776,2,27,9,4,7,7,56,38.25381314,-109.3365134
35777,6,28,9,6,8,5,62,38.25381314,-109.3362439
35778,2,24,10,3,7,10,56,38.25381314,-109.3359744
35779,2,25,9,5,9,7,57,38.25381314,-109.3357049
35780,4,22,10,6,9,6,57,38.25381314,-109.3354355
35781,6,22,12,9,10,6,65,38.25381314,-109.335166
35782,3,22,15,5,7,13,65,38.25381314,-109.3348965
35783,1,23,15,4,6,15,64,38.25381314,-109.334627
35784,1,21,12,4,7,14,59,38.25381314,-109.3343575
35785,1,22,11,4,11,11,60,38.25381314,-109.334088
35786,1,27,11,4,11,10,64,38.25381314,-109.3338185
35787,1,29,11,3,9,12,65,38.25381314,-109.333549
35788,1,27,10,6,8,7,59,38.25381314,-109.3332795
35789,3,26,9,8,8,5,59,38.25381314,-109.33301
35790,4,27,8,10,8,3,60,38.25381314,-109.3327405
35791,5,28,8,12,8,2,63,38.25381314,-109.332471
35792,4,25,10,11,10,4,64,38.25381314,-109.3322015
35793,1,22,10,7,10,10,60,38.25381314,-109.331932
35794,1,23,10,4,8,13,59,38.25381314,-109.3316625
35795,1,45,8,1,12,5,72,38.25354364859627,-109.4405383
35796,1,49,8,1,11,5,75,38.25354364859627,-109.4402688
35797,1,55,8,0,12,5,81,38.25354364859627,-109.4399993
35798,1,56,8,0,12,6,83,38.25354364859627,-109.4397299
35799,1,53,9,0,13,7,83,38.25354364859627,-109.4394604
35800,1,56,8,3,14,4,86,38.25354364859627,-109.4391909
35801,3,55,9,6,13,3,89,38.25354364859627,-109.4389214
35802,5,52,10,9,13,2,91,38.25354364859627,-109.4386519
35803,7,47,12,9,15,1,91,38.25354364859627,-109.4383824
35804,7,42,12,13,13,1,88,38.25354364859627,-109.4381129
35805,7,42,12,12,13,1,87,38.25354364859627,-109.4378434
35806,7,40,13,13,12,1,86,38.25354364859627,-109.4375739
35807,6,39,13,15,12,1,86,38.25354364859627,-109.4373044
35808,8,37,13,15,13,1,87,38.25354364859627,-109.4370349
35809,8,35,12,14,14,1,84,38.25354364859627,-109.4367654
35810,5,40,11,7,13,5,81,38.25354364859627,-109.4364959
35811,2,36,10,2,12,9,71,38.25354364859627,-109.4362264
35812,1,34,10,4,12,9,70,38.25354364859627,-109.4359569
35813,3,35,11,7,11,5,72,38.25354364859627,-109.4356874
35814,1,32,9,6,10,7,65,38.25354364859627,-109.4354179
35815,2,33,10,6,10,7,68,38.25354364859627,-109.4351484
35816,2,35,10,4,10,8,69,38.25354364859627,-109.434879
35817,1,35,9,2,8,9,64,38.25354364859627,-109.4346095
35818,3,43,7,5,6,4,68,38.25354364859627,-109.43434
35819,3,40,7,5,7,4,66,38.25354364859627,-109.4340705
35820,3,38,8,4,9,5,67,38.25354364859627,-109.433801
35821,1,46,8,1,12,4,72,38.25354364859627,-109.4335315
35822,1,53,8,2,12,3,79,38.25354364859627,-109.433262
35823,2,53,8,3,13,3,82,38.25354364859627,-109.4329925
35824,4,51,11,8,14,1,89,38.25354364859627,-109.432723
35825,7,49,12,9,15,0,92,38.25354364859627,-109.4324535
35826,7,50,12,9,16,0,94,38.25354364859627,-109.432184
35827,5,51,11,6,16,0,89,38.25354364859627,-109.4319145
35828,9,39,11,9,15,1,84,38.25354364859627,-109.431645
35829,13,38,13,12,14,0,90,38.25354364859627,-109.4313755
35830,14,38,13,13,13,0,91,38.25354364859627,-109.431106
35831,16,36,14,13,13,0,92,38.25354364859627,-109.4308365
35832,17,37,14,12,13,0,93,38.25354364859627,-109.430567
35833,15,39,13,11,14,0,92,38.25354364859627,-109.4302975
35834,11,43,13,11,14,0,92,38.25354364859627,-109.430028
35835,7,47,12,11,13,1,91,38.25354364859627,-109.4297586
35836,5,50,11,10,13,1,90,38.25354364859627,-109.4294891
35837,4,53,10,8,14,1,90,38.25354364859627,-109.4292196
35838,5,52,11,10,13,1,92,38.25354364859627,-109.4289501
35839,4,52,11,9,13,1,90,38.25354364859627,-109.4286806
35840,4,52,10,8,14,1,89,38.25354364859627,-109.4284111
35841,7,51,11,8,15,0,92,38.25354364859627,-109.4281416
35842,7,51,11,8,15,0,92,38.25354364859627,-109.4278721
35843,9,49,11,8,15,0,92,38.25354364859627,-109.4276026
35844,11,45,12,10,15,0,93,38.25354364859627,-109.4273331
35845,15,40,13,10,14,0,92,38.25354364859627,-109.4270636
35846,19,37,14,10,13,0,93,38.25354364859627,-109.4267941
35847,17,38,14,11,13,0,93,38.25354364859627,-109.4265246
35848,17,36,14,13,13,0,93,38.25354364859627,-109.4262551
35849,19,34,14,13,12,0,92,38.25354364859627,-109.4259856
35850,20,33,14,13,11,0,91,38.25354364859627,-109.4257161
35851,26,31,14,11,10,0,92,38.25354364859627,-109.4254466
35852,27,30,14,10,11,0,92,38.25354364859627,-109.4251771
35853,26,31,14,10,11,0,92,38.25354364859627,-109.4249077
35854,22,32,14,11,12,0,91,38.25354364859627,-109.4246382
35855,16,34,14,13,13,0,90,38.25354364859627,-109.4243687
35856,14,37,14,13,14,0,92,38.25354364859627,-109.4240992
35857,13,38,14,13,14,0,92,38.25354364859627,-109.4238297
35858,12,39,14,13,14,0,92,38.25354364859627,-109.4235602
35859,10,41,14,12,14,0,91,38.25354364859627,-109.4232907
35860,6,46,12,9,14,1,88,38.25354364859627,-109.4230212
35861,4,47,11,8,14,2,86,38.25354364859627,-109.4227517
35862,5,48,11,8,14,2,88,38.25354364859627,-109.4224822
35863,4,48,10,6,14,3,85,38.25354364859627,-109.4222127
35864,2,49,10,3,14,5,83,38.25354364859627,-109.4219432
35865,2,49,9,2,15,6,83,38.25354364859627,-109.4216737
35866,3,48,10,4,14,5,84,38.25354364859627,-109.4214042
35867,4,45,11,8,12,3,83,38.25354364859627,-109.4211347
35868,5,42,11,10,12,2,82,38.25354364859627,-109.4208652
35869,3,45,10,8,13,2,81,38.25354364859627,-109.4205957
35870,2,46,9,3,12,4,76,38.25354364859627,-109.4203262
35871,2,44,9,3,11,5,74,38.25354364859627,-109.4200568
35872,2,42,10,4,13,5,76,38.25354364859627,-109.4197873
35873,3,39,12,5,12,7,78,38.25354364859627,-109.4195178
35874,3,36,11,1,9,12,72,38.25354364859627,-109.4192483
35875,3,32,10,3,8,10,66,38.25354364859627,-109.4189788
35876,3,37,9,3,11,7,70,38.25354364859627,-109.4187093
35877,3,42,9,4,11,4,73,38.25354364859627,-109.4184398
35878,4,41,9,4,11,4,73,38.25354364859627,-109.4181703
35879,4,34,8,5,10,4,65,38.25354364859627,-109.4179008
35880,2,35,7,4,7,4,59,38.25354364859627,-109.4176313
35881,2,34,7,4,8,5,60,38.25354364859627,-109.4173618
35882,3,33,8,3,9,6,62,38.25354364859627,-109.4170923
35883,5,34,8,3,9,6,65,38.25354364859627,-109.4168228
35884,3,36,8,2,10,7,66,38.25354364859627,-109.4165533
35885,3,40,9,3,11,6,72,38.25354364859627,-109.4162838
35886,3,40,9,4,13,5,74,38.25354364859627,-109.4160143
35887,3,37,10,5,12,5,72,38.25354364859627,-109.4157448
35888,5,35,8,4,10,4,66,38.25354364859627,-109.4154753
35889,5,35,8,4,9,4,65,38.25354364859627,-109.4152058
35890,4,35,8,4,9,4,64,38.25354364859627,-109.4149364
35891,5,36,8,4,10,3,66,38.25354364859627,-109.4146669
35892,7,36,8,5,11,3,70,38.25354364859627,-109.4143974
35893,5,40,9,5,12,2,73,38.25354364859627,-109.4141279
35894,3,45,9,4,14,3,78,38.25354364859627,-109.4138584
35895,3,45,10,3,14,5,80,38.25354364859627,-109.4135889
35896,3,46,10,3,15,5,82,38.25354364859627,-109.4133194
35897,4,44,11,6,15,2,82,38.25354364859627,-109.4130499
35898,2,47,9,3,12,4,77,38.25354364859627,-109.4127804
35899,1,50,8,2,11,3,75,38.25354364859627,-109.4125109
35900,2,42,7,3,9,2,65,38.25354364859627,-109.4122414
35901,2,39,6,3,7,3,60,38.25354364859627,-109.4119719
35902,2,39,5,3,6,3,58,38.25354364859627,-109.4117024
35903,2,39,7,4,7,3,62,38.25354364859627,-109.4114329
35904,3,34,8,5,8,4,62,38.25354364859627,-109.4111634
35905,3,30,9,5,9,7,63,38.25354364859627,-109.4108939
35906,2,33,11,3,11,10,70,38.25354364859627,-109.4106244
35907,3,37,11,3,12,9,75,38.25354364859627,-109.4103549
35908,3,37,11,4,13,7,75,38.25354364859627,-109.4100855
35909,3,40,11,5,13,5,77,38.25354364859627,-109.409816
35910,4,42,10,6,12,4,78,38.25354364859627,-109.4095465
35911,5,43,11,6,12,4,81,38.25354364859627,-109.409277
35912,4,42,12,5,13,6,82,38.25354364859627,-109.4090075
35913,5,43,12,5,13,6,84,38.25354364859627,-109.408738
35914,6,45,13,7,13,3,87,38.25354364859627,-109.4084685
35915,6,46,13,9,13,2,89,38.25354364859627,-109.408199
35916,6,47,13,10,12,1,89,38.25354364859627,-109.4079295
35917,6,47,14,12,12,1,92,38.25354364859627,-109.40766
35918,6,48,14,10,13,1,92,38.25354364859627,-109.4073905
35919,5,48,13,7,14,2,89,38.25354364859627,-109.407121
35920,4,50,12,6,15,2,89,38.25354364859627,-109.4068515
35921,4,50,12,7,15,2,90,38.25354364859627,-109.406582
35922,4,48,12,5,13,5,87,38.25354364859627,-109.4063125
35923,3,46,10,5,15,4,83,38.25354364859627,-109.406043
35924,2,47,11,3,16,5,84,38.25354364859627,-109.4057735
35925,4,49,12,3,14,6,88,38.25354364859627,-109.405504
35926,5,48,12,5,17,2,89,38.25354364859627,-109.4052345
35927,5,47,12,7,17,1,89,38.25354364859627,-109.4049651
35928,5,47,12,7,17,1,89,38.25354364859627,-109.4046956
35929,5,47,11,6,15,2,86,38.25354364859627,-109.4044261
35930,3,42,10,3,12,6,76,38.25354364859627,-109.4041566
35931,2,33,8,2,7,7,59,38.25354364859627,-109.4038871
35932,2,35,7,2,7,6,59,38.25354364859627,-109.4036176
35933,2,34,8,2,8,6,60,38.25354364859627,-109.4033481
35934,2,35,8,2,7,6,60,38.25354364859627,-109.4030786
35935,2,37,8,4,7,4,62,38.25354364859627,-109.4028091
35936,3,34,9,3,8,6,63,38.25354364859627,-109.4025396
35937,0,33,9,1,8,10,61,38.25354364859627,-109.4022701
35938,0,34,9,0,8,9,60,38.25354364859627,-109.4020006
35939,1,36,8,2,9,6,62,38.25354364859627,-109.4017311
35940,2,30,9,5,11,5,62,38.25354364859627,-109.4014616
35941,4,27,12,12,12,5,72,38.25354364859627,-109.4011921
35942,9,22,13,16,12,4,76,38.25354364859627,-109.4009226
35943,10,21,12,16,13,5,77,38.25354364859627,-109.4006531
35944,4,21,11,15,13,8,72,38.25354364859627,-109.4003836
35945,15,26,12,7,11,3,74,38.25354364859627,-109.4001142
35946,2,26,9,4,9,9,59,38.25354364859627,-109.3998447
35947,4,26,10,8,10,7,65,38.25354364859627,-109.3995752
35948,13,29,15,12,12,4,85,38.25354364859627,-109.3993057
35949,7,25,19,14,13,12,90,38.25354364859627,-109.3990362
35950,7,27,18,16,12,8,88,38.25354364859627,-109.3987667
35951,9,28,13,12,13,4,79,38.25354364859627,-109.3984972
35952,7,28,12,10,13,5,75,38.25354364859627,-109.3982277
35953,5,22,11,11,11,6,66,38.25354364859627,-109.3979582
35954,11,35,11,8,11,2,78,38.25354364859627,-109.3976887
35955,4,34,12,5,14,6,75,38.25354364859627,-109.3974192
35956,0,32,11,0,12,12,67,38.25354364859627,-109.3971497
35957,0,32,9,0,8,14,63,38.25354364859627,-109.3968802
35958,0,36,8,0,9,9,62,38.25354364859627,-109.3966107
35959,0,32,8,1,9,7,57,38.25354364859627,-109.3963412
35960,2,26,9,3,10,6,56,38.25354364859627,-109.3960717
35961,3,26,9,5,10,6,59,38.25354364859627,-109.3958022
35962,4,27,9,6,10,6,62,38.25354364859627,-109.3955327
35963,2,29,9,4,9,7,60,38.25354364859627,-109.3952632
35964,5,38,9,2,8,5,67,38.25354364859627,-109.3949938
35965,3,34,9,6,10,6,68,38.25354364859627,-109.3947243
35966,2,35,9,6,11,6,69,38.25354364859627,-109.3944548
35967,3,32,9,5,13,4,66,38.25354364859627,-109.3941853
35968,1,34,9,4,10,6,64,38.25354364859627,-109.3939158
35969,2,30,10,15,15,3,75,38.25354364859627,-109.3936463
35970,3,28,11,26,19,0,87,38.25354364859627,-109.3933768
35971,0,26,12,19,21,4,82,38.25354364859627,-109.3931073
35972,2,22,12,13,17,6,72,38.25354364859627,-109.3928378
35973,0,28,13,5,14,15,75,38.25354364859627,-109.3925683
35974,2,35,12,5,17,7,78,38.25354364859627,-109.3922988
35975,5,38,12,8,18,3,84,38.25354364859627,-109.3920293
35976,9,35,12,11,17,1,85,38.25354364859627,-109.3917598
35977,14,34,12,11,16,1,88,38.25354364859627,-109.3914903
35978,16,34,12,13,16,0,91,38.25354364859627,-109.3912208
35979,15,35,13,14,15,1,93,38.25354364859627,-109.3909513
35980,13,36,14,12,15,1,91,38.25354364859627,-109.3906818
35981,11,38,13,10,15,2,89,38.25354364859627,-109.3904123
35982,10,40,13,11,15,1,90,38.25354364859627,-109.3901429
35983,10,39,13,10,17,1,90,38.25354364859627,-109.3898734
35984,10,37,13,10,17,1,88,38.25354364859627,-109.3896039
35985,8,33,13,9,16,4,83,38.25354364859627,-109.3893344
35986,5,30,12,4,13,11,75,38.25354364859627,-109.3890649
35987,3,32,11,0,12,14,72,38.25354364859627,-109.3887954
35988,3,32,11,1,12,13,72,38.25354364859627,-109.3885259
35989,4,31,12,3,12,12,74,38.25354364859627,-109.3882564
35990,4,30,12,4,11,12,73,38.25354364859627,-109.3879869
35991,5,31,13,5,11,12,77,38.25354364859627,-109.3877174
35992,3,28,12,2,9,16,70,38.25354364859627,-109.3874479
35993,2,29,13,0,7,20,71,38.25354364859627,-109.3871784
35994,1,31,12,0,8,20,72,38.25354364859627,-109.3869089
35995,0,33,11,0,11,17,72,38.25354364859627,-109.3866394
35996,1,33,11,0,12,14,71,38.25354364859627,-109.3863699
35997,1,38,10,0,13,10,72,38.25354364859627,-109.3861004
35998,1,35,10,5,14,7,72,38.25354364859627,-109.3858309
35999,2,38,9,9,13,4,75,38.25354364859627,-109.3855614
36000,5,46,10,12,14,1,88,38.25354364859627,-109.3852919
36001,7,41,11,13,13,1,86,38.25354364859627,-109.3850225
36002,10,41,13,13,13,1,91,38.25354364859627,-109.384753
36003,10,43,13,12,14,0,92,38.25354364859627,-109.3844835
36004,7,45,12,10,14,1,89,38.25354364859627,-109.384214
36005,4,41,10,9,15,2,81,38.25354364859627,-109.3839445
36006,12,42,12,11,12,0,89,38.25354364859627,-109.383675
36007,14,39,12,11,13,0,89,38.25354364859627,-109.3834055
36008,12,37,12,10,16,0,87,38.25354364859627,-109.383136
36009,11,36,11,8,15,2,83,38.25354364859627,-109.3828665
36010,12,35,11,7,12,3,80,38.25354364859627,-109.382597
36011,3,39,8,5,13,3,71,38.25354364859627,-109.3823275
36012,3,38,7,7,9,3,67,38.25354364859627,-109.382058
36013,3,35,8,10,9,2,67,38.25354364859627,-109.3817885
36014,4,42,10,6,15,1,78,38.25354364859627,-109.381519
36015,7,40,12,9,17,1,86,38.25354364859627,-109.3812495
36016,12,40,14,13,15,0,94,38.25354364859627,-109.38098
36017,12,40,14,13,14,0,93,38.25354364859627,-109.3807105
36018,10,42,14,12,14,1,93,38.25354364859627,-109.380441
36019,9,41,14,12,14,1,91,38.25354364859627,-109.3801716
36020,10,39,14,14,13,1,91,38.25354364859627,-109.3799021
36021,11,39,14,15,13,1,93,38.25354364859627,-109.3796326
36022,12,39,14,14,13,0,92,38.25354364859627,-109.3793631
36023,11,41,14,12,14,1,93,38.25354364859627,-109.3790936
36024,9,42,14,12,14,1,92,38.25354364859627,-109.3788241
36025,8,44,14,11,15,1,93,38.25354364859627,-109.3785546
36026,8,43,14,11,15,0,91,38.25354364859627,-109.3782851
36027,10,41,14,12,15,1,93,38.25354364859627,-109.3780156
36028,12,38,14,12,12,1,89,38.25354364859627,-109.3777461
36029,15,35,13,12,12,1,88,38.25354364859627,-109.3774766
36030,16,33,13,12,11,2,87,38.25354364859627,-109.3772071
36031,18,33,14,15,10,1,91,38.25354364859627,-109.3769376
36032,22,31,15,17,8,0,93,38.25354364859627,-109.3766681
36033,26,30,16,17,7,0,96,38.25354364859627,-109.3763986
36034,25,29,16,17,7,1,95,38.25354364859627,-109.3761291
36035,25,27,15,18,7,1,93,38.25354364859627,-109.3758596
36036,24,26,15,19,7,1,92,38.25354364859627,-109.3755901
36037,24,25,15,19,7,1,91,38.25354364859627,-109.3753206
36038,27,25,16,17,7,1,93,38.25354364859627,-109.3750512
36039,20,28,16,17,7,3,91,38.25354364859627,-109.3747817
36040,11,31,15,14,10,6,87,38.25354364859627,-109.3745122
36041,8,32,14,10,10,8,82,38.25354364859627,-109.3742427
36042,5,31,14,6,9,14,79,38.25354364859627,-109.3739732
36043,9,27,14,12,10,12,84,38.25354364859627,-109.3737037
36044,8,26,12,15,11,8,80,38.25354364859627,-109.3734342
36045,8,22,15,14,8,10,77,38.25354364859627,-109.3731647
36046,7,22,15,14,5,13,76,38.25354364859627,-109.3728952
36047,4,28,12,8,7,14,73,38.25354364859627,-109.3726257
36048,7,23,14,13,6,11,74,38.25354364859627,-109.3723562
36049,8,27,13,13,8,11,80,38.25354364859627,-109.3720867
36050,8,27,10,16,11,5,77,38.25354364859627,-109.3718172
36051,6,24,10,14,12,9,75,38.25354364859627,-109.3715477
36052,8,24,11,15,12,7,77,38.25354364859627,-109.3712782
36053,6,26,13,17,12,7,81,38.25354364859627,-109.3710087
36054,2,24,17,11,11,15,80,38.25354364859627,-109.3707392
36055,1,23,17,12,8,18,79,38.25354364859627,-109.3704697
36056,4,24,14,10,10,13,75,38.25354364859627,-109.3702003
36057,4,27,15,7,9,14,76,38.25354364859627,-109.3699308
36058,3,26,16,9,8,19,81,38.25354364859627,-109.3696613
36059,2,25,15,4,7,23,76,38.25354364859627,-109.3693918
36060,0,26,14,0,6,26,72,38.25354364859627,-109.3691223
36061,3,31,15,1,7,19,76,38.25354364859627,-109.3688528
36062,4,33,14,0,8,17,76,38.25354364859627,-109.3685833
36063,6,31,14,7,6,15,79,38.25354364859627,-109.3683138
36064,6,28,12,13,7,12,78,38.25354364859627,-109.3680443
36065,7,27,11,15,10,9,79,38.25354364859627,-109.3677748
36066,6,26,13,13,21,4,83,38.25354364859627,-109.3675053
36067,2,15,11,13,23,3,67,38.25354364859627,-109.3672358
36068,2,12,11,16,19,4,64,38.25354364859627,-109.3669663
36069,0,17,11,15,19,6,68,38.25354364859627,-109.3666968
36070,2,18,10,11,19,4,64,38.25354364859627,-109.3664273
36071,4,24,13,10,13,11,75,38.25354364859627,-109.3661578
36072,4,22,15,9,7,22,79,38.25354364859627,-109.3658883
36073,0,26,18,1,5,30,80,38.25354364859627,-109.3656188
36074,0,22,17,0,2,32,73,38.25354364859627,-109.3653493
36075,2,24,16,0,2,30,74,38.25354364859627,-109.3650799
36076,2,21,17,0,2,30,72,38.25354364859627,-109.3648104
36077,2,22,16,0,2,28,70,38.25354364859627,-109.3645409
36078,2,23,15,0,2,27,69,38.25354364859627,-109.3642714
36079,2,22,15,0,2,27,68,38.25354364859627,-109.3640019
36080,1,20,16,1,1,29,68,38.25354364859627,-109.3637324
36081,1,21,15,1,2,28,68,38.25354364859627,-109.3634629
36082,1,21,16,1,2,28,69,38.25354364859627,-109.3631934
36083,1,21,16,0,2,29,69,38.25354364859627,-109.3629239
36084,2,20,16,0,1,30,69,38.25354364859627,-109.3626544
36085,2,20,16,0,1,29,68,38.25354364859627,-109.3623849
36086,2,19,16,0,1,29,67,38.25354364859627,-109.3621154
36087,2,20,15,0,1,27,65,38.25354364859627,-109.3618459
36088,2,21,14,0,2,25,64,38.25354364859627,-109.3615764
36089,1,20,13,1,1,24,60,38.25354364859627,-109.3613069
36090,1,21,14,1,1,26,64,38.25354364859627,-109.3610374
36091,1,20,14,0,0,26,61,38.25354364859627,-109.3607679
36092,0,18,14,0,0,27,59,38.25354364859627,-109.3604984
36093,1,18,15,0,0,27,61,38.25354364859627,-109.360229
36094,3,20,15,0,0,27,65,38.25354364859627,-109.3599595
36095,3,23,15,0,2,24,67,38.25354364859627,-109.35969
36096,2,23,14,0,2,24,65,38.25354364859627,-109.3594205
36097,1,21,13,0,1,25,61,38.25354364859627,-109.359151
36098,1,22,14,0,1,25,63,38.25354364859627,-109.3588815
36099,1,23,15,0,2,27,68,38.25354364859627,-109.358612
36100,0,23,16,0,1,31,71,38.25354364859627,-109.3583425
36101,0,22,17,0,1,32,72,38.25354364859627,-109.358073
36102,0,20,16,0,1,31,68,38.25354364859627,-109.3578035
36103,0,20,15,0,1,28,64,38.25354364859627,-109.357534
36104,1,23,13,1,2,23,63,38.25354364859627,-109.3572645
36105,1,24,13,1,3,21,63,38.25354364859627,-109.356995
36106,1,21,14,2,2,25,65,38.25354364859627,-109.3567255
36107,1,21,15,2,1,27,67,38.25354364859627,-109.356456
36108,1,26,13,3,3,23,69,38.25354364859627,-109.3561865
36109,0,28,12,2,4,20,66,38.25354364859627,-109.355917
36110,1,28,12,2,3,21,67,38.25354364859627,-109.3556475
36111,1,25,13,2,2,23,66,38.25354364859627,-109.355378
36112,1,20,14,1,2,25,63,38.25354364859627,-109.3551086
36113,1,22,13,0,3,23,62,38.25354364859627,-109.3548391
36114,2,25,12,0,3,20,62,38.25354364859627,-109.3545696
36115,2,26,10,1,4,18,61,38.25354364859627,-109.3543001
36116,1,26,11,2,4,19,63,38.25354364859627,-109.3540306
36117,1,22,13,1,2,24,63,38.25354364859627,-109.3537611
36118,1,22,14,0,2,25,64,38.25354364859627,-109.3534916
36119,1,23,12,0,3,21,60,38.25354364859627,-109.3532221
36120,1,26,10,0,3,18,58,38.25354364859627,-109.3529526
36121,2,29,9,2,7,11,60,38.25354364859627,-109.3526831
36122,2,32,8,3,9,4,58,38.25354364859627,-109.3524136
36123,1,27,7,3,9,6,53,38.25354364859627,-109.3521441
36124,2,25,10,5,8,9,59,38.25354364859627,-109.3518746
36125,2,28,12,3,6,14,65,38.25354364859627,-109.3516051
36126,2,24,11,4,7,11,59,38.25354364859627,-109.3513356
36127,6,25,9,7,9,4,60,38.25354364859627,-109.3510661
36128,2,24,8,4,7,6,51,38.25354364859627,-109.3507966
36129,3,23,7,4,8,4,49,38.25354364859627,-109.3505271
36130,5,22,8,6,9,4,54,38.25354364859627,-109.3502577
36131,1,20,10,7,10,7,55,38.25354364859627,-109.3499882
36132,5,17,14,25,12,2,75,38.25354364859627,-109.3497187
36133,1,18,14,21,12,9,75,38.25354364859627,-109.3494492
36134,2,20,12,13,11,11,69,38.25354364859627,-109.3491797
36135,5,23,11,8,10,7,64,38.25354364859627,-109.3489102
36136,3,31,9,7,8,5,63,38.25354364859627,-109.3486407
36137,1,26,10,5,9,9,60,38.25354364859627,-109.3483712
36138,0,19,10,1,8,14,52,38.25354364859627,-109.3481017
36139,5,28,15,2,12,13,75,38.25354364859627,-109.3478322
36140,8,29,13,14,8,9,81,38.25354364859627,-109.3475627
36141,15,29,13,12,14,0,83,38.25354364859627,-109.3472932
36142,3,19,8,7,9,0,46,38.25354364859627,-109.3470237
36143,0,44,10,3,11,4,72,38.25354364859627,-109.3467542
36144,2,37,9,5,11,4,68,38.25354364859627,-109.3464847
36145,2,24,9,3,6,9,53,38.25354364859627,-109.3462152
36146,3,15,10,5,7,10,50,38.25354364859627,-109.3459457
36147,8,19,12,8,6,8,61,38.25354364859627,-109.3456762
36148,7,19,13,9,6,10,64,38.25354364859627,-109.3454068
36149,4,16,13,8,6,13,60,38.25354364859627,-109.3451373
36150,6,18,13,7,6,14,64,38.25354364859627,-109.3448678
36151,6,20,14,6,8,14,68,38.25354364859627,-109.3445983
36152,8,23,15,7,9,11,73,38.25354364859627,-109.3443288
36153,6,23,14,9,12,8,72,38.25354364859627,-109.3440593
36154,3,14,12,9,14,9,61,38.25354364859627,-109.3437898
36155,0,7,11,1,10,16,45,38.25354364859627,-109.3435203
36156,2,23,15,0,12,19,71,38.25354364859627,-109.3432508
36157,3,26,15,0,7,19,70,38.25354364859627,-109.3429813
36158,3,21,12,3,1,19,59,38.25354364859627,-109.3427118
36159,9,20,8,2,4,10,53,38.25354364859627,-109.3424423
36160,4,19,8,3,5,10,49,38.25354364859627,-109.3421728
36161,4,14,9,3,3,15,48,38.25354364859627,-109.3419033
36162,3,17,8,3,3,15,49,38.25354364859627,-109.3416338
36163,2,27,8,5,8,9,59,38.25354364859627,-109.3413643
36164,1,42,7,3,10,5,68,38.25354364859627,-109.3410948
36165,1,46,7,4,10,4,72,38.25354364859627,-109.3408253
36166,1,39,8,4,11,6,69,38.25354364859627,-109.3405558
36167,1,34,9,4,9,8,65,38.25354364859627,-109.3402864
36168,1,35,8,3,9,8,64,38.25354364859627,-109.3400169
36169,1,37,8,4,11,7,68,38.25354364859627,-109.3397474
36170,1,42,8,3,11,6,71,38.25354364859627,-109.3394779
36171,1,39,8,3,11,7,69,38.25354364859627,-109.3392084
36172,1,36,9,3,11,7,67,38.25354364859627,-109.3389389
36173,0,43,9,2,10,7,71,38.25354364859627,-109.3386694
36174,2,42,8,5,11,5,73,38.25354364859627,-109.3383999
36175,2,37,7,4,10,7,67,38.25354364859627,-109.3381304
36176,2,32,8,5,10,8,65,38.25354364859627,-109.3378609
36177,3,32,8,4,9,9,65,38.25354364859627,-109.3375914
36178,4,31,10,2,5,15,67,38.25354364859627,-109.3373219
36179,0,36,9,1,10,11,67,38.25354364859627,-109.3370524
36180,1,25,10,3,10,10,59,38.25354364859627,-109.3367829
36181,2,24,10,4,8,8,56,38.25354364859627,-109.3365134
36182,3,33,9,3,8,5,61,38.25354364859627,-109.3362439
36183,5,26,10,4,8,5,58,38.25354364859627,-109.3359744
36184,3,24,11,4,9,8,59,38.25354364859627,-109.3357049
36185,2,18,13,5,7,14,59,38.25354364859627,-109.3354355
36186,3,19,14,6,7,13,62,38.25354364859627,-109.335166
36187,3,27,14,3,6,14,67,38.25354364859627,-109.3348965
36188,2,22,14,6,9,11,64,38.25354364859627,-109.334627
36189,3,22,11,9,11,8,64,38.25354364859627,-109.3343575
36190,2,21,10,11,16,5,65,38.25354364859627,-109.334088
36191,2,24,11,8,16,5,66,38.25354364859627,-109.3338185
36192,1,25,10,6,10,9,61,38.25354364859627,-109.333549
36193,3,22,11,11,13,5,65,38.25354364859627,-109.3332795
36194,2,25,12,12,16,4,71,38.25354364859627,-109.33301
36195,2,24,13,12,15,4,70,38.25354364859627,-109.3327405
36196,1,21,12,10,12,7,63,38.25354364859627,-109.332471
36197,2,20,12,8,10,12,64,38.25354364859627,-109.3322015
36198,0,22,12,2,7,20,63,38.25354364859627,-109.331932
36199,0,23,12,2,6,22,65,38.25354364859627,-109.3316625
36200,2,53,8,0,11,7,81,38.25327415401104,-109.4405383
36201,1,47,9,2,13,5,77,38.25327415401104,-109.4402688
36202,1,47,9,1,13,5,76,38.25327415401104,-109.4399993
36203,1,48,8,0,12,7,76,38.25327415401104,-109.4397299
36204,0,47,8,0,13,6,74,38.25327415401104,-109.4394604
36205,1,48,8,1,12,6,76,38.25327415401104,-109.4391909
36206,2,52,9,4,14,3,84,38.25327415401104,-109.4389214
36207,3,53,9,6,13,3,87,38.25327415401104,-109.4386519
36208,3,51,10,7,13,2,86,38.25327415401104,-109.4383824
36209,4,44,10,7,12,3,80,38.25327415401104,-109.4381129
36210,4,42,11,7,12,4,80,38.25327415401104,-109.4378434
36211,4,42,12,7,13,5,83,38.25327415401104,-109.4375739
36212,4,41,11,6,13,4,79,38.25327415401104,-109.4373044
36213,3,36,10,7,11,5,72,38.25327415401104,-109.4370349
36214,6,35,10,9,13,3,76,38.25327415401104,-109.4367654
36215,8,40,10,9,13,2,82,38.25327415401104,-109.4364959
36216,7,38,11,11,14,2,83,38.25327415401104,-109.4362264
36217,5,35,10,12,13,3,78,38.25327415401104,-109.4359569
36218,4,37,10,6,13,5,75,38.25327415401104,-109.4356874
36219,1,35,11,3,13,10,73,38.25327415401104,-109.4354179
36220,2,39,12,1,12,12,78,38.25327415401104,-109.4351484
36221,2,39,11,0,11,13,76,38.25327415401104,-109.434879
36222,1,33,10,3,10,11,68,38.25327415401104,-109.4346095
36223,2,40,8,7,8,5,70,38.25327415401104,-109.43434
36224,3,42,8,6,7,4,70,38.25327415401104,-109.4340705
36225,3,37,8,5,8,5,66,38.25327415401104,-109.433801
36226,4,35,8,5,10,5,67,38.25327415401104,-109.4335315
36227,2,40,9,6,12,3,72,38.25327415401104,-109.433262
36228,3,43,9,5,13,3,76,38.25327415401104,-109.4329925
36229,3,46,10,7,14,2,82,38.25327415401104,-109.432723
36230,4,50,10,8,15,1,88,38.25327415401104,-109.4324535
36231,4,52,11,6,16,0,89,38.25327415401104,-109.432184
36232,4,46,10,3,16,3,82,38.25327415401104,-109.4319145
36233,7,40,11,7,15,2,82,38.25327415401104,-109.431645
36234,9,41,12,10,15,1,88,38.25327415401104,-109.4313755
36235,11,40,13,12,14,0,90,38.25327415401104,-109.431106
36236,13,38,14,13,14,0,92,38.25327415401104,-109.4308365
36237,13,39,14,12,14,0,92,38.25327415401104,-109.430567
36238,11,43,13,11,14,0,92,38.25327415401104,-109.4302975
36239,7,46,12,12,13,1,91,38.25327415401104,-109.430028
36240,7,46,12,12,13,1,91,38.25327415401104,-109.4297586
36241,8,47,13,13,12,1,94,38.25327415401104,-109.4294891
36242,5,51,11,11,13,1,92,38.25327415401104,-109.4292196
36243,4,55,10,8,13,1,91,38.25327415401104,-109.4289501
36244,4,54,10,8,13,1,90,38.25327415401104,-109.4286806
36245,7,50,11,10,13,1,92,38.25327415401104,-109.4284111
36246,15,42,13,10,13,0,93,38.25327415401104,-109.4281416
36247,14,42,13,10,14,0,93,38.25327415401104,-109.4278721
36248,16,41,13,10,14,0,94,38.25327415401104,-109.4276026
36249,17,40,13,10,13,0,93,38.25327415401104,-109.4273331
36250,16,40,13,10,13,0,92,38.25327415401104,-109.4270636
36251,15,39,14,12,13,0,93,38.25327415401104,-109.4267941
36252,16,39,14,12,14,0,95,38.25327415401104,-109.4265246
36253,17,36,14,13,13,0,93,38.25327415401104,-109.4262551
36254,19,33,14,14,12,0,92,38.25327415401104,-109.4259856
36255,19,33,14,15,12,0,93,38.25327415401104,-109.4257161
36256,22,32,14,13,11,0,92,38.25327415401104,-109.4254466
36257,21,32,14,12,11,0,90,38.25327415401104,-109.4251771
36258,21,33,14,12,12,0,92,38.25327415401104,-109.4249077
36259,20,33,14,12,12,0,91,38.25327415401104,-109.4246382
36260,18,34,14,12,13,0,91,38.25327415401104,-109.4243687
36261,14,36,15,14,13,0,92,38.25327415401104,-109.4240992
36262,14,37,15,14,13,0,93,38.25327415401104,-109.4238297
36263,13,38,14,13,13,0,91,38.25327415401104,-109.4235602
36264,11,42,13,11,14,0,91,38.25327415401104,-109.4232907
36265,7,49,11,8,14,1,90,38.25327415401104,-109.4230212
36266,6,48,11,8,14,1,88,38.25327415401104,-109.4227517
36267,5,47,11,9,14,1,87,38.25327415401104,-109.4224822
36268,4,48,10,6,14,3,85,38.25327415401104,-109.4222127
36269,2,50,9,2,14,6,83,38.25327415401104,-109.4219432
36270,2,51,9,2,14,6,84,38.25327415401104,-109.4216737
36271,2,49,9,3,14,5,82,38.25327415401104,-109.4214042
36272,2,47,9,4,12,4,78,38.25327415401104,-109.4211347
36273,4,42,10,6,12,3,77,38.25327415401104,-109.4208652
36274,3,36,9,5,11,3,67,38.25327415401104,-109.4205957
36275,1,34,8,2,10,6,61,38.25327415401104,-109.4203262
36276,1,40,9,3,13,5,71,38.25327415401104,-109.4200568
36277,3,43,10,4,14,4,78,38.25327415401104,-109.4197873
36278,3,42,11,6,13,4,79,38.25327415401104,-109.4195178
36279,2,42,10,3,12,6,75,38.25327415401104,-109.4192483
36280,4,38,10,5,11,5,73,38.25327415401104,-109.4189788
36281,2,37,9,2,11,7,68,38.25327415401104,-109.4187093
36282,2,39,9,1,10,8,69,38.25327415401104,-109.4184398
36283,2,37,9,3,11,6,68,38.25327415401104,-109.4181703
36284,2,35,8,3,9,5,62,38.25327415401104,-109.4179008
36285,1,35,8,3,8,5,60,38.25327415401104,-109.4176313
36286,1,34,8,2,9,6,60,38.25327415401104,-109.4173618
36287,1,35,8,1,9,8,62,38.25327415401104,-109.4170923
36288,0,37,9,0,9,11,66,38.25327415401104,-109.4168228
36289,0,37,8,0,10,9,64,38.25327415401104,-109.4165533
36290,1,38,8,1,10,7,65,38.25327415401104,-109.4162838
36291,2,37,8,2,10,6,65,38.25327415401104,-109.4160143
36292,2,36,8,2,9,6,63,38.25327415401104,-109.4157448
36293,2,36,8,1,8,7,62,38.25327415401104,-109.4154753
36294,3,34,7,2,8,6,60,38.25327415401104,-109.4152058
36295,3,34,7,3,8,5,60,38.25327415401104,-109.4149364
36296,3,36,7,3,8,5,62,38.25327415401104,-109.4146669
36297,3,36,7,4,8,5,63,38.25327415401104,-109.4143974
36298,2,36,7,4,9,4,62,38.25327415401104,-109.4141279
36299,3,36,8,4,10,4,65,38.25327415401104,-109.4138584
36300,3,38,8,4,11,4,68,38.25327415401104,-109.4135889
36301,2,43,8,3,12,4,72,38.25327415401104,-109.4133194
36302,1,48,8,2,12,4,75,38.25327415401104,-109.4130499
36303,0,48,7,2,11,3,71,38.25327415401104,-109.4127804
36304,2,44,7,3,9,2,67,38.25327415401104,-109.4125109
36305,3,41,7,4,7,2,64,38.25327415401104,-109.4122414
36306,2,39,7,5,7,3,63,38.25327415401104,-109.4119719
36307,3,35,8,4,8,4,62,38.25327415401104,-109.4117024
36308,3,32,9,4,9,7,64,38.25327415401104,-109.4114329
36309,4,30,10,5,11,8,68,38.25327415401104,-109.4111634
36310,3,31,12,4,11,11,72,38.25327415401104,-109.4108939
36311,3,33,13,2,11,14,76,38.25327415401104,-109.4106244
36312,3,34,11,1,11,12,72,38.25327415401104,-109.4103549
36313,2,36,11,2,12,10,73,38.25327415401104,-109.4100855
36314,2,37,11,3,13,9,75,38.25327415401104,-109.409816
36315,3,40,11,3,12,8,77,38.25327415401104,-109.4095465
36316,4,41,12,3,12,8,80,38.25327415401104,-109.409277
36317,3,41,12,4,13,7,80,38.25327415401104,-109.4090075
36318,5,44,12,6,14,4,85,38.25327415401104,-109.408738
36319,6,46,13,8,13,2,88,38.25327415401104,-109.4084685
36320,6,47,13,9,12,2,89,38.25327415401104,-109.408199
36321,5,47,13,10,11,2,88,38.25327415401104,-109.4079295
36322,7,44,14,13,11,1,90,38.25327415401104,-109.40766
36323,7,43,14,14,12,1,91,38.25327415401104,-109.4073905
36324,6,47,14,11,14,1,93,38.25327415401104,-109.407121
36325,6,48,13,7,15,1,90,38.25327415401104,-109.4068515
36326,5,47,13,8,16,1,90,38.25327415401104,-109.406582
36327,3,45,10,3,13,6,80,38.25327415401104,-109.4063125
36328,2,44,10,1,14,7,78,38.25327415401104,-109.406043
36329,1,43,10,1,15,8,78,38.25327415401104,-109.4057735
36330,3,42,12,1,14,10,82,38.25327415401104,-109.405504
36331,3,49,12,3,16,5,88,38.25327415401104,-109.4052345
36332,4,47,12,4,15,5,87,38.25327415401104,-109.4049651
36333,4,47,11,5,15,3,85,38.25327415401104,-109.4046956
36334,5,44,10,6,13,2,80,38.25327415401104,-109.4044261
36335,4,35,9,4,10,5,67,38.25327415401104,-109.4041566
36336,2,35,8,4,8,5,62,38.25327415401104,-109.4038871
36337,2,34,8,4,8,5,61,38.25327415401104,-109.4036176
36338,2,36,8,4,7,5,62,38.25327415401104,-109.4033481
36339,2,37,9,3,7,6,64,38.25327415401104,-109.4030786
36340,2,37,8,4,8,4,63,38.25327415401104,-109.4028091
36341,4,34,9,3,10,5,65,38.25327415401104,-109.4025396
36342,1,33,10,2,8,9,63,38.25327415401104,-109.4022701
36343,2,35,10,2,8,8,65,38.25327415401104,-109.4020006
36344,4,33,9,4,10,5,65,38.25327415401104,-109.4017311
36345,4,28,11,9,9,7,68,38.25327415401104,-109.4014616
36346,6,27,16,13,12,9,83,38.25327415401104,-109.4011921
36347,8,28,17,12,14,10,89,38.25327415401104,-109.4009226
36348,6,26,14,11,11,10,78,38.25327415401104,-109.4006531
36349,8,27,12,12,11,7,77,38.25327415401104,-109.4003836
36350,14,26,13,8,9,6,76,38.25327415401104,-109.4001142
36351,4,28,10,8,10,8,68,38.25327415401104,-109.3998447
36352,5,25,12,10,10,9,71,38.25327415401104,-109.3995752
36353,8,28,17,14,12,10,89,38.25327415401104,-109.3993057
36354,5,22,20,13,13,13,86,38.25327415401104,-109.3990362
36355,5,25,18,18,15,9,90,38.25327415401104,-109.3987667
36356,6,27,13,19,13,5,83,38.25327415401104,-109.3984972
36357,8,25,11,16,12,5,77,38.25327415401104,-109.3982277
36358,10,26,11,17,13,3,80,38.25327415401104,-109.3979582
36359,5,20,11,15,13,7,71,38.25327415401104,-109.3976887
36360,3,25,10,5,12,7,62,38.25327415401104,-109.3974192
36361,1,29,9,3,8,10,60,38.25327415401104,-109.3971497
36362,0,34,8,1,8,9,60,38.25327415401104,-109.3968802
36363,1,32,8,2,9,6,58,38.25327415401104,-109.3966107
36364,2,30,9,5,13,4,63,38.25327415401104,-109.3963412
36365,4,27,10,11,13,4,69,38.25327415401104,-109.3960717
36366,8,25,12,19,13,3,80,38.25327415401104,-109.3958022
36367,9,27,13,26,12,2,89,38.25327415401104,-109.3955327
36368,5,25,12,26,14,1,83,38.25327415401104,-109.3952632
36369,5,27,12,28,14,1,87,38.25327415401104,-109.3949938
36370,6,32,11,24,13,1,87,38.25327415401104,-109.3947243
36371,6,31,11,20,13,2,83,38.25327415401104,-109.3944548
36372,5,32,12,17,18,2,86,38.25327415401104,-109.3941853
36373,3,28,11,27,17,0,86,38.25327415401104,-109.3939158
36374,0,28,10,24,20,0,82,38.25327415401104,-109.3936463
36375,0,28,11,20,21,2,82,38.25327415401104,-109.3933768
36376,0,29,12,15,21,5,82,38.25327415401104,-109.3931073
36377,2,32,13,9,18,7,81,38.25327415401104,-109.3928378
36378,1,33,11,2,14,11,72,38.25327415401104,-109.3925683
36379,5,39,12,6,17,4,83,38.25327415401104,-109.3922988
36380,7,38,13,9,17,2,86,38.25327415401104,-109.3920293
36381,10,34,13,10,16,2,85,38.25327415401104,-109.3917598
36382,10,29,12,10,15,4,80,38.25327415401104,-109.3914903
36383,11,32,12,11,15,2,83,38.25327415401104,-109.3912208
36384,13,35,13,13,15,1,90,38.25327415401104,-109.3909513
36385,14,36,13,13,15,1,92,38.25327415401104,-109.3906818
36386,15,35,13,13,14,1,91,38.25327415401104,-109.3904123
36387,12,33,13,12,14,3,87,38.25327415401104,-109.3901429
36388,11,34,13,11,16,2,87,38.25327415401104,-109.3898734
36389,11,34,13,10,16,2,86,38.25327415401104,-109.3896039
36390,9,32,13,10,15,4,83,38.25327415401104,-109.3893344
36391,6,29,12,7,13,9,76,38.25327415401104,-109.3890649
36392,7,32,12,6,14,7,78,38.25327415401104,-109.3887954
36393,13,32,12,9,16,2,84,38.25327415401104,-109.3885259
36394,18,31,12,12,15,0,88,38.25327415401104,-109.3882564
36395,20,31,12,13,14,0,90,38.25327415401104,-109.3879869
36396,16,33,13,12,15,1,90,38.25327415401104,-109.3877174
36397,14,33,13,9,13,4,86,38.25327415401104,-109.3874479
36398,11,32,13,8,13,6,83,38.25327415401104,-109.3871784
36399,8,33,12,5,12,8,78,38.25327415401104,-109.3869089
36400,5,38,12,3,13,8,79,38.25327415401104,-109.3866394
36401,4,46,11,5,16,4,86,38.25327415401104,-109.3863699
36402,7,46,11,7,14,2,87,38.25327415401104,-109.3861004
36403,6,40,11,7,14,3,81,38.25327415401104,-109.3858309
36404,5,38,11,9,15,2,80,38.25327415401104,-109.3855614
36405,12,40,13,13,13,1,92,38.25327415401104,-109.3852919
36406,9,42,13,13,12,1,90,38.25327415401104,-109.3850225
36407,9,43,13,13,14,0,92,38.25327415401104,-109.384753
36408,9,42,14,13,14,0,92,38.25327415401104,-109.3844835
36409,11,37,13,13,13,1,88,38.25327415401104,-109.384214
36410,12,30,12,14,12,2,82,38.25327415401104,-109.3839445
36411,10,32,11,12,13,2,80,38.25327415401104,-109.383675
36412,7,34,11,9,15,2,78,38.25327415401104,-109.3834055
36413,4,37,10,6,16,2,75,38.25327415401104,-109.383136
36414,4,39,9,2,13,5,72,38.25327415401104,-109.3828665
36415,4,44,9,4,15,2,78,38.25327415401104,-109.382597
36416,2,49,7,5,9,1,73,38.25327415401104,-109.3823275
36417,1,53,6,7,7,1,75,38.25327415401104,-109.382058
36418,2,53,7,8,8,1,79,38.25327415401104,-109.3817885
36419,2,53,8,4,14,1,82,38.25327415401104,-109.381519
36420,7,45,11,7,16,1,87,38.25327415401104,-109.3812495
36421,11,43,13,11,15,0,93,38.25327415401104,-109.38098
36422,12,41,14,13,14,0,94,38.25327415401104,-109.3807105
36423,11,42,14,13,14,0,94,38.25327415401104,-109.380441
36424,12,40,14,13,13,1,93,38.25327415401104,-109.3801716
36425,14,38,13,14,11,1,91,38.25327415401104,-109.3799021
36426,15,38,13,13,12,1,92,38.25327415401104,-109.3796326
36427,14,39,13,12,12,1,91,38.25327415401104,-109.3793631
36428,13,40,13,11,13,0,90,38.25327415401104,-109.3790936
36429,11,43,13,10,13,1,91,38.25327415401104,-109.3788241
36430,9,44,13,11,14,1,92,38.25327415401104,-109.3785546
36431,10,42,14,12,14,0,92,38.25327415401104,-109.3782851
36432,14,38,14,13,13,0,92,38.25327415401104,-109.3780156
36433,18,34,14,15,13,0,94,38.25327415401104,-109.3777461
36434,22,30,14,16,10,1,93,38.25327415401104,-109.3774766
36435,20,31,15,17,10,1,94,38.25327415401104,-109.3772071
36436,20,30,16,17,9,1,93,38.25327415401104,-109.3769376
36437,22,28,16,18,8,1,93,38.25327415401104,-109.3766681
36438,23,28,17,19,7,1,95,38.25327415401104,-109.3763986
36439,26,26,16,17,6,1,92,38.25327415401104,-109.3761291
36440,25,26,16,18,6,1,92,38.25327415401104,-109.3758596
36441,23,26,16,19,7,1,92,38.25327415401104,-109.3755901
36442,23,26,15,19,8,1,92,38.25327415401104,-109.3753206
36443,19,28,15,19,9,1,91,38.25327415401104,-109.3750512
36444,13,29,15,13,7,8,85,38.25327415401104,-109.3747817
36445,11,29,14,11,10,8,83,38.25327415401104,-109.3745122
36446,9,29,14,6,12,11,81,38.25327415401104,-109.3742427
36447,4,29,14,6,8,17,78,38.25327415401104,-109.3739732
36448,12,30,11,18,13,3,87,38.25327415401104,-109.3737037
36449,8,28,12,22,18,1,89,38.25327415401104,-109.3734342
36450,4,20,12,19,19,9,83,38.25327415401104,-109.3731647
36451,4,18,12,16,16,12,78,38.25327415401104,-109.3728952
36452,5,23,13,17,16,6,80,38.25327415401104,-109.3726257
36453,0,27,13,14,17,7,78,38.25327415401104,-109.3723562
36454,1,27,14,14,19,5,80,38.25327415401104,-109.3720867
36455,8,32,12,15,18,0,85,38.25327415401104,-109.3718172
36456,10,30,11,13,19,0,83,38.25327415401104,-109.3715477
36457,3,34,13,9,16,6,81,38.25327415401104,-109.3712782
36458,4,22,11,15,14,9,75,38.25327415401104,-109.3710087
36459,2,28,12,13,20,4,79,38.25327415401104,-109.3707392
36460,3,22,13,16,16,7,77,38.25327415401104,-109.3704697
36461,5,21,13,24,14,3,80,38.25327415401104,-109.3702003
36462,4,24,15,20,11,6,80,38.25327415401104,-109.3699308
36463,1,27,14,13,12,10,77,38.25327415401104,-109.3696613
36464,0,25,13,10,8,14,70,38.25327415401104,-109.3693918
36465,0,32,11,8,10,14,75,38.25327415401104,-109.3691223
36466,2,34,11,6,9,13,75,38.25327415401104,-109.3688528
36467,3,39,12,4,11,11,80,38.25327415401104,-109.3685833
36468,2,46,10,2,13,5,78,38.25327415401104,-109.3683138
36469,7,28,9,13,11,7,75,38.25327415401104,-109.3680443
36470,7,27,11,13,10,9,77,38.25327415401104,-109.3677748
36471,2,16,10,10,18,4,60,38.25327415401104,-109.3675053
36472,3,16,10,12,17,3,61,38.25327415401104,-109.3672358
36473,2,12,9,17,15,2,57,38.25327415401104,-109.3669663
36474,2,16,10,15,14,4,61,38.25327415401104,-109.3666968
36475,2,23,12,12,13,9,71,38.25327415401104,-109.3664273
36476,1,27,14,4,8,22,76,38.25327415401104,-109.3661578
36477,0,25,17,1,4,31,78,38.25327415401104,-109.3658883
36478,0,21,17,0,1,34,73,38.25327415401104,-109.3656188
36479,1,21,17,0,1,33,73,38.25327415401104,-109.3653493
36480,2,20,17,0,1,31,71,38.25327415401104,-109.3650799
36481,1,20,17,0,1,32,71,38.25327415401104,-109.3648104
36482,2,21,16,0,2,29,70,38.25327415401104,-109.3645409
36483,2,22,16,0,2,28,70,38.25327415401104,-109.3642714
36484,2,22,15,0,1,28,68,38.25327415401104,-109.3640019
36485,3,22,16,1,2,27,71,38.25327415401104,-109.3637324
36486,1,19,17,0,2,30,69,38.25327415401104,-109.3634629
36487,1,18,18,0,2,32,71,38.25327415401104,-109.3631934
36488,1,19,18,0,2,32,72,38.25327415401104,-109.3629239
36489,2,21,16,0,2,29,70,38.25327415401104,-109.3626544
36490,1,20,16,0,1,29,67,38.25327415401104,-109.3623849
36491,1,19,16,0,1,29,66,38.25327415401104,-109.3621154
36492,1,19,15,0,1,28,64,38.25327415401104,-109.3618459
36493,1,19,14,0,1,27,62,38.25327415401104,-109.3615764
36494,0,19,14,0,1,26,60,38.25327415401104,-109.3613069
36495,0,19,14,0,1,28,62,38.25327415401104,-109.3610374
36496,0,18,14,0,1,28,61,38.25327415401104,-109.3607679
36497,0,18,14,0,1,26,59,38.25327415401104,-109.3604984
36498,0,20,13,0,1,24,58,38.25327415401104,-109.360229
36499,1,24,12,0,4,20,61,38.25327415401104,-109.3599595
36500,1,23,13,0,3,23,63,38.25327415401104,-109.35969
36501,1,21,14,0,2,25,63,38.25327415401104,-109.3594205
36502,1,21,14,0,1,27,64,38.25327415401104,-109.359151
36503,2,24,16,0,2,26,70,38.25327415401104,-109.3588815
36504,3,24,16,0,2,26,71,38.25327415401104,-109.358612
36505,2,25,16,0,2,26,71,38.25327415401104,-109.3583425
36506,2,23,16,1,2,27,71,38.25327415401104,-109.358073
36507,2,20,15,1,1,27,66,38.25327415401104,-109.3578035
36508,0,20,14,0,0,26,60,38.25327415401104,-109.357534
36509,1,22,13,1,3,24,64,38.25327415401104,-109.3572645
36510,1,22,15,2,3,25,68,38.25327415401104,-109.356995
36511,1,22,16,3,2,28,72,38.25327415401104,-109.3567255
36512,1,22,16,3,2,28,72,38.25327415401104,-109.356456
36513,1,30,13,3,4,22,73,38.25327415401104,-109.3561865
36514,1,30,13,4,3,21,72,38.25327415401104,-109.355917
36515,1,23,15,3,2,26,70,38.25327415401104,-109.3556475
36516,1,20,16,1,0,29,67,38.25327415401104,-109.355378
36517,1,21,15,0,1,27,65,38.25327415401104,-109.3551086
36518,1,23,13,0,2,22,61,38.25327415401104,-109.3548391
36519,2,26,11,1,3,19,62,38.25327415401104,-109.3545696
36520,1,28,11,1,4,20,65,38.25327415401104,-109.3543001
36521,1,27,12,2,3,23,68,38.25327415401104,-109.3540306
36522,0,22,14,2,1,26,65,38.25327415401104,-109.3537611
36523,1,20,16,0,1,27,65,38.25327415401104,-109.3534916
36524,1,18,15,0,1,27,62,38.25327415401104,-109.3532221
36525,1,17,14,1,2,23,58,38.25327415401104,-109.3529526
36526,2,25,10,3,6,13,59,38.25327415401104,-109.3526831
36527,3,32,8,3,8,4,58,38.25327415401104,-109.3524136
36528,2,29,7,3,9,5,55,38.25327415401104,-109.3521441
36529,2,24,9,4,9,8,56,38.25327415401104,-109.3518746
36530,1,30,11,2,7,13,64,38.25327415401104,-109.3516051
36531,0,22,11,3,5,15,56,38.25327415401104,-109.3513356
36532,7,26,11,8,8,4,64,38.25327415401104,-109.3510661
36533,1,24,9,4,7,7,52,38.25327415401104,-109.3507966
36534,3,21,8,5,8,4,49,38.25327415401104,-109.3505271
36535,5,18,9,8,10,4,54,38.25327415401104,-109.3502577
36536,0,23,13,14,12,8,70,38.25327415401104,-109.3499882
36537,6,19,12,22,17,3,79,38.25327415401104,-109.3497187
36538,3,20,12,17,13,7,72,38.25327415401104,-109.3494492
36539,3,21,12,9,11,11,67,38.25327415401104,-109.3491797
36540,4,24,11,4,7,12,62,38.25327415401104,-109.3489102
36541,2,25,10,4,8,10,59,38.25327415401104,-109.3486407
36542,0,25,10,5,8,10,58,38.25327415401104,-109.3483712
36543,2,20,11,5,9,13,60,38.25327415401104,-109.3481017
36544,3,21,14,6,9,17,70,38.25327415401104,-109.3478322
36545,4,19,16,7,11,14,71,38.25327415401104,-109.3475627
36546,15,22,12,10,12,1,72,38.25327415401104,-109.3472932
36547,3,40,9,5,10,3,70,38.25327415401104,-109.3470237
36548,1,32,8,2,9,6,58,38.25327415401104,-109.3467542
36549,4,29,9,4,10,5,61,38.25327415401104,-109.3464847
36550,2,25,8,4,6,6,51,38.25327415401104,-109.3462152
36551,2,20,8,6,6,6,48,38.25327415401104,-109.3459457
36552,8,21,10,7,6,6,58,38.25327415401104,-109.3456762
36553,8,20,11,10,6,7,62,38.25327415401104,-109.3454068
36554,3,21,10,10,7,9,60,38.25327415401104,-109.3451373
36555,6,20,12,7,6,13,64,38.25327415401104,-109.3448678
36556,6,19,13,4,8,15,65,38.25327415401104,-109.3445983
36557,4,22,13,3,9,11,62,38.25327415401104,-109.3443288
36558,6,21,12,3,14,6,62,38.25327415401104,-109.3440593
36559,2,13,11,6,14,8,54,38.25327415401104,-109.3437898
36560,10,12,9,6,18,3,58,38.25327415401104,-109.3435203
36561,2,24,14,0,9,17,66,38.25327415401104,-109.3432508
36562,3,23,14,0,4,22,66,38.25327415401104,-109.3429813
36563,8,24,11,1,2,15,61,38.25327415401104,-109.3427118
36564,2,29,7,3,8,8,57,38.25327415401104,-109.3424423
36565,4,32,8,3,8,6,61,38.25327415401104,-109.3421728
36566,3,21,7,4,6,9,50,38.25327415401104,-109.3419033
36567,4,24,11,4,4,16,63,38.25327415401104,-109.3416338
36568,5,21,10,4,3,14,57,38.25327415401104,-109.3413643
36569,3,28,9,5,7,10,62,38.25327415401104,-109.3410948
36570,2,27,10,3,7,13,62,38.25327415401104,-109.3408253
36571,2,23,11,3,4,15,58,38.25327415401104,-109.3405558
36572,1,22,11,2,2,19,57,38.25327415401104,-109.3402864
36573,0,24,11,3,3,18,59,38.25327415401104,-109.3400169
36574,1,35,10,2,9,10,67,38.25327415401104,-109.3397474
36575,1,36,10,3,10,8,68,38.25327415401104,-109.3394779
36576,1,33,10,4,8,9,65,38.25327415401104,-109.3392084
36577,2,30,11,3,8,9,63,38.25327415401104,-109.3389389
36578,3,42,12,5,11,6,79,38.25327415401104,-109.3386694
36579,1,38,11,3,11,8,72,38.25327415401104,-109.3383999
36580,1,31,10,2,9,11,64,38.25327415401104,-109.3381304
36581,2,31,8,3,9,10,63,38.25327415401104,-109.3378609
36582,1,35,8,3,9,9,65,38.25327415401104,-109.3375914
36583,1,41,7,2,11,6,68,38.25327415401104,-109.3373219
36584,0,40,8,2,10,7,67,38.25327415401104,-109.3370524
36585,2,25,9,4,8,8,56,38.25327415401104,-109.3367829
36586,3,23,10,5,7,8,56,38.25327415401104,-109.3365134
36587,2,30,8,3,7,7,57,38.25327415401104,-109.3362439
36588,4,28,8,6,10,3,59,38.25327415401104,-109.3359744
36589,4,22,9,6,9,6,56,38.25327415401104,-109.3357049
36590,4,20,11,6,9,7,57,38.25327415401104,-109.3354355
36591,5,24,13,8,9,6,65,38.25327415401104,-109.335166
36592,3,25,12,8,10,7,65,38.25327415401104,-109.3348965
36593,3,23,12,17,19,2,76,38.25327415401104,-109.334627
36594,4,17,10,18,17,9,75,38.25327415401104,-109.3343575
36595,1,16,11,17,20,5,70,38.25327415401104,-109.334088
36596,2,23,12,12,17,7,73,38.25327415401104,-109.3338185
36597,2,26,12,9,11,14,74,38.25327415401104,-109.333549
36598,2,26,13,8,10,16,75,38.25327415401104,-109.3332795
36599,1,24,13,7,11,12,68,38.25327415401104,-109.33301
36600,1,24,12,7,13,10,67,38.25327415401104,-109.3327405
36601,2,23,13,6,12,9,65,38.25327415401104,-109.332471
36602,2,26,15,6,10,14,73,38.25327415401104,-109.3322015
36603,1,24,15,5,9,20,74,38.25327415401104,-109.331932
36604,0,23,14,2,6,24,69,38.25327415401104,-109.3316625
36605,2,54,9,1,11,7,84,38.25300466,-109.4405383
36606,2,44,9,2,9,8,74,38.25300466,-109.4402688
36607,2,42,9,1,9,9,72,38.25300466,-109.4399993
36608,1,46,8,0,10,8,73,38.25300466,-109.4397299
36609,0,46,8,0,12,6,72,38.25300466,-109.4394604
36610,1,46,8,0,11,8,74,38.25300466,-109.4391909
36611,1,51,8,0,13,5,78,38.25300466,-109.4389214
36612,1,53,8,2,13,4,81,38.25300466,-109.4386519
36613,1,51,8,3,12,4,79,38.25300466,-109.4383824
36614,3,45,10,6,13,3,80,38.25300466,-109.4381129
36615,3,42,12,5,15,6,83,38.25300466,-109.4378434
36616,2,39,12,3,11,11,78,38.25300466,-109.4375739
36617,1,34,11,4,9,11,70,38.25300466,-109.4373044
36618,2,39,8,4,6,7,66,38.25300466,-109.4370349
36619,5,46,8,6,7,3,75,38.25300466,-109.4367654
36620,3,42,8,6,8,4,71,38.25300466,-109.4364959
36621,3,40,9,5,11,4,72,38.25300466,-109.4362264
36622,3,40,10,4,12,6,75,38.25300466,-109.4359569
36623,1,38,10,0,12,11,72,38.25300466,-109.4356874
36624,1,41,10,1,14,8,75,38.25300466,-109.4354179
36625,2,46,10,0,13,8,79,38.25300466,-109.4351484
36626,2,45,10,0,11,11,79,38.25300466,-109.434879
36627,1,40,10,0,11,11,73,38.25300466,-109.4346095
36628,3,41,9,4,10,5,72,38.25300466,-109.43434
36629,2,35,8,3,8,7,63,38.25300466,-109.4340705
36630,3,37,8,5,10,5,68,38.25300466,-109.433801
36631,2,39,10,6,12,4,73,38.25300466,-109.4335315
36632,3,37,11,5,13,6,75,38.25300466,-109.433262
36633,4,43,11,5,15,4,82,38.25300466,-109.4329925
36634,5,44,11,9,15,1,85,38.25300466,-109.432723
36635,5,49,12,10,14,0,90,38.25300466,-109.4324535
36636,5,50,11,7,17,0,90,38.25300466,-109.432184
36637,3,41,10,3,15,5,77,38.25300466,-109.4319145
36638,8,40,12,8,15,2,85,38.25300466,-109.431645
36639,8,41,13,11,14,1,88,38.25300466,-109.4313755
36640,10,39,14,13,14,1,91,38.25300466,-109.431106
36641,13,38,14,13,14,0,92,38.25300466,-109.4308365
36642,13,40,14,13,13,0,93,38.25300466,-109.430567
36643,9,44,13,12,14,0,92,38.25300466,-109.4302975
36644,5,49,11,11,13,1,90,38.25300466,-109.430028
36645,5,49,11,10,13,1,89,38.25300466,-109.4297586
36646,7,48,12,12,13,1,93,38.25300466,-109.4294891
36647,9,46,13,12,13,0,93,38.25300466,-109.4292196
36648,6,51,11,9,13,1,91,38.25300466,-109.4289501
36649,6,52,11,9,14,1,93,38.25300466,-109.4286806
36650,9,48,12,11,13,0,93,38.25300466,-109.4284111
36651,15,40,13,12,14,0,94,38.25300466,-109.4281416
36652,15,41,13,10,14,0,93,38.25300466,-109.4278721
36653,16,41,13,10,13,0,93,38.25300466,-109.4276026
36654,19,39,13,10,13,0,94,38.25300466,-109.4273331
36655,19,37,14,11,12,0,93,38.25300466,-109.4270636
36656,17,36,14,14,12,0,93,38.25300466,-109.4267941
36657,16,37,15,14,13,0,95,38.25300466,-109.4265246
36658,16,36,14,14,13,0,93,38.25300466,-109.4262551
36659,19,34,14,14,12,0,93,38.25300466,-109.4259856
36660,22,32,15,14,11,0,94,38.25300466,-109.4257161
36661,21,32,14,14,12,0,93,38.25300466,-109.4254466
36662,23,31,15,13,11,0,93,38.25300466,-109.4251771
36663,21,32,14,13,11,0,91,38.25300466,-109.4249077
36664,20,33,14,13,12,0,92,38.25300466,-109.4246382
36665,18,34,15,13,13,0,93,38.25300466,-109.4243687
36666,15,35,15,15,13,0,93,38.25300466,-109.4240992
36667,15,35,15,15,12,0,92,38.25300466,-109.4238297
36668,16,37,14,13,12,0,92,38.25300466,-109.4235602
36669,13,42,12,9,14,0,90,38.25300466,-109.4232907
36670,6,49,10,7,13,1,86,38.25300466,-109.4230212
36671,6,49,10,7,12,2,86,38.25300466,-109.4227517
36672,4,48,10,6,13,2,83,38.25300466,-109.4224822
36673,3,47,9,4,13,4,80,38.25300466,-109.4222127
36674,2,47,9,2,13,6,79,38.25300466,-109.4219432
36675,2,51,9,3,13,5,83,38.25300466,-109.4216737
36676,2,47,9,3,12,5,78,38.25300466,-109.4214042
36677,2,36,8,3,11,5,65,38.25300466,-109.4211347
36678,3,33,8,5,10,4,63,38.25300466,-109.4208652
36679,3,29,9,4,10,5,60,38.25300466,-109.4205957
36680,2,30,9,3,11,7,62,38.25300466,-109.4203262
36681,1,35,9,2,11,7,65,38.25300466,-109.4200568
36682,2,39,9,3,12,5,70,38.25300466,-109.4197873
36683,3,36,9,4,12,4,68,38.25300466,-109.4195178
36684,2,32,9,4,10,6,63,38.25300466,-109.4192483
36685,3,32,9,1,9,8,62,38.25300466,-109.4189788
36686,2,34,8,1,9,8,62,38.25300466,-109.4187093
36687,1,36,8,2,10,7,64,38.25300466,-109.4184398
36688,1,38,9,2,11,6,67,38.25300466,-109.4181703
36689,2,40,9,3,11,5,70,38.25300466,-109.4179008
36690,1,36,9,2,10,8,66,38.25300466,-109.4176313
36691,2,38,8,1,10,7,66,38.25300466,-109.4173618
36692,2,40,8,1,11,6,68,38.25300466,-109.4170923
36693,1,38,8,1,11,6,65,38.25300466,-109.4168228
36694,3,37,8,3,11,5,67,38.25300466,-109.4165533
36695,4,35,8,3,10,5,65,38.25300466,-109.4162838
36696,4,34,8,3,10,5,64,38.25300466,-109.4160143
36697,3,32,8,3,9,6,61,38.25300466,-109.4157448
36698,2,32,8,2,8,7,59,38.25300466,-109.4154753
36699,1,31,8,1,7,9,57,38.25300466,-109.4152058
36700,1,32,8,1,6,9,57,38.25300466,-109.4149364
36701,2,36,7,2,6,7,60,38.25300466,-109.4146669
36702,2,38,7,3,6,5,61,38.25300466,-109.4143974
36703,3,39,7,4,6,4,63,38.25300466,-109.4141279
36704,3,36,7,5,7,4,62,38.25300466,-109.4138584
36705,4,38,6,5,7,3,63,38.25300466,-109.4135889
36706,3,39,6,5,7,3,63,38.25300466,-109.4133194
36707,3,38,6,4,8,3,62,38.25300466,-109.4130499
36708,3,39,6,4,8,3,63,38.25300466,-109.4127804
36709,3,37,7,4,8,3,62,38.25300466,-109.4125109
36710,3,35,7,4,8,4,61,38.25300466,-109.4122414
36711,6,31,9,5,9,5,65,38.25300466,-109.4119719
36712,10,29,12,10,9,4,74,38.25300466,-109.4117024
36713,7,37,12,7,10,5,78,38.25300466,-109.4114329
36714,4,40,12,5,12,7,80,38.25300466,-109.4111634
36715,4,40,12,4,12,8,80,38.25300466,-109.4108939
36716,4,36,12,4,11,10,77,38.25300466,-109.4106244
36717,3,34,11,2,11,11,72,38.25300466,-109.4103549
36718,3,39,11,0,12,11,76,38.25300466,-109.4100855
36719,2,38,11,1,12,11,75,38.25300466,-109.409816
36720,2,36,11,1,11,13,74,38.25300466,-109.4095465
36721,3,34,12,0,9,15,73,38.25300466,-109.409277
36722,4,41,12,4,11,9,81,38.25300466,-109.4090075
36723,6,44,13,8,13,3,87,38.25300466,-109.408738
36724,6,44,14,11,12,2,89,38.25300466,-109.4084685
36725,6,43,14,12,11,2,88,38.25300466,-109.408199
36726,5,45,13,12,11,2,88,38.25300466,-109.4079295
36727,10,41,14,15,12,1,93,38.25300466,-109.40766
36728,11,38,14,15,12,1,91,38.25300466,-109.4073905
36729,10,41,14,13,13,0,91,38.25300466,-109.407121
36730,7,45,13,10,16,0,91,38.25300466,-109.4068515
36731,6,42,12,11,14,1,86,38.25300466,-109.406582
36732,5,44,9,2,9,5,74,38.25300466,-109.4063125
36733,3,35,9,3,10,7,67,38.25300466,-109.406043
36734,3,29,10,3,11,8,64,38.25300466,-109.4057735
36735,3,34,11,1,11,12,72,38.25300466,-109.405504
36736,2,47,11,1,16,8,85,38.25300466,-109.4052345
36737,3,47,10,3,15,5,83,38.25300466,-109.4049651
36738,3,43,9,4,12,4,75,38.25300466,-109.4046956
36739,3,38,9,3,10,5,68,38.25300466,-109.4044261
36740,3,36,9,3,9,6,66,38.25300466,-109.4041566
36741,3,33,10,3,8,8,65,38.25300466,-109.4038871
36742,2,32,10,3,9,8,64,38.25300466,-109.4036176
36743,3,34,9,3,9,6,64,38.25300466,-109.4033481
36744,2,33,9,3,10,6,63,38.25300466,-109.4030786
36745,2,31,9,3,10,6,61,38.25300466,-109.4028091
36746,2,32,9,2,9,7,61,38.25300466,-109.4025396
36747,2,31,9,3,8,8,61,38.25300466,-109.4022701
36748,2,31,10,4,9,7,63,38.25300466,-109.4020006
36749,7,33,10,6,10,5,71,38.25300466,-109.4017311
36750,5,31,15,10,11,8,80,38.25300466,-109.4014616
36751,7,25,19,12,11,11,85,38.25300466,-109.4011921
36752,6,25,19,13,13,11,87,38.25300466,-109.4009226
36753,6,27,15,15,12,8,83,38.25300466,-109.4006531
36754,12,27,12,16,13,3,83,38.25300466,-109.4003836
36755,7,28,13,12,13,6,79,38.25300466,-109.4001142
36756,8,28,13,12,14,5,80,38.25300466,-109.3998447
36757,6,28,14,16,13,7,84,38.25300466,-109.3995752
36758,1,25,18,17,17,11,89,38.25300466,-109.3993057
36759,2,23,17,12,18,14,86,38.25300466,-109.3990362
36760,1,24,17,19,20,7,88,38.25300466,-109.3987667
36761,2,27,16,15,17,9,86,38.25300466,-109.3984972
36762,7,27,13,20,11,7,85,38.25300466,-109.3982277
36763,9,26,13,24,11,3,86,38.25300466,-109.3979582
36764,10,25,12,20,14,7,88,38.25300466,-109.3976887
36765,7,18,11,14,10,7,67,38.25300466,-109.3974192
36766,2,28,8,5,10,7,60,38.25300466,-109.3971497
36767,2,31,8,4,10,6,61,38.25300466,-109.3968802
36768,3,34,10,8,12,5,72,38.25300466,-109.3966107
36769,8,29,12,25,16,0,90,38.25300466,-109.3963412
36770,1,26,11,26,21,1,86,38.25300466,-109.3960717
36771,0,27,13,24,18,4,86,38.25300466,-109.3958022
36772,3,24,13,22,19,4,85,38.25300466,-109.3955327
36773,3,25,13,21,21,2,85,38.25300466,-109.3952632
36774,1,26,13,19,20,4,83,38.25300466,-109.3949938
36775,2,27,12,17,22,4,84,38.25300466,-109.3947243
36776,2,27,13,16,23,4,85,38.25300466,-109.3944548
36777,0,29,12,20,20,3,84,38.25300466,-109.3941853
36778,0,29,12,20,21,2,84,38.25300466,-109.3939158
36779,0,32,12,10,21,5,80,38.25300466,-109.3936463
36780,0,29,12,6,17,10,74,38.25300466,-109.3933768
36781,0,29,12,4,15,12,72,38.25300466,-109.3931073
36782,0,30,13,3,15,12,73,38.25300466,-109.3928378
36783,0,29,12,2,13,13,69,38.25300466,-109.3925683
36784,3,32,12,5,15,9,76,38.25300466,-109.3922988
36785,5,30,12,7,14,8,76,38.25300466,-109.3920293
36786,5,27,12,7,13,10,74,38.25300466,-109.3917598
36787,6,26,13,6,12,12,75,38.25300466,-109.3914903
36788,11,31,12,10,15,4,83,38.25300466,-109.3912208
36789,13,35,13,12,16,0,89,38.25300466,-109.3909513
36790,14,35,13,13,16,0,91,38.25300466,-109.3906818
36791,15,34,13,12,15,1,90,38.25300466,-109.3904123
36792,13,31,13,12,15,2,86,38.25300466,-109.3901429
36793,15,33,13,13,15,1,90,38.25300466,-109.3898734
36794,16,34,13,13,14,1,91,38.25300466,-109.3896039
36795,15,33,13,13,14,1,89,38.25300466,-109.3893344
36796,14,32,13,13,15,1,88,38.25300466,-109.3890649
36797,18,32,12,11,14,0,87,38.25300466,-109.3887954
36798,22,30,12,10,13,0,87,38.25300466,-109.3885259
36799,22,30,12,12,13,0,89,38.25300466,-109.3882564
36800,21,30,13,15,13,0,92,38.25300466,-109.3879869
36801,22,30,13,15,13,0,93,38.25300466,-109.3877174
36802,21,32,13,12,13,0,91,38.25300466,-109.3874479
36803,20,32,13,11,13,1,90,38.25300466,-109.3871784
36804,17,33,13,10,14,1,88,38.25300466,-109.3869089
36805,11,37,13,8,14,3,86,38.25300466,-109.3866394
36806,5,46,11,7,14,2,85,38.25300466,-109.3863699
36807,9,40,12,11,14,1,87,38.25300466,-109.3861004
36808,10,34,12,13,14,1,84,38.25300466,-109.3858309
36809,11,35,13,15,14,1,89,38.25300466,-109.3855614
36810,16,36,14,14,12,1,93,38.25300466,-109.3852919
36811,10,42,13,13,12,1,91,38.25300466,-109.3850225
36812,8,44,13,13,13,1,92,38.25300466,-109.384753
36813,8,42,13,13,14,0,90,38.25300466,-109.3844835
36814,11,35,13,14,13,1,87,38.25300466,-109.384214
36815,16,29,12,14,13,1,85,38.25300466,-109.3839445
36816,10,29,11,13,13,3,79,38.25300466,-109.383675
36817,3,36,10,7,14,4,74,38.25300466,-109.3834055
36818,2,40,8,2,14,5,71,38.25300466,-109.383136
36819,1,40,8,1,12,5,67,38.25300466,-109.3828665
36820,2,39,8,5,13,4,71,38.25300466,-109.382597
36821,2,40,7,10,8,2,69,38.25300466,-109.3823275
36822,2,47,7,9,8,1,74,38.25300466,-109.382058
36823,2,50,7,7,10,1,77,38.25300466,-109.3817885
36824,2,48,9,3,16,2,80,38.25300466,-109.381519
36825,7,47,11,6,15,1,87,38.25300466,-109.3812495
36826,9,47,12,8,16,0,92,38.25300466,-109.38098
36827,8,46,14,11,16,0,95,38.25300466,-109.3807105
36828,8,44,14,12,15,0,93,38.25300466,-109.380441
36829,13,41,14,13,14,0,95,38.25300466,-109.3801716
36830,14,38,14,14,12,0,92,38.25300466,-109.3799021
36831,16,37,14,13,12,0,92,38.25300466,-109.3796326
36832,14,38,13,12,13,0,90,38.25300466,-109.3793631
36833,11,41,14,11,14,1,92,38.25300466,-109.3790936
36834,9,43,13,10,15,1,91,38.25300466,-109.3788241
36835,9,43,14,11,15,0,92,38.25300466,-109.3785546
36836,10,42,14,11,15,0,92,38.25300466,-109.3782851
36837,13,39,15,13,12,0,92,38.25300466,-109.3780156
36838,28,30,14,14,9,0,95,38.25300466,-109.3777461
36839,33,25,13,13,7,1,92,38.25300466,-109.3774766
36840,32,24,15,14,7,1,93,38.25300466,-109.3772071
36841,30,23,15,15,6,1,90,38.25300466,-109.3769376
36842,28,22,15,16,5,1,87,38.25300466,-109.3766681
36843,30,23,16,16,5,1,91,38.25300466,-109.3763986
36844,29,23,17,16,6,2,93,38.25300466,-109.3761291
36845,28,24,16,17,7,2,94,38.25300466,-109.3758596
36846,25,26,16,19,7,1,94,38.25300466,-109.3755901
36847,22,27,16,20,8,1,94,38.25300466,-109.3753206
36848,15,27,15,22,10,2,91,38.25300466,-109.3750512
36849,14,29,13,19,9,4,88,38.25300466,-109.3747817
36850,9,32,12,18,8,7,86,38.25300466,-109.3745122
36851,6,33,13,17,8,8,85,38.25300466,-109.3742427
36852,3,29,16,10,16,10,84,38.25300466,-109.3739732
36853,1,26,13,16,18,5,79,38.25300466,-109.3737037
36854,4,23,12,19,21,6,85,38.25300466,-109.3734342
36855,6,16,10,13,15,7,67,38.25300466,-109.3731647
36856,2,18,10,15,16,4,65,38.25300466,-109.3728952
36857,2,20,9,12,18,3,64,38.25300466,-109.3726257
36858,3,21,10,16,19,2,71,38.25300466,-109.3723562
36859,2,27,11,11,20,4,75,38.25300466,-109.3720867
36860,4,31,12,11,12,9,79,38.25300466,-109.3718172
36861,3,32,14,9,11,10,79,38.25300466,-109.3715477
36862,3,32,13,9,13,10,80,38.25300466,-109.3712782
36863,6,26,9,12,12,10,75,38.25300466,-109.3710087
36864,2,30,13,9,16,9,79,38.25300466,-109.3707392
36865,4,26,12,8,11,12,73,38.25300466,-109.3704697
36866,0,25,10,10,17,5,67,38.25300466,-109.3702003
36867,1,21,11,12,13,7,65,38.25300466,-109.3699308
36868,4,26,10,9,10,5,64,38.25300466,-109.3696613
36869,3,36,10,5,8,5,67,38.25300466,-109.3693918
36870,2,43,8,5,8,4,70,38.25300466,-109.3691223
36871,2,44,9,3,10,3,71,38.25300466,-109.3688528
36872,0,48,8,1,9,6,72,38.25300466,-109.3685833
36873,1,46,10,3,12,5,77,38.25300466,-109.3683138
36874,2,37,10,7,13,4,73,38.25300466,-109.3680443
36875,4,31,9,9,10,7,70,38.25300466,-109.3677748
36876,5,28,11,8,10,6,68,38.25300466,-109.3675053
36877,6,22,12,13,11,6,70,38.25300466,-109.3672358
36878,2,20,9,13,13,4,61,38.25300466,-109.3669663
36879,3,24,12,12,10,11,72,38.25300466,-109.3666968
36880,3,18,12,8,9,13,63,38.25300466,-109.3664273
36881,1,16,14,2,3,24,60,38.25300466,-109.3661578
36882,1,17,14,1,3,23,59,38.25300466,-109.3658883
36883,2,19,14,1,3,23,62,38.25300466,-109.3656188
36884,2,21,15,0,2,25,65,38.25300466,-109.3653493
36885,2,22,15,0,1,27,67,38.25300466,-109.3650799
36886,2,20,16,0,1,29,68,38.25300466,-109.3648104
36887,1,20,16,0,1,29,67,38.25300466,-109.3645409
36888,1,20,17,0,1,29,68,38.25300466,-109.3642714
36889,1,22,17,0,2,29,71,38.25300466,-109.3640019
36890,2,24,17,0,2,29,74,38.25300466,-109.3637324
36891,1,19,18,0,1,34,73,38.25300466,-109.3634629
36892,1,20,19,0,1,35,76,38.25300466,-109.3631934
36893,1,20,18,0,1,33,73,38.25300466,-109.3629239
36894,1,22,17,0,2,30,72,38.25300466,-109.3626544
36895,1,21,17,1,2,30,72,38.25300466,-109.3623849
36896,1,20,17,0,2,31,71,38.25300466,-109.3621154
36897,0,20,17,0,1,31,69,38.25300466,-109.3618459
36898,0,20,16,0,1,30,67,38.25300466,-109.3615764
36899,1,19,15,0,1,28,64,38.25300466,-109.3613069
36900,1,20,14,1,2,25,63,38.25300466,-109.3610374
36901,0,21,13,0,2,24,60,38.25300466,-109.3607679
36902,0,23,12,0,3,21,59,38.25300466,-109.3604984
36903,0,27,11,0,5,19,62,38.25300466,-109.360229
36904,0,26,11,0,5,19,61,38.25300466,-109.3599595
36905,0,24,13,0,3,23,63,38.25300466,-109.35969
36906,2,25,14,0,3,24,68,38.25300466,-109.3594205
36907,3,24,15,0,2,26,70,38.25300466,-109.359151
36908,2,23,17,0,1,29,72,38.25300466,-109.3588815
36909,1,22,17,0,2,30,72,38.25300466,-109.358612
36910,0,22,17,0,1,33,73,38.25300466,-109.3583425
36911,0,21,17,0,0,33,71,38.25300466,-109.358073
36912,1,21,17,0,0,32,71,38.25300466,-109.3578035
36913,1,21,17,1,1,31,72,38.25300466,-109.357534
36914,1,20,18,1,2,31,73,38.25300466,-109.3572645
36915,1,21,16,2,1,29,70,38.25300466,-109.356995
36916,1,23,16,3,2,28,73,38.25300466,-109.3567255
36917,1,25,16,3,2,27,74,38.25300466,-109.356456
36918,2,28,14,4,2,25,75,38.25300466,-109.3561865
36919,2,25,15,5,2,26,75,38.25300466,-109.355917
36920,2,20,16,3,1,29,71,38.25300466,-109.3556475
36921,1,19,16,1,1,28,66,38.25300466,-109.355378
36922,1,20,14,0,1,25,61,38.25300466,-109.3551086
36923,2,27,11,0,4,18,62,38.25300466,-109.3548391
36924,2,30,12,1,5,18,68,38.25300466,-109.3545696
36925,2,29,12,1,4,21,69,38.25300466,-109.3543001
36926,1,26,13,2,3,23,68,38.25300466,-109.3540306
36927,2,23,14,1,2,25,67,38.25300466,-109.3537611
36928,2,20,15,0,1,28,66,38.25300466,-109.3534916
36929,1,19,16,0,0,29,65,38.25300466,-109.3532221
36930,1,17,15,0,1,26,60,38.25300466,-109.3529526
36931,2,22,11,3,5,15,58,38.25300466,-109.3526831
36932,3,35,7,2,7,4,58,38.25300466,-109.3524136
36933,3,33,7,3,9,3,58,38.25300466,-109.3521441
36934,2,26,8,4,10,7,57,38.25300466,-109.3518746
36935,2,27,10,3,7,11,60,38.25300466,-109.3516051
36936,1,24,11,3,6,13,58,38.25300466,-109.3513356
36937,5,25,11,7,7,6,61,38.25300466,-109.3510661
36938,0,25,9,3,7,7,51,38.25300466,-109.3507966
36939,3,21,8,6,9,4,51,38.25300466,-109.3505271
36940,6,18,11,12,11,4,62,38.25300466,-109.3502577
36941,2,20,13,23,13,8,79,38.25300466,-109.3499882
36942,2,20,10,17,17,3,69,38.25300466,-109.3497187
36943,3,22,10,11,14,6,66,38.25300466,-109.3494492
36944,3,19,12,5,9,13,61,38.25300466,-109.3491797
36945,3,20,12,4,8,13,60,38.25300466,-109.3489102
36946,3,25,11,4,8,10,61,38.25300466,-109.3486407
36947,0,31,10,8,7,7,63,38.25300466,-109.3483712
36948,1,23,10,5,11,11,61,38.25300466,-109.3481017
36949,2,22,12,4,9,18,67,38.25300466,-109.3478322
36950,4,18,13,6,9,14,64,38.25300466,-109.3475627
36951,19,25,12,12,8,1,77,38.25300466,-109.3472932
36952,2,30,8,4,9,4,57,38.25300466,-109.3470237
36953,2,24,8,3,8,5,50,38.25300466,-109.3467542
36954,3,24,8,4,8,5,52,38.25300466,-109.3464847
36955,2,24,7,5,7,4,49,38.25300466,-109.3462152
36956,8,18,10,7,9,4,56,38.25300466,-109.3459457
36957,5,17,10,13,10,4,59,38.25300466,-109.3456762
36958,3,17,12,15,8,8,63,38.25300466,-109.3454068
36959,3,19,11,9,9,11,62,38.25300466,-109.3451373
36960,3,19,12,8,7,14,63,38.25300466,-109.3448678
36961,4,15,15,5,7,21,67,38.25300466,-109.3445983
36962,4,17,16,6,12,16,71,38.25300466,-109.3443288
36963,3,18,13,0,13,10,57,38.25300466,-109.3440593
36964,2,18,14,4,15,10,63,38.25300466,-109.3437898
36965,5,23,14,4,17,11,74,38.25300466,-109.3435203
36966,2,23,15,3,6,21,70,38.25300466,-109.3432508
36967,4,21,14,1,6,17,63,38.25300466,-109.3429813
36968,8,30,8,3,7,5,61,38.25300466,-109.3427118
36969,3,34,6,3,9,4,59,38.25300466,-109.3424423
36970,2,36,7,4,10,5,64,38.25300466,-109.3421728
36971,2,35,7,5,10,6,65,38.25300466,-109.3419033
36972,2,30,9,3,7,13,64,38.25300466,-109.3416338
36973,1,22,10,3,3,17,56,38.25300466,-109.3413643
36974,1,21,10,3,4,16,55,38.25300466,-109.3410948
36975,2,27,9,3,8,10,59,38.25300466,-109.3408253
36976,3,28,9,4,8,8,60,38.25300466,-109.3405558
36977,2,29,9,4,9,9,62,38.25300466,-109.3402864
36978,1,31,9,4,10,9,64,38.25300466,-109.3400169
36979,2,42,9,1,11,6,71,38.25300466,-109.3397474
36980,0,33,9,2,8,10,62,38.25300466,-109.3394779
36981,0,31,9,3,9,10,62,38.25300466,-109.3392084
36982,2,30,10,3,11,9,65,38.25300466,-109.3389389
36983,3,35,11,3,11,9,72,38.25300466,-109.3386694
36984,1,32,10,2,9,12,66,38.25300466,-109.3383999
36985,1,32,10,2,10,12,67,38.25300466,-109.3381304
36986,1,35,10,1,11,11,69,38.25300466,-109.3378609
36987,0,41,8,1,10,8,68,38.25300466,-109.3375914
36988,0,47,6,2,10,4,69,38.25300466,-109.3373219
36989,2,34,8,4,10,4,62,38.25300466,-109.3370524
36990,2,26,9,5,9,5,56,38.25300466,-109.3367829
36991,2,24,9,4,8,6,53,38.25300466,-109.3365134
36992,2,28,7,4,8,5,54,38.25300466,-109.3362439
36993,2,25,6,5,8,3,49,38.25300466,-109.3359744
36994,2,25,8,6,8,4,53,38.25300466,-109.3357049
36995,4,25,11,6,8,5,59,38.25300466,-109.3354355
36996,7,26,11,12,10,3,69,38.25300466,-109.335166
36997,1,26,10,16,18,3,74,38.25300466,-109.3348965
36998,2,20,12,18,15,5,72,38.25300466,-109.334627
36999,1,17,11,19,13,6,67,38.25300466,-109.3343575
37000,2,23,14,14,13,11,77,38.25300466,-109.334088
37001,2,26,14,13,10,13,78,38.25300466,-109.3338185
37002,1,29,14,3,8,21,76,38.25300466,-109.333549
37003,1,29,12,1,8,20,71,38.25300466,-109.3332795
37004,0,25,11,3,12,14,65,38.25300466,-109.33301
37005,0,24,12,2,12,12,62,38.25300466,-109.3327405
37006,1,25,12,4,11,12,65,38.25300466,-109.332471
37007,1,23,12,3,9,14,62,38.25300466,-109.3322015
37008,1,22,13,3,9,15,63,38.25300466,-109.331932
37009,1,23,14,3,8,18,67,38.25300466,-109.3316625
37010,3,57,8,1,10,4,83,38.25273516484056,-109.4405383
37011,2,46,9,1,8,8,74,38.25273516484056,-109.4402688
37012,2,43,9,2,8,8,72,38.25273516484056,-109.4399993
37013,2,42,9,1,9,6,69,38.25273516484056,-109.4397299
37014,2,41,9,3,11,5,71,38.25273516484056,-109.4394604
37015,1,44,8,1,8,8,70,38.25273516484056,-109.4391909
37016,1,43,8,0,10,8,70,38.25273516484056,-109.4389214
37017,1,43,9,0,13,8,74,38.25273516484056,-109.4386519
37018,2,46,10,1,15,6,80,38.25273516484056,-109.4383824
37019,4,48,11,5,16,2,86,38.25273516484056,-109.4381129
37020,6,44,11,8,16,1,86,38.25273516484056,-109.4378434
37021,8,41,12,9,15,1,86,38.25273516484056,-109.4375739
37022,8,37,11,11,13,2,82,38.25273516484056,-109.4373044
37023,4,41,9,11,9,2,76,38.25273516484056,-109.4370349
37024,4,46,8,8,7,2,75,38.25273516484056,-109.4367654
37025,3,42,8,5,9,5,72,38.25273516484056,-109.4364959
37026,2,36,9,4,11,7,69,38.25273516484056,-109.4362264
37027,2,34,10,4,11,9,70,38.25273516484056,-109.4359569
37028,1,32,10,2,9,12,66,38.25273516484056,-109.4356874
37029,3,39,11,6,14,5,78,38.25273516484056,-109.4354179
37030,3,43,10,6,15,3,80,38.25273516484056,-109.4351484
37031,2,43,10,5,15,4,79,38.25273516484056,-109.434879
37032,2,41,10,4,13,7,77,38.25273516484056,-109.4346095
37033,2,41,9,2,11,7,72,38.25273516484056,-109.43434
37034,1,39,8,3,10,6,67,38.25273516484056,-109.4340705
37035,2,42,9,4,14,4,75,38.25273516484056,-109.433801
37036,2,40,10,2,15,7,76,38.25273516484056,-109.4335315
37037,2,38,11,3,13,9,76,38.25273516484056,-109.433262
37038,5,48,12,7,16,2,90,38.25273516484056,-109.4329925
37039,4,48,11,9,15,1,88,38.25273516484056,-109.432723
37040,5,49,11,8,16,0,89,38.25273516484056,-109.4324535
37041,5,49,11,5,17,1,88,38.25273516484056,-109.432184
37042,3,38,10,4,14,5,74,38.25273516484056,-109.4319145
37043,9,41,13,11,14,2,90,38.25273516484056,-109.431645
37044,7,40,13,12,14,1,87,38.25273516484056,-109.4313755
37045,9,39,14,14,14,1,91,38.25273516484056,-109.431106
37046,13,38,14,14,13,0,92,38.25273516484056,-109.4308365
37047,14,38,14,13,13,0,92,38.25273516484056,-109.430567
37048,10,42,14,13,14,0,93,38.25273516484056,-109.4302975
37049,7,46,12,12,13,1,91,38.25273516484056,-109.430028
37050,6,48,12,11,13,1,91,38.25273516484056,-109.4297586
37051,5,49,11,10,13,1,89,38.25273516484056,-109.4294891
37052,7,47,12,11,13,1,91,38.25273516484056,-109.4292196
37053,8,47,12,11,13,1,92,38.25273516484056,-109.4289501
37054,9,47,11,11,13,1,92,38.25273516484056,-109.4286806
37055,10,47,12,11,13,1,94,38.25273516484056,-109.4284111
37056,10,45,13,12,14,0,94,38.25273516484056,-109.4281416
37057,13,44,13,11,14,0,95,38.25273516484056,-109.4278721
37058,13,42,13,11,14,0,93,38.25273516484056,-109.4276026
37059,16,38,13,12,13,0,92,38.25273516484056,-109.4273331
37060,19,35,14,13,12,0,93,38.25273516484056,-109.4270636
37061,16,35,15,15,12,1,94,38.25273516484056,-109.4267941
37062,15,37,15,14,12,0,93,38.25273516484056,-109.4265246
37063,15,37,14,14,13,0,93,38.25273516484056,-109.4262551
37064,17,35,14,13,12,0,91,38.25273516484056,-109.4259856
37065,20,33,14,13,12,0,92,38.25273516484056,-109.4257161
37066,20,32,14,14,12,0,92,38.25273516484056,-109.4254466
37067,23,31,15,13,11,0,93,38.25273516484056,-109.4251771
37068,22,31,15,13,11,0,92,38.25273516484056,-109.4249077
37069,21,32,14,13,12,0,92,38.25273516484056,-109.4246382
37070,21,32,14,12,12,0,91,38.25273516484056,-109.4243687
37071,17,34,14,13,13,0,91,38.25273516484056,-109.4240992
37072,17,35,13,12,13,0,90,38.25273516484056,-109.4238297
37073,16,38,13,10,13,0,90,38.25273516484056,-109.4235602
37074,12,43,12,9,14,0,90,38.25273516484056,-109.4232907
37075,7,49,10,8,13,1,88,38.25273516484056,-109.4230212
37076,5,48,10,7,13,2,85,38.25273516484056,-109.4227517
37077,3,48,9,4,13,4,81,38.25273516484056,-109.4224822
37078,3,49,9,3,13,5,82,38.25273516484056,-109.4222127
37079,3,49,10,3,13,5,83,38.25273516484056,-109.4219432
37080,4,46,11,7,12,4,84,38.25273516484056,-109.4216737
37081,4,45,10,6,12,3,80,38.25273516484056,-109.4214042
37082,5,38,10,6,11,3,73,38.25273516484056,-109.4211347
37083,7,33,9,5,9,5,68,38.25273516484056,-109.4208652
37084,5,30,11,6,7,9,68,38.25273516484056,-109.4205957
37085,5,34,12,7,9,8,75,38.25273516484056,-109.4203262
37086,4,34,10,4,8,10,70,38.25273516484056,-109.4200568
37087,4,35,9,4,9,8,69,38.25273516484056,-109.4197873
37088,4,35,9,5,9,5,67,38.25273516484056,-109.4195178
37089,5,36,9,5,10,4,69,38.25273516484056,-109.4192483
37090,3,33,9,2,8,8,63,38.25273516484056,-109.4189788
37091,2,31,8,2,9,8,60,38.25273516484056,-109.4187093
37092,3,33,8,3,10,6,63,38.25273516484056,-109.4184398
37093,2,34,8,3,10,5,62,38.25273516484056,-109.4181703
37094,2,33,9,3,11,6,64,38.25273516484056,-109.4179008
37095,1,32,9,2,10,8,62,38.25273516484056,-109.4176313
37096,2,34,9,3,10,7,65,38.25273516484056,-109.4173618
37097,3,36,8,2,10,6,65,38.25273516484056,-109.4170923
37098,1,36,8,2,9,6,62,38.25273516484056,-109.4168228
37099,4,35,8,4,11,4,66,38.25273516484056,-109.4165533
37100,2,34,8,1,9,7,61,38.25273516484056,-109.4162838
37101,2,31,8,2,9,8,60,38.25273516484056,-109.4160143
37102,3,31,8,3,10,6,61,38.25273516484056,-109.4157448
37103,3,36,9,3,11,5,67,38.25273516484056,-109.4154753
37104,3,38,9,2,10,8,70,38.25273516484056,-109.4152058
37105,3,36,10,1,9,10,69,38.25273516484056,-109.4149364
37106,4,30,10,1,9,10,64,38.25273516484056,-109.4146669
37107,5,28,10,1,8,10,62,38.25273516484056,-109.4143974
37108,6,31,10,2,8,8,65,38.25273516484056,-109.4141279
37109,3,34,8,3,6,6,60,38.25273516484056,-109.4138584
37110,3,38,6,4,6,4,61,38.25273516484056,-109.4135889
37111,3,41,5,4,6,3,62,38.25273516484056,-109.4133194
37112,3,40,5,4,6,3,61,38.25273516484056,-109.4130499
37113,2,39,5,4,6,4,60,38.25273516484056,-109.4127804
37114,2,37,7,4,7,4,61,38.25273516484056,-109.4125109
37115,3,30,8,4,9,5,59,38.25273516484056,-109.4122414
37116,5,27,10,5,9,7,63,38.25273516484056,-109.4119719
37117,8,31,12,9,10,5,75,38.25273516484056,-109.4117024
37118,7,43,12,8,10,3,83,38.25273516484056,-109.4114329
37119,5,46,12,7,10,4,84,38.25273516484056,-109.4111634
37120,5,44,12,7,11,4,83,38.25273516484056,-109.4108939
37121,5,42,12,7,11,4,81,38.25273516484056,-109.4106244
37122,4,38,11,5,11,7,76,38.25273516484056,-109.4103549
37123,3,34,12,3,11,11,74,38.25273516484056,-109.4100855
37124,4,34,12,3,12,11,76,38.25273516484056,-109.409816
37125,4,34,12,3,11,12,76,38.25273516484056,-109.4095465
37126,4,34,13,2,10,14,77,38.25273516484056,-109.409277
37127,5,41,13,7,12,6,84,38.25273516484056,-109.4090075
37128,5,44,13,12,11,2,87,38.25273516484056,-109.408738
37129,6,43,14,13,11,2,89,38.25273516484056,-109.4084685
37130,6,42,14,13,11,1,87,38.25273516484056,-109.408199
37131,8,44,14,14,12,1,93,38.25273516484056,-109.4079295
37132,12,41,14,14,12,0,93,38.25273516484056,-109.40766
37133,12,41,14,13,12,0,92,38.25273516484056,-109.4073905
37134,12,41,13,12,13,0,91,38.25273516484056,-109.407121
37135,11,40,13,12,15,0,91,38.25273516484056,-109.4068515
37136,6,37,12,12,13,1,81,38.25273516484056,-109.406582
37137,5,38,8,3,8,5,67,38.25273516484056,-109.4063125
37138,4,30,8,4,9,6,61,38.25273516484056,-109.406043
37139,5,21,9,4,9,8,56,38.25273516484056,-109.4057735
37140,2,23,10,4,8,11,58,38.25273516484056,-109.405504
37141,2,41,9,2,14,6,74,38.25273516484056,-109.4052345
37142,4,35,9,4,10,5,67,38.25273516484056,-109.4049651
37143,3,34,9,3,10,6,65,38.25273516484056,-109.4046956
37144,2,36,9,2,9,8,66,38.25273516484056,-109.4044261
37145,2,40,10,1,11,9,73,38.25273516484056,-109.4041566
37146,2,32,11,1,10,13,69,38.25273516484056,-109.4038871
37147,2,35,11,3,13,8,72,38.25273516484056,-109.4036176
37148,2,38,10,5,11,5,71,38.25273516484056,-109.4033481
37149,3,35,10,4,11,5,68,38.25273516484056,-109.4030786
37150,4,28,9,5,11,4,61,38.25273516484056,-109.4028091
37151,4,26,11,8,10,5,64,38.25273516484056,-109.4025396
37152,8,21,13,13,10,4,69,38.25273516484056,-109.4022701
37153,9,24,13,13,11,4,74,38.25273516484056,-109.4020006
37154,9,30,14,10,11,5,79,38.25273516484056,-109.4017311
37155,9,29,17,12,12,8,87,38.25273516484056,-109.4014616
37156,7,23,19,14,12,11,86,38.25273516484056,-109.4011921
37157,7,22,19,16,14,10,88,38.25273516484056,-109.4009226
37158,8,21,16,21,17,7,90,38.25273516484056,-109.4006531
37159,8,23,12,32,14,2,91,38.25273516484056,-109.4003836
37160,8,25,11,30,13,1,88,38.25273516484056,-109.4001142
37161,6,25,11,27,14,1,84,38.25273516484056,-109.3998447
37162,2,24,13,29,16,1,85,38.25273516484056,-109.3995752
37163,1,22,15,22,18,6,84,38.25273516484056,-109.3993057
37164,2,20,15,18,13,7,75,38.25273516484056,-109.3990362
37165,1,30,14,14,19,5,83,38.25273516484056,-109.3987667
37166,3,31,14,17,20,4,89,38.25273516484056,-109.3984972
37167,5,28,13,24,15,3,88,38.25273516484056,-109.3982277
37168,4,26,15,24,14,4,87,38.25273516484056,-109.3979582
37169,3,23,16,24,18,5,89,38.25273516484056,-109.3976887
37170,7,20,13,14,10,10,74,38.25273516484056,-109.3974192
37171,4,20,12,13,11,9,69,38.25273516484056,-109.3971497
37172,3,24,12,15,13,7,74,38.25273516484056,-109.3968802
37173,5,29,12,17,22,4,89,38.25273516484056,-109.3966107
37174,2,27,13,15,22,3,82,38.25273516484056,-109.3963412
37175,0,27,12,15,21,4,79,38.25273516484056,-109.3960717
37176,0,29,12,11,21,7,80,38.25273516484056,-109.3958022
37177,0,30,12,8,20,8,78,38.25273516484056,-109.3955327
37178,2,31,12,9,15,8,77,38.25273516484056,-109.3952632
37179,1,30,11,3,11,15,71,38.25273516484056,-109.3949938
37180,0,29,12,6,13,12,72,38.25273516484056,-109.3947243
37181,0,28,12,8,16,9,73,38.25273516484056,-109.3944548
37182,0,28,12,8,14,11,73,38.25273516484056,-109.3941853
37183,0,30,11,7,16,9,73,38.25273516484056,-109.3939158
37184,0,32,11,2,13,12,70,38.25273516484056,-109.3936463
37185,0,32,11,0,11,15,69,38.25273516484056,-109.3933768
37186,0,30,11,0,11,15,67,38.25273516484056,-109.3931073
37187,0,26,11,2,11,16,66,38.25273516484056,-109.3928378
37188,2,30,11,0,12,15,70,38.25273516484056,-109.3925683
37189,3,28,12,4,13,12,72,38.25273516484056,-109.3922988
37190,5,28,13,7,13,11,77,38.25273516484056,-109.3920293
37191,6,27,12,7,12,11,75,38.25273516484056,-109.3917598
37192,11,30,12,10,15,6,84,38.25273516484056,-109.3914903
37193,17,31,13,12,14,2,89,38.25273516484056,-109.3912208
37194,17,33,13,13,14,0,90,38.25273516484056,-109.3909513
37195,16,34,13,15,14,0,92,38.25273516484056,-109.3906818
37196,14,35,13,14,14,1,91,38.25273516484056,-109.3904123
37197,15,34,13,13,15,1,91,38.25273516484056,-109.3901429
37198,14,35,14,13,15,1,92,38.25273516484056,-109.3898734
37199,14,34,14,14,15,1,92,38.25273516484056,-109.3896039
37200,15,34,14,15,14,1,93,38.25273516484056,-109.3893344
37201,15,34,14,15,14,1,93,38.25273516484056,-109.3890649
37202,17,32,13,13,14,0,89,38.25273516484056,-109.3887954
37203,18,31,13,13,14,0,89,38.25273516484056,-109.3885259
37204,17,31,13,13,14,0,88,38.25273516484056,-109.3882564
37205,15,31,13,14,14,1,88,38.25273516484056,-109.3879869
37206,18,31,13,15,14,0,91,38.25273516484056,-109.3877174
37207,21,32,13,13,13,0,92,38.25273516484056,-109.3874479
37208,22,31,13,12,13,0,91,38.25273516484056,-109.3871784
37209,18,31,13,11,13,1,87,38.25273516484056,-109.3869089
37210,13,33,12,6,13,4,81,38.25273516484056,-109.3866394
37211,4,34,10,6,12,6,72,38.25273516484056,-109.3863699
37212,10,30,11,11,13,2,77,38.25273516484056,-109.3861004
37213,12,32,12,14,13,1,84,38.25273516484056,-109.3858309
37214,13,35,13,15,12,1,89,38.25273516484056,-109.3855614
37215,15,38,14,14,12,1,94,38.25273516484056,-109.3852919
37216,8,40,13,12,13,1,87,38.25273516484056,-109.3850225
37217,9,43,14,14,13,1,94,38.25273516484056,-109.384753
37218,10,41,14,14,14,0,93,38.25273516484056,-109.3844835
37219,11,39,13,13,14,0,90,38.25273516484056,-109.384214
37220,8,37,11,10,15,1,82,38.25273516484056,-109.3839445
37221,7,36,12,10,16,2,83,38.25273516484056,-109.383675
37222,4,36,11,7,15,3,76,38.25273516484056,-109.3834055
37223,2,36,9,5,14,4,70,38.25273516484056,-109.383136
37224,3,33,8,5,11,5,65,38.25273516484056,-109.3828665
37225,3,24,9,6,9,8,59,38.25273516484056,-109.382597
37226,4,25,10,17,11,2,69,38.25273516484056,-109.3823275
37227,4,31,9,12,11,2,69,38.25273516484056,-109.382058
37228,3,39,9,6,13,3,73,38.25273516484056,-109.3817885
37229,3,43,10,5,16,2,79,38.25273516484056,-109.381519
37230,5,48,11,6,18,1,89,38.25273516484056,-109.3812495
37231,8,49,12,7,15,0,91,38.25273516484056,-109.38098
37232,7,48,12,7,15,0,89,38.25273516484056,-109.3807105
37233,6,48,12,6,16,1,89,38.25273516484056,-109.380441
37234,7,47,13,8,16,1,92,38.25273516484056,-109.3801716
37235,11,40,14,14,14,0,93,38.25273516484056,-109.3799021
37236,13,38,14,15,14,0,94,38.25273516484056,-109.3796326
37237,12,38,14,14,14,0,92,38.25273516484056,-109.3793631
37238,10,40,14,12,15,1,92,38.25273516484056,-109.3790936
37239,11,41,15,13,14,0,94,38.25273516484056,-109.3788241
37240,12,41,14,14,12,0,93,38.25273516484056,-109.3785546
37241,11,41,14,13,12,1,92,38.25273516484056,-109.3782851
37242,12,38,15,13,11,2,91,38.25273516484056,-109.3780156
37243,21,31,15,14,9,1,91,38.25273516484056,-109.3777461
37244,32,26,14,14,7,1,94,38.25273516484056,-109.3774766
37245,31,22,12,14,5,1,85,38.25273516484056,-109.3772071
37246,28,19,11,12,5,1,76,38.25273516484056,-109.3769376
37247,28,18,11,11,4,1,73,38.25273516484056,-109.3766681
37248,32,18,15,16,5,1,87,38.25273516484056,-109.3763986
37249,32,20,16,17,6,2,93,38.25273516484056,-109.3761291
37250,29,21,15,18,7,1,91,38.25273516484056,-109.3758596
37251,24,23,15,20,8,1,91,38.25273516484056,-109.3755901
37252,17,27,14,18,11,1,88,38.25273516484056,-109.3753206
37253,10,26,14,14,11,6,81,38.25273516484056,-109.3750512
37254,4,27,14,8,12,14,79,38.25273516484056,-109.3747817
37255,3,26,16,9,14,10,78,38.25273516484056,-109.3745122
37256,3,30,13,10,17,6,79,38.25273516484056,-109.3742427
37257,5,24,11,16,18,2,76,38.25273516484056,-109.3739732
37258,13,23,12,12,14,1,75,38.25273516484056,-109.3737037
37259,12,21,11,11,12,2,69,38.25273516484056,-109.3734342
37260,6,20,10,10,15,2,63,38.25273516484056,-109.3731647
37261,5,25,9,9,12,3,63,38.25273516484056,-109.3728952
37262,4,31,10,5,8,5,63,38.25273516484056,-109.3726257
37263,4,32,10,5,9,6,66,38.25273516484056,-109.3723562
37264,7,31,8,5,5,6,62,38.25273516484056,-109.3720867
37265,6,32,7,6,7,6,64,38.25273516484056,-109.3718172
37266,6,33,7,7,7,5,65,38.25273516484056,-109.3715477
37267,8,31,8,6,7,6,66,38.25273516484056,-109.3712782
37268,5,23,9,4,9,7,57,38.25273516484056,-109.3710087
37269,9,25,10,4,8,4,60,38.25273516484056,-109.3707392
37270,10,27,9,4,7,4,61,38.25273516484056,-109.3704697
37271,6,38,7,5,4,5,65,38.25273516484056,-109.3702003
37272,7,40,5,4,5,3,64,38.25273516484056,-109.3699308
37273,6,41,5,5,6,3,66,38.25273516484056,-109.3696613
37274,4,44,6,4,7,2,67,38.25273516484056,-109.3693918
37275,2,36,7,2,8,4,59,38.25273516484056,-109.3691223
37276,2,45,8,4,10,3,72,38.25273516484056,-109.3688528
37277,0,38,10,2,7,12,69,38.25273516484056,-109.3685833
37278,1,32,10,3,9,11,66,38.25273516484056,-109.3683138
37279,3,30,11,12,12,5,73,38.25273516484056,-109.3680443
37280,7,28,11,21,13,1,81,38.25273516484056,-109.3677748
37281,3,31,10,17,14,0,75,38.25273516484056,-109.3675053
37282,5,22,13,13,12,4,69,38.25273516484056,-109.3672358
37283,1,18,10,12,15,4,60,38.25273516484056,-109.3669663
37284,3,26,12,12,8,9,70,38.25273516484056,-109.3666968
37285,3,18,11,6,9,11,58,38.25273516484056,-109.3664273
37286,2,18,12,3,4,18,57,38.25273516484056,-109.3661578
37287,3,14,13,5,5,16,56,38.25273516484056,-109.3658883
37288,3,16,13,5,5,18,60,38.25273516484056,-109.3656188
37289,2,18,14,1,3,24,62,38.25273516484056,-109.3653493
37290,1,20,15,0,1,29,66,38.25273516484056,-109.3650799
37291,1,17,16,0,1,31,66,38.25273516484056,-109.3648104
37292,1,18,17,0,1,32,69,38.25273516484056,-109.3645409
37293,1,19,18,0,1,33,72,38.25273516484056,-109.3642714
37294,1,21,18,0,2,34,76,38.25273516484056,-109.3640019
37295,1,24,18,0,3,32,78,38.25273516484056,-109.3637324
37296,2,21,17,0,1,33,74,38.25273516484056,-109.3634629
37297,2,21,18,1,2,33,77,38.25273516484056,-109.3631934
37298,2,24,18,1,2,31,78,38.25273516484056,-109.3629239
37299,3,27,17,1,4,27,79,38.25273516484056,-109.3626544
37300,2,30,15,0,8,23,78,38.25273516484056,-109.3623849
37301,2,29,15,0,6,25,77,38.25273516484056,-109.3621154
37302,2,27,16,0,4,27,76,38.25273516484056,-109.3618459
37303,1,24,17,0,4,29,75,38.25273516484056,-109.3615764
37304,1,21,18,0,3,32,75,38.25273516484056,-109.3613069
37305,0,20,17,0,2,31,70,38.25273516484056,-109.3610374
37306,0,21,16,0,3,29,69,38.25273516484056,-109.3607679
37307,0,23,14,0,4,25,66,38.25273516484056,-109.3604984
37308,0,23,13,0,4,23,63,38.25273516484056,-109.360229
37309,0,23,13,0,4,23,63,38.25273516484056,-109.3599595
37310,0,21,13,0,2,25,61,38.25273516484056,-109.35969
37311,0,19,15,0,1,28,63,38.25273516484056,-109.3594205
37312,1,19,16,0,1,30,67,38.25273516484056,-109.359151
37313,1,19,17,0,0,32,69,38.25273516484056,-109.3588815
37314,1,20,18,0,1,32,72,38.25273516484056,-109.358612
37315,0,22,19,0,2,35,78,38.25273516484056,-109.3583425
37316,1,21,19,1,2,33,77,38.25273516484056,-109.358073
37317,2,20,18,3,2,31,76,38.25273516484056,-109.3578035
37318,1,20,18,3,2,30,74,38.25273516484056,-109.357534
37319,1,19,18,1,1,32,72,38.25273516484056,-109.3572645
37320,1,21,16,2,1,29,70,38.25273516484056,-109.356995
37321,1,22,16,2,1,28,70,38.25273516484056,-109.3567255
37322,1,21,16,1,1,29,69,38.25273516484056,-109.356456
37323,1,21,16,3,1,27,69,38.25273516484056,-109.3561865
37324,2,22,15,3,1,27,70,38.25273516484056,-109.355917
37325,1,19,16,1,0,29,66,38.25273516484056,-109.3556475
37326,1,19,15,0,1,27,63,38.25273516484056,-109.355378
37327,1,22,13,1,2,23,62,38.25273516484056,-109.3551086
37328,2,28,11,1,4,19,65,38.25273516484056,-109.3548391
37329,2,26,13,1,3,23,68,38.25273516484056,-109.3545696
37330,2,23,14,1,2,23,65,38.25273516484056,-109.3543001
37331,2,21,13,1,2,23,62,38.25273516484056,-109.3540306
37332,2,18,13,1,2,22,58,38.25273516484056,-109.3537611
37333,3,17,14,1,2,22,59,38.25273516484056,-109.3534916
37334,3,20,14,0,2,22,61,38.25273516484056,-109.3532221
37335,1,19,14,0,2,22,58,38.25273516484056,-109.3529526
37336,3,23,11,3,8,12,60,38.25273516484056,-109.3526831
37337,2,27,8,3,9,5,54,38.25273516484056,-109.3524136
37338,1,30,7,1,9,5,53,38.25273516484056,-109.3521441
37339,2,28,8,4,10,6,58,38.25273516484056,-109.3518746
37340,2,25,10,5,7,10,59,38.25273516484056,-109.3516051
37341,1,24,11,3,5,12,56,38.25273516484056,-109.3513356
37342,7,27,12,8,6,6,66,38.25273516484056,-109.3510661
37343,0,30,8,3,7,7,55,38.25273516484056,-109.3507966
37344,2,23,9,6,9,5,54,38.25273516484056,-109.3505271
37345,10,21,15,16,11,2,75,38.25273516484056,-109.3502577
37346,1,23,16,8,14,18,80,38.25273516484056,-109.3499882
37347,2,22,10,13,13,6,66,38.25273516484056,-109.3497187
37348,2,23,10,11,11,7,64,38.25273516484056,-109.3494492
37349,2,20,12,5,8,15,62,38.25273516484056,-109.3491797
37350,2,22,13,4,7,17,65,38.25273516484056,-109.3489102
37351,1,22,12,2,6,16,59,38.25273516484056,-109.3486407
37352,1,32,10,7,9,7,66,38.25273516484056,-109.3483712
37353,1,26,10,3,12,10,62,38.25273516484056,-109.3481017
37354,1,25,12,3,11,15,67,38.25273516484056,-109.3478322
37355,3,22,11,9,12,8,65,38.25273516484056,-109.3475627
37356,12,34,12,10,11,1,80,38.25273516484056,-109.3472932
37357,3,30,7,3,6,4,53,38.25273516484056,-109.3470237
37358,2,30,6,2,6,4,50,38.25273516484056,-109.3467542
37359,2,25,7,3,6,5,48,38.25273516484056,-109.3464847
37360,2,23,8,6,7,5,51,38.25273516484056,-109.3462152
37361,5,18,11,15,12,3,64,38.25273516484056,-109.3459457
37362,3,20,12,12,9,11,67,38.25273516484056,-109.3456762
37363,4,24,13,8,8,12,69,38.25273516484056,-109.3454068
37364,5,23,12,8,10,10,68,38.25273516484056,-109.3451373
37365,5,21,13,8,8,14,69,38.25273516484056,-109.3448678
37366,6,16,16,4,5,22,69,38.25273516484056,-109.3445983
37367,7,21,15,2,6,16,67,38.25273516484056,-109.3443288
37368,4,23,13,2,9,11,62,38.25273516484056,-109.3440593
37369,0,18,12,3,8,12,53,38.25273516484056,-109.3437898
37370,6,19,11,8,15,5,64,38.25273516484056,-109.3435203
37371,5,18,13,3,4,17,60,38.25273516484056,-109.3432508
37372,5,25,9,4,7,8,58,38.25273516484056,-109.3429813
37373,3,32,7,3,8,5,58,38.25273516484056,-109.3427118
37374,3,34,6,4,9,4,60,38.25273516484056,-109.3424423
37375,2,34,7,4,10,5,62,38.25273516484056,-109.3421728
37376,2,41,7,5,10,5,70,38.25273516484056,-109.3419033
37377,2,36,8,3,9,7,65,38.25273516484056,-109.3416338
37378,3,31,10,3,7,11,65,38.25273516484056,-109.3413643
37379,5,18,13,4,4,16,60,38.25273516484056,-109.3410948
37380,4,21,11,4,5,14,59,38.25273516484056,-109.3408253
37381,2,21,11,3,4,15,56,38.25273516484056,-109.3405558
37382,2,25,10,3,8,11,59,38.25273516484056,-109.3402864
37383,2,29,9,3,11,7,61,38.25273516484056,-109.3400169
37384,3,33,9,2,9,7,63,38.25273516484056,-109.3397474
37385,3,26,9,4,10,8,60,38.25273516484056,-109.3394779
37386,1,32,9,5,11,6,64,38.25273516484056,-109.3392084
37387,0,41,8,2,13,6,70,38.25273516484056,-109.3389389
37388,1,41,9,1,11,8,71,38.25273516484056,-109.3386694
37389,0,36,9,1,8,11,65,38.25273516484056,-109.3383999
37390,0,42,8,0,10,9,69,38.25273516484056,-109.3381304
37391,0,46,7,0,11,7,71,38.25273516484056,-109.3378609
37392,0,40,7,2,11,5,65,38.25273516484056,-109.3375914
37393,2,35,7,3,8,4,59,38.25273516484056,-109.3373219
37394,3,30,7,3,7,4,54,38.25273516484056,-109.3370524
37395,3,27,7,4,8,4,53,38.25273516484056,-109.3367829
37396,2,26,6,4,8,4,50,38.25273516484056,-109.3365134
37397,2,25,6,5,8,4,50,38.25273516484056,-109.3362439
37398,3,31,6,5,8,2,55,38.25273516484056,-109.3359744
37399,3,28,8,8,8,4,59,38.25273516484056,-109.3357049
37400,2,23,10,14,12,3,64,38.25273516484056,-109.3354355
37401,3,25,12,22,9,9,80,38.25273516484056,-109.335166
37402,2,24,11,14,11,14,76,38.25273516484056,-109.3348965
37403,3,22,13,13,13,8,72,38.25273516484056,-109.334627
37404,1,21,11,11,12,9,65,38.25273516484056,-109.3343575
37405,0,22,11,10,12,10,65,38.25273516484056,-109.334088
37406,5,25,13,14,8,11,76,38.25273516484056,-109.3338185
37407,0,28,12,1,11,16,68,38.25273516484056,-109.333549
37408,0,31,10,0,12,12,65,38.25273516484056,-109.3332795
37409,0,27,11,0,10,16,64,38.25273516484056,-109.33301
37410,0,29,12,0,8,19,68,38.25273516484056,-109.3327405
37411,1,30,12,0,8,19,70,38.25273516484056,-109.332471
37412,1,29,12,0,7,19,68,38.25273516484056,-109.3322015
37413,0,28,12,0,8,17,65,38.25273516484056,-109.331932
37414,1,26,12,2,10,14,65,38.25273516484056,-109.3316625
37415,1,51,8,0,9,6,75,38.252465670255326,-109.4405383
37416,2,48,9,0,11,7,77,38.252465670255326,-109.4402688
37417,2,45,9,0,11,10,77,38.252465670255326,-109.4399993
37418,2,43,10,0,10,10,75,38.252465670255326,-109.4397299
37419,2,42,9,1,8,7,69,38.252465670255326,-109.4394604
37420,2,45,8,1,8,6,70,38.252465670255326,-109.4391909
37421,1,36,8,1,8,11,65,38.252465670255326,-109.4389214
37422,0,36,9,0,8,12,65,38.252465670255326,-109.4386519
37423,2,45,9,0,11,10,77,38.252465670255326,-109.4383824
37424,3,51,11,4,15,5,89,38.252465670255326,-109.4381129
37425,4,47,11,7,15,2,86,38.252465670255326,-109.4378434
37426,5,45,11,9,15,1,86,38.252465670255326,-109.4375739
37427,6,41,11,9,14,2,83,38.252465670255326,-109.4373044
37428,4,39,10,7,13,4,77,38.252465670255326,-109.4370349
37429,2,35,10,5,11,7,70,38.252465670255326,-109.4367654
37430,2,34,9,4,10,8,67,38.252465670255326,-109.4364959
37431,3,37,10,5,11,7,73,38.252465670255326,-109.4362264
37432,3,35,10,6,11,7,72,38.252465670255326,-109.4359569
37433,2,31,10,5,10,9,67,38.252465670255326,-109.4356874
37434,3,36,10,4,11,8,72,38.252465670255326,-109.4354179
37435,2,36,10,3,11,9,71,38.252465670255326,-109.4351484
37436,2,38,9,4,11,7,71,38.252465670255326,-109.434879
37437,2,41,9,4,12,5,73,38.252465670255326,-109.4346095
37438,2,43,9,4,12,4,74,38.252465670255326,-109.43434
37439,1,43,8,3,12,4,71,38.252465670255326,-109.4340705
37440,1,42,8,1,10,8,70,38.252465670255326,-109.433801
37441,1,39,8,0,9,10,67,38.252465670255326,-109.4335315
37442,2,39,9,1,10,9,70,38.252465670255326,-109.433262
37443,3,46,10,3,15,4,81,38.252465670255326,-109.4329925
37444,4,45,11,7,16,2,85,38.252465670255326,-109.432723
37445,6,48,11,8,16,1,90,38.252465670255326,-109.4324535
37446,6,48,11,6,17,1,89,38.252465670255326,-109.432184
37447,6,39,11,7,16,2,81,38.252465670255326,-109.4319145
37448,9,42,13,10,15,1,90,38.252465670255326,-109.431645
37449,9,40,14,13,14,1,91,38.252465670255326,-109.4313755
37450,10,39,14,15,14,0,92,38.252465670255326,-109.431106
37451,13,38,14,14,14,0,93,38.252465670255326,-109.4308365
37452,16,36,14,13,14,0,93,38.252465670255326,-109.430567
37453,12,41,14,13,14,0,94,38.252465670255326,-109.4302975
37454,10,43,14,13,14,0,94,38.252465670255326,-109.430028
37455,9,46,12,13,13,0,93,38.252465670255326,-109.4297586
37456,6,47,11,12,13,1,90,38.252465670255326,-109.4294891
37457,5,49,10,10,13,1,88,38.252465670255326,-109.4292196
37458,6,47,11,11,12,1,88,38.252465670255326,-109.4289501
37459,8,46,11,11,13,1,90,38.252465670255326,-109.4286806
37460,9,46,11,11,13,1,91,38.252465670255326,-109.4284111
37461,9,46,12,12,13,1,93,38.252465670255326,-109.4281416
37462,14,41,13,13,13,0,94,38.252465670255326,-109.4278721
37463,13,39,13,13,13,0,91,38.252465670255326,-109.4276026
37464,14,37,14,13,13,0,91,38.252465670255326,-109.4273331
37465,15,36,14,13,13,0,91,38.252465670255326,-109.4270636
37466,13,37,14,14,13,1,92,38.252465670255326,-109.4267941
37467,11,39,14,15,12,1,92,38.252465670255326,-109.4265246
37468,12,38,14,14,13,0,91,38.252465670255326,-109.4262551
37469,14,37,14,13,13,0,91,38.252465670255326,-109.4259856
37470,17,35,14,13,13,0,92,38.252465670255326,-109.4257161
37471,19,33,14,14,12,0,92,38.252465670255326,-109.4254466
37472,19,32,15,15,12,0,93,38.252465670255326,-109.4251771
37473,20,32,15,14,12,0,93,38.252465670255326,-109.4249077
37474,21,32,14,13,12,0,92,38.252465670255326,-109.4246382
37475,20,32,14,14,12,0,92,38.252465670255326,-109.4243687
37476,19,32,14,14,12,0,91,38.252465670255326,-109.4240992
37477,18,34,14,13,12,0,91,38.252465670255326,-109.4238297
37478,13,39,12,11,14,0,89,38.252465670255326,-109.4235602
37479,8,46,11,10,14,0,89,38.252465670255326,-109.4232907
37480,9,48,11,10,13,1,92,38.252465670255326,-109.4230212
37481,5,48,10,8,13,2,86,38.252465670255326,-109.4227517
37482,2,51,9,4,14,4,84,38.252465670255326,-109.4224822
37483,2,51,9,3,14,5,84,38.252465670255326,-109.4222127
37484,4,48,11,7,13,3,86,38.252465670255326,-109.4219432
37485,5,47,11,8,11,3,85,38.252465670255326,-109.4216737
37486,5,44,12,10,11,3,85,38.252465670255326,-109.4214042
37487,5,46,12,9,11,3,86,38.252465670255326,-109.4211347
37488,7,43,12,9,10,4,85,38.252465670255326,-109.4208652
37489,9,37,13,11,11,4,85,38.252465670255326,-109.4205957
37490,16,32,15,12,12,3,90,38.252465670255326,-109.4203262
37491,7,32,12,6,8,10,75,38.252465670255326,-109.4200568
37492,3,31,10,3,6,12,65,38.252465670255326,-109.4197873
37493,3,28,10,4,7,10,62,38.252465670255326,-109.4195178
37494,4,27,11,5,8,9,64,38.252465670255326,-109.4192483
37495,4,28,12,5,7,14,70,38.252465670255326,-109.4189788
37496,3,31,11,3,8,14,70,38.252465670255326,-109.4187093
37497,3,36,10,3,8,10,70,38.252465670255326,-109.4184398
37498,3,34,9,3,9,7,65,38.252465670255326,-109.4181703
37499,1,32,8,0,6,11,58,38.252465670255326,-109.4179008
37500,2,34,9,1,7,10,63,38.252465670255326,-109.4176313
37501,1,30,9,1,6,13,60,38.252465670255326,-109.4173618
37502,1,29,9,2,7,11,59,38.252465670255326,-109.4170923
37503,4,35,8,5,9,4,65,38.252465670255326,-109.4168228
37504,2,33,8,4,9,5,61,38.252465670255326,-109.4165533
37505,1,31,9,3,10,9,63,38.252465670255326,-109.4162838
37506,2,37,9,2,10,9,69,38.252465670255326,-109.4160143
37507,3,42,10,3,12,6,76,38.252465670255326,-109.4157448
37508,5,45,11,6,12,3,82,38.252465670255326,-109.4154753
37509,4,44,11,7,11,3,80,38.252465670255326,-109.4152058
37510,4,41,11,4,11,7,78,38.252465670255326,-109.4149364
37511,3,39,11,3,12,9,77,38.252465670255326,-109.4146669
37512,2,40,11,1,14,9,77,38.252465670255326,-109.4143974
37513,2,38,12,0,10,13,75,38.252465670255326,-109.4141279
37514,3,36,10,2,11,8,70,38.252465670255326,-109.4138584
37515,4,35,8,2,7,6,62,38.252465670255326,-109.4135889
37516,2,37,7,3,6,5,60,38.252465670255326,-109.4133194
37517,3,36,6,5,7,3,60,38.252465670255326,-109.4130499
37518,2,34,7,3,7,5,58,38.252465670255326,-109.4127804
37519,3,31,7,4,8,5,58,38.252465670255326,-109.4125109
37520,4,30,9,4,10,5,62,38.252465670255326,-109.4122414
37521,4,33,10,4,8,7,66,38.252465670255326,-109.4119719
37522,6,40,12,9,10,3,80,38.252465670255326,-109.4117024
37523,6,44,13,10,10,1,84,38.252465670255326,-109.4114329
37524,5,44,13,10,10,2,84,38.252465670255326,-109.4111634
37525,5,44,13,10,11,2,85,38.252465670255326,-109.4108939
37526,6,44,14,11,11,2,88,38.252465670255326,-109.4106244
37527,5,42,14,11,12,2,86,38.252465670255326,-109.4103549
37528,6,38,13,8,12,5,82,38.252465670255326,-109.4100855
37529,5,36,13,6,12,8,80,38.252465670255326,-109.409816
37530,5,35,13,3,10,12,78,38.252465670255326,-109.4095465
37531,5,36,13,2,10,13,79,38.252465670255326,-109.409277
37532,5,44,13,7,13,3,85,38.252465670255326,-109.4090075
37533,5,46,13,11,12,2,89,38.252465670255326,-109.408738
37534,6,46,13,12,12,1,90,38.252465670255326,-109.4084685
37535,7,45,13,12,13,1,91,38.252465670255326,-109.408199
37536,10,42,13,13,13,1,92,38.252465670255326,-109.4079295
37537,12,40,14,13,13,0,92,38.252465670255326,-109.40766
37538,11,39,13,13,13,0,89,38.252465670255326,-109.4073905
37539,12,38,12,11,13,1,87,38.252465670255326,-109.407121
37540,11,38,12,10,13,1,85,38.252465670255326,-109.4068515
37541,6,37,10,8,12,2,75,38.252465670255326,-109.406582
37542,3,34,8,3,9,5,62,38.252465670255326,-109.4063125
37543,4,30,8,4,9,5,60,38.252465670255326,-109.406043
37544,5,25,9,4,9,7,59,38.252465670255326,-109.4057735
37545,3,23,9,3,6,10,54,38.252465670255326,-109.405504
37546,2,34,8,2,10,7,63,38.252465670255326,-109.4052345
37547,2,31,9,1,8,9,60,38.252465670255326,-109.4049651
37548,3,33,9,3,9,8,65,38.252465670255326,-109.4046956
37549,2,36,10,3,12,8,71,38.252465670255326,-109.4044261
37550,2,39,11,0,12,11,75,38.252465670255326,-109.4041566
37551,1,38,10,0,11,10,70,38.252465670255326,-109.4038871
37552,2,40,9,1,10,8,70,38.252465670255326,-109.4036176
37553,2,38,9,4,11,4,68,38.252465670255326,-109.4033481
37554,5,32,10,7,11,3,68,38.252465670255326,-109.4030786
37555,5,24,12,13,11,3,68,38.252465670255326,-109.4028091
37556,9,26,15,16,13,4,83,38.252465670255326,-109.4025396
37557,6,29,17,11,14,11,88,38.252465670255326,-109.4022701
37558,3,30,16,8,14,13,84,38.252465670255326,-109.4020006
37559,4,25,14,15,14,9,81,38.252465670255326,-109.4017311
37560,10,21,16,16,16,8,87,38.252465670255326,-109.4014616
37561,4,20,16,20,17,8,85,38.252465670255326,-109.4011921
37562,3,21,14,23,17,6,84,38.252465670255326,-109.4009226
37563,5,21,13,25,18,3,85,38.252465670255326,-109.4006531
37564,5,21,15,23,21,5,90,38.252465670255326,-109.4003836
37565,8,20,13,26,18,1,86,38.252465670255326,-109.4001142
37566,8,23,13,23,18,1,86,38.252465670255326,-109.3998447
37567,1,26,12,19,18,3,79,38.252465670255326,-109.3995752
37568,0,25,13,11,17,9,75,38.252465670255326,-109.3993057
37569,1,34,13,5,15,12,80,38.252465670255326,-109.3990362
37570,1,34,11,1,13,13,73,38.252465670255326,-109.3987667
37571,1,36,11,0,13,12,73,38.252465670255326,-109.3984972
37572,1,34,12,1,13,13,74,38.252465670255326,-109.3982277
37573,2,30,13,10,15,10,80,38.252465670255326,-109.3979582
37574,7,21,14,31,15,0,88,38.252465670255326,-109.3976887
37575,6,21,14,28,18,2,89,38.252465670255326,-109.3974192
37576,5,22,14,28,18,3,90,38.252465670255326,-109.3971497
37577,1,22,15,25,18,7,88,38.252465670255326,-109.3968802
37578,2,19,15,21,18,6,81,38.252465670255326,-109.3966107
37579,0,28,13,14,20,6,81,38.252465670255326,-109.3963412
37580,0,27,11,7,13,10,68,38.252465670255326,-109.3960717
37581,2,31,11,1,9,13,67,38.252465670255326,-109.3958022
37582,2,36,11,0,11,12,72,38.252465670255326,-109.3955327
37583,4,43,11,2,16,5,81,38.252465670255326,-109.3952632
37584,2,37,10,2,13,9,73,38.252465670255326,-109.3949938
37585,2,34,10,1,12,11,70,38.252465670255326,-109.3947243
37586,1,32,10,0,10,15,68,38.252465670255326,-109.3944548
37587,0,31,11,0,8,17,67,38.252465670255326,-109.3941853
37588,0,32,11,0,9,17,69,38.252465670255326,-109.3939158
37589,0,31,10,0,10,16,67,38.252465670255326,-109.3936463
37590,1,31,10,0,13,12,67,38.252465670255326,-109.3933768
37591,2,29,11,2,13,12,69,38.252465670255326,-109.3931073
37592,1,26,11,2,11,15,66,38.252465670255326,-109.3928378
37593,5,33,12,4,14,8,76,38.252465670255326,-109.3925683
37594,9,32,12,9,14,5,81,38.252465670255326,-109.3922988
37595,12,33,13,10,14,3,85,38.252465670255326,-109.3920293
37596,16,33,13,11,14,2,89,38.252465670255326,-109.3917598
37597,17,31,13,12,14,2,89,38.252465670255326,-109.3914903
37598,21,31,13,11,12,1,89,38.252465670255326,-109.3912208
37599,18,34,13,12,14,0,91,38.252465670255326,-109.3909513
37600,15,35,14,14,14,1,93,38.252465670255326,-109.3906818
37601,15,36,14,14,14,1,94,38.252465670255326,-109.3904123
37602,16,36,14,14,14,0,94,38.252465670255326,-109.3901429
37603,14,36,14,13,15,0,92,38.252465670255326,-109.3898734
37604,14,36,14,13,15,1,93,38.252465670255326,-109.3896039
37605,14,37,14,14,14,1,94,38.252465670255326,-109.3893344
37606,14,38,14,15,14,1,96,38.252465670255326,-109.3890649
37607,15,36,14,13,16,0,94,38.252465670255326,-109.3887954
37608,15,33,14,13,15,0,90,38.252465670255326,-109.3885259
37609,15,32,13,13,15,0,88,38.252465670255326,-109.3882564
37610,15,31,13,14,14,1,88,38.252465670255326,-109.3879869
37611,17,31,13,14,14,0,89,38.252465670255326,-109.3877174
37612,22,31,14,12,13,0,92,38.252465670255326,-109.3874479
37613,22,31,14,12,13,0,92,38.252465670255326,-109.3871784
37614,19,31,14,12,13,1,90,38.252465670255326,-109.3869089
37615,14,33,12,8,14,2,83,38.252465670255326,-109.3866394
37616,7,29,11,8,13,5,73,38.252465670255326,-109.3863699
37617,13,28,12,11,13,3,80,38.252465670255326,-109.3861004
37618,14,31,12,14,13,1,85,38.252465670255326,-109.3858309
37619,13,36,13,15,12,1,90,38.252465670255326,-109.3855614
37620,12,40,14,14,12,1,93,38.252465670255326,-109.3852919
37621,7,41,14,13,14,1,90,38.252465670255326,-109.3850225
37622,8,42,14,13,14,1,92,38.252465670255326,-109.384753
37623,10,42,13,13,13,0,91,38.252465670255326,-109.3844835
37624,13,37,13,12,13,0,88,38.252465670255326,-109.384214
37625,8,38,11,10,15,1,83,38.252465670255326,-109.3839445
37626,7,37,11,9,15,1,80,38.252465670255326,-109.383675
37627,8,36,12,11,14,2,83,38.252465670255326,-109.3834055
37628,8,32,11,11,13,3,78,38.252465670255326,-109.383136
37629,9,26,11,13,11,3,73,38.252465670255326,-109.3828665
37630,11,25,12,16,11,3,78,38.252465670255326,-109.382597
37631,11,20,10,24,13,0,78,38.252465670255326,-109.3823275
37632,11,23,12,17,12,3,78,38.252465670255326,-109.382058
37633,7,26,12,9,8,9,71,38.252465670255326,-109.3817885
37634,4,32,11,5,12,8,72,38.252465670255326,-109.381519
37635,5,43,11,5,16,3,83,38.252465670255326,-109.3812495
37636,6,45,11,6,17,1,86,38.252465670255326,-109.38098
37637,6,47,12,7,18,0,90,38.252465670255326,-109.3807105
37638,6,49,13,8,18,0,94,38.252465670255326,-109.380441
37639,7,45,14,10,17,0,93,38.252465670255326,-109.3801716
37640,10,40,14,13,15,0,92,38.252465670255326,-109.3799021
37641,10,39,14,13,15,1,92,38.252465670255326,-109.3796326
37642,9,39,14,12,15,2,91,38.252465670255326,-109.3793631
37643,10,40,14,12,14,1,91,38.252465670255326,-109.3790936
37644,14,42,15,11,14,0,96,38.252465670255326,-109.3788241
37645,14,40,15,12,13,0,94,38.252465670255326,-109.3785546
37646,13,40,14,12,13,1,93,38.252465670255326,-109.3782851
37647,14,38,14,12,12,1,91,38.252465670255326,-109.3780156
37648,20,35,14,14,10,0,93,38.252465670255326,-109.3777461
37649,28,30,13,13,8,1,93,38.252465670255326,-109.3774766
37650,31,27,14,13,7,1,93,38.252465670255326,-109.3772071
37651,30,25,15,13,6,1,90,38.252465670255326,-109.3769376
37652,29,23,16,14,6,1,89,38.252465670255326,-109.3766681
37653,30,21,16,18,6,1,92,38.252465670255326,-109.3763986
37654,30,19,15,19,7,2,92,38.252465670255326,-109.3761291
37655,27,20,15,19,7,3,91,38.252465670255326,-109.3758596
37656,21,21,15,15,10,7,89,38.252465670255326,-109.3755901
37657,13,24,15,12,11,13,88,38.252465670255326,-109.3753206
37658,3,28,15,9,15,14,84,38.252465670255326,-109.3750512
37659,2,32,13,2,11,15,75,38.252465670255326,-109.3747817
37660,0,29,8,11,11,7,66,38.252465670255326,-109.3745122
37661,2,33,9,11,7,3,65,38.252465670255326,-109.3742427
37662,5,37,7,6,5,3,63,38.252465670255326,-109.3739732
37663,3,45,6,5,7,2,68,38.252465670255326,-109.3737037
37664,4,47,6,8,7,2,74,38.252465670255326,-109.3734342
37665,3,43,5,7,6,3,67,38.252465670255326,-109.3731647
37666,4,37,6,7,6,5,65,38.252465670255326,-109.3728952
37667,4,33,7,6,6,6,62,38.252465670255326,-109.3726257
37668,6,35,7,7,8,4,67,38.252465670255326,-109.3723562
37669,3,35,6,5,8,5,62,38.252465670255326,-109.3720867
37670,2,36,6,5,8,5,62,38.252465670255326,-109.3718172
37671,2,36,6,5,7,5,61,38.252465670255326,-109.3715477
37672,3,42,6,5,9,3,68,38.252465670255326,-109.3712782
37673,3,38,6,6,8,4,65,38.252465670255326,-109.3710087
37674,2,35,6,7,6,5,61,38.252465670255326,-109.3707392
37675,3,39,5,8,6,4,65,38.252465670255326,-109.3704697
37676,3,49,5,6,7,1,71,38.252465670255326,-109.3702003
37677,2,44,4,3,7,2,62,38.252465670255326,-109.3699308
37678,2,44,5,2,8,3,64,38.252465670255326,-109.3696613
37679,2,43,6,1,9,3,64,38.252465670255326,-109.3693918
37680,3,46,8,6,9,4,76,38.252465670255326,-109.3691223
37681,5,36,9,9,8,4,71,38.252465670255326,-109.3688528
37682,3,32,15,10,4,16,80,38.252465670255326,-109.3685833
37683,3,28,14,5,13,14,77,38.252465670255326,-109.3683138
37684,3,30,12,11,16,7,79,38.252465670255326,-109.3680443
37685,4,24,14,17,16,3,78,38.252465670255326,-109.3677748
37686,4,21,14,18,14,2,73,38.252465670255326,-109.3675053
37687,3,23,13,17,14,3,73,38.252465670255326,-109.3672358
37688,1,18,11,14,19,2,65,38.252465670255326,-109.3669663
37689,9,19,10,16,14,6,74,38.252465670255326,-109.3666968
37690,3,22,12,6,12,11,66,38.252465670255326,-109.3664273
37691,1,25,13,0,8,19,66,38.252465670255326,-109.3661578
37692,0,24,15,2,9,23,73,38.252465670255326,-109.3658883
37693,0,26,18,0,8,27,79,38.252465670255326,-109.3656188
37694,0,26,19,0,5,31,81,38.252465670255326,-109.3653493
37695,0,24,19,0,3,34,80,38.252465670255326,-109.3650799
37696,0,24,20,0,3,35,82,38.252465670255326,-109.3648104
37697,0,24,20,0,3,35,82,38.252465670255326,-109.3645409
37698,0,23,19,0,2,36,80,38.252465670255326,-109.3642714
37699,0,23,19,0,2,36,80,38.252465670255326,-109.3640019
37700,1,25,18,0,3,33,80,38.252465670255326,-109.3637324
37701,0,20,18,0,1,34,73,38.252465670255326,-109.3634629
37702,1,22,18,0,2,32,75,38.252465670255326,-109.3631934
37703,2,25,17,0,2,30,76,38.252465670255326,-109.3629239
37704,2,28,16,0,4,27,77,38.252465670255326,-109.3626544
37705,1,30,15,0,6,25,77,38.252465670255326,-109.3623849
37706,2,32,14,0,9,22,79,38.252465670255326,-109.3621154
37707,2,32,15,0,9,22,80,38.252465670255326,-109.3618459
37708,2,30,17,0,7,26,82,38.252465670255326,-109.3615764
37709,1,25,18,0,4,31,79,38.252465670255326,-109.3613069
37710,0,24,18,0,3,33,78,38.252465670255326,-109.3610374
37711,1,26,17,0,4,30,78,38.252465670255326,-109.3607679
37712,0,25,17,0,4,30,76,38.252465670255326,-109.3604984
37713,0,23,17,0,3,32,75,38.252465670255326,-109.360229
37714,0,23,17,0,3,33,76,38.252465670255326,-109.3599595
37715,1,25,17,0,3,30,76,38.252465670255326,-109.35969
37716,2,23,16,0,2,28,71,38.252465670255326,-109.3594205
37717,2,21,17,0,0,29,69,38.252465670255326,-109.359151
37718,1,22,17,0,0,31,71,38.252465670255326,-109.3588815
37719,1,22,16,0,1,29,69,38.252465670255326,-109.358612
37720,1,21,17,0,0,30,69,38.252465670255326,-109.3583425
37721,2,21,18,0,0,31,72,38.252465670255326,-109.358073
37722,1,20,17,1,1,30,70,38.252465670255326,-109.3578035
37723,1,20,16,1,1,29,68,38.252465670255326,-109.357534
37724,2,19,17,1,0,31,70,38.252465670255326,-109.3572645
37725,1,20,17,1,0,31,70,38.252465670255326,-109.356995
37726,1,20,17,0,0,30,68,38.252465670255326,-109.3567255
37727,2,22,16,2,1,27,70,38.252465670255326,-109.356456
37728,2,26,14,2,2,23,69,38.252465670255326,-109.3561865
37729,2,23,15,1,1,25,67,38.252465670255326,-109.355917
37730,1,20,15,0,1,26,63,38.252465670255326,-109.3556475
37731,1,20,14,1,2,24,62,38.252465670255326,-109.355378
37732,1,21,13,1,2,23,61,38.252465670255326,-109.3551086
37733,1,23,13,2,2,23,64,38.252465670255326,-109.3548391
37734,2,21,14,1,2,23,63,38.252465670255326,-109.3545696
37735,3,21,9,1,2,16,52,38.252465670255326,-109.3543001
37736,4,20,9,3,3,11,50,38.252465670255326,-109.3540306
37737,3,27,7,4,8,7,56,38.252465670255326,-109.3537611
37738,5,25,9,4,6,9,58,38.252465670255326,-109.3534916
37739,3,24,10,4,6,12,59,38.252465670255326,-109.3532221
37740,1,24,10,2,5,15,57,38.252465670255326,-109.3529526
37741,3,26,8,3,6,9,55,38.252465670255326,-109.3526831
37742,5,34,7,5,8,3,62,38.252465670255326,-109.3524136
37743,1,35,6,2,8,5,57,38.252465670255326,-109.3521441
37744,1,29,8,2,9,8,57,38.252465670255326,-109.3518746
37745,1,26,10,4,8,10,59,38.252465670255326,-109.3516051
37746,0,20,11,4,5,13,53,38.252465670255326,-109.3513356
37747,4,23,10,6,8,7,58,38.252465670255326,-109.3510661
37748,1,26,8,4,8,5,52,38.252465670255326,-109.3507966
37749,1,23,9,6,9,5,53,38.252465670255326,-109.3505271
37750,5,22,14,13,12,4,70,38.252465670255326,-109.3502577
37751,3,23,15,10,14,14,79,38.252465670255326,-109.3499882
37752,3,23,11,13,13,7,70,38.252465670255326,-109.3497187
37753,3,25,11,10,12,8,69,38.252465670255326,-109.3494492
37754,3,25,12,5,9,12,66,38.252465670255326,-109.3491797
37755,2,27,13,3,7,16,68,38.252465670255326,-109.3489102
37756,0,22,11,2,5,17,57,38.252465670255326,-109.3486407
37757,3,36,11,8,11,4,73,38.252465670255326,-109.3483712
37758,2,28,10,9,15,5,69,38.252465670255326,-109.3481017
37759,0,24,11,5,17,10,67,38.252465670255326,-109.3478322
37760,3,21,11,10,14,2,61,38.252465670255326,-109.3475627
37761,14,36,10,7,9,2,78,38.252465670255326,-109.3472932
37762,3,34,6,2,6,4,55,38.252465670255326,-109.3470237
37763,2,32,6,1,6,4,51,38.252465670255326,-109.3467542
37764,3,24,7,5,6,4,49,38.252465670255326,-109.3464847
37765,3,28,10,7,8,5,61,38.252465670255326,-109.3462152
37766,2,22,11,19,13,4,71,38.252465670255326,-109.3459457
37767,2,20,11,9,8,10,60,38.252465670255326,-109.3456762
37768,2,23,10,5,7,9,56,38.252465670255326,-109.3454068
37769,2,23,10,3,8,8,54,38.252465670255326,-109.3451373
37770,4,21,11,2,4,17,59,38.252465670255326,-109.3448678
37771,7,19,13,3,3,19,64,38.252465670255326,-109.3445983
37772,3,18,10,3,8,10,52,38.252465670255326,-109.3443288
37773,2,22,8,5,11,4,52,38.252465670255326,-109.3440593
37774,3,27,8,6,12,3,59,38.252465670255326,-109.3437898
37775,5,19,9,9,12,2,56,38.252465670255326,-109.3435203
37776,9,36,9,6,10,2,72,38.252465670255326,-109.3432508
37777,2,35,7,3,10,4,61,38.252465670255326,-109.3429813
37778,0,35,6,1,9,5,56,38.252465670255326,-109.3427118
37779,1,38,6,2,9,5,61,38.252465670255326,-109.3424423
37780,0,38,7,1,9,6,61,38.252465670255326,-109.3421728
37781,2,31,8,3,9,7,60,38.252465670255326,-109.3419033
37782,3,25,9,4,8,8,57,38.252465670255326,-109.3416338
37783,4,22,9,3,7,10,55,38.252465670255326,-109.3413643
37784,5,18,11,4,8,10,56,38.252465670255326,-109.3410948
37785,3,18,10,1,6,11,49,38.252465670255326,-109.3408253
37786,6,25,10,4,10,6,61,38.252465670255326,-109.3405558
37787,8,29,10,6,10,3,66,38.252465670255326,-109.3402864
37788,7,28,10,4,9,5,63,38.252465670255326,-109.3400169
37789,4,24,11,3,7,11,60,38.252465670255326,-109.3397474
37790,3,26,11,2,7,14,63,38.252465670255326,-109.3394779
37791,2,26,10,1,7,14,60,38.252465670255326,-109.3392084
37792,1,27,10,2,7,14,61,38.252465670255326,-109.3389389
37793,1,27,10,2,6,16,62,38.252465670255326,-109.3386694
37794,1,25,11,1,8,16,62,38.252465670255326,-109.3383999
37795,0,32,9,1,9,11,62,38.252465670255326,-109.3381304
37796,2,29,8,3,10,8,60,38.252465670255326,-109.3378609
37797,2,28,8,4,9,6,57,38.252465670255326,-109.3375914
37798,2,27,7,3,7,6,52,38.252465670255326,-109.3373219
37799,3,24,7,5,8,4,51,38.252465670255326,-109.3370524
37800,2,22,7,5,9,4,49,38.252465670255326,-109.3367829
37801,3,20,8,6,10,4,51,38.252465670255326,-109.3365134
37802,4,19,10,8,8,4,53,38.252465670255326,-109.3362439
37803,7,23,9,12,11,1,63,38.252465670255326,-109.3359744
37804,3,18,9,17,13,3,63,38.252465670255326,-109.3357049
37805,2,17,11,16,11,7,64,38.252465670255326,-109.3354355
37806,1,21,12,10,11,16,71,38.252465670255326,-109.335166
37807,1,22,12,8,12,14,69,38.252465670255326,-109.3348965
37808,2,20,12,8,10,12,64,38.252465670255326,-109.334627
37809,1,24,12,6,11,12,66,38.252465670255326,-109.3343575
37810,2,31,12,3,8,15,71,38.252465670255326,-109.334088
37811,1,29,12,2,15,12,71,38.252465670255326,-109.3338185
37812,1,29,11,0,10,15,66,38.252465670255326,-109.333549
37813,1,29,11,0,9,16,66,38.252465670255326,-109.3332795
37814,1,27,12,0,7,19,66,38.252465670255326,-109.33301
37815,1,27,15,0,6,23,72,38.252465670255326,-109.3327405
37816,1,27,15,1,7,23,74,38.252465670255326,-109.332471
37817,2,30,13,2,7,18,72,38.252465670255326,-109.3322015
37818,0,30,13,0,7,21,71,38.252465670255326,-109.331932
37819,1,28,14,0,8,19,70,38.252465670255326,-109.3316625
37820,1,47,10,0,12,10,80,38.25219617567009,-109.4402688
37821,1,45,9,0,11,11,77,38.25219617567009,-109.4399993
37822,2,41,10,0,9,10,72,38.25219617567009,-109.4397299
37823,2,40,10,2,9,8,71,38.25219617567009,-109.4394604
37824,2,47,10,0,14,7,80,38.25219617567009,-109.4391909
37825,0,31,10,1,7,13,62,38.25219617567009,-109.4389214
37826,0,30,10,0,5,16,61,38.25219617567009,-109.4386519
37827,1,43,10,0,11,11,76,38.25219617567009,-109.4383824
37828,2,50,10,2,15,6,85,38.25219617567009,-109.4381129
37829,2,41,9,3,14,5,74,38.25219617567009,-109.4378434
37830,4,41,10,6,15,3,79,38.25219617567009,-109.4375739
37831,5,39,10,9,14,2,79,38.25219617567009,-109.4373044
37832,4,38,10,9,13,2,76,38.25219617567009,-109.4370349
37833,4,43,10,6,15,2,80,38.25219617567009,-109.4367654
37834,3,40,9,3,12,7,74,38.25219617567009,-109.4364959
37835,2,36,9,4,9,8,68,38.25219617567009,-109.4362264
37836,4,32,10,7,11,6,70,38.25219617567009,-109.4359569
37837,5,31,10,7,12,6,71,38.25219617567009,-109.4356874
37838,6,37,10,4,11,6,74,38.25219617567009,-109.4354179
37839,1,34,9,3,9,8,64,38.25219617567009,-109.4351484
37840,1,35,8,3,9,7,63,38.25219617567009,-109.434879
37841,2,39,8,3,11,5,68,38.25219617567009,-109.4346095
37842,2,40,8,3,11,4,68,38.25219617567009,-109.43434
37843,2,43,7,3,10,4,69,38.25219617567009,-109.4340705
37844,1,40,8,3,10,6,68,38.25219617567009,-109.433801
37845,1,37,8,1,8,9,64,38.25219617567009,-109.4335315
37846,2,38,8,1,7,10,66,38.25219617567009,-109.433262
37847,1,35,9,3,9,8,65,38.25219617567009,-109.4329925
37848,4,37,9,5,13,4,72,38.25219617567009,-109.432723
37849,3,44,10,5,16,3,81,38.25219617567009,-109.4324535
37850,3,45,10,3,17,3,81,38.25219617567009,-109.432184
37851,5,39,11,6,16,3,80,38.25219617567009,-109.4319145
37852,8,42,12,11,16,1,90,38.25219617567009,-109.431645
37853,8,40,14,14,14,1,91,38.25219617567009,-109.4313755
37854,10,39,14,15,14,0,92,38.25219617567009,-109.431106
37855,14,37,14,15,14,0,94,38.25219617567009,-109.4308365
37856,17,36,14,14,14,0,95,38.25219617567009,-109.430567
37857,12,39,14,14,14,0,93,38.25219617567009,-109.4302975
37858,10,43,13,13,14,0,93,38.25219617567009,-109.430028
37859,8,45,12,12,13,1,91,38.25219617567009,-109.4297586
37860,8,47,12,11,13,1,92,38.25219617567009,-109.4294891
37861,6,49,11,10,13,1,90,38.25219617567009,-109.4292196
37862,7,48,11,12,13,1,92,38.25219617567009,-109.4289501
37863,8,47,12,12,13,1,93,38.25219617567009,-109.4286806
37864,10,46,12,12,13,1,94,38.25219617567009,-109.4284111
37865,11,45,12,12,13,1,94,38.25219617567009,-109.4281416
37866,13,41,13,14,13,0,94,38.25219617567009,-109.4278721
37867,12,40,14,15,12,1,94,38.25219617567009,-109.4276026
37868,12,38,14,15,12,1,92,38.25219617567009,-109.4273331
37869,12,38,14,14,13,1,92,38.25219617567009,-109.4270636
37870,11,41,13,13,14,1,93,38.25219617567009,-109.4267941
37871,8,43,13,13,13,1,91,38.25219617567009,-109.4265246
37872,8,43,13,13,13,1,91,38.25219617567009,-109.4262551
37873,9,42,13,14,13,0,91,38.25219617567009,-109.4259856
37874,12,40,14,14,14,0,94,38.25219617567009,-109.4257161
37875,17,36,14,14,13,0,94,38.25219617567009,-109.4254466
37876,18,32,14,15,13,0,92,38.25219617567009,-109.4251771
37877,19,32,14,15,12,0,92,38.25219617567009,-109.4249077
37878,18,33,14,15,12,0,92,38.25219617567009,-109.4246382
37879,15,34,14,15,13,0,91,38.25219617567009,-109.4243687
37880,15,35,14,15,12,0,91,38.25219617567009,-109.4240992
37881,15,37,13,13,13,0,91,38.25219617567009,-109.4238297
37882,9,43,12,11,14,0,89,38.25219617567009,-109.4235602
37883,8,47,11,10,14,1,91,38.25219617567009,-109.4232907
37884,10,46,12,9,12,1,90,38.25219617567009,-109.4230212
37885,4,47,10,7,13,3,84,38.25219617567009,-109.4227517
37886,3,51,9,5,14,3,85,38.25219617567009,-109.4224822
37887,3,51,10,6,13,2,85,38.25219617567009,-109.4222127
37888,6,46,12,10,12,2,88,38.25219617567009,-109.4219432
37889,5,42,12,9,10,3,81,38.25219617567009,-109.4216737
37890,5,43,12,10,10,3,83,38.25219617567009,-109.4214042
37891,6,44,13,12,10,2,87,38.25219617567009,-109.4211347
37892,8,43,13,13,10,2,89,38.25219617567009,-109.4208652
37893,11,39,13,13,10,1,87,38.25219617567009,-109.4205957
37894,17,31,12,7,8,0,75,38.25219617567009,-109.4203262
37895,14,36,14,13,11,2,90,38.25219617567009,-109.4200568
37896,10,34,14,13,11,3,85,38.25219617567009,-109.4197873
37897,9,31,14,13,11,3,81,38.25219617567009,-109.4195178
37898,10,30,14,14,11,3,82,38.25219617567009,-109.4192483
37899,10,34,15,10,11,6,86,38.25219617567009,-109.4189788
37900,5,35,13,5,10,10,78,38.25219617567009,-109.4187093
37901,3,37,11,4,10,10,75,38.25219617567009,-109.4184398
37902,3,37,11,4,10,9,74,38.25219617567009,-109.4181703
37903,3,35,11,2,7,14,72,38.25219617567009,-109.4179008
37904,3,35,10,2,8,12,70,38.25219617567009,-109.4176313
37905,3,35,10,2,8,11,69,38.25219617567009,-109.4173618
37906,2,34,10,1,8,12,67,38.25219617567009,-109.4170923
37907,2,33,9,1,9,11,65,38.25219617567009,-109.4168228
37908,1,35,9,0,9,10,64,38.25219617567009,-109.4165533
37909,2,39,10,2,11,9,73,38.25219617567009,-109.4162838
37910,3,45,10,2,12,8,80,38.25219617567009,-109.4160143
37911,4,48,11,4,13,5,85,38.25219617567009,-109.4157448
37912,6,46,12,7,12,2,85,38.25219617567009,-109.4154753
37913,6,45,12,9,11,2,85,38.25219617567009,-109.4152058
37914,5,45,11,6,11,3,81,38.25219617567009,-109.4149364
37915,4,44,11,5,13,4,81,38.25219617567009,-109.4146669
37916,3,43,11,4,15,5,81,38.25219617567009,-109.4143974
37917,3,46,11,2,14,7,83,38.25219617567009,-109.4141279
37918,2,42,11,2,14,7,78,38.25219617567009,-109.4138584
37919,2,38,10,2,12,8,72,38.25219617567009,-109.4135889
37920,4,32,9,3,9,8,65,38.25219617567009,-109.4133194
37921,7,27,9,4,10,6,63,38.25219617567009,-109.4130499
37922,5,21,12,4,6,13,61,38.25219617567009,-109.4127804
37923,5,28,11,4,11,8,67,38.25219617567009,-109.4125109
37924,5,36,11,5,13,4,74,38.25219617567009,-109.4122414
37925,5,40,11,5,11,4,76,38.25219617567009,-109.4119719
37926,5,43,13,9,10,2,82,38.25219617567009,-109.4117024
37927,5,44,13,10,10,1,83,38.25219617567009,-109.4114329
37928,5,44,13,11,10,1,84,38.25219617567009,-109.4111634
37929,5,45,13,11,11,1,86,38.25219617567009,-109.4108939
37930,5,45,14,12,11,1,88,38.25219617567009,-109.4106244
37931,5,43,14,12,12,1,87,38.25219617567009,-109.4103549
37932,6,43,14,11,11,2,87,38.25219617567009,-109.4100855
37933,5,42,14,8,12,3,84,38.25219617567009,-109.409816
37934,5,40,13,5,12,8,83,38.25219617567009,-109.4095465
37935,5,40,13,5,13,8,84,38.25219617567009,-109.409277
37936,6,44,13,8,13,2,86,38.25219617567009,-109.4090075
37937,8,46,13,10,13,1,91,38.25219617567009,-109.408738
37938,7,46,13,10,13,1,90,38.25219617567009,-109.4084685
37939,8,45,13,11,14,0,91,38.25219617567009,-109.408199
37940,8,42,14,13,15,0,92,38.25219617567009,-109.4079295
37941,9,40,13,13,14,0,89,38.25219617567009,-109.40766
37942,7,36,11,8,12,2,76,38.25219617567009,-109.4073905
37943,5,35,9,5,10,3,67,38.25219617567009,-109.407121
37944,5,36,8,4,10,3,66,38.25219617567009,-109.4068515
37945,3,34,8,4,9,4,62,38.25219617567009,-109.406582
37946,2,30,8,3,10,5,58,38.25219617567009,-109.4063125
37947,5,27,10,6,8,6,62,38.25219617567009,-109.406043
37948,11,24,13,10,10,5,73,38.25219617567009,-109.4057735
37949,6,22,11,11,12,5,67,38.25219617567009,-109.405504
37950,1,32,9,3,11,8,64,38.25219617567009,-109.4052345
37951,2,39,10,1,12,7,71,38.25219617567009,-109.4049651
37952,1,38,11,0,12,9,71,38.25219617567009,-109.4046956
37953,1,37,11,0,12,10,71,38.25219617567009,-109.4044261
37954,2,40,11,2,13,8,76,38.25219617567009,-109.4041566
37955,2,34,10,3,10,7,66,38.25219617567009,-109.4038871
37956,2,33,8,3,9,5,60,38.25219617567009,-109.4036176
37957,4,32,9,5,12,3,65,38.25219617567009,-109.4033481
37958,6,29,10,12,13,2,72,38.25219617567009,-109.4030786
37959,6,26,14,16,12,5,79,38.25219617567009,-109.4028091
37960,2,28,13,13,13,10,79,38.25219617567009,-109.4025396
37961,3,28,15,17,15,8,86,38.25219617567009,-109.4022701
37962,3,26,14,22,16,5,86,38.25219617567009,-109.4020006
37963,1,26,13,25,17,3,85,38.25219617567009,-109.4017311
37964,4,20,13,24,19,5,85,38.25219617567009,-109.4014616
37965,2,20,13,22,19,4,80,38.25219617567009,-109.4011921
37966,2,26,12,18,21,3,82,38.25219617567009,-109.4009226
37967,1,28,13,18,21,3,84,38.25219617567009,-109.4006531
37968,2,29,14,18,20,4,87,38.25219617567009,-109.4003836
37969,2,28,13,17,20,3,83,38.25219617567009,-109.4001142
37970,0,31,13,7,21,9,81,38.25219617567009,-109.3998447
37971,1,33,12,5,19,7,77,38.25219617567009,-109.3995752
37972,2,34,11,2,14,10,73,38.25219617567009,-109.3993057
37973,1,33,11,0,11,15,71,38.25219617567009,-109.3990362
37974,4,41,12,5,18,4,84,38.25219617567009,-109.3987667
37975,4,40,12,5,17,4,82,38.25219617567009,-109.3984972
37976,3,37,11,3,16,8,78,38.25219617567009,-109.3982277
37977,2,33,12,1,13,13,74,38.25219617567009,-109.3979582
37978,1,30,14,8,15,11,79,38.25219617567009,-109.3976887
37979,4,29,14,16,19,4,86,38.25219617567009,-109.3974192
37980,2,26,12,24,19,2,85,38.25219617567009,-109.3971497
37981,1,26,11,20,21,2,81,38.25219617567009,-109.3968802
37982,0,32,13,9,20,7,81,38.25219617567009,-109.3966107
37983,0,29,11,8,15,11,74,38.25219617567009,-109.3963412
37984,0,29,10,4,13,10,66,38.25219617567009,-109.3960717
37985,2,32,11,2,12,10,69,38.25219617567009,-109.3958022
37986,3,37,11,3,14,7,75,38.25219617567009,-109.3955327
37987,6,45,12,6,17,2,88,38.25219617567009,-109.3952632
37988,4,41,11,3,15,6,80,38.25219617567009,-109.3949938
37989,4,41,11,4,16,5,81,38.25219617567009,-109.3947243
37990,3,37,11,4,15,7,77,38.25219617567009,-109.3944548
37991,3,33,11,2,13,11,73,38.25219617567009,-109.3941853
37992,4,32,12,0,10,15,73,38.25219617567009,-109.3939158
37993,2,27,11,0,8,17,65,38.25219617567009,-109.3936463
37994,3,29,11,2,12,12,69,38.25219617567009,-109.3933768
37995,7,33,11,5,14,8,78,38.25219617567009,-109.3931073
37996,8,35,12,6,15,5,81,38.25219617567009,-109.3928378
37997,9,37,13,9,16,2,86,38.25219617567009,-109.3925683
37998,12,35,13,11,15,1,87,38.25219617567009,-109.3922988
37999,16,34,13,12,14,1,90,38.25219617567009,-109.3920293
38000,18,34,13,12,13,0,90,38.25219617567009,-109.3917598
38001,18,34,13,12,13,1,91,38.25219617567009,-109.3914903
38002,19,34,13,12,13,1,92,38.25219617567009,-109.3912208
38003,17,35,13,12,13,1,91,38.25219617567009,-109.3909513
38004,17,35,13,12,13,1,91,38.25219617567009,-109.3906818
38005,17,35,14,12,14,1,93,38.25219617567009,-109.3904123
38006,15,35,13,13,14,1,91,38.25219617567009,-109.3901429
38007,14,37,14,12,15,0,92,38.25219617567009,-109.3898734
38008,13,37,14,12,15,0,91,38.25219617567009,-109.3896039
38009,13,39,14,13,15,1,95,38.25219617567009,-109.3893344
38010,12,40,14,14,15,0,95,38.25219617567009,-109.3890649
38011,13,38,14,13,16,0,94,38.25219617567009,-109.3887954
38012,15,35,14,13,15,0,92,38.25219617567009,-109.3885259
38013,15,33,13,14,15,1,91,38.25219617567009,-109.3882564
38014,16,32,13,14,14,1,90,38.25219617567009,-109.3879869
38015,17,31,13,13,13,1,88,38.25219617567009,-109.3877174
38016,22,32,14,12,13,0,93,38.25219617567009,-109.3874479
38017,22,30,14,13,12,0,91,38.25219617567009,-109.3871784
38018,21,31,13,12,13,1,91,38.25219617567009,-109.3869089
38019,18,32,13,10,14,1,88,38.25219617567009,-109.3866394
38020,12,32,12,9,14,2,81,38.25219617567009,-109.3863699
38021,19,31,12,11,13,1,87,38.25219617567009,-109.3861004
38022,19,32,13,13,13,0,90,38.25219617567009,-109.3858309
38023,14,36,14,14,12,1,91,38.25219617567009,-109.3855614
38024,11,39,15,14,12,1,92,38.25219617567009,-109.3852919
38025,8,43,14,12,13,1,91,38.25219617567009,-109.3850225
38026,7,39,12,12,14,2,86,38.25219617567009,-109.384753
38027,9,39,13,13,13,1,88,38.25219617567009,-109.3844835
38028,13,36,13,14,13,1,90,38.25219617567009,-109.384214
38029,9,34,12,12,14,1,82,38.25219617567009,-109.3839445
38030,7,36,11,7,14,3,78,38.25219617567009,-109.383675
38031,9,36,12,10,14,2,83,38.25219617567009,-109.3834055
38032,12,33,12,13,13,2,85,38.25219617567009,-109.383136
38033,12,31,12,14,12,3,84,38.25219617567009,-109.3828665
38034,11,26,12,13,13,3,78,38.25219617567009,-109.382597
38035,11,21,10,22,13,1,78,38.25219617567009,-109.3823275
38036,12,23,12,21,12,1,81,38.25219617567009,-109.382058
38037,10,29,13,14,11,5,82,38.25219617567009,-109.3817885
38038,6,30,13,8,10,9,76,38.25219617567009,-109.381519
38039,3,28,13,4,7,15,70,38.25219617567009,-109.3812495
38040,4,33,12,6,12,8,75,38.25219617567009,-109.38098
38041,5,40,11,7,16,3,82,38.25219617567009,-109.3807105
38042,5,46,12,6,17,1,87,38.25219617567009,-109.380441
38043,6,51,13,6,17,1,94,38.25219617567009,-109.3801716
38044,7,45,14,8,18,1,93,38.25219617567009,-109.3799021
38045,6,43,13,7,17,3,89,38.25219617567009,-109.3796326
38046,7,44,14,9,16,2,92,38.25219617567009,-109.3793631
38047,9,42,14,12,15,1,93,38.25219617567009,-109.3790936
38048,13,39,15,14,13,0,94,38.25219617567009,-109.3788241
38049,16,37,14,13,12,0,92,38.25219617567009,-109.3785546
38050,16,38,14,12,13,0,93,38.25219617567009,-109.3782851
38051,17,37,14,12,12,0,92,38.25219617567009,-109.3780156
38052,24,34,13,12,10,0,93,38.25219617567009,-109.3777461
38053,26,31,14,14,8,1,94,38.25219617567009,-109.3774766
38054,28,27,14,15,8,1,93,38.25219617567009,-109.3772071
38055,29,26,15,15,7,1,93,38.25219617567009,-109.3769376
38056,29,26,15,14,7,1,92,38.25219617567009,-109.3766681
38057,28,26,15,14,8,1,92,38.25219617567009,-109.3763986
38058,22,24,14,14,9,3,86,38.25219617567009,-109.3761291
38059,11,27,16,8,10,13,85,38.25219617567009,-109.3758596
38060,10,26,15,2,12,16,81,38.25219617567009,-109.3755901
38061,7,25,13,7,10,10,72,38.25219617567009,-109.3753206
38062,9,27,11,9,9,2,67,38.25219617567009,-109.3750512
38063,3,52,8,7,9,1,80,38.25219617567009,-109.3747817
38064,2,52,6,5,10,1,76,38.25219617567009,-109.3745122
38065,2,54,6,4,9,1,76,38.25219617567009,-109.3742427
38066,2,44,6,3,7,4,66,38.25219617567009,-109.3739732
38067,3,42,7,5,10,3,70,38.25219617567009,-109.3737037
38068,4,35,8,6,10,4,67,38.25219617567009,-109.3734342
38069,3,33,7,6,10,5,64,38.25219617567009,-109.3731647
38070,2,37,6,5,10,5,65,38.25219617567009,-109.3728952
38071,2,38,7,5,9,5,66,38.25219617567009,-109.3726257
38072,3,46,6,5,10,3,73,38.25219617567009,-109.3723562
38073,2,42,6,4,10,5,69,38.25219617567009,-109.3720867
38074,2,38,7,5,9,5,66,38.25219617567009,-109.3718172
38075,2,39,7,5,9,4,66,38.25219617567009,-109.3715477
38076,2,47,6,3,11,3,72,38.25219617567009,-109.3712782
38077,1,45,6,3,9,4,68,38.25219617567009,-109.3710087
38078,2,45,6,4,8,4,69,38.25219617567009,-109.3707392
38079,2,46,6,3,9,4,70,38.25219617567009,-109.3704697
38080,3,46,6,3,9,3,70,38.25219617567009,-109.3702003
38081,2,44,6,1,8,3,64,38.25219617567009,-109.3699308
38082,2,41,6,2,9,3,63,38.25219617567009,-109.3696613
38083,3,38,8,5,9,5,68,38.25219617567009,-109.3693918
38084,4,39,10,7,9,5,74,38.25219617567009,-109.3691223
38085,3,36,11,6,7,7,70,38.25219617567009,-109.3688528
38086,2,26,14,1,9,20,72,38.25219617567009,-109.3685833
38087,1,29,15,3,12,16,76,38.25219617567009,-109.3683138
38088,6,26,14,12,18,3,79,38.25219617567009,-109.3680443
38089,5,18,14,20,16,4,77,38.25219617567009,-109.3677748
38090,3,11,13,22,12,4,65,38.25219617567009,-109.3675053
38091,3,9,11,17,11,4,55,38.25219617567009,-109.3672358
38092,2,20,13,16,15,6,72,38.25219617567009,-109.3669663
38093,0,19,14,14,11,10,68,38.25219617567009,-109.3666968
38094,2,28,16,7,11,16,80,38.25219617567009,-109.3664273
38095,3,28,18,5,7,22,83,38.25219617567009,-109.3661578
38096,1,28,18,2,6,26,81,38.25219617567009,-109.3658883
38097,0,24,17,0,4,30,75,38.25219617567009,-109.3656188
38098,0,23,17,0,2,33,75,38.25219617567009,-109.3653493
38099,0,24,18,0,2,33,77,38.25219617567009,-109.3650799
38100,0,24,18,0,3,33,78,38.25219617567009,-109.3648104
38101,1,23,18,0,3,33,78,38.25219617567009,-109.3645409
38102,0,22,18,0,2,34,76,38.25219617567009,-109.3642714
38103,0,22,18,0,2,35,77,38.25219617567009,-109.3640019
38104,1,22,19,0,3,34,79,38.25219617567009,-109.3637324
38105,0,21,18,0,2,35,76,38.25219617567009,-109.3634629
38106,1,23,18,0,3,33,78,38.25219617567009,-109.3631934
38107,1,24,18,0,3,32,78,38.25219617567009,-109.3629239
38108,1,23,18,0,3,33,78,38.25219617567009,-109.3626544
38109,1,24,17,0,3,32,77,38.25219617567009,-109.3623849
38110,2,26,17,1,5,28,79,38.25219617567009,-109.3621154
38111,2,28,17,1,6,27,81,38.25219617567009,-109.3618459
38112,3,28,17,1,5,28,82,38.25219617567009,-109.3615764
38113,1,24,17,0,4,31,77,38.25219617567009,-109.3613069
38114,1,25,18,0,3,32,79,38.25219617567009,-109.3610374
38115,0,23,18,0,3,33,77,38.25219617567009,-109.3607679
38116,0,24,19,0,3,34,80,38.25219617567009,-109.3604984
38117,1,24,19,1,4,34,83,38.25219617567009,-109.360229
38118,1,22,19,1,4,35,82,38.25219617567009,-109.3599595
38119,1,22,20,0,4,36,83,38.25219617567009,-109.35969
38120,1,23,18,1,3,32,78,38.25219617567009,-109.3594205
38121,2,24,17,2,2,29,76,38.25219617567009,-109.359151
38122,1,23,16,1,2,28,71,38.25219617567009,-109.3588815
38123,1,20,17,1,1,30,70,38.25219617567009,-109.358612
38124,1,19,16,0,0,30,66,38.25219617567009,-109.3583425
38125,1,19,16,0,1,29,66,38.25219617567009,-109.358073
38126,2,20,16,0,1,28,67,38.25219617567009,-109.3578035
38127,3,20,16,0,0,29,68,38.25219617567009,-109.357534
38128,2,19,17,0,0,31,69,38.25219617567009,-109.3572645
38129,1,21,16,0,0,29,67,38.25219617567009,-109.356995
38130,1,22,15,1,1,27,67,38.25219617567009,-109.3567255
38131,1,23,14,1,1,26,66,38.25219617567009,-109.356456
38132,1,24,14,1,1,25,66,38.25219617567009,-109.3561865
38133,2,24,14,1,2,24,67,38.25219617567009,-109.355917
38134,1,25,13,1,2,23,65,38.25219617567009,-109.3556475
38135,1,23,13,0,1,23,61,38.25219617567009,-109.355378
38136,2,19,13,1,3,21,59,38.25219617567009,-109.3551086
38137,3,19,10,2,3,16,53,38.25219617567009,-109.3548391
38138,3,21,8,3,6,10,51,38.25219617567009,-109.3545696
38139,2,29,7,4,8,5,55,38.25219617567009,-109.3543001
38140,2,35,6,4,8,3,58,38.25219617567009,-109.3540306
38141,2,37,6,6,9,3,63,38.25219617567009,-109.3537611
38142,3,38,7,6,8,5,67,38.25219617567009,-109.3534916
38143,4,36,7,6,9,6,68,38.25219617567009,-109.3532221
38144,3,33,7,4,9,7,63,38.25219617567009,-109.3529526
38145,3,29,7,3,8,8,58,38.25219617567009,-109.3526831
38146,4,37,5,5,8,2,61,38.25219617567009,-109.3524136
38147,1,37,5,2,9,4,58,38.25219617567009,-109.3521441
38148,2,27,7,4,8,8,56,38.25219617567009,-109.3518746
38149,1,25,10,3,7,11,57,38.25219617567009,-109.3516051
38150,1,20,10,4,8,9,52,38.25219617567009,-109.3513356
38151,2,27,7,3,7,5,51,38.25219617567009,-109.3510661
38152,2,28,6,3,8,4,51,38.25219617567009,-109.3507966
38153,1,25,6,4,8,4,48,38.25219617567009,-109.3505271
38154,2,21,11,7,9,6,56,38.25219617567009,-109.3502577
38155,4,24,12,21,19,2,82,38.25219617567009,-109.3499882
38156,1,24,11,9,11,10,66,38.25219617567009,-109.3497187
38157,4,26,12,8,10,8,68,38.25219617567009,-109.3494492
38158,5,27,12,5,10,9,68,38.25219617567009,-109.3491797
38159,2,30,11,0,6,16,65,38.25219617567009,-109.3489102
38160,1,26,12,3,7,13,62,38.25219617567009,-109.3486407
38161,4,41,11,11,12,1,80,38.25219617567009,-109.3483712
38162,2,33,11,14,17,1,78,38.25219617567009,-109.3481017
38163,0,22,9,8,11,4,54,38.25219617567009,-109.3478322
38164,6,43,9,7,9,1,75,38.25219617567009,-109.3475627
38165,4,35,7,3,7,4,60,38.25219617567009,-109.3472932
38166,2,29,6,2,6,4,49,38.25219617567009,-109.3470237
38167,2,25,7,4,7,4,49,38.25219617567009,-109.3467542
38168,3,23,9,8,7,4,54,38.25219617567009,-109.3464847
38169,2,29,9,11,10,4,65,38.25219617567009,-109.3462152
38170,3,22,12,13,9,8,67,38.25219617567009,-109.3459457
38171,3,21,11,6,6,11,58,38.25219617567009,-109.3456762
38172,2,23,10,5,6,9,55,38.25219617567009,-109.3454068
38173,2,24,9,4,9,7,55,38.25219617567009,-109.3451373
38174,2,22,11,1,4,14,54,38.25219617567009,-109.3448678
38175,3,23,10,2,8,10,56,38.25219617567009,-109.3445983
38176,1,38,9,2,12,5,67,38.25219617567009,-109.3443288
38177,1,45,7,2,10,5,70,38.25219617567009,-109.3440593
38178,2,47,8,5,10,4,76,38.25219617567009,-109.3437898
38179,3,33,8,6,8,5,63,38.25219617567009,-109.3435203
38180,3,47,7,4,10,3,74,38.25219617567009,-109.3432508
38181,2,41,7,3,9,5,67,38.25219617567009,-109.3429813
38182,1,35,7,3,8,7,61,38.25219617567009,-109.3427118
38183,1,43,7,2,8,5,66,38.25219617567009,-109.3424423
38184,1,38,7,2,9,5,62,38.25219617567009,-109.3421728
38185,2,21,8,4,7,8,50,38.25219617567009,-109.3419033
38186,2,19,9,4,6,9,49,38.25219617567009,-109.3416338
38187,3,22,9,4,7,7,52,38.25219617567009,-109.3413643
38188,4,25,8,5,8,5,55,38.25219617567009,-109.3410948
38189,2,26,8,3,6,7,52,38.25219617567009,-109.3408253
38190,3,26,8,3,7,7,54,38.25219617567009,-109.3405558
38191,2,26,9,3,6,7,53,38.25219617567009,-109.3402864
38192,2,27,9,3,5,8,54,38.25219617567009,-109.3400169
38193,3,24,10,3,7,8,55,38.25219617567009,-109.3397474
38194,6,26,10,2,8,8,60,38.25219617567009,-109.3394779
38195,6,27,11,2,8,8,62,38.25219617567009,-109.3392084
38196,4,26,11,2,8,9,60,38.25219617567009,-109.3389389
38197,3,28,10,2,8,9,60,38.25219617567009,-109.3386694
38198,5,29,10,4,9,7,64,38.25219617567009,-109.3383999
38199,4,26,9,5,9,7,60,38.25219617567009,-109.3381304
38200,3,27,8,5,8,5,56,38.25219617567009,-109.3378609
38201,2,25,7,4,8,5,51,38.25219617567009,-109.3375914
38202,1,24,7,4,8,4,48,38.25219617567009,-109.3373219
38203,0,16,7,6,12,5,46,38.25219617567009,-109.3370524
38204,4,19,13,10,14,4,64,38.25219617567009,-109.3367829
38205,2,12,11,26,14,3,68,38.25219617567009,-109.3365134
38206,1,15,10,26,14,3,69,38.25219617567009,-109.3362439
38207,2,11,9,17,14,4,57,38.25219617567009,-109.3359744
38208,3,15,11,14,11,8,62,38.25219617567009,-109.3357049
38209,1,20,11,9,12,11,64,38.25219617567009,-109.3354355
38210,1,23,12,6,9,16,67,38.25219617567009,-109.335166
38211,1,24,12,4,10,15,66,38.25219617567009,-109.3348965
38212,1,27,12,1,12,14,67,38.25219617567009,-109.334627
38213,0,26,10,0,12,14,62,38.25219617567009,-109.3343575
38214,0,27,11,0,11,15,64,38.25219617567009,-109.334088
38215,1,27,11,0,8,17,64,38.25219617567009,-109.3338185
38216,2,28,13,0,7,19,69,38.25219617567009,-109.333549
38217,2,28,13,0,5,21,69,38.25219617567009,-109.3332795
38218,1,25,14,0,5,23,68,38.25219617567009,-109.33301
38219,1,24,14,0,5,23,67,38.25219617567009,-109.3327405
38220,1,26,12,0,7,21,67,38.25219617567009,-109.332471
38221,2,31,11,2,9,16,71,38.25219617567009,-109.3322015
38222,2,26,13,1,7,20,69,38.25219617567009,-109.331932
38223,1,23,14,0,5,23,66,38.25219617567009,-109.3316625
38224,1,23,14,0,5,24,67,38.25219617567009,-109.331393
38225,1,51,10,0,14,8,84,38.25192668108485,-109.4402688
38226,1,47,10,0,13,8,79,38.25192668108485,-109.4399993
38227,2,45,10,1,13,8,79,38.25192668108485,-109.4397299
38228,3,42,11,1,13,10,80,38.25192668108485,-109.4394604
38229,2,36,11,0,11,13,73,38.25192668108485,-109.4391909
38230,2,33,11,0,8,16,70,38.25192668108485,-109.4389214
38231,2,32,10,0,9,14,67,38.25192668108485,-109.4386519
38232,2,35,10,0,10,12,69,38.25192668108485,-109.4383824
38233,3,36,10,2,10,10,71,38.25192668108485,-109.4381129
38234,3,37,10,2,9,9,70,38.25192668108485,-109.4378434
38235,6,39,9,6,13,3,76,38.25192668108485,-109.4375739
38236,5,41,10,7,14,2,79,38.25192668108485,-109.4373044
38237,5,42,12,10,15,1,85,38.25192668108485,-109.4370349
38238,4,43,11,9,15,2,84,38.25192668108485,-109.4367654
38239,7,42,11,9,13,1,83,38.25192668108485,-109.4364959
38240,6,37,10,8,12,3,76,38.25192668108485,-109.4362264
38241,6,37,10,8,13,3,77,38.25192668108485,-109.4359569
38242,5,43,11,8,12,3,82,38.25192668108485,-109.4356874
38243,3,41,9,1,12,7,73,38.25192668108485,-109.4354179
38244,1,37,8,3,10,6,65,38.25192668108485,-109.4351484
38245,2,36,8,3,10,5,64,38.25192668108485,-109.434879
38246,2,34,8,3,10,5,62,38.25192668108485,-109.4346095
38247,1,35,7,3,10,4,60,38.25192668108485,-109.43434
38248,2,42,7,4,9,3,67,38.25192668108485,-109.4340705
38249,1,41,7,2,9,6,66,38.25192668108485,-109.433801
38250,1,39,8,2,9,8,67,38.25192668108485,-109.4335315
38251,1,38,8,1,9,9,66,38.25192668108485,-109.433262
38252,1,36,8,1,7,10,63,38.25192668108485,-109.4329925
38253,3,39,8,3,9,6,68,38.25192668108485,-109.432723
38254,1,42,8,1,13,6,71,38.25192668108485,-109.4324535
38255,1,41,9,1,13,8,73,38.25192668108485,-109.432184
38256,4,39,11,4,15,4,77,38.25192668108485,-109.4319145
38257,7,43,12,10,16,1,89,38.25192668108485,-109.431645
38258,8,41,14,14,14,1,92,38.25192668108485,-109.4313755
38259,12,37,15,15,14,0,93,38.25192668108485,-109.431106
38260,14,36,14,16,13,0,93,38.25192668108485,-109.4308365
38261,14,36,15,15,14,0,94,38.25192668108485,-109.430567
38262,12,39,14,15,14,0,94,38.25192668108485,-109.4302975
38263,9,41,13,13,15,0,91,38.25192668108485,-109.430028
38264,9,42,13,12,14,1,91,38.25192668108485,-109.4297586
38265,10,42,12,12,13,1,90,38.25192668108485,-109.4294891
38266,8,43,12,11,13,1,88,38.25192668108485,-109.4292196
38267,9,44,13,13,13,1,93,38.25192668108485,-109.4289501
38268,9,46,13,13,12,1,94,38.25192668108485,-109.4286806
38269,8,50,12,12,12,1,95,38.25192668108485,-109.4284111
38270,7,51,11,12,13,1,95,38.25192668108485,-109.4281416
38271,9,45,13,13,13,1,94,38.25192668108485,-109.4278721
38272,11,40,14,13,12,1,91,38.25192668108485,-109.4276026
38273,12,38,14,14,12,1,91,38.25192668108485,-109.4273331
38274,10,39,14,14,12,1,90,38.25192668108485,-109.4270636
38275,7,43,12,12,12,1,87,38.25192668108485,-109.4267941
38276,5,46,11,10,13,1,86,38.25192668108485,-109.4265246
38277,5,46,11,10,13,1,86,38.25192668108485,-109.4262551
38278,5,46,11,11,14,1,88,38.25192668108485,-109.4259856
38279,6,44,12,12,14,1,89,38.25192668108485,-109.4257161
38280,14,38,14,13,14,0,93,38.25192668108485,-109.4254466
38281,17,35,14,14,13,0,93,38.25192668108485,-109.4251771
38282,17,33,14,15,13,0,92,38.25192668108485,-109.4249077
38283,16,34,15,16,13,0,94,38.25192668108485,-109.4246382
38284,14,35,15,17,12,0,93,38.25192668108485,-109.4243687
38285,13,35,14,16,12,0,90,38.25192668108485,-109.4240992
38286,10,41,13,12,14,0,90,38.25192668108485,-109.4238297
38287,5,47,11,10,14,1,88,38.25192668108485,-109.4235602
38288,6,49,11,10,13,1,90,38.25192668108485,-109.4232907
38289,8,46,12,8,12,3,89,38.25192668108485,-109.4230212
38290,5,45,11,6,12,4,83,38.25192668108485,-109.4227517
38291,6,45,11,9,12,2,85,38.25192668108485,-109.4224822
38292,8,44,12,11,12,1,88,38.25192668108485,-109.4222127
38293,8,42,13,13,12,1,89,38.25192668108485,-109.4219432
38294,8,40,13,14,11,1,87,38.25192668108485,-109.4216737
38295,8,41,13,13,11,1,87,38.25192668108485,-109.4214042
38296,8,44,14,14,11,1,92,38.25192668108485,-109.4211347
38297,8,43,14,15,11,1,92,38.25192668108485,-109.4208652
38298,11,41,13,14,11,1,91,38.25192668108485,-109.4205957
38299,17,33,12,9,8,0,79,38.25192668108485,-109.4203262
38300,18,29,10,7,7,0,71,38.25192668108485,-109.4200568
38301,16,31,12,7,7,0,73,38.25192668108485,-109.4197873
38302,14,33,14,12,9,0,82,38.25192668108485,-109.4195178
38303,12,34,16,16,11,1,90,38.25192668108485,-109.4192483
38304,11,34,16,17,11,1,90,38.25192668108485,-109.4189788
38305,8,37,15,12,10,4,86,38.25192668108485,-109.4187093
38306,4,38,13,5,9,10,79,38.25192668108485,-109.4184398
38307,3,39,11,2,8,11,74,38.25192668108485,-109.4181703
38308,4,41,11,4,10,9,79,38.25192668108485,-109.4179008
38309,3,39,11,2,10,11,76,38.25192668108485,-109.4176313
38310,4,38,11,3,9,11,76,38.25192668108485,-109.4173618
38311,3,38,11,3,10,11,76,38.25192668108485,-109.4170923
38312,3,40,11,3,11,11,79,38.25192668108485,-109.4168228
38313,2,40,10,0,10,13,75,38.25192668108485,-109.4165533
38314,3,43,11,2,12,9,80,38.25192668108485,-109.4162838
38315,4,47,11,6,14,4,86,38.25192668108485,-109.4160143
38316,5,46,12,8,14,2,87,38.25192668108485,-109.4157448
38317,5,46,11,6,13,3,84,38.25192668108485,-109.4154753
38318,5,46,11,6,10,3,81,38.25192668108485,-109.4152058
38319,3,43,10,4,9,6,75,38.25192668108485,-109.4149364
38320,3,41,10,3,10,6,73,38.25192668108485,-109.4146669
38321,4,40,10,3,11,5,73,38.25192668108485,-109.4143974
38322,4,41,10,3,10,6,74,38.25192668108485,-109.4141279
38323,2,39,10,3,11,8,73,38.25192668108485,-109.4138584
38324,2,42,10,2,12,8,76,38.25192668108485,-109.4135889
38325,3,42,10,4,12,6,77,38.25192668108485,-109.4133194
38326,4,41,10,4,11,5,75,38.25192668108485,-109.4130499
38327,7,34,13,4,11,9,78,38.25192668108485,-109.4127804
38328,4,35,12,4,12,8,75,38.25192668108485,-109.4125109
38329,5,43,12,6,13,3,82,38.25192668108485,-109.4122414
38330,5,44,13,9,11,2,84,38.25192668108485,-109.4119719
38331,5,43,13,11,11,1,84,38.25192668108485,-109.4117024
38332,4,44,12,9,10,2,81,38.25192668108485,-109.4114329
38333,5,45,13,10,10,1,84,38.25192668108485,-109.4111634
38334,5,45,13,11,11,1,86,38.25192668108485,-109.4108939
38335,5,46,13,11,11,1,87,38.25192668108485,-109.4106244
38336,5,44,13,12,11,1,86,38.25192668108485,-109.4103549
38337,5,43,14,11,11,1,85,38.25192668108485,-109.4100855
38338,5,44,13,9,12,2,85,38.25192668108485,-109.409816
38339,5,41,12,6,14,5,83,38.25192668108485,-109.4095465
38340,4,38,12,5,13,7,79,38.25192668108485,-109.409277
38341,7,41,13,9,14,2,86,38.25192668108485,-109.4090075
38342,8,43,13,10,14,1,89,38.25192668108485,-109.408738
38343,8,43,12,10,14,1,88,38.25192668108485,-109.4084685
38344,6,43,11,8,14,1,83,38.25192668108485,-109.408199
38345,7,38,10,7,12,2,76,38.25192668108485,-109.4079295
38346,5,36,9,6,10,2,68,38.25192668108485,-109.40766
38347,2,32,8,3,9,5,59,38.25192668108485,-109.4073905
38348,2,31,8,2,9,6,58,38.25192668108485,-109.407121
38349,2,30,8,3,9,5,57,38.25192668108485,-109.4068515
38350,3,29,9,4,9,5,59,38.25192668108485,-109.406582
38351,3,24,9,6,10,6,58,38.25192668108485,-109.4063125
38352,7,24,13,13,10,5,72,38.25192668108485,-109.406043
38353,9,28,14,15,15,4,85,38.25192668108485,-109.4057735
38354,7,29,13,17,14,2,82,38.25192668108485,-109.405504
38355,3,34,10,8,15,3,73,38.25192668108485,-109.4052345
38356,2,42,9,2,12,6,73,38.25192668108485,-109.4049651
38357,2,39,10,2,11,7,71,38.25192668108485,-109.4046956
38358,1,38,10,3,11,6,69,38.25192668108485,-109.4044261
38359,2,37,10,4,11,6,70,38.25192668108485,-109.4041566
38360,2,29,10,4,10,5,60,38.25192668108485,-109.4038871
38361,3,28,10,7,12,4,64,38.25192668108485,-109.4036176
38362,5,28,11,14,14,2,74,38.25192668108485,-109.4033481
38363,4,29,13,24,17,1,88,38.25192668108485,-109.4030786
38364,6,25,15,18,20,4,88,38.25192668108485,-109.4028091
38365,4,28,12,22,19,2,87,38.25192668108485,-109.4025396
38366,2,28,13,17,19,4,83,38.25192668108485,-109.4022701
38367,1,30,13,10,22,4,80,38.25192668108485,-109.4020006
38368,2,32,13,9,20,4,80,38.25192668108485,-109.4017311
38369,1,31,13,7,15,10,77,38.25192668108485,-109.4014616
38370,0,30,13,2,13,16,74,38.25192668108485,-109.4011921
38371,0,31,13,2,13,15,74,38.25192668108485,-109.4009226
38372,1,33,12,2,17,11,76,38.25192668108485,-109.4006531
38373,1,35,11,3,16,9,75,38.25192668108485,-109.4003836
38374,2,37,11,6,16,5,77,38.25192668108485,-109.4001142
38375,4,41,12,5,18,4,84,38.25192668108485,-109.3998447
38376,4,43,12,5,19,3,86,38.25192668108485,-109.3995752
38377,4,42,12,4,17,5,84,38.25192668108485,-109.3993057
38378,3,40,12,2,17,7,81,38.25192668108485,-109.3990362
38379,4,39,12,5,17,6,83,38.25192668108485,-109.3987667
38380,4,39,11,3,15,6,78,38.25192668108485,-109.3984972
38381,3,38,11,1,14,10,77,38.25192668108485,-109.3982277
38382,2,35,11,0,12,13,73,38.25192668108485,-109.3979582
38383,2,36,11,0,13,11,73,38.25192668108485,-109.3976887
38384,2,35,11,3,13,10,74,38.25192668108485,-109.3974192
38385,1,33,11,3,13,12,73,38.25192668108485,-109.3971497
38386,0,33,12,0,12,14,71,38.25192668108485,-109.3968802
38387,0,32,11,0,11,16,70,38.25192668108485,-109.3966107
38388,0,32,11,0,11,15,69,38.25192668108485,-109.3963412
38389,1,33,11,0,12,13,70,38.25192668108485,-109.3960717
38390,2,37,11,0,14,9,73,38.25192668108485,-109.3958022
38391,5,43,11,3,17,4,83,38.25192668108485,-109.3955327
38392,7,46,12,5,18,1,89,38.25192668108485,-109.3952632
38393,5,43,12,5,16,3,84,38.25192668108485,-109.3949938
38394,8,42,12,7,17,2,88,38.25192668108485,-109.3947243
38395,10,40,12,8,17,1,88,38.25192668108485,-109.3944548
38396,10,37,12,8,15,3,85,38.25192668108485,-109.3941853
38397,11,33,13,4,12,10,83,38.25192668108485,-109.3939158
38398,9,32,12,5,12,10,80,38.25192668108485,-109.3936463
38399,10,34,12,8,14,5,83,38.25192668108485,-109.3933768
38400,12,36,13,9,15,2,87,38.25192668108485,-109.3931073
38401,14,38,13,10,15,1,91,38.25192668108485,-109.3928378
38402,15,37,13,10,14,0,89,38.25192668108485,-109.3925683
38403,14,37,13,12,14,0,90,38.25192668108485,-109.3922988
38404,15,37,13,12,13,0,90,38.25192668108485,-109.3920293
38405,16,37,13,11,12,0,89,38.25192668108485,-109.3917598
38406,17,37,13,11,12,0,90,38.25192668108485,-109.3914903
38407,17,36,13,12,12,0,90,38.25192668108485,-109.3912208
38408,16,35,13,12,13,0,89,38.25192668108485,-109.3909513
38409,17,35,13,11,14,0,90,38.25192668108485,-109.3906818
38410,17,37,13,11,14,0,92,38.25192668108485,-109.3904123
38411,16,37,13,11,15,0,92,38.25192668108485,-109.3901429
38412,13,37,14,11,15,1,91,38.25192668108485,-109.3898734
38413,10,38,14,10,15,2,89,38.25192668108485,-109.3896039
38414,10,39,14,10,16,2,91,38.25192668108485,-109.3893344
38415,10,39,14,11,16,2,92,38.25192668108485,-109.3890649
38416,11,38,14,12,16,1,92,38.25192668108485,-109.3887954
38417,13,35,13,13,14,1,89,38.25192668108485,-109.3885259
38418,14,33,13,14,14,1,89,38.25192668108485,-109.3882564
38419,15,32,13,14,14,1,89,38.25192668108485,-109.3879869
38420,17,33,13,14,13,1,91,38.25192668108485,-109.3877174
38421,19,33,14,13,13,0,92,38.25192668108485,-109.3874479
38422,20,33,14,14,13,0,94,38.25192668108485,-109.3871784
38423,19,33,13,12,13,0,90,38.25192668108485,-109.3869089
38424,18,35,12,10,13,0,88,38.25192668108485,-109.3866394
38425,18,34,12,10,12,1,87,38.25192668108485,-109.3863699
38426,21,33,13,12,12,0,91,38.25192668108485,-109.3861004
38427,18,34,14,14,12,0,92,38.25192668108485,-109.3858309
38428,15,35,14,15,13,0,92,38.25192668108485,-109.3855614
38429,13,38,14,16,13,0,94,38.25192668108485,-109.3852919
38430,9,42,14,13,14,0,92,38.25192668108485,-109.3850225
38431,6,38,12,12,14,1,83,38.25192668108485,-109.384753
38432,8,37,13,14,13,1,86,38.25192668108485,-109.3844835
38433,11,35,13,15,13,1,88,38.25192668108485,-109.384214
38434,7,34,12,11,14,3,81,38.25192668108485,-109.3839445
38435,4,34,11,3,13,8,73,38.25192668108485,-109.383675
38436,5,35,11,5,14,6,76,38.25192668108485,-109.3834055
38437,8,32,12,9,13,5,79,38.25192668108485,-109.383136
38438,8,30,13,13,12,5,81,38.25192668108485,-109.3828665
38439,8,24,11,11,12,6,72,38.25192668108485,-109.382597
38440,10,21,10,17,14,2,74,38.25192668108485,-109.3823275
38441,14,24,12,16,13,1,80,38.25192668108485,-109.382058
38442,14,32,12,12,12,2,84,38.25192668108485,-109.3817885
38443,9,37,12,9,11,6,84,38.25192668108485,-109.381519
38444,7,41,12,4,13,7,84,38.25192668108485,-109.3812495
38445,2,32,12,2,10,13,71,38.25192668108485,-109.38098
38446,3,28,12,5,11,11,70,38.25192668108485,-109.3807105
38447,6,33,12,5,11,10,77,38.25192668108485,-109.380441
38448,5,44,14,3,15,7,88,38.25192668108485,-109.3801716
38449,5,45,13,4,16,6,89,38.25192668108485,-109.3799021
38450,5,46,13,4,16,4,88,38.25192668108485,-109.3796326
38451,6,47,13,7,16,2,91,38.25192668108485,-109.3793631
38452,9,44,14,10,15,1,93,38.25192668108485,-109.3790936
38453,12,39,14,13,14,1,93,38.25192668108485,-109.3788241
38454,14,37,14,13,14,0,92,38.25192668108485,-109.3785546
38455,13,37,14,13,15,1,93,38.25192668108485,-109.3782851
38456,12,37,14,12,15,2,92,38.25192668108485,-109.3780156
38457,16,36,14,12,14,1,93,38.25192668108485,-109.3777461
38458,24,32,14,12,11,0,93,38.25192668108485,-109.3774766
38459,21,32,14,13,11,1,92,38.25192668108485,-109.3772071
38460,18,32,14,11,10,3,88,38.25192668108485,-109.3769376
38461,11,35,14,9,11,6,86,38.25192668108485,-109.3766681
38462,6,39,12,7,12,6,82,38.25192668108485,-109.3763986
38463,3,38,11,5,11,8,76,38.25192668108485,-109.3761291
38464,3,38,9,6,12,4,72,38.25192668108485,-109.3758596
38465,4,40,10,7,12,2,75,38.25192668108485,-109.3755901
38466,2,42,8,6,11,3,72,38.25192668108485,-109.3753206
38467,1,45,7,3,11,4,71,38.25192668108485,-109.3750512
38468,1,47,7,5,10,3,73,38.25192668108485,-109.3747817
38469,1,45,7,4,11,3,71,38.25192668108485,-109.3745122
38470,2,44,7,5,11,3,72,38.25192668108485,-109.3742427
38471,2,42,7,5,11,4,71,38.25192668108485,-109.3739732
38472,6,38,13,6,10,5,78,38.25192668108485,-109.3737037
38473,4,34,12,6,7,8,71,38.25192668108485,-109.3734342
38474,1,35,9,3,9,9,66,38.25192668108485,-109.3731647
38475,1,38,8,2,10,7,66,38.25192668108485,-109.3728952
38476,2,40,7,4,10,6,69,38.25192668108485,-109.3726257
38477,2,46,6,4,10,4,72,38.25192668108485,-109.3723562
38478,2,44,6,5,10,5,72,38.25192668108485,-109.3720867
38479,2,41,7,5,9,5,69,38.25192668108485,-109.3718172
38480,1,45,7,4,9,5,71,38.25192668108485,-109.3715477
38481,1,50,6,3,11,3,74,38.25192668108485,-109.3712782
38482,1,49,6,3,10,3,72,38.25192668108485,-109.3710087
38483,1,46,6,2,8,4,67,38.25192668108485,-109.3707392
38484,1,48,6,3,9,3,70,38.25192668108485,-109.3704697
38485,1,45,6,3,10,4,69,38.25192668108485,-109.3702003
38486,2,47,7,4,10,3,73,38.25192668108485,-109.3699308
38487,2,40,8,5,10,5,70,38.25192668108485,-109.3696613
38488,4,34,11,7,10,8,74,38.25192668108485,-109.3693918
38489,5,32,13,8,7,13,78,38.25192668108485,-109.3691223
38490,1,26,12,0,6,21,66,38.25192668108485,-109.3688528
38491,2,31,15,1,8,20,77,38.25192668108485,-109.3685833
38492,1,27,14,2,14,14,72,38.25192668108485,-109.3683138
38493,0,22,13,9,19,5,68,38.25192668108485,-109.3680443
38494,0,15,13,15,20,3,66,38.25192668108485,-109.3677748
38495,0,10,13,19,15,7,64,38.25192668108485,-109.3675053
38496,2,21,14,8,14,11,70,38.25192668108485,-109.3672358
38497,0,26,16,2,11,19,74,38.25192668108485,-109.3669663
38498,1,25,14,5,7,20,72,38.25192668108485,-109.3666968
38499,0,23,15,1,4,28,71,38.25192668108485,-109.3664273
38500,0,23,16,0,2,29,70,38.25192668108485,-109.3661578
38501,1,22,16,0,3,26,68,38.25192668108485,-109.3658883
38502,1,21,15,0,2,27,66,38.25192668108485,-109.3656188
38503,0,21,15,0,1,28,65,38.25192668108485,-109.3653493
38504,1,20,15,0,0,29,65,38.25192668108485,-109.3650799
38505,2,21,15,0,1,27,66,38.25192668108485,-109.3648104
38506,2,20,16,1,0,29,68,38.25192668108485,-109.3645409
38507,1,19,17,0,0,32,69,38.25192668108485,-109.3642714
38508,1,20,17,0,1,33,72,38.25192668108485,-109.3640019
38509,1,20,18,0,1,35,75,38.25192668108485,-109.3637324
38510,1,22,18,0,2,34,77,38.25192668108485,-109.3634629
38511,1,24,18,0,3,34,80,38.25192668108485,-109.3631934
38512,1,23,18,0,2,33,77,38.25192668108485,-109.3629239
38513,0,22,17,0,1,32,72,38.25192668108485,-109.3626544
38514,1,22,17,0,2,30,72,38.25192668108485,-109.3623849
38515,2,22,17,1,3,30,75,38.25192668108485,-109.3621154
38516,1,23,18,0,2,32,76,38.25192668108485,-109.3618459
38517,1,23,18,0,2,32,76,38.25192668108485,-109.3615764
38518,0,22,17,0,2,32,73,38.25192668108485,-109.3613069
38519,0,21,18,0,3,32,74,38.25192668108485,-109.3610374
38520,0,21,18,0,3,32,74,38.25192668108485,-109.3607679
38521,0,23,17,0,4,31,75,38.25192668108485,-109.3604984
38522,1,24,18,0,4,30,77,38.25192668108485,-109.360229
38523,2,24,18,1,3,31,79,38.25192668108485,-109.3599595
38524,1,19,18,0,0,33,71,38.25192668108485,-109.35969
38525,1,20,16,1,1,29,68,38.25192668108485,-109.3594205
38526,1,21,15,1,2,27,67,38.25192668108485,-109.359151
38527,1,20,15,1,1,27,65,38.25192668108485,-109.3588815
38528,0,19,14,1,2,25,61,38.25192668108485,-109.358612
38529,0,22,14,0,1,25,62,38.25192668108485,-109.3583425
38530,1,21,14,0,1,25,62,38.25192668108485,-109.358073
38531,2,21,14,0,2,25,64,38.25192668108485,-109.3578035
38532,2,22,15,0,2,26,67,38.25192668108485,-109.357534
38533,2,22,16,0,1,28,69,38.25192668108485,-109.3572645
38534,1,21,16,0,0,29,67,38.25192668108485,-109.356995
38535,1,22,14,0,1,27,65,38.25192668108485,-109.3567255
38536,1,22,14,0,1,27,65,38.25192668108485,-109.356456
38537,1,19,15,0,1,27,63,38.25192668108485,-109.3561865
38538,1,22,14,0,1,25,63,38.25192668108485,-109.355917
38539,1,20,13,0,2,22,58,38.25192668108485,-109.3556475
38540,3,20,9,1,2,16,51,38.25192668108485,-109.355378
38541,3,21,8,3,4,12,51,38.25192668108485,-109.3551086
38542,3,26,7,5,7,7,55,38.25192668108485,-109.3548391
38543,2,30,7,4,8,6,57,38.25192668108485,-109.3545696
38544,1,35,7,4,9,5,61,38.25192668108485,-109.3543001
38545,2,32,7,5,9,5,60,38.25192668108485,-109.3540306
38546,3,30,7,4,9,6,59,38.25192668108485,-109.3537611
38547,3,28,7,6,8,8,60,38.25192668108485,-109.3534916
38548,3,28,8,6,8,9,62,38.25192668108485,-109.3532221
38549,3,27,7,5,7,9,58,38.25192668108485,-109.3529526
38550,3,28,6,4,7,8,56,38.25192668108485,-109.3526831
38551,3,33,6,5,9,3,59,38.25192668108485,-109.3524136
38552,3,34,5,4,9,3,58,38.25192668108485,-109.3521441
38553,2,26,8,3,8,9,56,38.25192668108485,-109.3518746
38554,1,23,10,2,6,13,55,38.25192668108485,-109.3516051
38555,3,24,10,5,9,6,57,38.25192668108485,-109.3513356
38556,1,31,6,2,7,4,51,38.25192668108485,-109.3510661
38557,1,28,6,4,7,4,50,38.25192668108485,-109.3507966
38558,1,25,7,5,8,4,50,38.25192668108485,-109.3505271
38559,2,18,10,8,9,6,53,38.25192668108485,-109.3502577
38560,8,24,9,15,18,1,75,38.25192668108485,-109.3499882
38561,2,24,9,9,8,7,59,38.25192668108485,-109.3497187
38562,3,20,10,6,8,10,57,38.25192668108485,-109.3494492
38563,3,24,11,3,7,13,61,38.25192668108485,-109.3491797
38564,1,26,12,0,4,21,64,38.25192668108485,-109.3489102
38565,1,28,13,1,6,18,67,38.25192668108485,-109.3486407
38566,10,38,13,7,16,0,84,38.25192668108485,-109.3483712
38567,7,31,11,10,8,1,68,38.25192668108485,-109.3481017
38568,5,44,8,8,8,1,74,38.25192668108485,-109.3478322
38569,7,44,6,2,7,2,68,38.25192668108485,-109.3475627
38570,5,26,6,2,5,5,49,38.25192668108485,-109.3472932
38571,2,26,6,4,7,4,49,38.25192668108485,-109.3470237
38572,3,20,8,7,7,4,49,38.25192668108485,-109.3467542
38573,3,25,10,12,9,4,63,38.25192668108485,-109.3464847
38574,3,27,9,13,10,4,66,38.25192668108485,-109.3462152
38575,4,21,13,9,8,9,64,38.25192668108485,-109.3459457
38576,3,20,10,5,6,11,55,38.25192668108485,-109.3456762
38577,3,24,10,6,7,8,58,38.25192668108485,-109.3454068
38578,2,27,9,5,10,5,58,38.25192668108485,-109.3451373
38579,2,29,9,0,11,9,60,38.25192668108485,-109.3448678
38580,5,35,11,4,15,4,74,38.25192668108485,-109.3445983
38581,1,43,8,1,11,6,70,38.25192668108485,-109.3443288
38582,0,43,7,0,10,6,66,38.25192668108485,-109.3440593
38583,2,36,8,3,9,7,65,38.25192668108485,-109.3437898
38584,5,30,8,7,11,4,65,38.25192668108485,-109.3435203
38585,3,47,7,4,10,3,74,38.25192668108485,-109.3432508
38586,2,35,8,4,8,7,64,38.25192668108485,-109.3429813
38587,2,28,8,4,8,8,58,38.25192668108485,-109.3427118
38588,2,30,8,3,7,6,56,38.25192668108485,-109.3424423
38589,3,23,9,4,7,7,53,38.25192668108485,-109.3421728
38590,2,19,9,4,5,9,48,38.25192668108485,-109.3419033
38591,3,19,10,4,5,10,51,38.25192668108485,-109.3416338
38592,4,23,11,2,4,11,55,38.25192668108485,-109.3413643
38593,3,25,9,3,6,8,54,38.25192668108485,-109.3410948
38594,2,26,8,4,6,7,53,38.25192668108485,-109.3408253
38595,4,25,8,5,8,6,56,38.25192668108485,-109.3405558
38596,5,26,10,5,10,5,61,38.25192668108485,-109.3402864
38597,5,26,10,4,9,7,61,38.25192668108485,-109.3400169
38598,4,27,11,6,9,7,64,38.25192668108485,-109.3397474
38599,4,23,11,4,9,8,59,38.25192668108485,-109.3394779
38600,3,21,10,3,8,8,53,38.25192668108485,-109.3392084
38601,1,22,9,3,7,9,51,38.25192668108485,-109.3389389
38602,2,28,9,3,7,8,57,38.25192668108485,-109.3386694
38603,4,30,10,4,8,6,62,38.25192668108485,-109.3383999
38604,2,24,9,4,7,8,54,38.25192668108485,-109.3381304
38605,1,23,9,4,8,7,52,38.25192668108485,-109.3378609
38606,2,22,8,5,9,6,52,38.25192668108485,-109.3375914
38607,2,18,8,6,11,5,50,38.25192668108485,-109.3373219
38608,4,21,13,15,14,4,71,38.25192668108485,-109.3370524
38609,3,10,10,36,19,3,81,38.25192668108485,-109.3367829
38610,3,8,9,28,24,6,78,38.25192668108485,-109.3365134
38611,0,7,9,23,9,4,52,38.25192668108485,-109.3362439
38612,3,13,11,20,12,5,64,38.25192668108485,-109.3359744
38613,2,20,10,12,13,7,64,38.25192668108485,-109.3357049
38614,2,26,12,8,14,10,72,38.25192668108485,-109.3354355
38615,2,24,12,5,11,15,69,38.25192668108485,-109.335166
38616,2,26,12,1,9,16,66,38.25192668108485,-109.3348965
38617,2,29,11,1,10,12,65,38.25192668108485,-109.334627
38618,1,28,9,0,9,12,59,38.25192668108485,-109.3343575
38619,1,25,9,0,8,12,55,38.25192668108485,-109.334088
38620,1,24,10,1,7,15,58,38.25192668108485,-109.3338185
38621,3,28,13,1,4,20,69,38.25192668108485,-109.333549
38622,2,28,12,0,4,20,66,38.25192668108485,-109.3332795
38623,1,27,11,0,4,20,63,38.25192668108485,-109.33301
38624,1,29,11,0,6,18,65,38.25192668108485,-109.3327405
38625,2,34,11,0,8,17,72,38.25192668108485,-109.332471
38626,2,37,11,1,9,14,74,38.25192668108485,-109.3322015
38627,2,34,11,1,6,18,72,38.25192668108485,-109.331932
38628,2,27,13,1,4,21,68,38.25192668108485,-109.3316625
38629,2,23,14,0,4,23,66,38.25192668108485,-109.331393
38630,2,51,10,1,16,5,85,38.25165718649962,-109.4402688
38631,2,52,11,2,16,5,88,38.25165718649962,-109.4399993
38632,3,52,11,2,16,5,89,38.25165718649962,-109.4397299
38633,3,51,12,4,17,4,91,38.25165718649962,-109.4394604
38634,2,44,12,4,17,6,85,38.25165718649962,-109.4391909
38635,1,35,12,0,11,16,75,38.25165718649962,-109.4389214
38636,1,31,11,0,10,15,68,38.25165718649962,-109.4386519
38637,1,28,10,3,12,10,64,38.25165718649962,-109.4383824
38638,6,31,10,6,11,5,69,38.25165718649962,-109.4381129
38639,5,39,9,7,8,3,71,38.25165718649962,-109.4378434
38640,9,36,10,8,14,1,78,38.25165718649962,-109.4375739
38641,7,42,12,10,15,1,87,38.25165718649962,-109.4373044
38642,6,47,12,8,15,1,89,38.25165718649962,-109.4370349
38643,4,45,11,8,15,1,84,38.25165718649962,-109.4367654
38644,7,39,12,12,12,1,83,38.25165718649962,-109.4364959
38645,8,37,13,13,12,1,84,38.25165718649962,-109.4362264
38646,7,39,12,11,13,1,83,38.25165718649962,-109.4359569
38647,5,42,11,7,13,3,81,38.25165718649962,-109.4356874
38648,2,32,9,4,8,10,65,38.25165718649962,-109.4354179
38649,2,36,8,3,8,6,63,38.25165718649962,-109.4351484
38650,1,33,7,2,8,6,57,38.25165718649962,-109.434879
38651,1,33,7,2,9,6,58,38.25165718649962,-109.4346095
38652,3,38,7,5,9,3,65,38.25165718649962,-109.43434
38653,3,40,7,5,9,3,67,38.25165718649962,-109.4340705
38654,2,40,8,3,9,5,67,38.25165718649962,-109.433801
38655,1,39,8,1,9,10,68,38.25165718649962,-109.4335315
38656,1,38,9,0,9,12,69,38.25165718649962,-109.433262
38657,1,39,9,0,9,12,70,38.25165718649962,-109.4329925
38658,1,40,8,0,11,9,69,38.25165718649962,-109.432723
38659,0,41,8,0,12,8,69,38.25165718649962,-109.4324535
38660,1,41,9,1,14,6,72,38.25165718649962,-109.432184
38661,3,39,11,4,17,3,77,38.25165718649962,-109.4319145
38662,6,39,12,9,15,2,83,38.25165718649962,-109.431645
38663,8,41,14,12,14,1,90,38.25165718649962,-109.4313755
38664,11,40,15,14,13,0,93,38.25165718649962,-109.431106
38665,13,38,15,15,13,0,94,38.25165718649962,-109.4308365
38666,14,37,14,14,14,0,93,38.25165718649962,-109.430567
38667,10,39,14,13,15,0,91,38.25165718649962,-109.4302975
38668,5,43,11,10,15,1,85,38.25165718649962,-109.430028
38669,4,47,10,10,14,1,86,38.25165718649962,-109.4297586
38670,4,47,11,9,13,1,85,38.25165718649962,-109.4294891
38671,6,46,11,10,13,1,87,38.25165718649962,-109.4292196
38672,7,44,12,12,12,1,88,38.25165718649962,-109.4289501
38673,6,46,12,12,12,1,89,38.25165718649962,-109.4286806
38674,4,51,10,10,12,1,88,38.25165718649962,-109.4284111
38675,3,53,10,9,13,1,89,38.25165718649962,-109.4281416
38676,7,50,11,11,13,1,93,38.25165718649962,-109.4278721
38677,10,43,13,13,12,1,92,38.25165718649962,-109.4276026
38678,11,41,13,13,12,1,91,38.25165718649962,-109.4273331
38679,10,41,13,13,12,1,90,38.25165718649962,-109.4270636
38680,9,41,12,12,12,1,87,38.25165718649962,-109.4267941
38681,6,45,12,11,14,1,89,38.25165718649962,-109.4265246
38682,7,42,12,12,14,1,88,38.25165718649962,-109.4262551
38683,5,46,12,11,14,1,89,38.25165718649962,-109.4259856
38684,4,47,11,8,15,1,86,38.25165718649962,-109.4257161
38685,11,39,13,11,14,0,88,38.25165718649962,-109.4254466
38686,15,38,14,13,14,0,94,38.25165718649962,-109.4251771
38687,14,38,14,13,14,0,93,38.25165718649962,-109.4249077
38688,14,37,14,15,13,0,93,38.25165718649962,-109.4246382
38689,15,35,14,16,12,0,92,38.25165718649962,-109.4243687
38690,15,35,14,15,12,0,91,38.25165718649962,-109.4240992
38691,6,45,11,10,14,1,87,38.25165718649962,-109.4238297
38692,3,50,10,7,13,2,85,38.25165718649962,-109.4235602
38693,4,49,10,8,13,3,87,38.25165718649962,-109.4232907
38694,7,42,12,9,11,4,85,38.25165718649962,-109.4230212
38695,7,40,13,10,11,4,85,38.25165718649962,-109.4227517
38696,9,38,14,12,11,3,87,38.25165718649962,-109.4224822
38697,10,38,14,15,11,1,89,38.25165718649962,-109.4222127
38698,7,40,14,15,11,1,88,38.25165718649962,-109.4219432
38699,5,43,13,14,10,1,86,38.25165718649962,-109.4216737
38700,6,43,13,14,10,2,88,38.25165718649962,-109.4214042
38701,7,43,13,14,11,1,89,38.25165718649962,-109.4211347
38702,7,42,13,15,11,1,89,38.25165718649962,-109.4208652
38703,10,41,13,15,11,1,91,38.25165718649962,-109.4205957
38704,12,40,13,14,11,1,91,38.25165718649962,-109.4203262
38705,18,37,13,10,9,0,87,38.25165718649962,-109.4200568
38706,19,34,11,7,8,0,79,38.25165718649962,-109.4197873
38707,15,32,11,8,8,0,74,38.25165718649962,-109.4195178
38708,13,36,15,15,11,1,91,38.25165718649962,-109.4192483
38709,11,36,16,18,11,1,93,38.25165718649962,-109.4189788
38710,9,35,15,16,11,2,88,38.25165718649962,-109.4187093
38711,8,38,14,12,11,3,86,38.25165718649962,-109.4184398
38712,6,41,13,9,10,5,84,38.25165718649962,-109.4181703
38713,5,43,12,7,10,5,82,38.25165718649962,-109.4179008
38714,6,44,12,8,11,4,85,38.25165718649962,-109.4176313
38715,5,41,12,8,11,5,82,38.25165718649962,-109.4173618
38716,5,41,12,7,11,5,81,38.25165718649962,-109.4170923
38717,8,42,13,9,13,3,88,38.25165718649962,-109.4168228
38718,10,39,12,8,12,5,86,38.25165718649962,-109.4165533
38719,6,47,12,6,13,4,88,38.25165718649962,-109.4162838
38720,6,48,11,6,13,3,87,38.25165718649962,-109.4160143
38721,5,46,11,7,13,3,85,38.25165718649962,-109.4157448
38722,5,45,11,7,12,3,83,38.25165718649962,-109.4154753
38723,4,46,10,5,11,4,80,38.25165718649962,-109.4152058
38724,3,42,9,3,10,5,72,38.25165718649962,-109.4149364
38725,2,39,9,3,10,6,69,38.25165718649962,-109.4146669
38726,2,38,9,2,10,8,69,38.25165718649962,-109.4143974
38727,3,39,9,2,9,8,70,38.25165718649962,-109.4141279
38728,2,35,10,4,11,9,71,38.25165718649962,-109.4138584
38729,3,44,10,4,13,5,79,38.25165718649962,-109.4135889
38730,3,46,10,6,13,4,82,38.25165718649962,-109.4133194
38731,3,40,10,4,10,7,74,38.25165718649962,-109.4130499
38732,7,37,13,3,11,10,81,38.25165718649962,-109.4127804
38733,8,40,12,5,12,4,81,38.25165718649962,-109.4125109
38734,6,44,12,7,11,2,82,38.25165718649962,-109.4122414
38735,5,43,12,9,10,2,81,38.25165718649962,-109.4119719
38736,5,41,13,10,10,2,81,38.25165718649962,-109.4117024
38737,5,43,13,10,10,1,82,38.25165718649962,-109.4114329
38738,5,44,12,11,10,1,83,38.25165718649962,-109.4111634
38739,5,44,13,11,10,1,84,38.25165718649962,-109.4108939
38740,5,45,13,11,11,1,86,38.25165718649962,-109.4106244
38741,6,44,14,12,11,1,88,38.25165718649962,-109.4103549
38742,6,44,14,11,11,1,87,38.25165718649962,-109.4100855
38743,5,41,12,8,12,2,80,38.25165718649962,-109.409816
38744,3,38,11,5,13,5,75,38.25165718649962,-109.4095465
38745,2,35,10,3,11,8,69,38.25165718649962,-109.409277
38746,4,38,10,4,13,5,74,38.25165718649962,-109.4090075
38747,5,39,10,5,13,3,75,38.25165718649962,-109.408738
38748,5,38,9,5,11,4,72,38.25165718649962,-109.4084685
38749,3,38,9,3,10,4,67,38.25165718649962,-109.408199
38750,2,34,8,2,9,5,60,38.25165718649962,-109.4079295
38751,2,34,8,2,9,5,60,38.25165718649962,-109.40766
38752,2,30,8,3,9,6,58,38.25165718649962,-109.4073905
38753,3,26,9,4,9,7,58,38.25165718649962,-109.407121
38754,5,24,10,7,9,6,61,38.25165718649962,-109.4068515
38755,4,25,11,9,8,6,63,38.25165718649962,-109.406582
38756,7,25,13,16,11,3,75,38.25165718649962,-109.4063125
38757,9,29,14,18,14,2,86,38.25165718649962,-109.406043
38758,11,30,14,18,14,1,88,38.25165718649962,-109.4057735
38759,11,29,13,13,14,1,81,38.25165718649962,-109.405504
38760,4,39,10,10,12,1,76,38.25165718649962,-109.4052345
38761,3,35,9,5,10,5,67,38.25165718649962,-109.4049651
38762,4,33,9,6,11,4,67,38.25165718649962,-109.4046956
38763,5,32,10,7,11,4,69,38.25165718649962,-109.4044261
38764,5,30,11,6,9,5,66,38.25165718649962,-109.4041566
38765,3,27,11,6,8,7,62,38.25165718649962,-109.4038871
38766,4,29,12,11,11,6,73,38.25165718649962,-109.4036176
38767,5,29,13,18,18,4,87,38.25165718649962,-109.4033481
38768,3,23,14,15,22,8,85,38.25165718649962,-109.4030786
38769,1,25,14,13,19,10,82,38.25165718649962,-109.4028091
38770,2,33,13,8,20,7,83,38.25165718649962,-109.4025396
38771,1,33,11,4,19,7,75,38.25165718649962,-109.4022701
38772,2,34,11,3,14,8,72,38.25165718649962,-109.4020006
38773,2,34,11,2,12,9,70,38.25165718649962,-109.4017311
38774,2,36,11,1,13,9,72,38.25165718649962,-109.4014616
38775,1,35,11,1,12,11,71,38.25165718649962,-109.4011921
38776,1,33,11,0,10,15,70,38.25165718649962,-109.4009226
38777,2,35,11,0,12,14,74,38.25165718649962,-109.4006531
38778,3,40,12,3,16,6,80,38.25165718649962,-109.4003836
38779,5,45,13,9,18,0,90,38.25165718649962,-109.4001142
38780,5,43,13,8,17,1,87,38.25165718649962,-109.3998447
38781,3,38,11,5,15,6,78,38.25165718649962,-109.3995752
38782,2,35,11,2,11,11,72,38.25165718649962,-109.3993057
38783,1,30,12,0,9,16,68,38.25165718649962,-109.3990362
38784,1,30,12,0,9,15,67,38.25165718649962,-109.3987667
38785,1,32,12,0,11,14,70,38.25165718649962,-109.3984972
38786,1,31,12,2,12,12,70,38.25165718649962,-109.3982277
38787,2,32,11,4,14,8,71,38.25165718649962,-109.3979582
38788,5,37,12,9,17,2,82,38.25165718649962,-109.3976887
38789,3,39,11,4,16,5,78,38.25165718649962,-109.3974192
38790,2,35,10,1,13,9,70,38.25165718649962,-109.3971497
38791,1,31,11,0,10,13,66,38.25165718649962,-109.3968802
38792,2,33,11,0,12,14,72,38.25165718649962,-109.3966107
38793,2,32,11,0,12,14,71,38.25165718649962,-109.3963412
38794,3,36,11,0,15,9,74,38.25165718649962,-109.3960717
38795,5,39,11,4,17,3,79,38.25165718649962,-109.3958022
38796,8,43,12,7,19,0,89,38.25165718649962,-109.3955327
38797,10,43,13,8,18,0,92,38.25165718649962,-109.3952632
38798,6,44,12,8,17,1,88,38.25165718649962,-109.3949938
38799,8,43,13,9,16,1,90,38.25165718649962,-109.3947243
38800,8,40,13,11,16,1,89,38.25165718649962,-109.3944548
38801,10,38,13,11,16,1,89,38.25165718649962,-109.3941853
38802,12,37,13,9,15,2,88,38.25165718649962,-109.3939158
38803,14,36,13,10,15,1,89,38.25165718649962,-109.3936463
38804,13,36,13,11,14,1,88,38.25165718649962,-109.3933768
38805,15,37,13,11,13,1,90,38.25165718649962,-109.3931073
38806,15,38,13,11,14,0,91,38.25165718649962,-109.3928378
38807,15,39,13,10,14,0,91,38.25165718649962,-109.3925683
38808,14,38,13,12,13,0,90,38.25165718649962,-109.3922988
38809,13,38,13,12,13,1,90,38.25165718649962,-109.3920293
38810,15,39,13,11,12,1,91,38.25165718649962,-109.3917598
38811,16,38,13,11,12,0,90,38.25165718649962,-109.3914903
38812,16,37,13,12,12,0,90,38.25165718649962,-109.3912208
38813,16,37,13,12,13,0,91,38.25165718649962,-109.3909513
38814,15,38,13,11,14,0,91,38.25165718649962,-109.3906818
38815,14,40,13,11,14,0,92,38.25165718649962,-109.3904123
38816,15,40,13,10,14,0,92,38.25165718649962,-109.3901429
38817,13,39,13,11,15,0,91,38.25165718649962,-109.3898734
38818,10,39,14,11,15,1,90,38.25165718649962,-109.3896039
38819,9,39,14,11,15,2,90,38.25165718649962,-109.3893344
38820,11,38,14,11,16,1,91,38.25165718649962,-109.3890649
38821,14,36,14,13,14,0,91,38.25165718649962,-109.3887954
38822,15,35,13,13,13,0,89,38.25165718649962,-109.3885259
38823,14,34,13,13,14,1,89,38.25165718649962,-109.3882564
38824,14,34,14,13,14,1,90,38.25165718649962,-109.3879869
38825,16,34,13,13,13,1,90,38.25165718649962,-109.3877174
38826,17,35,14,12,13,0,91,38.25165718649962,-109.3874479
38827,17,35,14,12,13,0,91,38.25165718649962,-109.3871784
38828,17,35,13,12,13,0,90,38.25165718649962,-109.3869089
38829,18,34,12,10,12,1,87,38.25165718649962,-109.3866394
38830,21,30,12,11,12,1,87,38.25165718649962,-109.3863699
38831,22,32,13,12,11,0,90,38.25165718649962,-109.3861004
38832,19,34,14,13,11,0,91,38.25165718649962,-109.3858309
38833,16,37,14,14,12,0,93,38.25165718649962,-109.3855614
38834,13,40,14,13,14,0,94,38.25165718649962,-109.3852919
38835,10,45,13,10,15,0,93,38.25165718649962,-109.3850225
38836,7,40,12,10,16,1,86,38.25165718649962,-109.384753
38837,9,37,13,13,14,1,87,38.25165718649962,-109.3844835
38838,13,34,14,14,12,1,88,38.25165718649962,-109.384214
38839,9,35,13,11,13,4,85,38.25165718649962,-109.3839445
38840,4,36,12,5,13,8,78,38.25165718649962,-109.383675
38841,3,36,11,4,14,6,74,38.25165718649962,-109.3834055
38842,3,31,11,4,12,8,69,38.25165718649962,-109.383136
38843,6,28,11,10,12,5,72,38.25165718649962,-109.3828665
38844,10,24,11,14,15,2,76,38.25165718649962,-109.382597
38845,11,23,11,13,14,2,74,38.25165718649962,-109.3823275
38846,10,30,13,13,12,4,82,38.25165718649962,-109.382058
38847,8,34,13,14,11,5,85,38.25165718649962,-109.3817885
38848,9,36,13,16,12,3,89,38.25165718649962,-109.381519
38849,10,40,13,13,13,2,91,38.25165718649962,-109.3812495
38850,5,42,12,8,13,6,86,38.25165718649962,-109.38098
38851,4,31,11,10,11,8,75,38.25165718649962,-109.3807105
38852,5,26,11,12,12,7,73,38.25165718649962,-109.380441
38853,5,29,12,6,11,10,73,38.25165718649962,-109.3801716
38854,5,43,12,3,14,6,83,38.25165718649962,-109.3799021
38855,3,48,11,3,17,4,86,38.25165718649962,-109.3796326
38856,3,50,12,4,16,3,88,38.25165718649962,-109.3793631
38857,6,47,13,7,16,2,91,38.25165718649962,-109.3790936
38858,12,38,14,11,16,1,92,38.25165718649962,-109.3788241
38859,13,36,14,10,15,3,91,38.25165718649962,-109.3785546
38860,12,38,14,8,14,4,90,38.25165718649962,-109.3782851
38861,8,41,14,7,14,5,89,38.25165718649962,-109.3780156
38862,7,43,13,7,15,4,89,38.25165718649962,-109.3777461
38863,9,45,14,10,15,1,94,38.25165718649962,-109.3774766
38864,8,44,13,10,15,1,91,38.25165718649962,-109.3772071
38865,5,44,11,6,14,4,84,38.25165718649962,-109.3769376
38866,3,43,10,3,13,6,78,38.25165718649962,-109.3766681
38867,1,40,10,3,10,7,71,38.25165718649962,-109.3763986
38868,0,41,9,1,12,7,70,38.25165718649962,-109.3761291
38869,1,46,8,2,12,4,73,38.25165718649962,-109.3758596
38870,2,43,8,4,10,6,73,38.25165718649962,-109.3755901
38871,1,40,8,4,12,6,71,38.25165718649962,-109.3753206
38872,1,36,10,3,8,11,69,38.25165718649962,-109.3750512
38873,2,37,11,4,8,10,72,38.25165718649962,-109.3747817
38874,1,39,8,3,9,7,67,38.25165718649962,-109.3745122
38875,1,36,8,3,10,8,66,38.25165718649962,-109.3742427
38876,2,35,10,4,7,11,69,38.25165718649962,-109.3739732
38877,3,34,12,1,8,13,71,38.25165718649962,-109.3737037
38878,1,41,9,1,11,8,71,38.25165718649962,-109.3734342
38879,1,41,8,2,10,6,68,38.25165718649962,-109.3731647
38880,1,40,7,1,9,6,64,38.25165718649962,-109.3728952
38881,1,41,7,1,9,5,64,38.25165718649962,-109.3726257
38882,0,45,6,0,9,5,65,38.25165718649962,-109.3723562
38883,2,44,7,5,10,4,72,38.25165718649962,-109.3720867
38884,2,37,7,5,10,7,68,38.25165718649962,-109.3718172
38885,2,37,8,4,10,8,69,38.25165718649962,-109.3715477
38886,1,40,7,3,11,7,69,38.25165718649962,-109.3712782
38887,1,39,8,4,10,7,69,38.25165718649962,-109.3710087
38888,1,45,7,4,10,4,71,38.25165718649962,-109.3707392
38889,1,47,6,3,10,4,71,38.25165718649962,-109.3704697
38890,1,48,7,3,11,3,73,38.25165718649962,-109.3702003
38891,2,48,8,5,12,3,78,38.25165718649962,-109.3699308
38892,3,36,14,7,10,9,79,38.25165718649962,-109.3696613
38893,4,27,14,2,7,20,74,38.25165718649962,-109.3693918
38894,2,31,15,0,5,22,75,38.25165718649962,-109.3691223
38895,1,29,14,1,10,20,75,38.25165718649962,-109.3688528
38896,2,27,15,3,12,16,75,38.25165718649962,-109.3685833
38897,3,23,13,6,14,10,69,38.25165718649962,-109.3683138
38898,3,20,13,9,16,5,66,38.25165718649962,-109.3680443
38899,2,16,13,13,18,3,65,38.25165718649962,-109.3677748
38900,3,23,14,6,16,7,69,38.25165718649962,-109.3675053
38901,1,29,15,0,10,20,75,38.25165718649962,-109.3672358
38902,0,24,14,0,4,26,68,38.25165718649962,-109.3669663
38903,1,21,14,0,2,26,64,38.25165718649962,-109.3666968
38904,1,19,14,0,1,26,61,38.25165718649962,-109.3664273
38905,1,19,14,0,1,26,61,38.25165718649962,-109.3661578
38906,1,20,14,0,1,25,61,38.25165718649962,-109.3658883
38907,1,21,14,0,1,25,62,38.25165718649962,-109.3656188
38908,1,21,14,0,1,26,63,38.25165718649962,-109.3653493
38909,1,20,14,0,0,27,62,38.25165718649962,-109.3650799
38910,1,21,14,0,1,27,64,38.25165718649962,-109.3648104
38911,1,19,15,1,0,28,64,38.25165718649962,-109.3645409
38912,1,19,16,0,0,29,65,38.25165718649962,-109.3642714
38913,1,20,16,0,0,30,67,38.25165718649962,-109.3640019
38914,1,21,17,0,0,32,71,38.25165718649962,-109.3637324
38915,1,22,17,0,2,32,74,38.25165718649962,-109.3634629
38916,1,24,17,0,4,30,76,38.25165718649962,-109.3631934
38917,0,24,17,0,4,30,75,38.25165718649962,-109.3629239
38918,0,22,16,0,3,30,71,38.25165718649962,-109.3626544
38919,1,24,17,0,3,31,76,38.25165718649962,-109.3623849
38920,0,22,18,0,2,33,75,38.25165718649962,-109.3621154
38921,0,22,18,0,2,33,75,38.25165718649962,-109.3618459
38922,0,22,17,0,2,32,73,38.25165718649962,-109.3615764
38923,0,22,17,0,3,30,72,38.25165718649962,-109.3613069
38924,0,20,17,0,2,31,70,38.25165718649962,-109.3610374
38925,0,21,16,0,1,30,68,38.25165718649962,-109.3607679
38926,0,21,16,0,0,29,66,38.25165718649962,-109.3604984
38927,0,21,15,0,0,29,65,38.25165718649962,-109.360229
38928,0,23,14,1,0,27,65,38.25165718649962,-109.3599595
38929,1,24,14,0,0,27,66,38.25165718649962,-109.35969
38930,1,22,14,0,0,27,64,38.25165718649962,-109.3594205
38931,1,23,14,0,1,25,64,38.25165718649962,-109.359151
38932,1,24,12,0,2,22,61,38.25165718649962,-109.3588815
38933,0,26,11,1,6,17,61,38.25165718649962,-109.358612
38934,0,25,11,1,3,18,58,38.25165718649962,-109.3583425
38935,1,23,11,1,3,19,58,38.25165718649962,-109.358073
38936,1,19,13,0,2,22,57,38.25165718649962,-109.3578035
38937,1,17,14,0,1,25,58,38.25165718649962,-109.357534
38938,1,19,14,0,1,27,62,38.25165718649962,-109.3572645
38939,1,21,15,0,0,28,65,38.25165718649962,-109.356995
38940,0,19,15,0,1,27,62,38.25165718649962,-109.3567255
38941,0,18,15,0,1,26,60,38.25165718649962,-109.356456
38942,1,18,14,0,1,25,59,38.25165718649962,-109.3561865
38943,1,18,12,1,3,20,55,38.25165718649962,-109.355917
38944,5,21,7,4,5,10,52,38.25165718649962,-109.3556475
38945,3,23,7,4,7,7,51,38.25165718649962,-109.355378
38946,2,31,7,5,8,5,58,38.25165718649962,-109.3551086
38947,2,41,7,3,9,5,67,38.25165718649962,-109.3548391
38948,3,45,7,4,11,5,75,38.25165718649962,-109.3545696
38949,2,33,7,3,10,6,61,38.25165718649962,-109.3543001
38950,2,27,7,3,8,7,54,38.25165718649962,-109.3540306
38951,1,27,8,4,8,9,57,38.25165718649962,-109.3537611
38952,3,23,9,5,6,10,56,38.25165718649962,-109.3534916
38953,1,21,9,5,6,12,54,38.25165718649962,-109.3532221
38954,0,19,10,3,5,14,51,38.25165718649962,-109.3529526
38955,2,23,9,4,8,10,56,38.25165718649962,-109.3526831
38956,3,29,7,6,8,6,59,38.25165718649962,-109.3524136
38957,5,30,6,5,9,4,59,38.25165718649962,-109.3521441
38958,3,26,8,4,8,9,58,38.25165718649962,-109.3518746
38959,1,21,10,2,5,13,52,38.25165718649962,-109.3516051
38960,2,24,10,4,8,7,55,38.25165718649962,-109.3513356
38961,1,28,7,4,7,4,51,38.25165718649962,-109.3510661
38962,2,25,7,4,8,4,50,38.25165718649962,-109.3507966
38963,3,22,10,9,10,3,57,38.25165718649962,-109.3505271
38964,2,21,10,13,13,4,63,38.25165718649962,-109.3502577
38965,4,23,9,15,18,1,70,38.25165718649962,-109.3499882
38966,3,25,9,7,8,6,58,38.25165718649962,-109.3497187
38967,2,21,10,5,8,11,57,38.25165718649962,-109.3494492
38968,2,20,11,3,5,17,58,38.25165718649962,-109.3491797
38969,1,19,13,1,3,23,60,38.25165718649962,-109.3489102
38970,2,23,14,2,4,23,68,38.25165718649962,-109.3486407
38971,17,31,16,7,12,1,84,38.25165718649962,-109.3483712
38972,5,45,9,9,9,1,78,38.25165718649962,-109.3481017
38973,3,40,7,3,6,3,62,38.25165718649962,-109.3478322
38974,4,32,5,1,6,3,51,38.25165718649962,-109.3475627
38975,4,30,7,3,7,3,54,38.25165718649962,-109.3472932
38976,4,30,7,5,7,3,56,38.25165718649962,-109.3470237
38977,6,25,8,7,7,4,57,38.25165718649962,-109.3467542
38978,3,29,10,15,12,2,71,38.25165718649962,-109.3464847
38979,2,26,10,14,10,5,67,38.25165718649962,-109.3462152
38980,3,20,11,4,7,13,58,38.25165718649962,-109.3459457
38981,3,22,10,6,7,10,58,38.25165718649962,-109.3456762
38982,3,27,10,7,8,7,62,38.25165718649962,-109.3454068
38983,1,29,9,5,10,6,60,38.25165718649962,-109.3451373
38984,3,39,9,3,12,4,70,38.25165718649962,-109.3448678
38985,2,36,9,3,13,5,68,38.25165718649962,-109.3445983
38986,2,35,8,2,11,6,64,38.25165718649962,-109.3443288
38987,1,33,7,2,10,6,59,38.25165718649962,-109.3440593
38988,2,29,7,3,10,6,57,38.25165718649962,-109.3437898
38989,3,34,7,4,9,4,61,38.25165718649962,-109.3435203
38990,4,33,7,4,9,4,61,38.25165718649962,-109.3432508
38991,3,26,8,4,7,6,54,38.25165718649962,-109.3429813
38992,3,26,8,5,6,6,54,38.25165718649962,-109.3427118
38993,2,24,8,4,5,8,51,38.25165718649962,-109.3424423
38994,2,24,10,3,5,9,53,38.25165718649962,-109.3421728
38995,3,21,10,4,6,9,53,38.25165718649962,-109.3419033
38996,3,20,10,4,6,8,51,38.25165718649962,-109.3416338
38997,2,23,8,4,6,7,50,38.25165718649962,-109.3413643
38998,2,30,6,4,8,4,54,38.25165718649962,-109.3410948
38999,2,32,6,3,7,4,54,38.25165718649962,-109.3408253
39000,3,32,6,4,7,3,55,38.25165718649962,-109.3405558
39001,2,27,7,6,7,4,53,38.25165718649962,-109.3402864
39002,2,24,9,5,8,7,55,38.25165718649962,-109.3400169
39003,2,24,11,3,8,11,59,38.25165718649962,-109.3397474
39004,2,24,12,2,7,15,62,38.25165718649962,-109.3394779
39005,2,25,12,2,6,16,63,38.25165718649962,-109.3392084
39006,2,27,12,2,7,14,64,38.25165718649962,-109.3389389
39007,2,32,12,1,7,11,65,38.25165718649962,-109.3386694
39008,4,29,11,4,8,8,64,38.25165718649962,-109.3383999
39009,2,28,10,4,6,8,58,38.25165718649962,-109.3381304
39010,2,26,10,5,7,7,57,38.25165718649962,-109.3378609
39011,4,23,9,6,10,5,57,38.25165718649962,-109.3375914
39012,4,20,11,9,12,5,61,38.25165718649962,-109.3373219
39013,5,20,14,22,20,5,86,38.25165718649962,-109.3370524
39014,3,12,13,24,23,10,85,38.25165718649962,-109.3367829
39015,2,8,11,25,18,11,75,38.25165718649962,-109.3365134
39016,2,13,11,17,10,8,61,38.25165718649962,-109.3362439
39017,1,20,10,14,13,5,63,38.25165718649962,-109.3359744
39018,2,21,10,7,13,7,60,38.25165718649962,-109.3357049
39019,1,19,11,5,11,12,59,38.25165718649962,-109.3354355
39020,2,20,12,4,8,15,61,38.25165718649962,-109.335166
39021,2,24,11,1,5,17,60,38.25165718649962,-109.3348965
39022,2,31,9,0,11,9,62,38.25165718649962,-109.334627
39023,1,34,8,0,12,8,63,38.25165718649962,-109.3343575
39024,1,28,9,0,10,10,58,38.25165718649962,-109.334088
39025,1,26,10,0,7,15,59,38.25165718649962,-109.3338185
39026,2,28,13,0,3,21,67,38.25165718649962,-109.333549
39027,2,27,11,0,3,19,62,38.25165718649962,-109.3332795
39028,1,27,11,0,3,19,61,38.25165718649962,-109.33301
39029,2,29,11,0,4,18,64,38.25165718649962,-109.3327405
39030,2,32,11,0,5,17,67,38.25165718649962,-109.332471
39031,2,37,10,0,8,13,70,38.25165718649962,-109.3322015
39032,1,37,10,0,6,15,69,38.25165718649962,-109.331932
39033,2,33,11,0,7,17,70,38.25165718649962,-109.3316625
39034,2,30,11,0,7,19,69,38.25165718649962,-109.331393
39035,3,53,10,5,16,1,88,38.25138769191438,-109.4402688
39036,2,52,11,2,16,5,88,38.25138769191438,-109.4399993
39037,2,50,11,1,14,8,86,38.25138769191438,-109.4397299
39038,2,48,11,0,13,9,83,38.25138769191438,-109.4394604
39039,2,42,11,0,13,11,79,38.25138769191438,-109.4391909
39040,3,37,11,0,9,13,73,38.25138769191438,-109.4389214
39041,1,32,11,0,8,15,67,38.25138769191438,-109.4386519
39042,1,33,11,3,11,12,71,38.25138769191438,-109.4383824
39043,1,31,10,1,10,11,64,38.25138769191438,-109.4381129
39044,2,30,10,7,11,6,66,38.25138769191438,-109.4378434
39045,8,36,11,10,14,1,80,38.25138769191438,-109.4375739
39046,9,40,12,12,14,1,88,38.25138769191438,-109.4373044
39047,8,43,12,11,14,1,89,38.25138769191438,-109.4370349
39048,5,41,12,10,14,1,83,38.25138769191438,-109.4367654
39049,9,37,13,14,12,1,86,38.25138769191438,-109.4364959
39050,8,37,13,13,13,1,85,38.25138769191438,-109.4362264
39051,7,38,12,10,13,2,82,38.25138769191438,-109.4359569
39052,5,36,11,8,11,4,75,38.25138769191438,-109.4356874
39053,4,30,10,5,8,8,65,38.25138769191438,-109.4354179
39054,2,31,9,4,9,6,61,38.25138769191438,-109.4351484
39055,2,32,8,4,9,5,60,38.25138769191438,-109.434879
39056,4,34,9,5,10,4,66,38.25138769191438,-109.4346095
39057,2,35,9,4,11,6,67,38.25138769191438,-109.43434
39058,2,40,9,3,12,6,72,38.25138769191438,-109.4340705
39059,1,35,9,3,12,8,68,38.25138769191438,-109.433801
39060,1,32,10,1,12,11,67,38.25138769191438,-109.4335315
39061,1,34,9,0,10,12,66,38.25138769191438,-109.433262
39062,1,34,10,0,10,12,67,38.25138769191438,-109.4329925
39063,1,34,9,0,11,11,66,38.25138769191438,-109.432723
39064,0,39,8,0,12,9,68,38.25138769191438,-109.4324535
39065,1,42,9,0,14,6,72,38.25138769191438,-109.432184
39066,2,38,10,2,16,4,72,38.25138769191438,-109.4319145
39067,5,36,10,7,15,3,76,38.25138769191438,-109.431645
39068,8,41,13,11,14,1,88,38.25138769191438,-109.4313755
39069,10,40,15,13,14,1,93,38.25138769191438,-109.431106
39070,12,38,15,13,14,0,92,38.25138769191438,-109.4308365
39071,14,37,14,13,15,0,93,38.25138769191438,-109.430567
39072,7,41,12,10,15,1,86,38.25138769191438,-109.4302975
39073,2,51,9,5,14,2,83,38.25138769191438,-109.430028
39074,1,57,8,4,14,2,86,38.25138769191438,-109.4297586
39075,2,57,9,5,14,2,89,38.25138769191438,-109.4294891
39076,3,51,10,8,13,2,87,38.25138769191438,-109.4292196
39077,4,47,10,9,13,2,85,38.25138769191438,-109.4289501
39078,3,49,10,7,12,2,83,38.25138769191438,-109.4286806
39079,3,48,9,6,12,2,80,38.25138769191438,-109.4284111
39080,3,46,9,7,13,1,79,38.25138769191438,-109.4281416
39081,5,48,10,10,13,1,87,38.25138769191438,-109.4278721
39082,8,45,12,12,13,1,91,38.25138769191438,-109.4276026
39083,10,44,12,13,13,1,93,38.25138769191438,-109.4273331
39084,11,43,13,13,13,1,94,38.25138769191438,-109.4270636
39085,10,41,13,13,13,1,91,38.25138769191438,-109.4267941
39086,9,42,13,13,14,1,92,38.25138769191438,-109.4265246
39087,9,40,14,13,14,1,91,38.25138769191438,-109.4262551
39088,6,47,12,11,13,1,90,38.25138769191438,-109.4259856
39089,3,51,10,6,15,2,87,38.25138769191438,-109.4257161
39090,5,47,11,9,15,0,87,38.25138769191438,-109.4254466
39091,8,44,12,10,14,0,88,38.25138769191438,-109.4251771
39092,10,43,12,11,15,0,91,38.25138769191438,-109.4249077
39093,13,40,13,13,14,0,93,38.25138769191438,-109.4246382
39094,17,37,14,13,13,0,94,38.25138769191438,-109.4243687
39095,17,37,14,13,12,0,93,38.25138769191438,-109.4240992
39096,5,47,10,9,14,1,86,38.25138769191438,-109.4238297
39097,4,50,9,7,13,2,85,38.25138769191438,-109.4235602
39098,4,51,9,6,13,3,86,38.25138769191438,-109.4232907
39099,4,43,10,7,11,4,79,38.25138769191438,-109.4230212
39100,5,39,11,9,11,4,79,38.25138769191438,-109.4227517
39101,8,37,12,11,10,4,82,38.25138769191438,-109.4224822
39102,11,35,14,14,11,2,87,38.25138769191438,-109.4222127
39103,10,36,15,17,11,1,90,38.25138769191438,-109.4219432
39104,7,41,14,15,11,1,89,38.25138769191438,-109.4216737
39105,6,42,13,14,11,1,87,38.25138769191438,-109.4214042
39106,7,43,12,14,11,1,88,38.25138769191438,-109.4211347
39107,8,43,13,15,11,1,91,38.25138769191438,-109.4208652
39108,9,42,13,15,11,1,91,38.25138769191438,-109.4205957
39109,11,42,13,15,10,1,92,38.25138769191438,-109.4203262
39110,15,40,13,13,10,1,92,38.25138769191438,-109.4200568
39111,16,39,13,13,10,1,92,38.25138769191438,-109.4197873
39112,14,39,13,13,10,1,90,38.25138769191438,-109.4195178
39113,13,38,14,14,11,1,91,38.25138769191438,-109.4192483
39114,10,37,15,15,12,2,91,38.25138769191438,-109.4189788
39115,9,36,15,16,12,1,89,38.25138769191438,-109.4187093
39116,8,37,14,15,11,1,86,38.25138769191438,-109.4184398
39117,9,38,15,15,11,1,89,38.25138769191438,-109.4181703
39118,8,38,14,15,11,1,87,38.25138769191438,-109.4179008
39119,7,41,13,13,12,1,87,38.25138769191438,-109.4176313
39120,5,44,13,10,12,2,86,38.25138769191438,-109.4173618
39121,4,46,12,7,12,5,86,38.25138769191438,-109.4170923
39122,4,46,12,6,13,5,86,38.25138769191438,-109.4168228
39123,6,45,12,8,14,3,88,38.25138769191438,-109.4165533
39124,7,45,12,11,13,1,89,38.25138769191438,-109.4162838
39125,8,44,13,12,12,1,90,38.25138769191438,-109.4160143
39126,7,44,12,11,12,1,87,38.25138769191438,-109.4157448
39127,4,45,11,7,11,3,81,38.25138769191438,-109.4154753
39128,2,43,9,3,10,4,71,38.25138769191438,-109.4152058
39129,2,32,9,3,9,6,61,38.25138769191438,-109.4149364
39130,1,30,8,2,9,7,57,38.25138769191438,-109.4146669
39131,1,33,8,1,9,8,60,38.25138769191438,-109.4143974
39132,2,36,9,2,9,10,68,38.25138769191438,-109.4141279
39133,2,41,11,4,15,6,79,38.25138769191438,-109.4138584
39134,3,46,10,4,13,5,81,38.25138769191438,-109.4135889
39135,3,44,10,5,12,5,79,38.25138769191438,-109.4133194
39136,3,38,11,4,11,8,75,38.25138769191438,-109.4130499
39137,4,38,12,3,13,9,79,38.25138769191438,-109.4127804
39138,5,43,11,6,12,4,81,38.25138769191438,-109.4125109
39139,4,44,11,7,10,3,79,38.25138769191438,-109.4122414
39140,5,43,12,7,10,3,80,38.25138769191438,-109.4119719
39141,6,42,12,8,10,3,81,38.25138769191438,-109.4117024
39142,6,43,12,8,10,2,81,38.25138769191438,-109.4114329
39143,5,44,12,8,10,2,81,38.25138769191438,-109.4111634
39144,5,44,12,9,11,2,83,38.25138769191438,-109.4108939
39145,5,44,12,9,11,2,83,38.25138769191438,-109.4106244
39146,6,44,12,9,10,1,82,38.25138769191438,-109.4103549
39147,5,40,10,5,9,3,72,38.25138769191438,-109.4100855
39148,3,35,9,4,10,5,66,38.25138769191438,-109.409816
39149,1,34,8,2,9,6,60,38.25138769191438,-109.4095465
39150,1,35,8,2,9,6,61,38.25138769191438,-109.409277
39151,1,33,8,2,9,6,59,38.25138769191438,-109.4090075
39152,2,33,8,3,9,5,60,38.25138769191438,-109.408738
39153,2,34,8,2,9,5,60,38.25138769191438,-109.4084685
39154,2,35,8,2,9,5,61,38.25138769191438,-109.408199
39155,2,31,8,3,9,5,58,38.25138769191438,-109.4079295
39156,2,34,9,3,10,5,63,38.25138769191438,-109.40766
39157,3,29,11,9,10,5,67,38.25138769191438,-109.4073905
39158,8,24,14,14,12,4,76,38.25138769191438,-109.407121
39159,10,25,15,17,13,4,84,38.25138769191438,-109.4068515
39160,9,26,14,17,14,3,83,38.25138769191438,-109.406582
39161,8,29,14,17,15,3,86,38.25138769191438,-109.4063125
39162,7,33,14,16,14,2,86,38.25138769191438,-109.406043
39163,6,36,12,14,14,2,84,38.25138769191438,-109.4057735
39164,6,37,11,17,14,1,86,38.25138769191438,-109.405504
39165,6,39,12,17,13,1,88,38.25138769191438,-109.4052345
39166,7,41,12,15,13,1,89,38.25138769191438,-109.4049651
39167,6,37,11,11,14,2,81,38.25138769191438,-109.4046956
39168,8,32,12,12,13,3,80,38.25138769191438,-109.4044261
39169,9,30,13,14,12,5,83,38.25138769191438,-109.4041566
39170,8,33,13,9,14,7,84,38.25138769191438,-109.4038871
39171,4,28,13,14,17,6,82,38.25138769191438,-109.4036176
39172,3,23,13,23,18,4,84,38.25138769191438,-109.4033481
39173,3,25,13,16,20,6,83,38.25138769191438,-109.4030786
39174,0,29,14,4,15,15,77,38.25138769191438,-109.4028091
39175,0,33,13,3,16,12,77,38.25138769191438,-109.4025396
39176,1,32,11,5,16,7,72,38.25138769191438,-109.4022701
39177,1,30,11,3,13,9,67,38.25138769191438,-109.4020006
39178,2,32,12,4,12,9,71,38.25138769191438,-109.4017311
39179,2,33,12,4,15,6,72,38.25138769191438,-109.4014616
39180,1,31,12,2,13,12,71,38.25138769191438,-109.4011921
39181,1,33,11,0,11,14,70,38.25138769191438,-109.4009226
39182,2,33,12,1,10,14,72,38.25138769191438,-109.4006531
39183,3,33,12,2,10,13,73,38.25138769191438,-109.4003836
39184,5,39,12,4,13,6,79,38.25138769191438,-109.4001142
39185,3,40,11,1,13,8,76,38.25138769191438,-109.3998447
39186,3,39,11,0,13,9,75,38.25138769191438,-109.3995752
39187,2,36,11,0,13,10,72,38.25138769191438,-109.3993057
39188,2,36,11,1,12,10,72,38.25138769191438,-109.3990362
39189,2,37,10,0,13,9,71,38.25138769191438,-109.3987667
39190,3,36,11,3,14,8,75,38.25138769191438,-109.3984972
39191,4,37,11,5,16,5,78,38.25138769191438,-109.3982277
39192,7,40,12,9,17,1,86,38.25138769191438,-109.3979582
39193,9,42,14,11,16,0,92,38.25138769191438,-109.3976887
39194,5,42,12,9,17,0,85,38.25138769191438,-109.3974192
39195,2,43,11,3,16,4,79,38.25138769191438,-109.3971497
39196,2,40,10,1,15,6,74,38.25138769191438,-109.3968802
39197,3,37,11,3,15,6,75,38.25138769191438,-109.3966107
39198,4,35,11,3,15,7,75,38.25138769191438,-109.3963412
39199,4,38,11,6,18,3,80,38.25138769191438,-109.3960717
39200,4,41,12,6,18,2,83,38.25138769191438,-109.3958022
39201,5,44,12,6,18,1,86,38.25138769191438,-109.3955327
39202,6,47,12,7,18,0,90,38.25138769191438,-109.3952632
39203,6,45,13,8,17,1,90,38.25138769191438,-109.3949938
39204,9,44,14,10,16,0,93,38.25138769191438,-109.3947243
39205,8,42,14,12,15,1,92,38.25138769191438,-109.3944548
39206,8,40,13,13,15,1,90,38.25138769191438,-109.3941853
39207,9,41,14,12,15,0,91,38.25138769191438,-109.3939158
39208,11,39,13,11,15,1,90,38.25138769191438,-109.3936463
39209,14,38,13,11,14,0,90,38.25138769191438,-109.3933768
39210,15,37,13,11,13,0,89,38.25138769191438,-109.3931073
39211,15,38,13,11,14,0,91,38.25138769191438,-109.3928378
39212,15,38,13,11,14,0,91,38.25138769191438,-109.3925683
39213,13,39,13,11,13,1,90,38.25138769191438,-109.3922988
39214,12,39,13,11,13,1,89,38.25138769191438,-109.3920293
39215,13,39,13,11,13,1,90,38.25138769191438,-109.3917598
39216,17,37,13,11,12,1,91,38.25138769191438,-109.3914903
39217,15,37,13,11,13,1,90,38.25138769191438,-109.3912208
39218,16,37,13,11,13,0,90,38.25138769191438,-109.3909513
39219,16,39,13,11,13,0,92,38.25138769191438,-109.3906818
39220,15,39,13,11,14,0,92,38.25138769191438,-109.3904123
39221,16,36,13,13,12,0,90,38.25138769191438,-109.3901429
39222,14,40,13,10,14,0,91,38.25138769191438,-109.3898734
39223,11,39,13,11,14,1,89,38.25138769191438,-109.3896039
39224,12,39,13,12,14,1,91,38.25138769191438,-109.3893344
39225,14,38,13,11,13,1,90,38.25138769191438,-109.3890649
39226,17,36,13,12,12,0,90,38.25138769191438,-109.3887954
39227,16,36,13,13,12,0,90,38.25138769191438,-109.3885259
39228,15,36,13,13,13,0,90,38.25138769191438,-109.3882564
39229,14,36,13,13,13,1,90,38.25138769191438,-109.3879869
39230,14,37,13,11,13,1,89,38.25138769191438,-109.3877174
39231,14,37,14,11,13,1,90,38.25138769191438,-109.3874479
39232,13,37,14,12,13,1,90,38.25138769191438,-109.3871784
39233,13,37,13,13,13,1,90,38.25138769191438,-109.3869089
39234,16,33,12,12,12,1,86,38.25138769191438,-109.3866394
39235,20,31,12,12,12,0,87,38.25138769191438,-109.3863699
39236,18,34,13,13,12,0,90,38.25138769191438,-109.3861004
39237,17,36,13,13,12,0,91,38.25138769191438,-109.3858309
39238,15,38,14,13,12,0,92,38.25138769191438,-109.3855614
39239,13,41,13,12,13,0,92,38.25138769191438,-109.3852919
39240,10,44,13,10,15,0,92,38.25138769191438,-109.3850225
39241,7,42,12,10,16,0,87,38.25138769191438,-109.384753
39242,8,39,13,11,15,1,87,38.25138769191438,-109.3844835
39243,10,39,13,11,14,1,88,38.25138769191438,-109.384214
39244,11,37,13,11,14,3,89,38.25138769191438,-109.3839445
39245,10,36,13,10,15,3,87,38.25138769191438,-109.383675
39246,8,36,13,12,14,3,86,38.25138769191438,-109.3834055
39247,7,35,12,10,14,4,82,38.25138769191438,-109.383136
39248,7,29,12,15,13,2,78,38.25138769191438,-109.3828665
39249,10,21,10,18,15,1,75,38.25138769191438,-109.382597
39250,12,25,12,13,15,2,79,38.25138769191438,-109.3823275
39251,11,30,14,12,11,6,84,38.25138769191438,-109.382058
39252,9,35,14,14,11,5,88,38.25138769191438,-109.3817885
39253,14,34,14,18,10,2,92,38.25138769191438,-109.381519
39254,18,34,14,15,10,1,92,38.25138769191438,-109.3812495
39255,12,39,14,12,11,3,91,38.25138769191438,-109.38098
39256,9,34,13,13,12,4,85,38.25138769191438,-109.3807105
39257,9,23,12,17,14,4,79,38.25138769191438,-109.380441
39258,7,19,12,14,13,7,72,38.25138769191438,-109.3801716
39259,2,27,12,6,11,9,67,38.25138769191438,-109.3799021
39260,3,38,10,4,15,5,75,38.25138769191438,-109.3796326
39261,3,43,11,2,17,5,81,38.25138769191438,-109.3793631
39262,3,46,12,3,17,5,86,38.25138769191438,-109.3790936
39263,5,46,12,3,16,6,88,38.25138769191438,-109.3788241
39264,6,40,12,3,13,8,82,38.25138769191438,-109.3785546
39265,4,43,12,3,14,8,84,38.25138769191438,-109.3782851
39266,3,46,11,2,13,7,82,38.25138769191438,-109.3780156
39267,2,50,9,2,12,6,81,38.25138769191438,-109.3777461
39268,2,53,9,3,12,4,83,38.25138769191438,-109.3774766
39269,2,49,9,2,13,4,79,38.25138769191438,-109.3772071
39270,1,44,9,2,12,7,75,38.25138769191438,-109.3769376
39271,1,40,9,2,10,10,72,38.25138769191438,-109.3766681
39272,1,35,10,3,9,11,69,38.25138769191438,-109.3763986
39273,0,33,10,1,9,13,66,38.25138769191438,-109.3761291
39274,1,41,10,1,14,8,75,38.25138769191438,-109.3758596
39275,1,42,10,1,13,9,76,38.25138769191438,-109.3755901
39276,1,42,9,1,12,10,75,38.25138769191438,-109.3753206
39277,1,42,9,1,11,10,74,38.25138769191438,-109.3750512
39278,1,42,9,1,10,10,73,38.25138769191438,-109.3747817
39279,1,34,10,2,6,14,67,38.25138769191438,-109.3745122
39280,1,25,11,3,5,17,62,38.25138769191438,-109.3742427
39281,1,30,11,2,8,14,66,38.25138769191438,-109.3739732
39282,2,42,10,1,11,9,75,38.25138769191438,-109.3737037
39283,1,44,8,2,11,5,71,38.25138769191438,-109.3734342
39284,1,45,7,2,11,7,73,38.25138769191438,-109.3731647
39285,1,40,7,3,9,6,66,38.25138769191438,-109.3728952
39286,2,43,6,3,9,4,67,38.25138769191438,-109.3726257
39287,1,45,7,4,9,5,71,38.25138769191438,-109.3723562
39288,3,39,8,6,11,7,74,38.25138769191438,-109.3720867
39289,3,32,10,6,8,11,70,38.25138769191438,-109.3718172
39290,1,23,12,6,5,17,64,38.25138769191438,-109.3715477
39291,0,24,11,3,5,17,60,38.25138769191438,-109.3712782
39292,1,27,13,3,7,16,67,38.25138769191438,-109.3710087
39293,2,25,12,4,6,15,64,38.25138769191438,-109.3707392
39294,2,33,10,5,9,11,70,38.25138769191438,-109.3704697
39295,2,43,12,2,10,12,81,38.25138769191438,-109.3702003
39296,1,29,12,1,7,17,67,38.25138769191438,-109.3699308
39297,1,26,14,0,6,22,69,38.25138769191438,-109.3696613
39298,2,30,16,1,5,26,80,38.25138769191438,-109.3693918
39299,2,31,15,0,5,26,79,38.25138769191438,-109.3691223
39300,0,28,13,0,9,20,70,38.25138769191438,-109.3688528
39301,2,29,15,0,11,19,76,38.25138769191438,-109.3685833
39302,4,25,13,4,17,8,71,38.25138769191438,-109.3683138
39303,2,23,13,6,16,8,68,38.25138769191438,-109.3680443
39304,2,22,14,6,15,9,68,38.25138769191438,-109.3677748
39305,5,27,15,2,14,11,74,38.25138769191438,-109.3675053
39306,2,25,13,0,4,22,66,38.25138769191438,-109.3672358
39307,1,23,15,0,2,26,67,38.25138769191438,-109.3669663
39308,1,21,14,0,1,26,63,38.25138769191438,-109.3666968
39309,2,21,14,0,1,24,62,38.25138769191438,-109.3664273
39310,1,20,14,0,2,24,61,38.25138769191438,-109.3661578
39311,2,19,14,0,2,24,61,38.25138769191438,-109.3658883
39312,2,19,15,0,2,25,63,38.25138769191438,-109.3656188
39313,2,20,15,0,1,27,65,38.25138769191438,-109.3653493
39314,2,21,16,0,1,28,68,38.25138769191438,-109.3650799
39315,1,22,14,0,1,27,65,38.25138769191438,-109.3648104
39316,2,20,16,0,0,29,67,38.25138769191438,-109.3645409
39317,1,21,16,0,0,30,68,38.25138769191438,-109.3642714
39318,1,22,16,0,1,31,71,38.25138769191438,-109.3640019
39319,1,21,17,0,1,32,72,38.25138769191438,-109.3637324
39320,1,20,17,0,0,32,70,38.25138769191438,-109.3634629
39321,0,21,17,0,1,32,71,38.25138769191438,-109.3631934
39322,0,21,17,0,2,33,73,38.25138769191438,-109.3629239
39323,0,22,18,0,2,34,76,38.25138769191438,-109.3626544
39324,1,22,19,0,2,35,79,38.25138769191438,-109.3623849
39325,0,21,19,0,2,35,77,38.25138769191438,-109.3621154
39326,1,22,18,0,2,32,75,38.25138769191438,-109.3618459
39327,1,23,17,0,2,31,74,38.25138769191438,-109.3615764
39328,0,22,16,0,1,31,70,38.25138769191438,-109.3613069
39329,0,20,16,0,2,30,68,38.25138769191438,-109.3610374
39330,1,22,15,0,2,28,68,38.25138769191438,-109.3607679
39331,1,25,13,0,2,24,65,38.25138769191438,-109.3604984
39332,1,29,12,0,4,19,65,38.25138769191438,-109.360229
39333,1,29,10,1,6,16,63,38.25138769191438,-109.3599595
39334,1,26,11,1,4,20,63,38.25138769191438,-109.35969
39335,0,23,13,0,1,25,62,38.25138769191438,-109.3594205
39336,0,24,14,0,0,27,65,38.25138769191438,-109.359151
39337,0,26,13,0,1,26,66,38.25138769191438,-109.3588815
39338,1,32,12,0,3,20,68,38.25138769191438,-109.358612
39339,0,26,12,0,2,22,62,38.25138769191438,-109.3583425
39340,0,25,12,0,2,22,61,38.25138769191438,-109.358073
39341,1,21,13,0,3,22,60,38.25138769191438,-109.3578035
39342,1,19,13,0,2,23,58,38.25138769191438,-109.357534
39343,1,19,12,0,3,21,56,38.25138769191438,-109.3572645
39344,1,20,13,0,2,23,59,38.25138769191438,-109.356995
39345,1,19,13,1,3,22,59,38.25138769191438,-109.3567255
39346,2,19,12,1,4,19,57,38.25138769191438,-109.356456
39347,1,20,11,1,3,19,55,38.25138769191438,-109.3561865
39348,3,21,8,2,4,13,51,38.25138769191438,-109.355917
39349,3,31,6,5,7,6,58,38.25138769191438,-109.3556475
39350,2,35,6,5,8,4,60,38.25138769191438,-109.355378
39351,2,38,7,4,9,5,65,38.25138769191438,-109.3551086
39352,3,37,7,4,9,5,65,38.25138769191438,-109.3548391
39353,2,30,7,5,9,6,59,38.25138769191438,-109.3545696
39354,2,28,8,5,9,7,59,38.25138769191438,-109.3543001
39355,3,29,8,3,8,8,59,38.25138769191438,-109.3540306
39356,1,29,9,3,7,10,59,38.25138769191438,-109.3537611
39357,2,26,10,2,7,11,58,38.25138769191438,-109.3534916
39358,3,28,12,2,8,12,65,38.25138769191438,-109.3532221
39359,3,20,12,2,4,17,58,38.25138769191438,-109.3529526
39360,2,21,11,4,4,16,58,38.25138769191438,-109.3526831
39361,4,27,9,5,9,8,62,38.25138769191438,-109.3524136
39362,3,35,7,5,9,5,64,38.25138769191438,-109.3521441
39363,2,26,7,4,8,8,55,38.25138769191438,-109.3518746
39364,4,23,8,3,6,10,54,38.25138769191438,-109.3516051
39365,1,21,9,4,6,8,49,38.25138769191438,-109.3513356
39366,2,29,8,4,8,4,55,38.25138769191438,-109.3510661
39367,3,26,7,5,9,3,53,38.25138769191438,-109.3507966
39368,3,22,12,10,11,4,62,38.25138769191438,-109.3505271
39369,1,21,10,17,17,4,70,38.25138769191438,-109.3502577
39370,3,22,10,14,15,2,66,38.25138769191438,-109.3499882
39371,6,27,9,8,10,4,64,38.25138769191438,-109.3497187
39372,2,20,12,4,7,15,60,38.25138769191438,-109.3494492
39373,2,18,13,3,4,21,61,38.25138769191438,-109.3491797
39374,2,19,13,1,3,24,62,38.25138769191438,-109.3489102
39375,5,22,16,3,2,23,71,38.25138769191438,-109.3486407
39376,17,40,12,11,7,0,87,38.25138769191438,-109.3483712
39377,3,41,6,5,6,3,64,38.25138769191438,-109.3481017
39378,2,35,4,0,5,4,50,38.25138769191438,-109.3478322
39379,4,32,5,2,6,3,52,38.25138769191438,-109.3475627
39380,4,34,7,4,7,3,59,38.25138769191438,-109.3472932
39381,7,27,7,6,7,2,56,38.25138769191438,-109.3470237
39382,2,25,9,9,8,5,58,38.25138769191438,-109.3467542
39383,2,28,10,15,13,4,72,38.25138769191438,-109.3464847
39384,2,22,11,8,8,13,64,38.25138769191438,-109.3462152
39385,5,22,12,3,6,15,63,38.25138769191438,-109.3459457
39386,3,24,10,7,7,7,58,38.25138769191438,-109.3456762
39387,5,35,10,7,5,6,68,38.25138769191438,-109.3454068
39388,3,43,8,7,8,2,71,38.25138769191438,-109.3451373
39389,7,46,7,6,9,1,76,38.25138769191438,-109.3448678
39390,3,40,7,6,9,3,68,38.25138769191438,-109.3445983
39391,3,39,6,6,8,3,65,38.25138769191438,-109.3443288
39392,2,25,8,4,7,6,52,38.25138769191438,-109.3440593
39393,2,24,9,5,6,7,53,38.25138769191438,-109.3437898
39394,3,27,8,5,6,6,55,38.25138769191438,-109.3435203
39395,3,26,8,5,6,6,54,38.25138769191438,-109.3432508
39396,2,25,8,4,6,7,52,38.25138769191438,-109.3429813
39397,2,25,8,4,6,6,51,38.25138769191438,-109.3427118
39398,2,25,8,3,6,7,51,38.25138769191438,-109.3424423
39399,3,27,10,3,7,7,57,38.25138769191438,-109.3421728
39400,2,23,8,5,7,6,51,38.25138769191438,-109.3419033
39401,1,20,7,5,7,6,46,38.25138769191438,-109.3416338
39402,1,20,7,5,8,6,47,38.25138769191438,-109.3413643
39403,1,20,8,5,8,5,47,38.25138769191438,-109.3410948
39404,2,26,8,5,7,5,53,38.25138769191438,-109.3408253
39405,2,26,9,6,6,7,56,38.25138769191438,-109.3405558
39406,2,25,9,4,7,8,55,38.25138769191438,-109.3402864
39407,2,22,10,5,9,9,57,38.25138769191438,-109.3400169
39408,4,24,11,4,9,9,61,38.25138769191438,-109.3397474
39409,3,21,11,4,7,12,58,38.25138769191438,-109.3394779
39410,4,26,11,6,9,9,65,38.25138769191438,-109.3392084
39411,3,31,11,4,9,9,67,38.25138769191438,-109.3389389
39412,4,34,11,4,8,7,68,38.25138769191438,-109.3386694
39413,5,26,11,5,9,7,63,38.25138769191438,-109.3383999
39414,2,24,9,5,7,7,54,38.25138769191438,-109.3381304
39415,1,22,9,5,8,6,51,38.25138769191438,-109.3378609
39416,1,18,9,5,9,6,48,38.25138769191438,-109.3375914
39417,4,16,12,9,12,5,58,38.25138769191438,-109.3373219
39418,4,19,12,31,19,2,87,38.25138769191438,-109.3370524
39419,3,11,10,24,26,7,81,38.25138769191438,-109.3367829
39420,4,12,11,19,17,9,72,38.25138769191438,-109.3365134
39421,3,19,10,12,12,9,65,38.25138769191438,-109.3362439
39422,1,21,10,10,10,11,63,38.25138769191438,-109.3359744
39423,1,24,11,4,12,12,64,38.25138769191438,-109.3357049
39424,2,21,11,4,9,14,61,38.25138769191438,-109.3354355
39425,2,22,11,3,9,13,60,38.25138769191438,-109.335166
39426,2,24,10,2,8,12,58,38.25138769191438,-109.3348965
39427,1,35,8,0,11,8,63,38.25138769191438,-109.334627
39428,0,40,8,0,13,6,67,38.25138769191438,-109.3343575
39429,2,33,9,0,12,7,63,38.25138769191438,-109.334088
39430,2,29,10,1,9,11,62,38.25138769191438,-109.3338185
39431,3,31,11,0,6,16,67,38.25138769191438,-109.333549
39432,2,29,11,1,5,16,64,38.25138769191438,-109.3332795
39433,1,29,10,0,6,16,62,38.25138769191438,-109.33301
39434,1,33,10,0,6,15,65,38.25138769191438,-109.3327405
39435,2,35,10,0,7,14,68,38.25138769191438,-109.332471
39436,1,40,8,0,11,9,69,38.25138769191438,-109.3322015
39437,1,33,8,1,8,9,60,38.25138769191438,-109.331932
39438,1,28,8,3,11,6,57,38.25138769191438,-109.3316625
39439,1,31,9,3,11,8,63,38.25138769191438,-109.331393
39440,3,51,10,6,16,1,87,38.25111819732915,-109.4402688
39441,2,46,11,3,16,6,84,38.25111819732915,-109.4399993
39442,2,41,12,1,15,9,80,38.25111819732915,-109.4397299
39443,2,39,12,1,15,10,79,38.25111819732915,-109.4394604
39444,1,36,11,0,12,14,74,38.25111819732915,-109.4391909
39445,1,33,10,0,11,12,67,38.25111819732915,-109.4389214
39446,1,32,10,2,11,10,66,38.25111819732915,-109.4386519
39447,1,33,11,4,13,9,71,38.25111819732915,-109.4383824
39448,2,31,11,5,14,8,71,38.25111819732915,-109.4381129
39449,4,39,11,6,14,4,78,38.25111819732915,-109.4378434
39450,6,41,12,12,13,1,85,38.25111819732915,-109.4375739
39451,8,40,13,14,13,1,89,38.25111819732915,-109.4373044
39452,11,39,13,13,13,0,89,38.25111819732915,-109.4370349
39453,9,40,13,13,13,1,89,38.25111819732915,-109.4367654
39454,8,40,13,13,13,1,88,38.25111819732915,-109.4364959
39455,8,40,13,13,13,1,88,38.25111819732915,-109.4362264
39456,8,39,13,13,13,1,87,38.25111819732915,-109.4359569
39457,9,38,13,11,12,1,84,38.25111819732915,-109.4356874
39458,7,37,12,9,12,3,80,38.25111819732915,-109.4354179
39459,3,34,10,6,10,7,70,38.25111819732915,-109.4351484
39460,4,36,10,5,9,8,72,38.25111819732915,-109.434879
39461,4,31,12,4,10,12,73,38.25111819732915,-109.4346095
39462,1,28,13,2,8,19,71,38.25111819732915,-109.43434
39463,1,30,12,4,14,11,72,38.25111819732915,-109.4340705
39464,2,35,11,2,13,11,74,38.25111819732915,-109.433801
39465,2,36,10,0,10,13,71,38.25111819732915,-109.4335315
39466,2,34,10,0,8,14,68,38.25111819732915,-109.433262
39467,2,37,9,0,11,10,69,38.25111819732915,-109.4329925
39468,3,35,9,1,9,10,67,38.25111819732915,-109.432723
39469,1,37,9,1,11,8,67,38.25111819732915,-109.4324535
39470,1,41,9,1,14,6,72,38.25111819732915,-109.432184
39471,1,40,9,0,13,7,70,38.25111819732915,-109.4319145
39472,4,38,9,4,13,5,73,38.25111819732915,-109.431645
39473,8,40,13,10,15,1,87,38.25111819732915,-109.4313755
39474,10,39,14,12,14,1,90,38.25111819732915,-109.431106
39475,11,37,14,12,15,1,90,38.25111819732915,-109.4308365
39476,12,37,14,13,14,0,90,38.25111819732915,-109.430567
39477,8,41,12,11,14,1,87,38.25111819732915,-109.4302975
39478,2,52,9,6,14,2,85,38.25111819732915,-109.430028
39479,1,59,8,4,14,2,88,38.25111819732915,-109.4297586
39480,1,60,8,3,14,3,89,38.25111819732915,-109.4294891
39481,2,53,9,5,13,3,85,38.25111819732915,-109.4292196
39482,2,49,9,6,12,2,80,38.25111819732915,-109.4289501
39483,3,46,9,5,11,2,76,38.25111819732915,-109.4286806
39484,3,39,8,5,10,3,68,38.25111819732915,-109.4284111
39485,2,37,8,5,9,3,64,38.25111819732915,-109.4281416
39486,5,41,8,6,10,2,72,38.25111819732915,-109.4278721
39487,9,39,10,7,12,1,78,38.25111819732915,-109.4276026
39488,7,40,10,7,13,1,78,38.25111819732915,-109.4273331
39489,6,44,11,9,13,1,84,38.25111819732915,-109.4270636
39490,7,44,12,11,14,1,89,38.25111819732915,-109.4267941
39491,9,44,13,12,14,1,93,38.25111819732915,-109.4265246
39492,10,41,14,12,13,1,91,38.25111819732915,-109.4262551
39493,8,45,13,11,13,1,91,38.25111819732915,-109.4259856
39494,5,52,11,9,13,1,91,38.25111819732915,-109.4257161
39495,4,52,10,8,14,0,88,38.25111819732915,-109.4254466
39496,5,47,11,9,15,0,87,38.25111819732915,-109.4251771
39497,8,43,12,11,16,0,90,38.25111819732915,-109.4249077
39498,13,41,13,12,14,0,93,38.25111819732915,-109.4246382
39499,14,41,14,12,13,0,94,38.25111819732915,-109.4243687
39500,9,46,12,11,14,0,92,38.25111819732915,-109.4240992
39501,4,50,9,8,13,1,85,38.25111819732915,-109.4238297
39502,3,54,9,6,13,1,86,38.25111819732915,-109.4235602
39503,3,54,9,5,13,3,87,38.25111819732915,-109.4232907
39504,3,48,10,7,12,4,84,38.25111819732915,-109.4230212
39505,6,41,11,10,11,3,82,38.25111819732915,-109.4227517
39506,9,38,13,13,12,1,86,38.25111819732915,-109.4224822
39507,11,35,14,15,11,1,87,38.25111819732915,-109.4222127
39508,10,36,14,15,12,1,88,38.25111819732915,-109.4219432
39509,8,36,13,13,11,1,82,38.25111819732915,-109.4216737
39510,6,39,13,12,11,2,83,38.25111819732915,-109.4214042
39511,6,42,13,13,11,2,87,38.25111819732915,-109.4211347
39512,8,41,13,12,11,2,87,38.25111819732915,-109.4208652
39513,10,41,13,14,11,1,90,38.25111819732915,-109.4205957
39514,11,41,13,15,11,1,92,38.25111819732915,-109.4203262
39515,13,41,13,15,10,1,93,38.25111819732915,-109.4200568
39516,12,40,13,15,10,1,91,38.25111819732915,-109.4197873
39517,12,40,14,15,11,1,93,38.25111819732915,-109.4195178
39518,12,39,14,14,11,1,91,38.25111819732915,-109.4192483
39519,11,38,14,16,12,1,92,38.25111819732915,-109.4189788
39520,8,38,14,16,11,1,88,38.25111819732915,-109.4187093
39521,5,42,14,14,11,2,88,38.25111819732915,-109.4184398
39522,5,42,14,14,11,2,88,38.25111819732915,-109.4181703
39523,6,40,14,14,12,2,88,38.25111819732915,-109.4179008
39524,7,40,13,12,13,2,87,38.25111819732915,-109.4176313
39525,5,41,12,8,13,5,84,38.25111819732915,-109.4173618
39526,3,45,10,3,11,7,79,38.25111819732915,-109.4170923
39527,2,47,9,3,11,6,78,38.25111819732915,-109.4168228
39528,3,43,10,8,12,3,79,38.25111819732915,-109.4165533
39529,3,41,10,7,10,3,74,38.25111819732915,-109.4162838
39530,3,41,9,5,10,4,72,38.25111819732915,-109.4160143
39531,2,39,9,3,10,5,68,38.25111819732915,-109.4157448
39532,2,39,9,2,9,6,67,38.25111819732915,-109.4154753
39533,2,41,9,1,9,6,68,38.25111819732915,-109.4152058
39534,2,35,9,3,9,6,64,38.25111819732915,-109.4149364
39535,2,32,9,3,10,7,63,38.25111819732915,-109.4146669
39536,1,35,9,3,10,8,66,38.25111819732915,-109.4143974
39537,2,39,9,1,10,9,70,38.25111819732915,-109.4141279
39538,3,45,10,6,13,3,80,38.25111819732915,-109.4138584
39539,3,48,9,4,11,4,79,38.25111819732915,-109.4135889
39540,3,42,10,3,10,7,75,38.25111819732915,-109.4133194
39541,2,35,10,2,9,12,70,38.25111819732915,-109.4130499
39542,2,39,11,1,11,11,75,38.25111819732915,-109.4127804
39543,3,41,10,2,11,9,76,38.25111819732915,-109.4125109
39544,3,42,10,4,10,6,75,38.25111819732915,-109.4122414
39545,4,43,10,5,10,5,77,38.25111819732915,-109.4119719
39546,4,41,10,5,9,6,75,38.25111819732915,-109.4117024
39547,4,40,10,5,9,7,75,38.25111819732915,-109.4114329
39548,4,42,10,4,9,7,76,38.25111819732915,-109.4111634
39549,3,41,10,4,11,5,74,38.25111819732915,-109.4108939
39550,3,42,9,4,10,4,72,38.25111819732915,-109.4106244
39551,4,42,9,4,9,3,71,38.25111819732915,-109.4103549
39552,1,37,8,2,9,5,62,38.25111819732915,-109.4100855
39553,1,34,8,1,9,6,59,38.25111819732915,-109.409816
39554,1,30,8,2,9,6,56,38.25111819732915,-109.4095465
39555,2,31,8,3,9,6,59,38.25111819732915,-109.409277
39556,1,33,8,2,9,6,59,38.25111819732915,-109.4090075
39557,1,33,8,3,9,5,59,38.25111819732915,-109.408738
39558,2,29,8,3,10,5,57,38.25111819732915,-109.4084685
39559,3,26,9,5,10,5,58,38.25111819732915,-109.408199
39560,3,26,10,7,11,4,61,38.25111819732915,-109.4079295
39561,4,39,9,8,11,2,73,38.25111819732915,-109.40766
39562,8,34,12,15,13,2,84,38.25111819732915,-109.4073905
39563,11,24,14,21,16,4,90,38.25111819732915,-109.407121
39564,9,19,14,26,19,4,91,38.25111819732915,-109.4068515
39565,7,22,14,26,18,4,91,38.25111819732915,-109.406582
39566,6,24,14,25,17,4,90,38.25111819732915,-109.4063125
39567,6,27,13,24,16,2,88,38.25111819732915,-109.406043
39568,5,27,13,25,14,2,86,38.25111819732915,-109.4057735
39569,5,26,12,28,14,1,86,38.25111819732915,-109.405504
39570,8,25,12,29,12,1,87,38.25111819732915,-109.4052345
39571,10,30,12,29,10,0,91,38.25111819732915,-109.4049651
39572,12,33,11,26,10,0,92,38.25111819732915,-109.4046956
39573,11,32,10,26,11,0,90,38.25111819732915,-109.4044261
39574,9,28,11,25,13,1,87,38.25111819732915,-109.4041566
39575,7,26,11,25,16,1,86,38.25111819732915,-109.4038871
39576,4,25,13,21,20,4,87,38.25111819732915,-109.4036176
39577,2,27,14,11,19,7,80,38.25111819732915,-109.4033481
39578,1,31,14,4,15,14,79,38.25111819732915,-109.4030786
39579,0,32,12,1,14,15,74,38.25111819732915,-109.4028091
39580,1,34,12,3,15,11,76,38.25111819732915,-109.4025396
39581,1,31,11,1,11,15,70,38.25111819732915,-109.4022701
39582,0,28,12,1,9,15,65,38.25111819732915,-109.4020006
39583,1,29,11,2,10,12,65,38.25111819732915,-109.4017311
39584,1,31,11,5,13,7,68,38.25111819732915,-109.4014616
39585,3,35,12,1,12,12,75,38.25111819732915,-109.4011921
39586,3,33,13,0,11,14,74,38.25111819732915,-109.4009226
39587,1,28,12,0,10,13,64,38.25111819732915,-109.4006531
39588,3,30,11,4,11,6,65,38.25111819732915,-109.4003836
39589,2,30,10,7,10,6,65,38.25111819732915,-109.4001142
39590,0,28,11,4,10,11,64,38.25111819732915,-109.3998447
39591,2,32,11,2,13,10,70,38.25111819732915,-109.3995752
39592,3,38,11,3,15,7,77,38.25111819732915,-109.3993057
39593,3,42,11,5,17,3,81,38.25111819732915,-109.3990362
39594,5,41,13,6,19,1,85,38.25111819732915,-109.3987667
39595,6,38,12,5,19,4,84,38.25111819732915,-109.3984972
39596,7,39,12,5,18,3,84,38.25111819732915,-109.3982277
39597,8,42,13,8,18,0,89,38.25111819732915,-109.3979582
39598,8,43,14,11,17,0,93,38.25111819732915,-109.3976887
39599,8,43,14,12,17,0,94,38.25111819732915,-109.3974192
39600,5,43,12,8,17,1,86,38.25111819732915,-109.3971497
39601,4,41,11,4,17,3,80,38.25111819732915,-109.3968802
39602,5,40,11,3,16,4,79,38.25111819732915,-109.3966107
39603,6,34,12,5,16,5,78,38.25111819732915,-109.3963412
39604,7,38,12,6,17,2,82,38.25111819732915,-109.3960717
39605,7,40,12,6,18,1,84,38.25111819732915,-109.3958022
39606,7,43,12,6,18,0,86,38.25111819732915,-109.3955327
39607,8,44,12,8,18,0,90,38.25111819732915,-109.3952632
39608,8,44,13,9,17,1,92,38.25111819732915,-109.3949938
39609,10,41,14,11,15,0,91,38.25111819732915,-109.3947243
39610,10,41,14,12,14,0,91,38.25111819732915,-109.3944548
39611,7,42,14,12,15,1,91,38.25111819732915,-109.3941853
39612,7,43,14,13,15,0,92,38.25111819732915,-109.3939158
39613,8,40,14,11,15,1,89,38.25111819732915,-109.3936463
39614,11,39,14,11,15,0,90,38.25111819732915,-109.3933768
39615,13,38,14,12,14,0,91,38.25111819732915,-109.3931073
39616,14,38,14,12,14,0,92,38.25111819732915,-109.3928378
39617,12,39,13,11,13,1,89,38.25111819732915,-109.3925683
39618,12,39,13,11,14,1,90,38.25111819732915,-109.3922988
39619,11,40,13,11,14,1,90,38.25111819732915,-109.3920293
39620,14,39,13,11,13,1,91,38.25111819732915,-109.3917598
39621,17,37,13,11,12,1,91,38.25111819732915,-109.3914903
39622,17,37,13,11,13,0,91,38.25111819732915,-109.3912208
39623,19,37,13,11,12,0,92,38.25111819732915,-109.3909513
39624,18,37,13,11,12,0,91,38.25111819732915,-109.3906818
39625,17,37,13,12,13,0,92,38.25111819732915,-109.3904123
39626,16,35,13,13,13,0,90,38.25111819732915,-109.3901429
39627,12,39,13,10,14,1,89,38.25111819732915,-109.3898734
39628,12,39,13,11,13,1,89,38.25111819732915,-109.3896039
39629,12,38,13,11,13,1,88,38.25111819732915,-109.3893344
39630,14,37,13,11,13,1,89,38.25111819732915,-109.3890649
39631,15,37,13,12,13,0,90,38.25111819732915,-109.3887954
39632,16,38,13,13,12,0,92,38.25111819732915,-109.3885259
39633,16,39,13,13,12,0,93,38.25111819732915,-109.3882564
39634,15,40,13,11,12,0,91,38.25111819732915,-109.3879869
39635,12,41,13,11,13,1,91,38.25111819732915,-109.3877174
39636,10,42,13,11,13,1,90,38.25111819732915,-109.3874479
39637,10,41,13,11,14,1,90,38.25111819732915,-109.3871784
39638,11,40,13,12,13,1,90,38.25111819732915,-109.3869089
39639,15,36,12,11,12,1,87,38.25111819732915,-109.3866394
39640,14,35,12,11,12,1,85,38.25111819732915,-109.3863699
39641,15,37,13,11,13,0,89,38.25111819732915,-109.3861004
39642,16,38,13,12,12,0,91,38.25111819732915,-109.3858309
39643,15,39,13,12,12,0,91,38.25111819732915,-109.3855614
39644,12,41,14,13,13,0,93,38.25111819732915,-109.3852919
39645,10,44,13,11,14,0,92,38.25111819732915,-109.3850225
39646,9,42,13,11,15,0,90,38.25111819732915,-109.384753
39647,7,39,12,10,15,1,84,38.25111819732915,-109.3844835
39648,6,38,13,10,15,2,84,38.25111819732915,-109.384214
39649,9,40,13,10,16,1,89,38.25111819732915,-109.3839445
39650,12,39,12,11,14,1,89,38.25111819732915,-109.383675
39651,10,36,13,12,14,2,87,38.25111819732915,-109.3834055
39652,10,35,12,13,14,2,86,38.25111819732915,-109.383136
39653,14,27,12,15,14,1,83,38.25111819732915,-109.3828665
39654,16,19,10,21,13,0,79,38.25111819732915,-109.382597
39655,15,23,12,12,11,2,75,38.25111819732915,-109.3823275
39656,11,31,13,10,11,6,82,38.25111819732915,-109.382058
39657,9,37,13,14,12,3,88,38.25111819732915,-109.3817885
39658,17,35,14,16,9,1,92,38.25111819732915,-109.381519
39659,23,32,13,14,8,1,91,38.25111819732915,-109.3812495
39660,14,37,14,13,11,2,91,38.25111819732915,-109.38098
39661,10,38,14,11,13,3,89,38.25111819732915,-109.3807105
39662,8,35,13,10,14,4,84,38.25111819732915,-109.380441
39663,5,29,13,8,13,6,74,38.25111819732915,-109.3801716
39664,4,26,13,6,8,14,71,38.25111819732915,-109.3799021
39665,2,26,13,1,7,18,67,38.25111819732915,-109.3796326
39666,2,36,11,0,10,14,73,38.25111819732915,-109.3793631
39667,0,41,10,0,12,12,75,38.25111819732915,-109.3790936
39668,1,46,9,0,13,9,78,38.25111819732915,-109.3788241
39669,1,49,9,0,15,5,79,38.25111819732915,-109.3785546
39670,0,53,8,2,13,3,79,38.25111819732915,-109.3782851
39671,0,54,7,2,13,3,79,38.25111819732915,-109.3780156
39672,1,52,8,2,13,4,80,38.25111819732915,-109.3777461
39673,1,48,8,2,12,5,76,38.25111819732915,-109.3774766
39674,2,38,11,2,10,13,76,38.25111819732915,-109.3772071
39675,2,33,12,2,9,15,73,38.25111819732915,-109.3769376
39676,3,37,12,1,9,14,76,38.25111819732915,-109.3766681
39677,2,41,11,0,11,12,77,38.25111819732915,-109.3763986
39678,1,39,10,0,10,12,72,38.25111819732915,-109.3761291
39679,1,47,10,0,14,7,79,38.25111819732915,-109.3758596
39680,1,47,9,0,13,8,78,38.25111819732915,-109.3755901
39681,1,45,9,0,12,9,76,38.25111819732915,-109.3753206
39682,1,45,9,0,11,10,76,38.25111819732915,-109.3750512
39683,1,41,10,1,9,12,74,38.25111819732915,-109.3747817
39684,1,36,10,0,9,13,69,38.25111819732915,-109.3745122
39685,1,37,11,0,11,12,72,38.25111819732915,-109.3742427
39686,1,41,10,0,12,10,74,38.25111819732915,-109.3739732
39687,1,44,9,0,12,9,75,38.25111819732915,-109.3737037
39688,2,43,9,2,11,7,74,38.25111819732915,-109.3734342
39689,1,42,8,2,10,10,73,38.25111819732915,-109.3731647
39690,1,38,8,3,11,8,69,38.25111819732915,-109.3728952
39691,2,41,8,4,11,6,72,38.25111819732915,-109.3726257
39692,2,38,9,5,9,10,73,38.25111819732915,-109.3723562
39693,4,30,13,9,10,13,79,38.25111819732915,-109.3720867
39694,8,19,16,6,6,23,78,38.25111819732915,-109.3718172
39695,4,19,17,4,5,25,74,38.25111819732915,-109.3715477
39696,4,25,16,0,5,27,77,38.25111819732915,-109.3712782
39697,3,25,16,0,6,27,77,38.25111819732915,-109.3710087
39698,1,22,17,0,4,30,74,38.25111819732915,-109.3707392
39699,1,24,16,0,5,29,75,38.25111819732915,-109.3704697
39700,2,29,17,0,5,29,82,38.25111819732915,-109.3702003
39701,2,29,16,1,4,29,81,38.25111819732915,-109.3699308
39702,1,29,15,0,6,27,78,38.25111819732915,-109.3696613
39703,2,30,16,1,4,28,81,38.25111819732915,-109.3693918
39704,1,26,14,0,7,24,72,38.25111819732915,-109.3691223
39705,3,24,15,2,9,18,71,38.25111819732915,-109.3688528
39706,1,32,13,0,12,16,74,38.25111819732915,-109.3685833
39707,2,27,12,2,15,9,67,38.25111819732915,-109.3683138
39708,4,25,12,8,11,8,68,38.25111819732915,-109.3680443
39709,1,19,10,6,10,10,56,38.25111819732915,-109.3677748
39710,3,22,11,4,11,11,62,38.25111819732915,-109.3675053
39711,4,23,14,7,3,17,68,38.25111819732915,-109.3672358
39712,1,22,14,0,2,24,63,38.25111819732915,-109.3669663
39713,1,23,14,0,2,25,65,38.25111819732915,-109.3666968
39714,1,22,14,0,1,25,63,38.25111819732915,-109.3664273
39715,1,19,14,0,1,26,61,38.25111819732915,-109.3661578
39716,1,18,16,0,2,29,66,38.25111819732915,-109.3658883
39717,1,19,16,0,1,32,69,38.25111819732915,-109.3656188
39718,1,19,16,0,1,32,69,38.25111819732915,-109.3653493
39719,0,21,16,0,1,31,69,38.25111819732915,-109.3650799
39720,0,21,16,0,1,30,68,38.25111819732915,-109.3648104
39721,0,21,16,0,1,30,68,38.25111819732915,-109.3645409
39722,0,24,16,0,3,30,73,38.25111819732915,-109.3642714
39723,0,24,16,0,3,29,72,38.25111819732915,-109.3640019
39724,0,22,17,0,2,31,72,38.25111819732915,-109.3637324
39725,1,20,17,0,1,31,70,38.25111819732915,-109.3634629
39726,1,22,16,0,1,29,69,38.25111819732915,-109.3631934
39727,1,22,16,0,0,29,68,38.25111819732915,-109.3629239
39728,1,20,17,0,0,31,69,38.25111819732915,-109.3626544
39729,1,20,17,0,1,32,71,38.25111819732915,-109.3623849
39730,1,20,17,0,1,32,71,38.25111819732915,-109.3621154
39731,1,22,17,0,1,33,74,38.25111819732915,-109.3618459
39732,0,22,17,0,0,32,71,38.25111819732915,-109.3615764
39733,0,22,17,0,0,32,71,38.25111819732915,-109.3613069
39734,0,20,16,0,1,31,68,38.25111819732915,-109.3610374
39735,0,25,13,0,3,25,66,38.25111819732915,-109.3607679
39736,0,28,11,0,4,19,62,38.25111819732915,-109.3604984
39737,0,28,11,1,5,16,61,38.25111819732915,-109.360229
39738,1,27,11,1,6,16,62,38.25111819732915,-109.3599595
39739,0,27,12,0,3,22,64,38.25111819732915,-109.35969
39740,0,28,12,1,2,24,67,38.25111819732915,-109.3594205
39741,1,28,12,0,1,24,66,38.25111819732915,-109.359151
39742,1,28,13,0,1,24,67,38.25111819732915,-109.3588815
39743,1,28,13,0,1,23,66,38.25111819732915,-109.358612
39744,0,23,13,0,2,22,60,38.25111819732915,-109.3583425
39745,1,25,12,1,4,19,62,38.25111819732915,-109.358073
39746,0,25,13,0,3,21,62,38.25111819732915,-109.3578035
39747,0,22,14,0,1,26,63,38.25111819732915,-109.357534
39748,2,23,13,1,5,18,62,38.25111819732915,-109.3572645
39749,1,22,12,1,4,19,59,38.25111819732915,-109.356995
39750,1,21,13,1,4,20,60,38.25111819732915,-109.3567255
39751,2,21,12,1,5,19,60,38.25111819732915,-109.356456
39752,1,22,11,1,5,16,56,38.25111819732915,-109.3561865
39753,2,26,6,3,6,9,52,38.25111819732915,-109.355917
39754,2,30,6,4,8,4,54,38.25111819732915,-109.3556475
39755,2,32,6,5,8,4,57,38.25111819732915,-109.355378
39756,3,26,7,4,8,7,55,38.25111819732915,-109.3551086
39757,3,30,8,6,8,8,63,38.25111819732915,-109.3548391
39758,2,28,8,5,8,10,61,38.25111819732915,-109.3545696
39759,1,31,8,4,9,9,62,38.25111819732915,-109.3543001
39760,1,32,8,2,9,8,60,38.25111819732915,-109.3540306
39761,1,29,9,3,10,7,59,38.25111819732915,-109.3537611
39762,1,28,10,3,10,9,61,38.25111819732915,-109.3534916
39763,1,31,10,1,10,12,65,38.25111819732915,-109.3532221
39764,1,31,10,1,6,14,63,38.25111819732915,-109.3529526
39765,1,31,10,1,6,14,63,38.25111819732915,-109.3526831
39766,6,30,12,6,9,6,69,38.25111819732915,-109.3524136
39767,1,40,7,3,9,7,67,38.25111819732915,-109.3521441
39768,2,28,7,4,9,7,57,38.25111819732915,-109.3518746
39769,5,24,8,5,7,8,57,38.25111819732915,-109.3516051
39770,1,22,9,4,7,7,50,38.25111819732915,-109.3513356
39771,1,27,7,4,8,5,52,38.25111819732915,-109.3510661
39772,2,27,7,5,9,3,53,38.25111819732915,-109.3507966
39773,3,19,12,9,13,6,62,38.25111819732915,-109.3505271
39774,2,20,11,19,17,4,73,38.25111819732915,-109.3502577
39775,2,23,9,13,12,3,62,38.25111819732915,-109.3499882
39776,6,28,9,8,10,4,65,38.25111819732915,-109.3497187
39777,2,22,11,2,5,17,59,38.25111819732915,-109.3494492
39778,2,21,12,2,4,20,61,38.25111819732915,-109.3491797
39779,2,19,12,2,4,20,59,38.25111819732915,-109.3489102
39780,2,24,13,2,4,20,65,38.25111819732915,-109.3486407
39781,9,46,9,9,9,1,83,38.25111819732915,-109.3483712
39782,3,43,5,2,6,2,61,38.25111819732915,-109.3481017
39783,3,36,6,2,6,3,56,38.25111819732915,-109.3478322
39784,5,33,7,4,7,3,59,38.25111819732915,-109.3475627
39785,6,29,8,9,5,3,60,38.25111819732915,-109.3472932
39786,3,23,10,18,11,1,66,38.25111819732915,-109.3470237
39787,1,23,10,16,14,5,69,38.25111819732915,-109.3467542
39788,1,24,11,9,10,14,69,38.25111819732915,-109.3464847
39789,1,22,11,4,7,18,63,38.25111819732915,-109.3462152
39790,2,22,11,2,5,18,60,38.25111819732915,-109.3459457
39791,4,28,10,7,9,6,64,38.25111819732915,-109.3456762
39792,10,44,6,7,5,2,74,38.25111819732915,-109.3454068
39793,6,42,6,6,6,1,67,38.25111819732915,-109.3451373
39794,4,34,7,5,8,3,61,38.25111819732915,-109.3448678
39795,6,28,8,6,7,6,61,38.25111819732915,-109.3445983
39796,7,28,7,6,6,6,60,38.25111819732915,-109.3443288
39797,3,19,9,5,7,8,51,38.25111819732915,-109.3440593
39798,2,19,10,3,7,10,51,38.25111819732915,-109.3437898
39799,3,24,9,4,7,8,55,38.25111819732915,-109.3435203
39800,3,20,10,4,5,10,52,38.25111819732915,-109.3432508
39801,2,20,11,3,5,11,52,38.25111819732915,-109.3429813
39802,2,22,10,3,5,11,53,38.25111819732915,-109.3427118
39803,5,23,9,4,3,11,55,38.25111819732915,-109.3424423
39804,7,28,8,7,6,4,60,38.25111819732915,-109.3421728
39805,3,28,4,4,6,4,49,38.25111819732915,-109.3419033
39806,2,23,6,3,5,5,44,38.25111819732915,-109.3416338
39807,4,27,7,4,5,4,51,38.25111819732915,-109.3413643
39808,4,31,7,4,6,4,56,38.25111819732915,-109.3410948
39809,2,27,7,5,7,5,53,38.25111819732915,-109.3408253
39810,2,27,7,6,7,5,54,38.25111819732915,-109.3405558
39811,3,27,8,6,7,5,56,38.25111819732915,-109.3402864
39812,2,26,10,5,9,7,59,38.25111819732915,-109.3400169
39813,4,24,11,4,9,11,63,38.25111819732915,-109.3397474
39814,4,27,11,5,8,11,66,38.25111819732915,-109.3394779
39815,3,30,10,5,8,7,63,38.25111819732915,-109.3392084
39816,3,27,9,4,7,6,56,38.25111819732915,-109.3389389
39817,2,25,9,5,8,6,55,38.25111819732915,-109.3386694
39818,2,20,10,4,6,9,51,38.25111819732915,-109.3383999
39819,2,22,10,4,8,7,53,38.25111819732915,-109.3381304
39820,1,23,10,5,7,6,52,38.25111819732915,-109.3378609
39821,1,20,10,6,8,7,52,38.25111819732915,-109.3375914
39822,4,21,12,11,13,4,65,38.25111819732915,-109.3373219
39823,2,13,11,32,22,2,82,38.25111819732915,-109.3370524
39824,2,9,10,18,20,9,68,38.25111819732915,-109.3367829
39825,4,10,11,15,14,10,64,38.25111819732915,-109.3365134
39826,3,20,10,12,13,9,67,38.25111819732915,-109.3362439
39827,1,27,10,5,13,13,69,38.25111819732915,-109.3359744
39828,2,30,12,5,12,13,74,38.25111819732915,-109.3357049
39829,1,26,12,3,10,16,68,38.25111819732915,-109.3354355
39830,2,23,11,2,7,14,59,38.25111819732915,-109.335166
39831,1,22,10,1,8,13,55,38.25111819732915,-109.3348965
39832,0,34,9,0,11,9,63,38.25111819732915,-109.334627
39833,0,43,8,0,14,5,70,38.25111819732915,-109.3343575
39834,1,44,7,0,14,5,71,38.25111819732915,-109.334088
39835,2,41,8,0,14,5,70,38.25111819732915,-109.3338185
39836,3,36,10,1,10,9,69,38.25111819732915,-109.333549
39837,2,32,10,1,7,13,65,38.25111819732915,-109.3332795
39838,1,32,9,1,7,13,63,38.25111819732915,-109.33301
39839,1,36,9,0,8,12,66,38.25111819732915,-109.3327405
39840,1,38,8,0,8,11,66,38.25111819732915,-109.332471
39841,1,37,8,0,10,10,66,38.25111819732915,-109.3322015
39842,1,33,9,3,9,8,63,38.25111819732915,-109.331932
39843,1,43,7,3,11,4,69,38.25111819732915,-109.3316625
39844,1,46,7,3,11,3,71,38.25111819732915,-109.331393
39845,3,47,11,7,17,1,86,38.25084870274391,-109.4402688
39846,6,47,12,6,18,1,90,38.25084870274391,-109.4399993
39847,5,46,13,5,19,3,91,38.25084870274391,-109.4397299
39848,3,43,12,0,17,7,82,38.25084870274391,-109.4394604
39849,2,41,12,0,16,11,82,38.25084870274391,-109.4391909
39850,2,39,10,0,12,9,72,38.25084870274391,-109.4389214
39851,1,32,10,2,10,11,66,38.25084870274391,-109.4386519
39852,1,32,11,3,12,9,68,38.25084870274391,-109.4383824
39853,2,35,11,3,13,8,72,38.25084870274391,-109.4381129
39854,4,43,12,9,15,1,84,38.25084870274391,-109.4378434
39855,5,42,13,16,13,1,90,38.25084870274391,-109.4375739
39856,8,39,14,18,13,0,92,38.25084870274391,-109.4373044
39857,10,38,14,16,13,0,91,38.25084870274391,-109.4370349
39858,8,40,13,14,13,1,89,38.25084870274391,-109.4367654
39859,6,41,13,14,12,1,87,38.25084870274391,-109.4364959
39860,6,41,13,13,12,1,86,38.25084870274391,-109.4362264
39861,8,39,14,14,13,1,89,38.25084870274391,-109.4359569
39862,9,38,14,14,13,1,89,38.25084870274391,-109.4356874
39863,6,42,12,10,12,2,84,38.25084870274391,-109.4354179
39864,4,43,12,5,13,6,83,38.25084870274391,-109.4351484
39865,3,36,11,2,11,13,76,38.25084870274391,-109.434879
39866,2,27,12,2,8,17,68,38.25084870274391,-109.4346095
39867,1,25,12,1,8,18,65,38.25084870274391,-109.43434
39868,1,32,11,1,13,11,69,38.25084870274391,-109.4340705
39869,3,40,11,4,14,8,80,38.25084870274391,-109.433801
39870,3,42,11,4,15,6,81,38.25084870274391,-109.4335315
39871,3,40,11,4,15,6,79,38.25084870274391,-109.433262
39872,3,39,10,4,14,6,76,38.25084870274391,-109.4329925
39873,2,36,10,4,13,7,72,38.25084870274391,-109.432723
39874,2,38,9,4,14,5,72,38.25084870274391,-109.4324535
39875,2,41,9,4,16,4,76,38.25084870274391,-109.432184
39876,2,43,9,2,16,4,76,38.25084870274391,-109.4319145
39877,2,39,9,3,15,4,72,38.25084870274391,-109.431645
39878,8,38,11,9,14,1,81,38.25084870274391,-109.4313755
39879,10,37,13,11,15,1,87,38.25084870274391,-109.431106
39880,11,37,13,12,15,1,89,38.25084870274391,-109.4308365
39881,11,39,13,12,14,1,90,38.25084870274391,-109.430567
39882,9,40,12,11,13,1,86,38.25084870274391,-109.4302975
39883,6,46,11,9,13,1,86,38.25084870274391,-109.430028
39884,4,50,10,8,13,1,86,38.25084870274391,-109.4297586
39885,3,52,10,7,12,2,86,38.25084870274391,-109.4294891
39886,3,50,10,7,12,2,84,38.25084870274391,-109.4292196
39887,2,44,9,6,11,2,74,38.25084870274391,-109.4289501
39888,6,38,9,5,11,2,71,38.25084870274391,-109.4286806
39889,7,32,9,6,11,3,68,38.25084870274391,-109.4284111
39890,6,30,10,7,12,4,69,38.25084870274391,-109.4281416
39891,8,34,9,7,10,2,70,38.25084870274391,-109.4278721
39892,7,35,9,6,11,2,70,38.25084870274391,-109.4276026
39893,6,34,9,6,12,3,70,38.25084870274391,-109.4273331
39894,5,39,10,7,13,2,76,38.25084870274391,-109.4270636
39895,5,45,11,10,14,1,86,38.25084870274391,-109.4267941
39896,6,46,12,10,13,1,88,38.25084870274391,-109.4265246
39897,7,45,12,10,13,1,88,38.25084870274391,-109.4262551
39898,10,42,13,13,13,1,92,38.25084870274391,-109.4259856
39899,12,40,13,13,13,0,91,38.25084870274391,-109.4257161
39900,10,43,13,12,14,0,92,38.25084870274391,-109.4254466
39901,4,51,10,6,16,1,88,38.25084870274391,-109.4251771
39902,3,49,10,5,15,2,84,38.25084870274391,-109.4249077
39903,4,49,10,9,15,1,88,38.25084870274391,-109.4246382
39904,5,50,11,9,14,1,90,38.25084870274391,-109.4243687
39905,4,54,9,7,13,1,88,38.25084870274391,-109.4240992
39906,2,54,8,5,12,1,82,38.25084870274391,-109.4238297
39907,2,54,8,5,12,1,82,38.25084870274391,-109.4235602
39908,2,54,9,5,13,3,86,38.25084870274391,-109.4232907
39909,3,52,9,6,13,4,87,38.25084870274391,-109.4230212
39910,6,44,11,9,12,3,85,38.25084870274391,-109.4227517
39911,9,39,13,13,12,1,87,38.25084870274391,-109.4224822
39912,7,39,13,13,12,1,85,38.25084870274391,-109.4222127
39913,6,37,12,10,12,2,79,38.25084870274391,-109.4219432
39914,8,33,12,10,12,2,77,38.25084870274391,-109.4216737
39915,9,32,13,13,12,1,80,38.25084870274391,-109.4214042
39916,9,38,14,15,12,1,89,38.25084870274391,-109.4211347
39917,10,41,14,14,12,1,92,38.25084870274391,-109.4208652
39918,9,42,13,14,11,2,91,38.25084870274391,-109.4205957
39919,9,42,13,15,11,1,91,38.25084870274391,-109.4203262
39920,11,42,14,15,10,1,93,38.25084870274391,-109.4200568
39921,10,41,14,16,11,1,93,38.25084870274391,-109.4197873
39922,10,39,14,16,11,1,91,38.25084870274391,-109.4195178
39923,9,39,14,15,12,2,91,38.25084870274391,-109.4192483
39924,9,38,14,15,12,2,90,38.25084870274391,-109.4189788
39925,10,38,14,16,12,1,91,38.25084870274391,-109.4187093
39926,10,40,15,16,13,1,95,38.25084870274391,-109.4184398
39927,8,41,14,15,13,1,92,38.25084870274391,-109.4181703
39928,6,42,13,12,13,2,88,38.25084870274391,-109.4179008
39929,4,40,12,8,13,4,81,38.25084870274391,-109.4176313
39930,3,38,12,5,11,9,78,38.25084870274391,-109.4173618
39931,2,39,11,2,10,11,75,38.25084870274391,-109.4170923
39932,1,39,10,1,11,10,72,38.25084870274391,-109.4168228
39933,1,35,10,2,10,10,68,38.25084870274391,-109.4165533
39934,1,38,9,1,9,9,67,38.25084870274391,-109.4162838
39935,1,37,9,2,9,7,65,38.25084870274391,-109.4160143
39936,2,38,9,3,9,7,68,38.25084870274391,-109.4157448
39937,2,40,9,2,10,7,70,38.25084870274391,-109.4154753
39938,2,39,10,3,12,7,73,38.25084870274391,-109.4152058
39939,2,38,11,4,12,8,75,38.25084870274391,-109.4149364
39940,2,37,10,2,10,9,70,38.25084870274391,-109.4146669
39941,1,37,9,1,9,10,67,38.25084870274391,-109.4143974
39942,2,38,9,3,9,7,68,38.25084870274391,-109.4141279
39943,3,41,9,5,11,3,72,38.25084870274391,-109.4138584
39944,4,43,9,4,12,3,75,38.25084870274391,-109.4135889
39945,3,42,10,3,13,6,77,38.25084870274391,-109.4133194
39946,3,40,11,2,11,10,77,38.25084870274391,-109.4130499
39947,3,42,11,3,12,7,78,38.25084870274391,-109.4127804
39948,3,44,10,2,9,8,76,38.25084870274391,-109.4125109
39949,3,43,9,3,9,6,73,38.25084870274391,-109.4122414
39950,3,43,9,3,9,5,72,38.25084870274391,-109.4119719
39951,3,42,9,3,9,6,72,38.25084870274391,-109.4117024
39952,3,41,9,3,10,6,72,38.25084870274391,-109.4114329
39953,3,41,8,2,9,6,69,38.25084870274391,-109.4111634
39954,2,39,8,3,10,5,67,38.25084870274391,-109.4108939
39955,2,38,8,3,9,5,65,38.25084870274391,-109.4106244
39956,3,39,8,2,8,4,64,38.25084870274391,-109.4103549
39957,1,34,7,2,9,5,58,38.25084870274391,-109.4100855
39958,2,26,9,5,10,5,57,38.25084870274391,-109.409816
39959,4,22,11,9,10,6,62,38.25084870274391,-109.4095465
39960,5,24,11,11,10,5,66,38.25084870274391,-109.409277
39961,3,26,10,9,11,6,65,38.25084870274391,-109.4090075
39962,3,27,11,8,10,6,65,38.25084870274391,-109.408738
39963,5,23,11,11,10,6,66,38.25084870274391,-109.4084685
39964,7,20,12,12,10,6,67,38.25084870274391,-109.408199
39965,7,26,13,13,11,5,75,38.25084870274391,-109.4079295
39966,4,40,11,17,12,1,85,38.25084870274391,-109.40766
39967,6,31,12,19,13,2,83,38.25084870274391,-109.4073905
39968,6,27,13,20,17,5,88,38.25084870274391,-109.407121
39969,2,24,14,19,20,8,87,38.25084870274391,-109.4068515
39970,3,24,14,22,19,5,87,38.25084870274391,-109.406582
39971,5,24,14,22,15,6,86,38.25084870274391,-109.4063125
39972,7,25,14,23,16,5,90,38.25084870274391,-109.406043
39973,3,23,16,25,17,6,90,38.25084870274391,-109.4057735
39974,2,23,16,23,18,10,92,38.25084870274391,-109.405504
39975,3,22,16,23,17,10,91,38.25084870274391,-109.4052345
39976,2,21,15,22,16,7,83,38.25084870274391,-109.4049651
39977,3,26,13,23,16,4,85,38.25084870274391,-109.4046956
39978,2,29,13,20,17,2,83,38.25084870274391,-109.4044261
39979,3,27,12,21,18,2,83,38.25084870274391,-109.4041566
39980,1,30,14,14,19,5,83,38.25084870274391,-109.4038871
39981,1,29,14,16,19,4,83,38.25084870274391,-109.4036176
39982,0,29,14,4,14,15,76,38.25084870274391,-109.4033481
39983,0,29,13,0,11,19,72,38.25084870274391,-109.4030786
39984,0,30,13,0,11,19,73,38.25084870274391,-109.4028091
39985,0,31,12,3,12,13,71,38.25084870274391,-109.4025396
39986,0,31,11,3,14,10,69,38.25084870274391,-109.4022701
39987,0,31,11,4,13,10,69,38.25084870274391,-109.4020006
39988,1,31,11,5,12,10,70,38.25084870274391,-109.4017311
39989,1,30,11,2,12,10,66,38.25084870274391,-109.4014616
39990,3,32,12,2,14,9,72,38.25084870274391,-109.4011921
39991,3,33,12,1,13,10,72,38.25084870274391,-109.4009226
39992,1,31,11,0,15,10,68,38.25084870274391,-109.4006531
39993,0,32,11,2,14,9,68,38.25084870274391,-109.4003836
39994,2,34,11,4,14,7,72,38.25084870274391,-109.4001142
39995,2,32,12,4,14,9,73,38.25084870274391,-109.3998447
39996,2,31,11,3,14,10,71,38.25084870274391,-109.3995752
39997,3,32,12,5,15,9,76,38.25084870274391,-109.3993057
39998,3,32,12,4,15,8,74,38.25084870274391,-109.3990362
39999,8,37,12,6,17,3,83,38.25084870274391,-109.3987667
40000,7,34,12,6,17,5,81,38.25084870274391,-109.3984972
40001,7,33,12,7,17,4,80,38.25084870274391,-109.3982277
40002,9,37,13,10,18,1,88,38.25084870274391,-109.3979582
40003,10,41,14,10,17,0,92,38.25084870274391,-109.3976887
40004,11,41,14,10,16,1,93,38.25084870274391,-109.3974192
40005,7,41,13,6,17,3,87,38.25084870274391,-109.3971497
40006,6,39,12,5,16,4,82,38.25084870274391,-109.3968802
40007,10,37,12,7,16,3,85,38.25084870274391,-109.3966107
40008,13,35,13,10,16,1,88,38.25084870274391,-109.3963412
40009,12,37,13,9,16,1,88,38.25084870274391,-109.3960717
40010,13,37,13,10,16,0,89,38.25084870274391,-109.3958022
40011,14,38,13,10,15,0,90,38.25084870274391,-109.3955327
40012,14,39,14,10,15,0,92,38.25084870274391,-109.3952632
40013,12,40,14,10,16,0,92,38.25084870274391,-109.3949938
40014,13,39,14,12,15,0,93,38.25084870274391,-109.3947243
40015,10,40,14,13,15,0,92,38.25084870274391,-109.3944548
40016,7,43,14,13,15,0,92,38.25084870274391,-109.3941853
40017,7,43,14,11,14,1,90,38.25084870274391,-109.3939158
40018,9,41,14,11,15,1,91,38.25084870274391,-109.3936463
40019,12,40,14,11,14,0,91,38.25084870274391,-109.3933768
40020,13,38,14,12,13,0,90,38.25084870274391,-109.3931073
40021,13,38,14,12,14,0,91,38.25084870274391,-109.3928378
40022,11,40,13,11,14,1,90,38.25084870274391,-109.3925683
40023,12,39,13,11,14,1,90,38.25084870274391,-109.3922988
40024,13,39,13,10,14,1,90,38.25084870274391,-109.3920293
40025,16,39,13,10,12,1,91,38.25084870274391,-109.3917598
40026,18,38,13,11,12,0,92,38.25084870274391,-109.3914903
40027,20,37,13,11,11,0,92,38.25084870274391,-109.3912208
40028,18,37,13,11,12,0,91,38.25084870274391,-109.3909513
40029,17,37,13,11,12,0,90,38.25084870274391,-109.3906818
40030,15,38,13,11,13,0,90,38.25084870274391,-109.3904123
40031,13,38,13,11,14,1,90,38.25084870274391,-109.3901429
40032,11,40,13,10,14,1,89,38.25084870274391,-109.3898734
40033,10,39,13,10,14,1,87,38.25084870274391,-109.3896039
40034,10,38,13,11,13,2,87,38.25084870274391,-109.3893344
40035,10,38,13,11,14,1,87,38.25084870274391,-109.3890649
40036,13,40,13,11,14,0,91,38.25084870274391,-109.3887954
40037,15,40,13,12,13,0,93,38.25084870274391,-109.3885259
40038,15,41,14,12,12,0,94,38.25084870274391,-109.3882564
40039,14,43,13,11,12,0,93,38.25084870274391,-109.3879869
40040,12,44,13,10,13,0,92,38.25084870274391,-109.3877174
40041,10,43,13,11,14,1,92,38.25084870274391,-109.3874479
40042,11,44,13,10,14,0,92,38.25084870274391,-109.3871784
40043,12,43,12,10,14,0,91,38.25084870274391,-109.3869089
40044,12,40,12,10,13,1,88,38.25084870274391,-109.3866394
40045,14,37,12,11,13,1,88,38.25084870274391,-109.3863699
40046,14,39,12,10,13,0,88,38.25084870274391,-109.3861004
40047,15,38,13,11,12,0,89,38.25084870274391,-109.3858309
40048,15,39,13,12,12,0,91,38.25084870274391,-109.3855614
40049,12,42,13,11,13,0,91,38.25084870274391,-109.3852919
40050,9,45,13,11,14,0,92,38.25084870274391,-109.3850225
40051,8,42,13,13,14,1,91,38.25084870274391,-109.384753
40052,6,40,12,10,15,2,85,38.25084870274391,-109.3844835
40053,5,39,12,9,15,2,82,38.25084870274391,-109.384214
40054,7,42,12,9,15,1,86,38.25084870274391,-109.3839445
40055,6,43,12,9,15,1,86,38.25084870274391,-109.383675
40056,6,36,12,9,15,3,81,38.25084870274391,-109.3834055
40057,8,34,13,10,13,5,83,38.25084870274391,-109.383136
40058,11,27,12,13,11,5,79,38.25084870274391,-109.3828665
40059,14,22,11,14,12,2,75,38.25084870274391,-109.382597
40060,14,25,12,11,11,3,76,38.25084870274391,-109.3823275
40061,13,34,12,9,11,3,82,38.25084870274391,-109.382058
40062,9,38,13,10,13,3,86,38.25084870274391,-109.3817885
40063,10,39,14,12,12,3,90,38.25084870274391,-109.381519
40064,16,34,14,13,9,3,89,38.25084870274391,-109.3812495
40065,17,35,14,12,10,3,91,38.25084870274391,-109.38098
40066,16,38,14,12,11,2,93,38.25084870274391,-109.3807105
40067,14,41,13,10,12,1,91,38.25084870274391,-109.380441
40068,7,41,13,8,15,3,87,38.25084870274391,-109.3801716
40069,6,29,12,6,11,9,73,38.25084870274391,-109.3799021
40070,3,27,12,6,10,11,69,38.25084870274391,-109.3796326
40071,2,40,10,6,14,4,76,38.25084870274391,-109.3793631
40072,1,47,9,7,12,2,78,38.25084870274391,-109.3790936
40073,1,48,8,3,13,3,76,38.25084870274391,-109.3788241
40074,1,55,8,2,11,3,80,38.25084870274391,-109.3785546
40075,1,53,7,2,11,5,79,38.25084870274391,-109.3782851
40076,1,48,8,2,11,5,75,38.25084870274391,-109.3780156
40077,1,46,9,3,12,5,76,38.25084870274391,-109.3777461
40078,3,44,10,5,16,3,81,38.25084870274391,-109.3774766
40079,1,40,11,2,15,7,76,38.25084870274391,-109.3772071
40080,1,40,11,2,14,9,77,38.25084870274391,-109.3769376
40081,1,43,11,1,15,8,79,38.25084870274391,-109.3766681
40082,1,46,10,1,15,7,80,38.25084870274391,-109.3763986
40083,2,43,11,0,11,12,79,38.25084870274391,-109.3761291
40084,1,44,11,0,12,10,78,38.25084870274391,-109.3758596
40085,1,43,10,1,14,8,77,38.25084870274391,-109.3755901
40086,1,44,9,1,12,8,75,38.25084870274391,-109.3753206
40087,1,43,10,1,11,11,77,38.25084870274391,-109.3750512
40088,1,41,10,0,9,13,74,38.25084870274391,-109.3747817
40089,1,39,10,0,11,12,73,38.25084870274391,-109.3745122
40090,1,42,10,0,12,10,75,38.25084870274391,-109.3742427
40091,2,43,10,1,11,10,77,38.25084870274391,-109.3739732
40092,1,42,10,0,11,11,75,38.25084870274391,-109.3737037
40093,3,44,10,4,12,7,80,38.25084870274391,-109.3734342
40094,3,36,11,4,9,12,75,38.25084870274391,-109.3731647
40095,3,26,14,8,9,15,75,38.25084870274391,-109.3728952
40096,7,20,15,9,10,15,76,38.25084870274391,-109.3726257
40097,11,20,16,8,10,17,82,38.25084870274391,-109.3723562
40098,15,20,14,6,14,18,87,38.25084870274391,-109.3720867
40099,12,22,14,6,13,17,84,38.25084870274391,-109.3718172
40100,4,22,15,3,7,24,75,38.25084870274391,-109.3715477
40101,1,29,15,0,7,26,78,38.25084870274391,-109.3712782
40102,1,26,15,0,7,25,74,38.25084870274391,-109.3710087
40103,1,27,15,0,9,22,74,38.25084870274391,-109.3707392
40104,2,30,16,5,4,23,80,38.25084870274391,-109.3704697
40105,3,31,16,5,4,23,82,38.25084870274391,-109.3702003
40106,2,28,16,3,7,25,81,38.25084870274391,-109.3699308
40107,3,27,16,4,3,26,79,38.25084870274391,-109.3696613
40108,4,24,15,6,3,24,76,38.25084870274391,-109.3693918
40109,4,26,14,8,5,18,75,38.25084870274391,-109.3691223
40110,7,30,14,11,5,14,81,38.25084870274391,-109.3688528
40111,7,29,14,6,12,10,78,38.25084870274391,-109.3685833
40112,6,29,13,7,15,7,77,38.25084870274391,-109.3683138
40113,4,27,11,11,13,5,71,38.25084870274391,-109.3680443
40114,0,15,9,15,11,5,55,38.25084870274391,-109.3677748
40115,1,22,11,6,13,11,64,38.25084870274391,-109.3675053
40116,8,24,12,13,7,12,76,38.25084870274391,-109.3672358
40117,6,25,13,7,6,20,77,38.25084870274391,-109.3669663
40118,1,23,14,0,1,26,65,38.25084870274391,-109.3666968
40119,1,22,14,0,1,27,65,38.25084870274391,-109.3664273
40120,1,21,14,0,1,26,63,38.25084870274391,-109.3661578
40121,1,22,16,0,2,29,70,38.25084870274391,-109.3658883
40122,1,22,16,0,2,31,72,38.25084870274391,-109.3656188
40123,0,23,17,0,2,31,73,38.25084870274391,-109.3653493
40124,0,22,16,0,2,31,71,38.25084870274391,-109.3650799
40125,0,21,17,0,0,33,71,38.25084870274391,-109.3648104
40126,0,21,16,0,0,31,68,38.25084870274391,-109.3645409
40127,1,22,16,0,1,29,69,38.25084870274391,-109.3642714
40128,1,23,16,0,2,27,69,38.25084870274391,-109.3640019
40129,1,22,16,0,1,28,68,38.25084870274391,-109.3637324
40130,1,21,15,0,1,27,65,38.25084870274391,-109.3634629
40131,1,22,14,0,1,25,63,38.25084870274391,-109.3631934
40132,1,23,14,0,2,24,64,38.25084870274391,-109.3629239
40133,1,21,14,0,1,25,62,38.25084870274391,-109.3626544
40134,1,21,14,0,1,26,63,38.25084870274391,-109.3623849
40135,3,23,15,0,2,26,69,38.25084870274391,-109.3621154
40136,2,25,15,0,1,26,69,38.25084870274391,-109.3618459
40137,0,22,15,0,0,28,65,38.25084870274391,-109.3615764
40138,0,21,15,0,0,29,65,38.25084870274391,-109.3613069
40139,1,28,13,0,2,24,68,38.25084870274391,-109.3610374
40140,0,26,12,0,2,23,63,38.25084870274391,-109.3607679
40141,0,29,11,0,3,18,61,38.25084870274391,-109.3604984
40142,0,28,10,0,5,16,59,38.25084870274391,-109.360229
40143,1,23,13,0,3,22,62,38.25084870274391,-109.3599595
40144,1,21,15,0,1,27,65,38.25084870274391,-109.35969
40145,0,28,12,0,3,23,66,38.25084870274391,-109.3594205
40146,0,24,11,0,2,21,58,38.25084870274391,-109.359151
40147,1,22,11,0,2,20,56,38.25084870274391,-109.3588815
40148,1,22,10,1,3,18,55,38.25084870274391,-109.358612
40149,1,20,10,2,4,16,53,38.25084870274391,-109.3583425
40150,3,17,12,2,5,16,55,38.25084870274391,-109.358073
40151,2,16,13,2,4,20,57,38.25084870274391,-109.3578035
40152,1,18,13,1,3,21,57,38.25084870274391,-109.357534
40153,3,22,12,2,7,15,61,38.25084870274391,-109.3572645
40154,1,24,12,1,5,18,61,38.25084870274391,-109.356995
40155,0,25,13,0,3,23,64,38.25084870274391,-109.3567255
40156,0,22,13,0,2,23,60,38.25084870274391,-109.356456
40157,0,19,12,1,3,19,54,38.25084870274391,-109.3561865
40158,5,35,6,2,7,5,60,38.25084870274391,-109.355917
40159,4,31,6,3,8,4,56,38.25084870274391,-109.3556475
40160,4,26,7,5,8,5,55,38.25084870274391,-109.355378
40161,3,26,9,4,7,9,58,38.25084870274391,-109.3551086
40162,3,28,11,4,5,15,66,38.25084870274391,-109.3548391
40163,2,32,10,3,8,13,68,38.25084870274391,-109.3545696
40164,2,31,9,3,9,8,62,38.25084870274391,-109.3543001
40165,1,28,9,3,9,7,57,38.25084870274391,-109.3540306
40166,1,24,10,4,9,8,56,38.25084870274391,-109.3537611
40167,2,26,10,5,10,7,60,38.25084870274391,-109.3534916
40168,2,32,9,4,11,6,64,38.25084870274391,-109.3532221
40169,1,33,9,2,11,7,63,38.25084870274391,-109.3529526
40170,1,30,10,3,10,10,64,38.25084870274391,-109.3526831
40171,1,37,8,2,9,9,66,38.25084870274391,-109.3524136
40172,1,34,8,4,8,9,64,38.25084870274391,-109.3521441
40173,2,28,8,4,9,8,59,38.25084870274391,-109.3518746
40174,4,25,8,5,7,8,57,38.25084870274391,-109.3516051
40175,3,23,9,5,8,5,53,38.25084870274391,-109.3513356
40176,2,25,8,5,7,5,52,38.25084870274391,-109.3510661
40177,1,28,7,4,9,4,53,38.25084870274391,-109.3507966
40178,3,18,12,11,10,5,59,38.25084870274391,-109.3505271
40179,2,21,9,14,15,4,65,38.25084870274391,-109.3502577
40180,3,26,8,8,9,5,59,38.25084870274391,-109.3499882
40181,7,28,9,8,11,3,66,38.25084870274391,-109.3497187
40182,1,24,11,2,7,15,60,38.25084870274391,-109.3494492
40183,3,26,11,2,8,13,63,38.25084870274391,-109.3491797
40184,2,25,11,3,8,12,61,38.25084870274391,-109.3489102
40185,5,33,8,6,6,9,67,38.25084870274391,-109.3486407
40186,4,50,5,5,8,2,74,38.25084870274391,-109.3483712
40187,3,46,5,2,7,2,65,38.25084870274391,-109.3481017
40188,4,36,6,3,7,3,59,38.25084870274391,-109.3478322
40189,6,32,10,12,8,2,70,38.25084870274391,-109.3475627
40190,4,27,13,23,11,2,80,38.25084870274391,-109.3472932
40191,2,27,9,16,14,2,70,38.25084870274391,-109.3470237
40192,2,28,11,11,13,6,71,38.25084870274391,-109.3467542
40193,1,26,11,3,8,14,63,38.25084870274391,-109.3464847
40194,1,23,11,1,5,17,58,38.25084870274391,-109.3462152
40195,3,26,11,3,7,14,64,38.25084870274391,-109.3459457
40196,5,32,10,4,8,7,66,38.25084870274391,-109.3456762
40197,2,26,8,5,7,6,54,38.25084870274391,-109.3454068
40198,2,19,9,5,7,8,50,38.25084870274391,-109.3451373
40199,7,19,12,5,4,16,63,38.25084870274391,-109.3448678
40200,3,17,15,1,1,24,61,38.25084870274391,-109.3445983
40201,2,16,14,4,4,20,60,38.25084870274391,-109.3443288
40202,3,18,13,5,6,18,63,38.25084870274391,-109.3440593
40203,2,19,12,4,5,17,59,38.25084870274391,-109.3437898
40204,2,23,10,3,6,14,58,38.25084870274391,-109.3435203
40205,2,27,11,4,5,12,61,38.25084870274391,-109.3432508
40206,1,23,11,5,5,10,55,38.25084870274391,-109.3429813
40207,1,20,10,4,5,10,50,38.25084870274391,-109.3427118
40208,4,29,9,7,5,6,60,38.25084870274391,-109.3424423
40209,5,34,6,5,7,3,60,38.25084870274391,-109.3421728
40210,3,35,6,2,6,3,55,38.25084870274391,-109.3419033
40211,4,27,6,3,6,4,50,38.25084870274391,-109.3416338
40212,4,26,7,4,6,5,52,38.25084870274391,-109.3413643
40213,6,29,8,6,6,4,59,38.25084870274391,-109.3410948
40214,3,23,8,7,7,5,53,38.25084870274391,-109.3408253
40215,3,27,9,8,8,5,60,38.25084870274391,-109.3405558
40216,2,28,9,8,8,5,60,38.25084870274391,-109.3402864
40217,2,23,9,9,9,6,58,38.25084870274391,-109.3400169
40218,2,22,10,7,11,8,60,38.25084870274391,-109.3397474
40219,3,29,11,5,12,8,68,38.25084870274391,-109.3394779
40220,3,28,11,4,8,8,62,38.25084870274391,-109.3392084
40221,2,22,10,3,7,10,54,38.25084870274391,-109.3389389
40222,4,23,12,4,9,9,61,38.25084870274391,-109.3386694
40223,4,27,11,3,6,10,61,38.25084870274391,-109.3383999
40224,4,28,10,5,7,6,60,38.25084870274391,-109.3381304
40225,2,28,9,6,7,6,58,38.25084870274391,-109.3378609
40226,2,25,10,8,9,6,60,38.25084870274391,-109.3375914
40227,9,20,11,33,13,0,86,38.25084870274391,-109.3373219
40228,4,8,12,33,17,3,77,38.25084870274391,-109.3370524
40229,2,8,9,18,11,7,55,38.25084870274391,-109.3367829
40230,5,15,11,17,12,7,67,38.25084870274391,-109.3365134
40231,2,22,10,11,12,8,65,38.25084870274391,-109.3362439
40232,1,26,10,5,11,10,63,38.25084870274391,-109.3359744
40233,1,25,11,4,11,13,65,38.25084870274391,-109.3357049
40234,1,21,12,3,8,17,62,38.25084870274391,-109.3354355
40235,1,20,12,2,6,17,58,38.25084870274391,-109.335166
40236,1,21,11,2,6,15,56,38.25084870274391,-109.3348965
40237,0,27,10,0,10,11,58,38.25084870274391,-109.334627
40238,0,44,8,0,13,5,70,38.25084870274391,-109.3343575
40239,1,49,7,1,12,3,73,38.25084870274391,-109.334088
40240,1,47,7,0,13,4,72,38.25084870274391,-109.3338185
40241,1,46,8,0,14,5,74,38.25084870274391,-109.333549
40242,1,43,8,0,13,6,71,38.25084870274391,-109.3332795
40243,0,32,8,0,8,11,59,38.25084870274391,-109.33301
40244,1,36,8,0,7,11,63,38.25084870274391,-109.3327405
40245,1,36,8,0,8,11,64,38.25084870274391,-109.332471
40246,0,36,9,1,11,10,67,38.25084870274391,-109.3322015
40247,1,38,9,2,10,9,69,38.25084870274391,-109.331932
40248,0,45,7,2,11,6,71,38.25084870274391,-109.3316625
40249,0,51,6,2,10,4,73,38.25084870274391,-109.331393
40250,2,42,12,1,16,8,81,38.250579208158676,-109.4402688
40251,2,42,12,2,16,9,83,38.250579208158676,-109.4399993
40252,3,44,12,2,17,7,85,38.250579208158676,-109.4397299
40253,3,43,12,2,17,7,84,38.250579208158676,-109.4394604
40254,2,42,12,0,15,11,82,38.250579208158676,-109.4391909
40255,0,34,11,0,11,15,71,38.250579208158676,-109.4389214
40256,1,34,12,6,13,9,75,38.250579208158676,-109.4386519
40257,2,37,11,6,15,4,75,38.250579208158676,-109.4383824
40258,4,42,11,8,16,1,82,38.250579208158676,-109.4381129
40259,7,45,13,15,13,0,93,38.250579208158676,-109.4378434
40260,9,41,14,17,12,0,93,38.250579208158676,-109.4375739
40261,12,38,14,16,12,0,92,38.250579208158676,-109.4373044
40262,13,38,14,14,13,0,92,38.250579208158676,-109.4370349
40263,10,40,13,13,13,0,89,38.250579208158676,-109.4367654
40264,7,41,14,15,12,1,90,38.250579208158676,-109.4364959
40265,8,40,14,15,13,0,90,38.250579208158676,-109.4362264
40266,8,39,14,14,13,1,89,38.250579208158676,-109.4359569
40267,7,41,14,13,13,1,89,38.250579208158676,-109.4356874
40268,6,46,12,9,13,2,88,38.250579208158676,-109.4354179
40269,4,44,12,5,14,6,85,38.250579208158676,-109.4351484
40270,3,41,11,2,13,10,80,38.250579208158676,-109.434879
40271,2,41,10,0,11,12,76,38.250579208158676,-109.4346095
40272,2,40,10,0,11,11,74,38.250579208158676,-109.43434
40273,2,37,11,3,13,9,75,38.250579208158676,-109.4340705
40274,3,39,10,2,12,9,75,38.250579208158676,-109.433801
40275,2,39,10,3,13,8,75,38.250579208158676,-109.4335315
40276,2,40,10,4,15,6,77,38.250579208158676,-109.433262
40277,3,42,10,4,15,5,79,38.250579208158676,-109.4329925
40278,3,40,10,4,15,6,78,38.250579208158676,-109.432723
40279,4,41,11,7,15,3,81,38.250579208158676,-109.4324535
40280,4,42,11,7,16,2,82,38.250579208158676,-109.432184
40281,3,44,10,6,17,2,82,38.250579208158676,-109.4319145
40282,2,42,9,4,16,3,76,38.250579208158676,-109.431645
40283,3,42,9,5,15,2,76,38.250579208158676,-109.4313755
40284,6,41,10,7,14,1,79,38.250579208158676,-109.431106
40285,7,42,11,8,14,1,83,38.250579208158676,-109.4308365
40286,6,44,11,10,13,1,85,38.250579208158676,-109.430567
40287,8,40,12,11,13,1,85,38.250579208158676,-109.4302975
40288,9,40,12,11,13,1,86,38.250579208158676,-109.430028
40289,10,41,13,11,12,1,88,38.250579208158676,-109.4297586
40290,8,44,12,11,12,1,88,38.250579208158676,-109.4294891
40291,5,46,11,9,12,1,84,38.250579208158676,-109.4292196
40292,4,44,11,9,12,1,81,38.250579208158676,-109.4289501
40293,7,40,11,8,13,1,80,38.250579208158676,-109.4286806
40294,10,36,12,10,13,1,82,38.250579208158676,-109.4284111
40295,15,32,13,13,12,1,86,38.250579208158676,-109.4281416
40296,17,28,15,14,11,1,86,38.250579208158676,-109.4278721
40297,11,32,13,13,12,1,82,38.250579208158676,-109.4276026
40298,8,38,12,11,13,1,83,38.250579208158676,-109.4273331
40299,6,43,11,9,13,1,83,38.250579208158676,-109.4270636
40300,5,45,12,10,13,1,86,38.250579208158676,-109.4267941
40301,5,43,11,9,13,2,83,38.250579208158676,-109.4265246
40302,5,42,11,8,13,1,80,38.250579208158676,-109.4262551
40303,7,41,12,11,14,1,86,38.250579208158676,-109.4259856
40304,10,40,13,13,14,0,90,38.250579208158676,-109.4257161
40305,11,43,13,11,13,0,91,38.250579208158676,-109.4254466
40306,4,55,11,6,14,1,91,38.250579208158676,-109.4251771
40307,2,55,9,4,14,2,86,38.250579208158676,-109.4249077
40308,2,55,9,4,14,2,86,38.250579208158676,-109.4246382
40309,2,55,9,6,13,2,87,38.250579208158676,-109.4243687
40310,4,53,10,7,13,1,88,38.250579208158676,-109.4240992
40311,4,55,9,6,13,1,88,38.250579208158676,-109.4238297
40312,5,52,9,7,12,1,86,38.250579208158676,-109.4235602
40313,4,53,9,7,13,1,87,38.250579208158676,-109.4232907
40314,5,53,10,7,13,2,90,38.250579208158676,-109.4230212
40315,6,44,12,11,12,1,86,38.250579208158676,-109.4227517
40316,8,43,13,12,12,1,89,38.250579208158676,-109.4224822
40317,7,42,13,11,11,1,85,38.250579208158676,-109.4222127
40318,8,37,12,11,11,1,80,38.250579208158676,-109.4219432
40319,11,31,13,13,11,1,80,38.250579208158676,-109.4216737
40320,13,31,15,16,11,1,87,38.250579208158676,-109.4214042
40321,12,37,14,15,12,1,91,38.250579208158676,-109.4211347
40322,10,41,13,14,12,1,91,38.250579208158676,-109.4208652
40323,9,44,13,13,11,1,91,38.250579208158676,-109.4205957
40324,9,46,12,14,10,1,92,38.250579208158676,-109.4203262
40325,10,45,13,14,11,1,94,38.250579208158676,-109.4200568
40326,10,43,13,16,11,1,94,38.250579208158676,-109.4197873
40327,9,42,14,16,11,1,93,38.250579208158676,-109.4195178
40328,9,40,14,16,12,1,92,38.250579208158676,-109.4192483
40329,9,41,14,14,13,1,92,38.250579208158676,-109.4189788
40330,11,39,14,15,13,1,93,38.250579208158676,-109.4187093
40331,14,36,15,16,13,0,94,38.250579208158676,-109.4184398
40332,13,35,14,16,13,0,91,38.250579208158676,-109.4181703
40333,10,38,14,16,13,1,92,38.250579208158676,-109.4179008
40334,6,43,13,12,13,1,88,38.250579208158676,-109.4176313
40335,5,41,12,7,14,4,83,38.250579208158676,-109.4173618
40336,3,41,11,3,12,8,78,38.250579208158676,-109.4170923
40337,2,42,10,1,11,10,76,38.250579208158676,-109.4168228
40338,1,41,10,0,11,12,75,38.250579208158676,-109.4165533
40339,2,38,10,0,9,13,72,38.250579208158676,-109.4162838
40340,2,34,9,1,7,13,66,38.250579208158676,-109.4160143
40341,1,35,9,1,7,11,64,38.250579208158676,-109.4157448
40342,1,37,9,2,9,9,67,38.250579208158676,-109.4154753
40343,2,41,11,4,14,6,78,38.250579208158676,-109.4152058
40344,3,39,11,4,13,8,78,38.250579208158676,-109.4149364
40345,2,40,11,3,12,8,76,38.250579208158676,-109.4146669
40346,2,37,10,4,11,7,71,38.250579208158676,-109.4143974
40347,2,33,9,4,9,7,64,38.250579208158676,-109.4141279
40348,2,36,8,3,9,7,65,38.250579208158676,-109.4138584
40349,3,40,9,5,12,4,73,38.250579208158676,-109.4135889
40350,3,42,9,5,14,4,77,38.250579208158676,-109.4133194
40351,3,42,10,6,13,4,78,38.250579208158676,-109.4130499
40352,3,43,10,6,11,4,77,38.250579208158676,-109.4127804
40353,3,44,9,3,10,5,74,38.250579208158676,-109.4125109
40354,3,39,9,3,10,5,69,38.250579208158676,-109.4122414
40355,2,37,8,3,9,5,64,38.250579208158676,-109.4119719
40356,2,38,9,3,9,5,66,38.250579208158676,-109.4117024
40357,3,37,9,4,10,4,67,38.250579208158676,-109.4114329
40358,2,37,8,2,9,5,63,38.250579208158676,-109.4111634
40359,2,36,8,3,9,5,63,38.250579208158676,-109.4108939
40360,2,36,8,2,9,5,62,38.250579208158676,-109.4106244
40361,2,32,8,3,8,6,59,38.250579208158676,-109.4103549
40362,3,24,9,5,8,8,57,38.250579208158676,-109.4100855
40363,7,21,13,15,11,4,71,38.250579208158676,-109.409816
40364,14,26,14,16,15,2,87,38.250579208158676,-109.4095465
40365,15,27,14,16,15,2,89,38.250579208158676,-109.409277
40366,15,30,14,15,14,2,90,38.250579208158676,-109.4090075
40367,14,28,14,14,14,3,87,38.250579208158676,-109.408738
40368,15,26,14,14,16,4,89,38.250579208158676,-109.4084685
40369,14,28,13,12,15,5,87,38.250579208158676,-109.408199
40370,12,30,14,16,14,3,89,38.250579208158676,-109.4079295
40371,8,30,12,24,10,3,87,38.250579208158676,-109.40766
40372,2,28,12,24,15,2,83,38.250579208158676,-109.4073905
40373,1,26,14,18,15,8,82,38.250579208158676,-109.407121
40374,1,26,16,13,14,12,82,38.250579208158676,-109.4068515
40375,1,27,14,10,16,11,79,38.250579208158676,-109.406582
40376,0,28,15,6,15,12,76,38.250579208158676,-109.4063125
40377,2,29,15,15,18,7,86,38.250579208158676,-109.406043
40378,2,28,15,17,19,6,87,38.250579208158676,-109.4057735
40379,1,28,14,17,20,5,85,38.250579208158676,-109.405504
40380,1,28,14,17,18,5,83,38.250579208158676,-109.4052345
40381,2,26,14,19,18,3,82,38.250579208158676,-109.4049651
40382,2,27,13,14,15,7,78,38.250579208158676,-109.4046956
40383,1,29,14,12,15,8,79,38.250579208158676,-109.4044261
40384,1,30,13,8,18,8,78,38.250579208158676,-109.4041566
40385,0,31,11,2,16,10,70,38.250579208158676,-109.4038871
40386,0,31,12,7,17,7,74,38.250579208158676,-109.4036176
40387,0,30,14,3,14,14,75,38.250579208158676,-109.4033481
40388,0,30,14,0,13,17,74,38.250579208158676,-109.4030786
40389,0,30,14,0,12,17,73,38.250579208158676,-109.4028091
40390,0,30,13,2,14,14,73,38.250579208158676,-109.4025396
40391,0,29,12,2,13,14,70,38.250579208158676,-109.4022701
40392,0,30,12,0,12,15,69,38.250579208158676,-109.4020006
40393,0,31,11,0,10,16,68,38.250579208158676,-109.4017311
40394,0,29,11,0,11,14,65,38.250579208158676,-109.4014616
40395,0,31,11,0,8,16,66,38.250579208158676,-109.4011921
40396,0,32,10,0,10,16,68,38.250579208158676,-109.4009226
40397,1,33,11,0,12,13,70,38.250579208158676,-109.4006531
40398,1,32,11,1,12,13,70,38.250579208158676,-109.4003836
40399,1,29,12,4,13,12,71,38.250579208158676,-109.4001142
40400,5,30,12,6,14,7,74,38.250579208158676,-109.3998447
40401,4,29,11,4,14,9,71,38.250579208158676,-109.3995752
40402,4,28,12,6,14,8,72,38.250579208158676,-109.3993057
40403,7,29,12,9,14,6,77,38.250579208158676,-109.3990362
40404,6,27,12,6,13,9,73,38.250579208158676,-109.3987667
40405,8,27,12,10,13,6,76,38.250579208158676,-109.3984972
40406,12,31,12,14,15,2,86,38.250579208158676,-109.3982277
40407,16,33,13,14,14,0,90,38.250579208158676,-109.3979582
40408,18,35,14,13,14,0,94,38.250579208158676,-109.3976887
40409,16,38,15,12,13,0,94,38.250579208158676,-109.3974192
40410,13,40,14,9,15,1,92,38.250579208158676,-109.3971497
40411,13,40,14,9,15,2,93,38.250579208158676,-109.3968802
40412,13,39,14,11,15,0,92,38.250579208158676,-109.3966107
40413,12,38,14,14,15,0,93,38.250579208158676,-109.3963412
40414,13,37,14,12,16,0,92,38.250579208158676,-109.3960717
40415,14,37,13,11,15,0,90,38.250579208158676,-109.3958022
40416,15,37,13,11,15,0,91,38.250579208158676,-109.3955327
40417,15,37,14,12,15,0,93,38.250579208158676,-109.3952632
40418,13,37,14,11,15,1,91,38.250579208158676,-109.3949938
40419,11,39,14,12,15,0,91,38.250579208158676,-109.3947243
40420,7,41,14,12,15,1,90,38.250579208158676,-109.3944548
40421,7,42,14,11,15,1,90,38.250579208158676,-109.3941853
40422,8,43,14,10,14,1,90,38.250579208158676,-109.3939158
40423,9,42,14,10,15,1,91,38.250579208158676,-109.3936463
40424,11,41,14,11,15,0,92,38.250579208158676,-109.3933768
40425,13,40,14,11,14,0,92,38.250579208158676,-109.3931073
40426,14,39,14,11,13,0,91,38.250579208158676,-109.3928378
40427,11,40,13,10,14,1,89,38.250579208158676,-109.3925683
40428,13,39,14,11,14,0,91,38.250579208158676,-109.3922988
40429,15,40,13,10,13,0,91,38.250579208158676,-109.3920293
40430,16,40,13,10,12,0,91,38.250579208158676,-109.3917598
40431,16,40,13,10,12,0,91,38.250579208158676,-109.3914903
40432,16,39,13,11,12,0,91,38.250579208158676,-109.3912208
40433,14,39,13,11,13,1,91,38.250579208158676,-109.3909513
40434,14,39,13,10,13,1,90,38.250579208158676,-109.3906818
40435,14,39,13,10,13,1,90,38.250579208158676,-109.3904123
40436,14,39,13,11,13,1,91,38.250579208158676,-109.3901429
40437,11,39,13,10,14,1,88,38.250579208158676,-109.3898734
40438,10,39,13,11,14,2,89,38.250579208158676,-109.3896039
40439,10,39,13,11,13,2,88,38.250579208158676,-109.3893344
40440,10,39,13,11,14,1,88,38.250579208158676,-109.3890649
40441,13,39,13,11,14,0,90,38.250579208158676,-109.3887954
40442,14,41,13,11,13,0,92,38.250579208158676,-109.3885259
40443,15,41,13,11,12,0,92,38.250579208158676,-109.3882564
40444,16,41,13,11,11,0,92,38.250579208158676,-109.3879869
40445,15,42,13,11,11,0,92,38.250579208158676,-109.3877174
40446,14,43,13,10,12,0,92,38.250579208158676,-109.3874479
40447,12,44,13,10,13,0,92,38.250579208158676,-109.3871784
40448,12,44,12,9,13,0,90,38.250579208158676,-109.3869089
40449,12,41,11,10,13,1,88,38.250579208158676,-109.3866394
40450,14,38,11,10,13,1,87,38.250579208158676,-109.3863699
40451,15,41,12,9,14,0,91,38.250579208158676,-109.3861004
40452,14,41,12,9,14,0,90,38.250579208158676,-109.3858309
40453,14,42,13,10,13,0,92,38.250579208158676,-109.3855614
40454,12,44,13,10,13,0,92,38.250579208158676,-109.3852919
40455,9,47,13,11,13,0,93,38.250579208158676,-109.3850225
40456,8,44,13,12,14,1,92,38.250579208158676,-109.384753
40457,8,44,12,9,14,1,88,38.250579208158676,-109.3844835
40458,7,41,12,9,14,2,85,38.250579208158676,-109.384214
40459,7,42,12,9,14,1,85,38.250579208158676,-109.3839445
40460,7,46,12,8,15,1,89,38.250579208158676,-109.383675
40461,6,38,11,7,15,3,80,38.250579208158676,-109.3834055
40462,9,30,12,8,12,5,76,38.250579208158676,-109.383136
40463,12,24,12,11,11,5,75,38.250579208158676,-109.3828665
40464,14,21,11,14,12,2,74,38.250579208158676,-109.382597
40465,9,23,11,11,10,4,68,38.250579208158676,-109.3823275
40466,13,31,11,10,11,3,79,38.250579208158676,-109.382058
40467,9,39,12,9,14,3,86,38.250579208158676,-109.3817885
40468,7,41,13,8,13,4,86,38.250579208158676,-109.381519
40469,8,39,14,10,13,4,88,38.250579208158676,-109.3812495
40470,9,38,15,11,12,4,89,38.250579208158676,-109.38098
40471,9,39,15,10,12,5,90,38.250579208158676,-109.3807105
40472,7,41,14,9,13,4,88,38.250579208158676,-109.380441
40473,6,40,13,8,15,4,86,38.250579208158676,-109.3801716
40474,5,40,12,5,16,5,83,38.250579208158676,-109.3799021
40475,8,26,13,7,10,11,75,38.250579208158676,-109.3796326
40476,12,30,13,10,12,5,82,38.250579208158676,-109.3793631
40477,6,34,13,8,13,6,80,38.250579208158676,-109.3790936
40478,3,26,13,9,8,12,71,38.250579208158676,-109.3788241
40479,2,28,14,7,10,15,76,38.250579208158676,-109.3785546
40480,6,21,15,11,11,15,79,38.250579208158676,-109.3782851
40481,6,19,14,11,10,15,75,38.250579208158676,-109.3780156
40482,4,19,14,9,8,16,70,38.250579208158676,-109.3777461
40483,4,25,12,8,10,11,70,38.250579208158676,-109.3774766
40484,1,31,11,3,9,13,68,38.250579208158676,-109.3772071
40485,1,28,12,5,11,11,68,38.250579208158676,-109.3769376
40486,4,32,12,5,11,10,74,38.250579208158676,-109.3766681
40487,5,39,12,4,14,7,81,38.250579208158676,-109.3763986
40488,3,41,11,2,13,9,79,38.250579208158676,-109.3761291
40489,2,42,10,2,11,10,77,38.250579208158676,-109.3758596
40490,3,35,11,6,12,9,76,38.250579208158676,-109.3755901
40491,6,30,11,9,11,9,76,38.250579208158676,-109.3753206
40492,13,24,12,10,12,7,78,38.250579208158676,-109.3750512
40493,12,23,12,11,13,7,78,38.250579208158676,-109.3747817
40494,9,24,12,9,11,9,74,38.250579208158676,-109.3745122
40495,14,26,12,11,14,4,81,38.250579208158676,-109.3742427
40496,14,29,13,11,12,5,84,38.250579208158676,-109.3739732
40497,5,33,13,7,8,14,80,38.250579208158676,-109.3737037
40498,7,33,14,9,9,11,83,38.250579208158676,-109.3734342
40499,10,24,16,7,9,16,82,38.250579208158676,-109.3731647
40500,15,17,16,7,14,17,86,38.250579208158676,-109.3728952
40501,16,15,15,6,18,23,93,38.250579208158676,-109.3726257
40502,16,17,18,2,16,23,92,38.250579208158676,-109.3723562
40503,12,21,16,3,14,22,88,38.250579208158676,-109.3720867
40504,6,20,15,6,8,22,77,38.250579208158676,-109.3718172
40505,4,31,14,4,7,19,79,38.250579208158676,-109.3715477
40506,4,32,14,5,8,15,78,38.250579208158676,-109.3712782
40507,4,30,16,8,4,16,78,38.250579208158676,-109.3710087
40508,4,32,15,14,5,13,83,38.250579208158676,-109.3707392
40509,4,33,13,9,7,12,78,38.250579208158676,-109.3704697
40510,5,31,13,7,10,12,78,38.250579208158676,-109.3702003
40511,6,29,13,6,11,13,78,38.250579208158676,-109.3699308
40512,3,36,14,7,6,16,82,38.250579208158676,-109.3696613
40513,3,34,13,10,5,15,80,38.250579208158676,-109.3693918
40514,7,27,13,17,7,10,81,38.250579208158676,-109.3691223
40515,11,24,11,20,9,6,81,38.250579208158676,-109.3688528
40516,4,31,13,18,9,5,80,38.250579208158676,-109.3685833
40517,3,24,12,15,21,2,77,38.250579208158676,-109.3683138
40518,1,15,11,16,16,4,63,38.250579208158676,-109.3680443
40519,2,14,10,15,13,3,57,38.250579208158676,-109.3677748
40520,6,25,10,12,12,8,73,38.250579208158676,-109.3675053
40521,7,25,11,12,9,12,76,38.250579208158676,-109.3672358
40522,7,25,12,8,8,16,76,38.250579208158676,-109.3669663
40523,1,22,13,0,2,25,63,38.250579208158676,-109.3666968
40524,1,22,14,0,1,26,64,38.250579208158676,-109.3664273
40525,1,21,14,0,1,26,63,38.250579208158676,-109.3661578
40526,1,25,14,0,2,26,68,38.250579208158676,-109.3658883
40527,1,25,16,0,2,30,74,38.250579208158676,-109.3656188
40528,0,23,17,0,1,32,73,38.250579208158676,-109.3653493
40529,0,23,17,0,0,32,72,38.250579208158676,-109.3650799
40530,1,21,16,0,0,30,68,38.250579208158676,-109.3648104
40531,0,20,15,0,0,28,63,38.250579208158676,-109.3645409
40532,1,20,15,0,1,27,64,38.250579208158676,-109.3642714
40533,1,21,14,0,1,26,63,38.250579208158676,-109.3640019
40534,1,22,14,0,2,24,63,38.250579208158676,-109.3637324
40535,1,24,13,0,3,21,62,38.250579208158676,-109.3634629
40536,2,21,13,0,3,20,59,38.250579208158676,-109.3631934
40537,2,20,13,0,3,21,59,38.250579208158676,-109.3629239
40538,1,19,14,0,2,23,59,38.250579208158676,-109.3626544
40539,2,20,14,0,2,24,62,38.250579208158676,-109.3623849
40540,3,25,14,0,2,24,68,38.250579208158676,-109.3621154
40541,1,23,14,0,2,26,66,38.250579208158676,-109.3618459
40542,0,23,14,0,1,27,65,38.250579208158676,-109.3615764
40543,1,24,14,0,1,26,66,38.250579208158676,-109.3613069
40544,3,28,14,0,1,24,70,38.250579208158676,-109.3610374
40545,2,31,12,0,4,19,68,38.250579208158676,-109.3607679
40546,1,32,11,0,4,18,66,38.250579208158676,-109.3604984
40547,1,30,11,0,4,18,64,38.250579208158676,-109.360229
40548,1,25,12,0,4,20,62,38.250579208158676,-109.3599595
40549,1,21,13,0,2,22,59,38.250579208158676,-109.35969
40550,1,24,12,1,4,19,61,38.250579208158676,-109.3594205
40551,1,23,12,1,3,19,59,38.250579208158676,-109.359151
40552,0,19,12,1,3,20,55,38.250579208158676,-109.3588815
40553,1,17,12,3,3,18,54,38.250579208158676,-109.358612
40554,2,20,10,5,5,13,55,38.250579208158676,-109.3583425
40555,1,21,11,3,3,16,55,38.250579208158676,-109.358073
40556,1,21,11,2,3,16,54,38.250579208158676,-109.3578035
40557,1,22,10,4,5,15,57,38.250579208158676,-109.357534
40558,2,19,10,3,5,14,53,38.250579208158676,-109.3572645
40559,3,15,11,3,6,14,52,38.250579208158676,-109.356995
40560,3,18,13,2,6,17,59,38.250579208158676,-109.3567255
40561,1,21,13,2,5,18,60,38.250579208158676,-109.356456
40562,2,22,10,2,6,14,56,38.250579208158676,-109.3561865
40563,5,37,6,1,6,6,61,38.250579208158676,-109.355917
40564,5,28,7,2,8,6,56,38.250579208158676,-109.3556475
40565,4,23,8,3,7,9,54,38.250579208158676,-109.355378
40566,2,23,13,3,3,19,63,38.250579208158676,-109.3551086
40567,1,25,11,1,3,20,61,38.250579208158676,-109.3548391
40568,1,32,11,1,7,14,66,38.250579208158676,-109.3545696
40569,1,27,9,3,9,9,58,38.250579208158676,-109.3543001
40570,2,24,9,4,9,7,55,38.250579208158676,-109.3540306
40571,3,24,8,5,5,9,54,38.250579208158676,-109.3537611
40572,7,32,7,5,7,5,63,38.250579208158676,-109.3534916
40573,2,28,9,4,9,5,57,38.250579208158676,-109.3532221
40574,2,29,9,4,8,5,57,38.250579208158676,-109.3529526
40575,3,30,9,5,9,5,61,38.250579208158676,-109.3526831
40576,2,33,9,5,11,5,65,38.250579208158676,-109.3524136
40577,2,34,9,3,11,7,66,38.250579208158676,-109.3521441
40578,2,28,9,4,9,6,58,38.250579208158676,-109.3518746
40579,1,22,10,5,7,7,52,38.250579208158676,-109.3516051
40580,1,21,9,4,7,7,49,38.250579208158676,-109.3513356
40581,3,26,9,5,10,4,57,38.250579208158676,-109.3510661
40582,2,34,8,4,8,3,59,38.250579208158676,-109.3507966
40583,10,30,12,20,8,4,84,38.250579208158676,-109.3505271
40584,9,28,10,20,10,4,81,38.250579208158676,-109.3502577
40585,5,29,8,9,10,3,64,38.250579208158676,-109.3499882
40586,7,32,10,10,11,1,71,38.250579208158676,-109.3497187
40587,2,27,11,3,9,12,64,38.250579208158676,-109.3494492
40588,2,28,11,2,8,13,64,38.250579208158676,-109.3491797
40589,2,30,10,3,9,10,64,38.250579208158676,-109.3489102
40590,3,35,9,6,8,4,65,38.250579208158676,-109.3486407
40591,1,36,4,2,8,2,53,38.250579208158676,-109.3483712
40592,2,50,4,2,7,2,67,38.250579208158676,-109.3481017
40593,7,35,8,7,8,3,68,38.250579208158676,-109.3478322
40594,6,25,15,19,8,4,77,38.250579208158676,-109.3475627
40595,2,28,9,16,16,1,72,38.250579208158676,-109.3472932
40596,5,28,9,10,11,3,66,38.250579208158676,-109.3470237
40597,2,23,10,5,7,11,58,38.250579208158676,-109.3467542
40598,1,24,12,2,6,16,61,38.250579208158676,-109.3464847
40599,1,29,11,1,7,16,65,38.250579208158676,-109.3462152
40600,4,32,12,2,8,11,69,38.250579208158676,-109.3459457
40601,2,25,11,3,6,11,58,38.250579208158676,-109.3456762
40602,2,22,12,3,5,13,57,38.250579208158676,-109.3454068
40603,2,20,13,3,3,18,59,38.250579208158676,-109.3451373
40604,2,21,14,1,4,23,65,38.250579208158676,-109.3448678
40605,2,18,15,2,3,26,66,38.250579208158676,-109.3445983
40606,3,22,15,1,3,26,70,38.250579208158676,-109.3443288
40607,2,24,13,0,3,24,66,38.250579208158676,-109.3440593
40608,2,24,12,0,4,21,63,38.250579208158676,-109.3437898
40609,2,23,12,1,4,19,61,38.250579208158676,-109.3435203
40610,1,28,11,2,7,16,65,38.250579208158676,-109.3432508
40611,2,23,10,5,6,9,55,38.250579208158676,-109.3429813
40612,2,23,8,6,6,5,50,38.250579208158676,-109.3427118
40613,3,37,6,4,7,3,60,38.250579208158676,-109.3424423
40614,3,42,6,2,6,3,62,38.250579208158676,-109.3421728
40615,3,34,6,4,6,4,57,38.250579208158676,-109.3419033
40616,3,30,8,5,7,6,59,38.250579208158676,-109.3416338
40617,4,25,8,5,6,8,56,38.250579208158676,-109.3413643
40618,1,26,9,6,5,8,55,38.250579208158676,-109.3410948
40619,5,30,10,11,8,4,68,38.250579208158676,-109.3408253
40620,0,23,10,17,12,6,68,38.250579208158676,-109.3405558
40621,1,25,10,16,15,4,71,38.250579208158676,-109.3402864
40622,4,32,12,9,19,2,78,38.250579208158676,-109.3400169
40623,1,24,11,3,8,14,61,38.250579208158676,-109.3397474
40624,5,36,12,7,12,5,77,38.250579208158676,-109.3394779
40625,2,30,10,4,7,8,61,38.250579208158676,-109.3392084
40626,2,25,10,5,9,8,59,38.250579208158676,-109.3389389
40627,6,27,11,5,11,6,66,38.250579208158676,-109.3386694
40628,1,27,10,4,7,10,59,38.250579208158676,-109.3383999
40629,4,29,9,5,9,5,61,38.250579208158676,-109.3381304
40630,4,27,9,8,11,3,62,38.250579208158676,-109.3378609
40631,4,29,12,22,16,1,84,38.250579208158676,-109.3375914
40632,6,9,9,34,24,3,85,38.250579208158676,-109.3373219
40633,3,8,12,28,14,2,67,38.250579208158676,-109.3370524
40634,4,20,12,20,16,4,76,38.250579208158676,-109.3367829
40635,2,24,8,12,14,5,65,38.250579208158676,-109.3365134
40636,2,26,10,9,13,6,66,38.250579208158676,-109.3362439
40637,1,25,11,6,13,8,64,38.250579208158676,-109.3359744
40638,2,21,11,6,11,13,64,38.250579208158676,-109.3357049
40639,1,21,12,5,8,17,64,38.250579208158676,-109.3354355
40640,1,21,12,3,7,16,60,38.250579208158676,-109.335166
40641,1,22,11,1,7,16,58,38.250579208158676,-109.3348965
40642,1,24,11,1,8,15,60,38.250579208158676,-109.334627
40643,0,31,9,1,9,10,60,38.250579208158676,-109.3343575
40644,0,37,8,3,9,6,63,38.250579208158676,-109.334088
40645,0,43,7,2,9,5,66,38.250579208158676,-109.3338185
40646,0,46,7,0,11,5,69,38.250579208158676,-109.333549
40647,1,47,7,0,13,4,72,38.250579208158676,-109.3332795
40648,1,33,7,0,8,10,59,38.250579208158676,-109.33301
40649,0,35,8,0,8,10,61,38.250579208158676,-109.3327405
40650,0,43,7,0,11,8,69,38.250579208158676,-109.332471
40651,0,49,7,0,13,6,75,38.250579208158676,-109.3322015
40652,0,51,7,0,13,5,76,38.250579208158676,-109.331932
40653,0,51,6,0,12,5,74,38.250579208158676,-109.3316625
40654,0,54,6,1,11,4,76,38.250579208158676,-109.331393
40655,2,36,15,2,16,14,85,38.250309713573444,-109.4402688
40656,2,36,15,1,13,16,83,38.250309713573444,-109.4399993
40657,1,36,12,0,12,14,75,38.250309713573444,-109.4397299
40658,2,42,11,0,16,8,79,38.250309713573444,-109.4394604
40659,3,46,12,1,16,7,85,38.250309713573444,-109.4391909
40660,1,35,11,0,9,16,72,38.250309713573444,-109.4389214
40661,2,36,12,3,15,7,75,38.250309713573444,-109.4386519
40662,5,40,12,10,16,1,84,38.250309713573444,-109.4383824
40663,6,42,12,10,15,0,85,38.250309713573444,-109.4381129
40664,11,41,14,13,13,0,92,38.250309713573444,-109.4378434
40665,12,39,14,15,13,0,93,38.250309713573444,-109.4375739
40666,14,37,14,15,13,0,93,38.250309713573444,-109.4373044
40667,16,37,14,14,13,0,94,38.250309713573444,-109.4370349
40668,14,39,14,13,13,0,93,38.250309713573444,-109.4367654
40669,11,41,14,14,13,0,93,38.250309713573444,-109.4364959
40670,10,40,14,15,13,0,92,38.250309713573444,-109.4362264
40671,8,40,14,14,13,1,90,38.250309713573444,-109.4359569
40672,6,43,13,11,13,1,87,38.250309713573444,-109.4356874
40673,5,46,12,7,13,3,86,38.250309713573444,-109.4354179
40674,5,46,13,6,16,4,90,38.250309713573444,-109.4351484
40675,5,44,12,5,15,6,87,38.250309713573444,-109.434879
40676,3,44,11,3,14,8,83,38.250309713573444,-109.4346095
40677,2,43,10,0,13,9,77,38.250309713573444,-109.43434
40678,1,37,10,0,12,11,71,38.250309713573444,-109.4340705
40679,2,31,10,3,11,11,68,38.250309713573444,-109.433801
40680,1,30,10,3,11,10,65,38.250309713573444,-109.4335315
40681,1,33,10,3,12,9,68,38.250309713573444,-109.433262
40682,2,37,10,4,14,7,74,38.250309713573444,-109.4329925
40683,3,42,11,2,13,10,81,38.250309713573444,-109.432723
40684,4,42,11,7,15,3,82,38.250309713573444,-109.4324535
40685,4,40,11,7,15,3,80,38.250309713573444,-109.432184
40686,3,40,10,6,15,3,77,38.250309713573444,-109.4319145
40687,2,43,10,5,16,3,79,38.250309713573444,-109.431645
40688,1,48,9,3,14,3,78,38.250309713573444,-109.4313755
40689,1,56,8,3,13,2,83,38.250309713573444,-109.431106
40690,1,57,8,4,13,2,85,38.250309713573444,-109.4308365
40691,2,53,9,7,13,2,86,38.250309713573444,-109.430567
40692,6,45,12,11,12,1,87,38.250309713573444,-109.4302975
40693,7,41,12,11,13,1,85,38.250309713573444,-109.430028
40694,9,40,13,11,13,1,87,38.250309713573444,-109.4297586
40695,9,41,13,12,12,1,88,38.250309713573444,-109.4294891
40696,7,43,13,12,12,1,88,38.250309713573444,-109.4292196
40697,7,41,13,13,12,1,87,38.250309713573444,-109.4289501
40698,9,45,13,12,13,1,93,38.250309713573444,-109.4286806
40699,9,46,13,12,13,1,94,38.250309713573444,-109.4284111
40700,9,44,13,13,13,1,93,38.250309713573444,-109.4281416
40701,12,38,15,15,12,1,93,38.250309713573444,-109.4278721
40702,12,39,15,14,11,1,92,38.250309713573444,-109.4276026
40703,10,42,15,13,12,1,93,38.250309713573444,-109.4273331
40704,7,44,14,12,13,1,91,38.250309713573444,-109.4270636
40705,6,44,12,10,13,1,86,38.250309713573444,-109.4267941
40706,6,41,12,10,13,2,84,38.250309713573444,-109.4265246
40707,5,42,11,8,13,1,80,38.250309713573444,-109.4262551
40708,6,41,11,9,13,1,81,38.250309713573444,-109.4259856
40709,9,40,12,10,14,1,86,38.250309713573444,-109.4257161
40710,13,39,13,12,13,1,91,38.250309713573444,-109.4254466
40711,14,39,14,13,12,0,92,38.250309713573444,-109.4251771
40712,8,46,13,11,13,1,92,38.250309713573444,-109.4249077
40713,4,53,10,7,13,2,89,38.250309713573444,-109.4246382
40714,3,53,10,6,13,2,87,38.250309713573444,-109.4243687
40715,7,48,12,11,13,1,92,38.250309713573444,-109.4240992
40716,8,48,12,10,14,1,93,38.250309713573444,-109.4238297
40717,7,50,10,9,13,0,89,38.250309713573444,-109.4235602
40718,5,51,9,8,13,1,87,38.250309713573444,-109.4232907
40719,5,54,10,9,13,1,92,38.250309713573444,-109.4230212
40720,5,46,12,11,13,1,88,38.250309713573444,-109.4227517
40721,6,46,13,11,12,1,89,38.250309713573444,-109.4224822
40722,9,43,14,12,12,1,91,38.250309713573444,-109.4222127
40723,12,38,14,14,12,1,91,38.250309713573444,-109.4219432
40724,14,35,15,15,12,1,92,38.250309713573444,-109.4216737
40725,15,33,16,15,11,1,91,38.250309713573444,-109.4214042
40726,13,38,15,15,12,1,94,38.250309713573444,-109.4211347
40727,11,42,14,15,12,1,95,38.250309713573444,-109.4208652
40728,9,45,13,14,11,1,93,38.250309713573444,-109.4205957
40729,10,46,12,12,11,1,92,38.250309713573444,-109.4203262
40730,10,44,13,12,11,1,91,38.250309713573444,-109.4200568
40731,10,43,13,15,12,1,94,38.250309713573444,-109.4197873
40732,8,42,13,15,12,1,91,38.250309713573444,-109.4195178
40733,7,41,13,15,12,1,89,38.250309713573444,-109.4192483
40734,9,41,13,15,13,1,92,38.250309713573444,-109.4189788
40735,8,40,13,17,14,1,93,38.250309713573444,-109.4187093
40736,10,40,13,16,14,0,93,38.250309713573444,-109.4184398
40737,9,40,13,16,13,1,92,38.250309713573444,-109.4181703
40738,8,40,13,16,13,1,91,38.250309713573444,-109.4179008
40739,8,41,13,15,13,1,91,38.250309713573444,-109.4176313
40740,7,40,13,12,14,1,87,38.250309713573444,-109.4173618
40741,5,42,12,9,15,3,86,38.250309713573444,-109.4170923
40742,3,43,11,6,15,5,83,38.250309713573444,-109.4168228
40743,2,44,11,3,14,6,80,38.250309713573444,-109.4165533
40744,2,36,10,1,8,13,70,38.250309713573444,-109.4162838
40745,1,36,10,1,8,12,68,38.250309713573444,-109.4160143
40746,1,34,10,1,10,11,67,38.250309713573444,-109.4157448
40747,2,31,10,2,10,11,66,38.250309713573444,-109.4154753
40748,2,34,11,2,11,11,71,38.250309713573444,-109.4152058
40749,2,36,11,3,12,9,73,38.250309713573444,-109.4149364
40750,3,38,11,6,13,5,76,38.250309713573444,-109.4146669
40751,3,39,10,6,12,4,74,38.250309713573444,-109.4143974
40752,3,37,9,5,11,5,70,38.250309713573444,-109.4141279
40753,3,36,8,3,8,6,64,38.250309713573444,-109.4138584
40754,4,37,8,5,10,4,68,38.250309713573444,-109.4135889
40755,4,39,9,5,11,3,71,38.250309713573444,-109.4133194
40756,3,39,9,5,11,4,71,38.250309713573444,-109.4130499
40757,2,38,9,4,10,6,69,38.250309713573444,-109.4127804
40758,4,37,10,6,11,4,72,38.250309713573444,-109.4125109
40759,3,34,9,5,10,5,66,38.250309713573444,-109.4122414
40760,2,31,9,2,8,6,58,38.250309713573444,-109.4119719
40761,2,32,8,2,9,5,58,38.250309713573444,-109.4117024
40762,2,35,8,3,10,4,62,38.250309713573444,-109.4114329
40763,1,33,8,2,9,5,58,38.250309713573444,-109.4111634
40764,2,34,9,3,10,5,63,38.250309713573444,-109.4108939
40765,2,32,9,4,9,6,62,38.250309713573444,-109.4106244
40766,3,26,10,6,7,8,60,38.250309713573444,-109.4103549
40767,9,21,13,14,11,6,74,38.250309713573444,-109.4100855
40768,12,27,15,14,15,3,86,38.250309713573444,-109.409816
40769,12,31,14,13,15,3,88,38.250309713573444,-109.4095465
40770,15,34,14,12,13,2,90,38.250309713573444,-109.409277
40771,19,35,12,13,11,1,91,38.250309713573444,-109.4090075
40772,23,30,11,16,10,2,92,38.250309713573444,-109.408738
40773,21,28,11,16,9,3,88,38.250309713573444,-109.4084685
40774,15,28,11,22,9,3,88,38.250309713573444,-109.408199
40775,6,28,12,28,12,1,87,38.250309713573444,-109.4079295
40776,1,29,14,21,15,4,84,38.250309713573444,-109.40766
40777,2,27,13,15,18,4,79,38.250309713573444,-109.4073905
40778,2,30,14,9,18,8,81,38.250309713573444,-109.407121
40779,0,28,14,4,13,14,73,38.250309713573444,-109.4068515
40780,0,28,14,2,12,17,73,38.250309713573444,-109.406582
40781,0,31,13,2,14,12,72,38.250309713573444,-109.4063125
40782,0,30,13,3,13,14,73,38.250309713573444,-109.406043
40783,0,30,14,3,13,13,73,38.250309713573444,-109.4057735
40784,0,29,14,4,13,13,73,38.250309713573444,-109.405504
40785,0,29,13,4,14,13,73,38.250309713573444,-109.4052345
40786,0,27,14,4,14,14,73,38.250309713573444,-109.4049651
40787,0,27,13,1,12,17,70,38.250309713573444,-109.4046956
40788,0,27,13,0,11,17,68,38.250309713573444,-109.4044261
40789,0,30,12,0,12,16,70,38.250309713573444,-109.4041566
40790,0,30,11,0,11,14,66,38.250309713573444,-109.4038871
40791,0,29,12,3,11,14,69,38.250309713573444,-109.4036176
40792,0,32,12,3,12,13,72,38.250309713573444,-109.4033481
40793,1,33,13,3,12,12,74,38.250309713573444,-109.4030786
40794,1,32,13,4,12,12,74,38.250309713573444,-109.4028091
40795,1,31,13,4,12,12,73,38.250309713573444,-109.4025396
40796,0,28,12,2,10,14,66,38.250309713573444,-109.4022701
40797,0,30,11,0,10,16,67,38.250309713573444,-109.4020006
40798,0,32,11,0,11,14,68,38.250309713573444,-109.4017311
40799,1,32,11,1,12,13,70,38.250309713573444,-109.4014616
40800,1,30,12,0,8,18,69,38.250309713573444,-109.4011921
40801,1,29,12,1,11,14,68,38.250309713573444,-109.4009226
40802,2,29,11,1,12,12,67,38.250309713573444,-109.4006531
40803,2,27,11,2,11,12,65,38.250309713573444,-109.4003836
40804,2,25,12,4,10,12,65,38.250309713573444,-109.4001142
40805,3,27,11,6,13,9,69,38.250309713573444,-109.3998447
40806,3,26,12,7,13,9,70,38.250309713573444,-109.3995752
40807,7,29,12,10,15,4,77,38.250309713573444,-109.3993057
40808,11,32,12,12,16,2,85,38.250309713573444,-109.3990362
40809,12,32,13,11,16,1,85,38.250309713573444,-109.3987667
40810,10,31,13,11,15,3,83,38.250309713573444,-109.3984972
40811,14,32,13,14,15,1,89,38.250309713573444,-109.3982277
40812,18,33,13,15,14,0,93,38.250309713573444,-109.3979582
40813,17,35,14,14,14,0,94,38.250309713573444,-109.3976887
40814,18,37,15,12,12,0,94,38.250309713573444,-109.3974192
40815,17,38,15,11,13,0,94,38.250309713573444,-109.3971497
40816,17,37,14,12,14,0,94,38.250309713573444,-109.3968802
40817,16,36,14,13,14,0,93,38.250309713573444,-109.3966107
40818,15,36,14,14,14,0,93,38.250309713573444,-109.3963412
40819,15,36,14,12,15,0,92,38.250309713573444,-109.3960717
40820,16,37,14,11,15,0,93,38.250309713573444,-109.3958022
40821,16,37,14,12,14,0,93,38.250309713573444,-109.3955327
40822,15,37,14,13,14,0,93,38.250309713573444,-109.3952632
40823,13,38,14,13,15,0,93,38.250309713573444,-109.3949938
40824,10,39,14,12,15,1,91,38.250309713573444,-109.3947243
40825,7,41,14,12,15,1,90,38.250309713573444,-109.3944548
40826,6,42,14,11,15,1,89,38.250309713573444,-109.3941853
40827,8,42,14,10,15,1,90,38.250309713573444,-109.3939158
40828,8,42,14,10,16,1,91,38.250309713573444,-109.3936463
40829,9,43,13,10,15,1,91,38.250309713573444,-109.3933768
40830,10,42,13,10,15,1,91,38.250309713573444,-109.3931073
40831,10,40,13,10,15,1,89,38.250309713573444,-109.3928378
40832,10,40,13,10,15,1,89,38.250309713573444,-109.3925683
40833,13,40,13,11,14,0,91,38.250309713573444,-109.3922988
40834,13,41,13,10,14,0,91,38.250309713573444,-109.3920293
40835,14,41,13,10,13,0,91,38.250309713573444,-109.3917598
40836,13,41,13,10,14,0,91,38.250309713573444,-109.3914903
40837,12,41,13,10,14,0,90,38.250309713573444,-109.3912208
40838,14,40,13,10,14,0,91,38.250309713573444,-109.3909513
40839,15,39,13,10,13,0,90,38.250309713573444,-109.3906818
40840,15,39,13,11,13,0,91,38.250309713573444,-109.3904123
40841,14,39,13,11,13,0,90,38.250309713573444,-109.3901429
40842,14,40,13,10,13,1,91,38.250309713573444,-109.3898734
40843,12,39,13,11,13,1,89,38.250309713573444,-109.3896039
40844,12,39,13,11,13,1,89,38.250309713573444,-109.3893344
40845,12,40,13,11,14,1,91,38.250309713573444,-109.3890649
40846,14,39,13,11,13,0,90,38.250309713573444,-109.3887954
40847,14,40,13,11,13,0,91,38.250309713573444,-109.3885259
40848,16,41,13,10,12,0,92,38.250309713573444,-109.3882564
40849,18,40,13,10,11,0,92,38.250309713573444,-109.3879869
40850,17,39,13,11,11,0,91,38.250309713573444,-109.3877174
40851,15,42,13,11,12,0,93,38.250309713573444,-109.3874479
40852,13,43,13,11,12,0,92,38.250309713573444,-109.3871784
40853,13,41,12,11,12,0,89,38.250309713573444,-109.3869089
40854,13,39,12,10,13,1,88,38.250309713573444,-109.3866394
40855,14,38,11,9,13,1,86,38.250309713573444,-109.3863699
40856,16,41,12,9,13,0,91,38.250309713573444,-109.3861004
40857,14,42,12,9,14,0,91,38.250309713573444,-109.3858309
40858,13,43,13,9,14,0,92,38.250309713573444,-109.3855614
40859,12,44,13,10,13,0,92,38.250309713573444,-109.3852919
40860,9,45,13,11,14,0,92,38.250309713573444,-109.3850225
40861,10,43,13,13,13,0,92,38.250309713573444,-109.384753
40862,10,45,12,9,14,0,90,38.250309713573444,-109.3844835
40863,8,44,12,9,14,1,88,38.250309713573444,-109.384214
40864,8,41,12,10,14,1,86,38.250309713573444,-109.3839445
40865,12,40,13,11,14,1,91,38.250309713573444,-109.383675
40866,11,35,12,11,14,2,85,38.250309713573444,-109.3834055
40867,11,30,12,8,12,6,79,38.250309713573444,-109.383136
40868,13,21,12,10,9,8,73,38.250309713573444,-109.3828665
40869,14,21,11,14,12,3,75,38.250309713573444,-109.382597
40870,17,26,12,10,12,3,80,38.250309713573444,-109.3823275
40871,10,33,12,8,12,5,80,38.250309713573444,-109.382058
40872,9,39,12,9,13,3,85,38.250309713573444,-109.3817885
40873,8,42,13,11,13,2,89,38.250309713573444,-109.381519
40874,8,41,14,11,12,4,90,38.250309713573444,-109.3812495
40875,9,42,14,11,11,3,90,38.250309713573444,-109.38098
40876,9,42,14,11,12,3,91,38.250309713573444,-109.3807105
40877,9,42,14,11,13,3,92,38.250309713573444,-109.380441
40878,8,42,14,10,14,2,90,38.250309713573444,-109.3801716
40879,7,41,13,9,14,4,88,38.250309713573444,-109.3799021
40880,3,29,13,2,11,15,73,38.250309713573444,-109.3796326
40881,1,24,15,1,7,23,71,38.250309713573444,-109.3793631
40882,0,23,16,0,5,26,70,38.250309713573444,-109.3790936
40883,1,27,14,0,5,22,69,38.250309713573444,-109.3788241
40884,2,28,13,1,10,17,71,38.250309713573444,-109.3785546
40885,2,24,16,2,5,26,75,38.250309713573444,-109.3782851
40886,0,23,18,0,5,31,77,38.250309713573444,-109.3780156
40887,0,23,18,2,7,29,79,38.250309713573444,-109.3777461
40888,1,21,15,4,6,24,71,38.250309713573444,-109.3774766
40889,4,25,13,5,8,16,71,38.250309713573444,-109.3772071
40890,7,28,14,9,10,10,78,38.250309713573444,-109.3769376
40891,9,29,15,11,11,9,84,38.250309713573444,-109.3766681
40892,9,29,14,8,11,10,81,38.250309713573444,-109.3763986
40893,7,33,13,7,10,10,80,38.250309713573444,-109.3761291
40894,7,28,12,9,9,10,75,38.250309713573444,-109.3758596
40895,10,23,12,11,10,8,74,38.250309713573444,-109.3755901
40896,14,22,13,15,11,5,80,38.250309713573444,-109.3753206
40897,17,21,13,20,13,4,88,38.250309713573444,-109.3750512
40898,16,17,12,22,16,4,87,38.250309713573444,-109.3747817
40899,21,14,11,22,15,3,86,38.250309713573444,-109.3745122
40900,31,15,10,17,11,2,86,38.250309713573444,-109.3742427
40901,30,12,11,18,13,3,87,38.250309713573444,-109.3739732
40902,24,14,12,17,14,5,86,38.250309713573444,-109.3737037
40903,25,15,15,9,12,12,88,38.250309713573444,-109.3734342
40904,16,19,15,5,14,17,86,38.250309713573444,-109.3731647
40905,14,20,16,5,15,20,90,38.250309713573444,-109.3728952
40906,11,20,16,4,13,23,87,38.250309713573444,-109.3726257
40907,4,19,17,3,7,28,78,38.250309713573444,-109.3723562
40908,4,23,16,3,5,28,79,38.250309713573444,-109.3720867
40909,2,24,15,2,5,25,73,38.250309713573444,-109.3718172
40910,3,31,14,0,9,18,75,38.250309713573444,-109.3715477
40911,5,33,13,1,12,14,78,38.250309713573444,-109.3712782
40912,3,31,15,9,4,16,78,38.250309713573444,-109.3710087
40913,5,28,14,13,6,15,81,38.250309713573444,-109.3707392
40914,6,31,13,5,12,11,78,38.250309713573444,-109.3704697
40915,2,33,12,3,10,13,73,38.250309713573444,-109.3702003
40916,7,32,11,8,13,7,78,38.250309713573444,-109.3699308
40917,7,36,13,14,7,8,85,38.250309713573444,-109.3696613
40918,9,34,11,13,9,6,82,38.250309713573444,-109.3693918
40919,10,33,11,18,8,4,84,38.250309713573444,-109.3691223
40920,4,35,12,20,13,2,86,38.250309713573444,-109.3688528
40921,6,21,13,17,21,2,80,38.250309713573444,-109.3685833
40922,3,16,15,17,20,7,78,38.250309713573444,-109.3683138
40923,3,10,10,9,11,10,53,38.250309713573444,-109.3680443
40924,1,12,10,17,11,5,56,38.250309713573444,-109.3677748
40925,0,18,10,13,13,6,60,38.250309713573444,-109.3675053
40926,0,28,13,3,17,11,72,38.250309713573444,-109.3672358
40927,1,27,15,0,7,23,73,38.250309713573444,-109.3669663
40928,0,25,14,0,4,26,69,38.250309713573444,-109.3666968
40929,0,23,14,0,3,28,68,38.250309713573444,-109.3664273
40930,0,21,15,0,2,30,68,38.250309713573444,-109.3661578
40931,1,23,16,0,3,30,73,38.250309713573444,-109.3658883
40932,1,23,16,0,2,30,72,38.250309713573444,-109.3656188
40933,1,21,16,0,0,31,69,38.250309713573444,-109.3653493
40934,1,20,16,0,0,30,67,38.250309713573444,-109.3650799
40935,1,21,15,0,1,28,66,38.250309713573444,-109.3648104
40936,1,23,13,0,1,25,63,38.250309713573444,-109.3645409
40937,1,24,13,0,2,23,63,38.250309713573444,-109.3642714
40938,1,23,14,0,2,23,63,38.250309713573444,-109.3640019
40939,2,24,14,0,2,23,65,38.250309713573444,-109.3637324
40940,2,25,14,0,3,21,65,38.250309713573444,-109.3634629
40941,2,23,13,0,3,21,62,38.250309713573444,-109.3631934
40942,2,21,13,0,3,22,61,38.250309713573444,-109.3629239
40943,2,21,14,0,2,24,63,38.250309713573444,-109.3626544
40944,2,24,15,1,3,25,70,38.250309713573444,-109.3623849
40945,1,27,16,1,4,27,76,38.250309713573444,-109.3621154
40946,0,24,14,0,1,27,66,38.250309713573444,-109.3618459
40947,1,22,15,0,0,28,66,38.250309713573444,-109.3615764
40948,1,22,15,0,0,28,66,38.250309713573444,-109.3613069
40949,1,26,13,0,1,23,64,38.250309713573444,-109.3610374
40950,1,34,10,0,6,16,67,38.250309713573444,-109.3607679
40951,1,34,10,0,6,16,67,38.250309713573444,-109.3604984
40952,0,32,10,0,5,17,64,38.250309713573444,-109.360229
40953,1,28,11,1,4,18,63,38.250309713573444,-109.3599595
40954,0,24,13,0,2,22,61,38.250309713573444,-109.35969
40955,1,24,13,0,3,22,63,38.250309713573444,-109.3594205
40956,0,23,13,1,3,20,60,38.250309713573444,-109.359151
40957,0,21,11,3,4,16,55,38.250309713573444,-109.3588815
40958,3,22,8,3,4,11,51,38.250309713573444,-109.358612
40959,2,32,6,5,8,5,58,38.250309713573444,-109.3583425
40960,2,40,6,6,8,3,65,38.250309713573444,-109.358073
40961,1,39,5,4,7,5,61,38.250309713573444,-109.3578035
40962,2,38,5,4,8,4,61,38.250309713573444,-109.357534
40963,2,38,5,4,8,5,62,38.250309713573444,-109.3572645
40964,2,39,6,5,8,5,65,38.250309713573444,-109.356995
40965,2,31,6,5,8,7,59,38.250309713573444,-109.3567255
40966,1,26,8,4,8,9,56,38.250309713573444,-109.356456
40967,3,24,7,2,7,8,51,38.250309713573444,-109.3561865
40968,2,32,5,3,6,6,54,38.250309713573444,-109.355917
40969,8,33,7,5,7,3,63,38.250309713573444,-109.3556475
40970,6,27,9,4,5,10,61,38.250309713573444,-109.355378
40971,1,18,13,3,3,21,59,38.250309713573444,-109.3551086
40972,1,24,13,0,3,21,62,38.250309713573444,-109.3548391
40973,2,32,12,0,5,17,68,38.250309713573444,-109.3545696
40974,1,25,10,4,7,10,57,38.250309713573444,-109.3543001
40975,2,22,9,4,7,7,51,38.250309713573444,-109.3540306
40976,3,31,7,5,7,6,59,38.250309713573444,-109.3537611
40977,4,32,7,6,7,5,61,38.250309713573444,-109.3534916
40978,1,21,10,5,9,8,54,38.250309713573444,-109.3532221
40979,2,22,11,4,8,9,56,38.250309713573444,-109.3529526
40980,1,29,10,5,7,7,59,38.250309713573444,-109.3526831
40981,2,35,10,6,7,5,65,38.250309713573444,-109.3524136
40982,2,39,10,4,8,5,68,38.250309713573444,-109.3521441
40983,2,29,10,5,8,6,60,38.250309713573444,-109.3518746
40984,1,24,9,5,7,6,52,38.250309713573444,-109.3516051
40985,0,24,8,4,7,6,49,38.250309713573444,-109.3513356
40986,1,26,7,4,8,4,50,38.250309713573444,-109.3510661
40987,2,32,9,5,8,3,59,38.250309713573444,-109.3507966
40988,8,30,12,18,8,5,81,38.250309713573444,-109.3505271
40989,6,30,11,16,11,4,78,38.250309713573444,-109.3502577
40990,4,26,8,10,8,3,59,38.250309713573444,-109.3499882
40991,4,33,8,7,8,2,62,38.250309713573444,-109.3497187
40992,2,31,9,4,8,9,63,38.250309713573444,-109.3494492
40993,1,26,11,3,8,14,63,38.250309713573444,-109.3491797
40994,1,26,11,3,6,11,58,38.250309713573444,-109.3489102
40995,3,37,7,6,9,2,64,38.250309713573444,-109.3486407
40996,1,38,5,3,9,2,58,38.250309713573444,-109.3483712
40997,2,36,6,3,9,2,58,38.250309713573444,-109.3481017
40998,3,23,10,7,10,4,57,38.250309713573444,-109.3478322
40999,4,22,10,8,12,5,61,38.250309713573444,-109.3475627
41000,5,27,8,8,8,3,59,38.250309713573444,-109.3472932
41001,6,30,9,9,9,2,65,38.250309713573444,-109.3470237
41002,2,27,10,5,8,8,60,38.250309713573444,-109.3467542
41003,2,27,11,2,8,13,63,38.250309713573444,-109.3464847
41004,2,32,11,1,7,13,66,38.250309713573444,-109.3462152
41005,2,33,11,1,6,12,65,38.250309713573444,-109.3459457
41006,2,29,12,2,4,14,63,38.250309713573444,-109.3456762
41007,2,27,12,2,3,17,63,38.250309713573444,-109.3454068
41008,2,26,12,0,3,21,64,38.250309713573444,-109.3451373
41009,2,23,13,1,4,20,63,38.250309713573444,-109.3448678
41010,2,20,14,2,4,22,64,38.250309713573444,-109.3445983
41011,4,26,13,1,4,20,68,38.250309713573444,-109.3443288
41012,3,27,11,0,4,20,65,38.250309713573444,-109.3440593
41013,2,30,11,0,5,18,66,38.250309713573444,-109.3437898
41014,3,32,11,0,5,16,67,38.250309713573444,-109.3435203
41015,2,28,11,3,6,15,65,38.250309713573444,-109.3432508
41016,2,23,10,5,7,7,54,38.250309713573444,-109.3429813
41017,3,25,8,4,6,5,51,38.250309713573444,-109.3427118
41018,3,38,7,4,8,3,63,38.250309713573444,-109.3424423
41019,3,35,8,5,7,5,63,38.250309713573444,-109.3421728
41020,4,26,8,7,8,5,58,38.250309713573444,-109.3419033
41021,5,28,7,6,7,5,58,38.250309713573444,-109.3416338
41022,2,26,9,7,7,5,56,38.250309713573444,-109.3413643
41023,8,24,11,10,9,4,66,38.250309713573444,-109.3410948
41024,1,23,10,13,16,5,68,38.250309713573444,-109.3408253
41025,0,19,9,13,10,9,60,38.250309713573444,-109.3405558
41026,1,24,10,11,13,6,65,38.250309713573444,-109.3402864
41027,2,30,11,6,10,6,65,38.250309713573444,-109.3400169
41028,3,34,11,6,9,6,69,38.250309713573444,-109.3397474
41029,1,36,10,5,5,7,64,38.250309713573444,-109.3394779
41030,4,29,10,6,9,5,63,38.250309713573444,-109.3392084
41031,2,25,10,6,8,7,58,38.250309713573444,-109.3389389
41032,1,27,10,5,8,9,60,38.250309713573444,-109.3386694
41033,4,25,8,5,6,10,58,38.250309713573444,-109.3383999
41034,8,31,7,8,9,2,65,38.250309713573444,-109.3381304
41035,4,36,13,25,8,1,87,38.250309713573444,-109.3378609
41036,10,22,9,24,19,0,84,38.250309713573444,-109.3375914
41037,11,9,9,32,25,1,87,38.250309713573444,-109.3373219
41038,2,15,10,25,11,2,65,38.250309713573444,-109.3370524
41039,2,20,9,17,14,3,65,38.250309713573444,-109.3367829
41040,2,24,10,12,14,5,67,38.250309713573444,-109.3365134
41041,2,25,10,10,12,6,65,38.250309713573444,-109.3362439
41042,3,25,11,7,12,7,65,38.250309713573444,-109.3359744
41043,7,29,12,6,15,9,78,38.250309713573444,-109.3357049
41044,1,23,12,2,8,17,63,38.250309713573444,-109.3354355
41045,1,21,12,3,6,17,60,38.250309713573444,-109.335166
41046,1,21,12,3,7,16,60,38.250309713573444,-109.3348965
41047,2,22,11,2,6,16,59,38.250309713573444,-109.334627
41048,0,22,10,1,7,15,55,38.250309713573444,-109.3343575
41049,0,28,9,1,8,12,58,38.250309713573444,-109.334088
41050,0,36,8,1,10,8,63,38.250309713573444,-109.3338185
41051,1,41,7,0,12,5,66,38.250309713573444,-109.333549
41052,1,44,6,0,11,5,67,38.250309713573444,-109.3332795
41053,0,38,7,0,11,7,63,38.250309713573444,-109.33301
41054,0,44,7,0,11,6,68,38.250309713573444,-109.3327405
41055,0,49,6,1,11,4,71,38.250309713573444,-109.332471
41056,0,55,6,2,11,3,77,38.250309713573444,-109.3322015
41057,1,58,7,3,11,2,82,38.250309713573444,-109.331932
41058,0,55,7,2,11,3,78,38.250309713573444,-109.3316625
41059,0,54,7,2,10,3,76,38.250309713573444,-109.331393
41060,1,33,11,6,14,8,73,38.250040218988204,-109.4402688
41061,1,34,11,1,13,12,72,38.250040218988204,-109.4399993
41062,2,37,11,1,13,11,75,38.250040218988204,-109.4397299
41063,2,39,11,0,14,11,77,38.250040218988204,-109.4394604
41064,2,40,11,0,12,12,77,38.250040218988204,-109.4391909
41065,1,36,11,0,10,15,73,38.250040218988204,-109.4389214
41066,1,33,12,1,11,13,71,38.250040218988204,-109.4386519
41067,4,35,11,9,16,3,78,38.250040218988204,-109.4383824
41068,10,37,12,12,14,1,86,38.250040218988204,-109.4381129
41069,18,35,13,12,13,0,91,38.250040218988204,-109.4378434
41070,14,38,13,13,14,0,92,38.250040218988204,-109.4375739
41071,13,38,14,14,14,0,93,38.250040218988204,-109.4373044
41072,12,39,14,14,13,0,92,38.250040218988204,-109.4370349
41073,12,40,14,15,13,0,94,38.250040218988204,-109.4367654
41074,11,40,14,15,13,0,93,38.250040218988204,-109.4364959
41075,11,39,14,15,13,0,92,38.250040218988204,-109.4362264
41076,9,41,14,14,13,1,92,38.250040218988204,-109.4359569
41077,7,43,13,10,13,2,88,38.250040218988204,-109.4356874
41078,4,49,11,5,13,4,86,38.250040218988204,-109.4354179
41079,4,47,12,4,15,6,88,38.250040218988204,-109.4351484
41080,2,43,12,3,15,8,83,38.250040218988204,-109.434879
41081,2,41,12,2,14,10,81,38.250040218988204,-109.4346095
41082,2,39,11,1,13,11,77,38.250040218988204,-109.43434
41083,2,38,11,1,15,9,76,38.250040218988204,-109.4340705
41084,1,36,11,1,14,9,72,38.250040218988204,-109.433801
41085,1,27,10,3,9,12,62,38.250040218988204,-109.4335315
41086,1,26,10,3,8,13,61,38.250040218988204,-109.433262
41087,1,34,10,2,11,11,69,38.250040218988204,-109.4329925
41088,2,43,10,2,12,10,79,38.250040218988204,-109.432723
41089,2,44,11,4,16,5,82,38.250040218988204,-109.4324535
41090,2,38,10,4,15,6,75,38.250040218988204,-109.432184
41091,3,33,10,4,12,7,69,38.250040218988204,-109.4319145
41092,3,34,10,6,13,4,70,38.250040218988204,-109.431645
41093,1,45,9,5,12,3,75,38.250040218988204,-109.4313755
41094,0,57,7,2,12,3,81,38.250040218988204,-109.431106
41095,0,58,8,2,13,3,84,38.250040218988204,-109.4308365
41096,2,52,9,5,14,3,85,38.250040218988204,-109.430567
41097,7,44,11,10,13,2,87,38.250040218988204,-109.4302975
41098,8,41,12,10,13,1,85,38.250040218988204,-109.430028
41099,10,39,13,11,13,1,87,38.250040218988204,-109.4297586
41100,10,37,14,12,13,1,87,38.250040218988204,-109.4294891
41101,10,39,14,13,13,1,90,38.250040218988204,-109.4292196
41102,10,39,14,13,13,1,90,38.250040218988204,-109.4289501
41103,11,42,14,13,13,1,94,38.250040218988204,-109.4286806
41104,9,46,13,12,13,1,94,38.250040218988204,-109.4284111
41105,7,49,12,11,13,1,93,38.250040218988204,-109.4281416
41106,8,47,13,12,12,1,93,38.250040218988204,-109.4278721
41107,9,45,14,14,12,1,95,38.250040218988204,-109.4276026
41108,8,45,14,13,13,0,93,38.250040218988204,-109.4273331
41109,7,44,13,13,14,1,92,38.250040218988204,-109.4270636
41110,7,42,14,12,14,1,90,38.250040218988204,-109.4267941
41111,8,40,13,12,13,1,87,38.250040218988204,-109.4265246
41112,6,42,12,10,13,1,84,38.250040218988204,-109.4262551
41113,6,38,10,6,13,2,75,38.250040218988204,-109.4259856
41114,7,37,10,6,13,2,75,38.250040218988204,-109.4257161
41115,8,37,11,9,14,1,80,38.250040218988204,-109.4254466
41116,16,34,14,14,13,0,91,38.250040218988204,-109.4251771
41117,12,34,13,12,12,1,84,38.250040218988204,-109.4249077
41118,7,40,12,9,12,2,82,38.250040218988204,-109.4246382
41119,7,44,12,10,12,2,87,38.250040218988204,-109.4243687
41120,11,42,13,12,13,1,92,38.250040218988204,-109.4240992
41121,11,41,13,11,12,1,89,38.250040218988204,-109.4238297
41122,9,48,12,10,12,0,91,38.250040218988204,-109.4235602
41123,8,51,10,9,12,0,90,38.250040218988204,-109.4232907
41124,6,53,10,10,12,0,91,38.250040218988204,-109.4230212
41125,6,53,12,10,13,1,95,38.250040218988204,-109.4227517
41126,7,48,13,11,13,1,93,38.250040218988204,-109.4224822
41127,10,42,14,12,13,1,92,38.250040218988204,-109.4222127
41128,12,39,14,14,13,1,93,38.250040218988204,-109.4219432
41129,13,38,15,14,13,0,93,38.250040218988204,-109.4216737
41130,12,38,15,15,12,1,93,38.250040218988204,-109.4214042
41131,10,39,14,15,13,1,92,38.250040218988204,-109.4211347
41132,8,43,14,14,12,1,92,38.250040218988204,-109.4208652
41133,7,46,13,13,12,1,92,38.250040218988204,-109.4205957
41134,8,47,12,11,12,1,91,38.250040218988204,-109.4203262
41135,9,45,13,13,12,1,93,38.250040218988204,-109.4200568
41136,10,43,13,14,12,1,93,38.250040218988204,-109.4197873
41137,9,44,14,14,13,1,95,38.250040218988204,-109.4195178
41138,8,45,13,13,14,1,94,38.250040218988204,-109.4192483
41139,8,43,14,14,14,1,94,38.250040218988204,-109.4189788
41140,8,41,13,15,14,1,92,38.250040218988204,-109.4187093
41141,9,41,13,15,14,1,93,38.250040218988204,-109.4184398
41142,9,41,13,15,13,1,92,38.250040218988204,-109.4181703
41143,9,40,13,15,13,1,91,38.250040218988204,-109.4179008
41144,11,38,13,14,13,1,90,38.250040218988204,-109.4176313
41145,8,41,13,13,14,1,90,38.250040218988204,-109.4173618
41146,4,42,12,8,15,3,84,38.250040218988204,-109.4170923
41147,2,40,10,3,13,6,74,38.250040218988204,-109.4168228
41148,1,34,9,3,9,8,64,38.250040218988204,-109.4165533
41149,1,31,9,1,8,10,60,38.250040218988204,-109.4162838
41150,1,32,9,1,7,11,61,38.250040218988204,-109.4160143
41151,1,32,9,0,6,14,62,38.250040218988204,-109.4157448
41152,1,32,10,0,6,16,65,38.250040218988204,-109.4154753
41153,2,33,10,2,9,14,70,38.250040218988204,-109.4152058
41154,2,36,11,4,12,8,73,38.250040218988204,-109.4149364
41155,3,40,10,6,13,4,76,38.250040218988204,-109.4146669
41156,3,43,10,6,12,3,77,38.250040218988204,-109.4143974
41157,3,43,9,5,11,3,74,38.250040218988204,-109.4141279
41158,2,38,9,4,10,6,69,38.250040218988204,-109.4138584
41159,2,38,9,3,10,7,69,38.250040218988204,-109.4135889
41160,3,38,9,5,11,5,71,38.250040218988204,-109.4133194
41161,2,38,9,4,10,4,67,38.250040218988204,-109.4130499
41162,2,35,9,3,9,5,63,38.250040218988204,-109.4127804
41163,4,35,10,6,11,4,70,38.250040218988204,-109.4125109
41164,3,35,10,5,10,6,69,38.250040218988204,-109.4122414
41165,2,36,10,4,10,6,68,38.250040218988204,-109.4119719
41166,2,36,10,4,10,6,68,38.250040218988204,-109.4117024
41167,2,38,9,3,10,5,67,38.250040218988204,-109.4114329
41168,1,39,9,3,10,5,67,38.250040218988204,-109.4111634
41169,3,34,10,5,9,5,66,38.250040218988204,-109.4108939
41170,6,27,11,10,9,5,68,38.250040218988204,-109.4106244
41171,13,23,14,14,11,4,79,38.250040218988204,-109.4103549
41172,16,31,15,12,15,2,91,38.250040218988204,-109.4100855
41173,8,38,13,15,14,2,90,38.250040218988204,-109.409816
41174,7,41,11,18,11,1,89,38.250040218988204,-109.4095465
41175,6,40,10,18,10,2,86,38.250040218988204,-109.409277
41176,7,36,10,18,11,2,84,38.250040218988204,-109.4090075
41177,8,31,10,21,11,1,82,38.250040218988204,-109.408738
41178,5,29,11,26,13,1,85,38.250040218988204,-109.4084685
41179,1,28,12,24,17,1,83,38.250040218988204,-109.408199
41180,0,29,13,15,21,5,83,38.250040218988204,-109.4079295
41181,1,29,15,7,16,13,81,38.250040218988204,-109.40766
41182,2,33,14,4,14,13,80,38.250040218988204,-109.4073905
41183,0,32,14,0,13,16,75,38.250040218988204,-109.407121
41184,0,33,13,0,11,18,75,38.250040218988204,-109.4068515
41185,0,35,13,0,10,18,76,38.250040218988204,-109.406582
41186,0,34,12,0,12,16,74,38.250040218988204,-109.4063125
41187,1,34,13,0,11,16,75,38.250040218988204,-109.406043
41188,0,32,13,0,11,16,72,38.250040218988204,-109.4057735
41189,0,31,14,0,10,19,74,38.250040218988204,-109.405504
41190,0,29,15,0,10,22,76,38.250040218988204,-109.4052345
41191,0,30,15,0,9,24,78,38.250040218988204,-109.4049651
41192,0,29,15,0,9,23,76,38.250040218988204,-109.4046956
41193,1,29,14,0,10,19,73,38.250040218988204,-109.4044261
41194,1,31,13,1,12,15,73,38.250040218988204,-109.4041566
41195,2,34,12,4,15,9,76,38.250040218988204,-109.4038871
41196,1,30,11,0,10,15,67,38.250040218988204,-109.4036176
41197,1,32,11,0,10,14,68,38.250040218988204,-109.4033481
41198,1,31,11,0,10,14,67,38.250040218988204,-109.4030786
41199,0,31,10,0,10,14,65,38.250040218988204,-109.4028091
41200,1,34,10,0,12,12,69,38.250040218988204,-109.4025396
41201,1,32,10,0,11,15,69,38.250040218988204,-109.4022701
41202,0,31,11,0,10,17,69,38.250040218988204,-109.4020006
41203,0,30,11,0,9,18,68,38.250040218988204,-109.4017311
41204,1,30,12,0,9,18,70,38.250040218988204,-109.4014616
41205,1,20,13,3,7,21,65,38.250040218988204,-109.4011921
41206,2,20,13,6,8,18,67,38.250040218988204,-109.4009226
41207,4,23,13,8,10,13,71,38.250040218988204,-109.4006531
41208,6,27,12,8,13,7,73,38.250040218988204,-109.4003836
41209,5,28,11,7,13,7,71,38.250040218988204,-109.4001142
41210,9,32,12,11,16,2,82,38.250040218988204,-109.3998447
41211,14,33,13,13,16,0,89,38.250040218988204,-109.3995752
41212,13,33,13,13,15,1,88,38.250040218988204,-109.3993057
41213,14,33,13,14,14,1,89,38.250040218988204,-109.3990362
41214,21,33,13,12,13,0,92,38.250040218988204,-109.3987667
41215,18,33,14,14,14,0,93,38.250040218988204,-109.3984972
41216,17,33,14,13,14,0,91,38.250040218988204,-109.3982277
41217,17,34,14,12,14,0,91,38.250040218988204,-109.3979582
41218,16,36,14,12,15,0,93,38.250040218988204,-109.3976887
41219,13,38,15,13,16,1,96,38.250040218988204,-109.3974192
41220,13,36,14,12,15,1,91,38.250040218988204,-109.3971497
41221,14,35,14,13,16,0,92,38.250040218988204,-109.3968802
41222,16,35,14,14,15,0,94,38.250040218988204,-109.3966107
41223,17,35,14,12,14,0,92,38.250040218988204,-109.3963412
41224,17,37,14,12,14,0,94,38.250040218988204,-109.3960717
41225,16,37,14,13,14,0,94,38.250040218988204,-109.3958022
41226,14,38,14,12,14,0,92,38.250040218988204,-109.3955327
41227,11,40,14,12,15,0,92,38.250040218988204,-109.3952632
41228,10,41,14,13,15,0,93,38.250040218988204,-109.3949938
41229,10,41,14,12,15,1,93,38.250040218988204,-109.3947243
41230,9,42,14,12,16,1,94,38.250040218988204,-109.3944548
41231,8,42,13,12,16,1,92,38.250040218988204,-109.3941853
41232,9,42,13,11,16,1,92,38.250040218988204,-109.3939158
41233,9,43,14,12,16,0,94,38.250040218988204,-109.3936463
41234,9,43,13,11,15,0,91,38.250040218988204,-109.3933768
41235,10,41,14,12,16,0,93,38.250040218988204,-109.3931073
41236,11,40,14,12,16,0,93,38.250040218988204,-109.3928378
41237,13,39,13,11,15,0,91,38.250040218988204,-109.3925683
41238,12,40,13,11,15,0,91,38.250040218988204,-109.3922988
41239,13,39,13,11,15,0,91,38.250040218988204,-109.3920293
41240,14,39,13,10,14,0,90,38.250040218988204,-109.3917598
41241,14,38,13,11,14,0,90,38.250040218988204,-109.3914903
41242,14,40,13,11,14,0,92,38.250040218988204,-109.3912208
41243,16,39,13,10,14,0,92,38.250040218988204,-109.3909513
41244,15,39,13,11,14,0,92,38.250040218988204,-109.3906818
41245,14,40,13,11,14,0,92,38.250040218988204,-109.3904123
41246,13,40,13,10,14,1,91,38.250040218988204,-109.3901429
41247,14,40,13,11,13,1,92,38.250040218988204,-109.3898734
41248,11,40,14,12,14,1,92,38.250040218988204,-109.3896039
41249,11,41,14,11,13,1,91,38.250040218988204,-109.3893344
41250,12,40,14,11,13,1,91,38.250040218988204,-109.3890649
41251,13,39,13,12,13,0,90,38.250040218988204,-109.3887954
41252,14,40,13,11,13,0,91,38.250040218988204,-109.3885259
41253,15,41,13,10,13,0,92,38.250040218988204,-109.3882564
41254,16,41,13,10,12,0,92,38.250040218988204,-109.3879869
41255,16,41,13,10,12,0,92,38.250040218988204,-109.3877174
41256,13,42,14,11,13,0,93,38.250040218988204,-109.3874479
41257,13,41,14,11,13,0,92,38.250040218988204,-109.3871784
41258,14,40,12,11,13,0,90,38.250040218988204,-109.3869089
41259,13,37,12,11,13,1,87,38.250040218988204,-109.3866394
41260,14,37,12,10,14,1,88,38.250040218988204,-109.3863699
41261,16,41,12,10,12,0,91,38.250040218988204,-109.3861004
41262,15,43,12,10,13,0,93,38.250040218988204,-109.3858309
41263,12,45,13,10,14,0,94,38.250040218988204,-109.3855614
41264,11,45,13,10,14,0,93,38.250040218988204,-109.3852919
41265,11,43,13,12,14,0,93,38.250040218988204,-109.3850225
41266,11,43,13,12,13,0,92,38.250040218988204,-109.384753
41267,10,46,12,9,14,0,91,38.250040218988204,-109.3844835
41268,7,46,12,8,15,1,89,38.250040218988204,-109.384214
41269,8,43,12,9,15,1,88,38.250040218988204,-109.3839445
41270,14,38,13,12,13,1,91,38.250040218988204,-109.383675
41271,14,35,13,14,12,1,89,38.250040218988204,-109.3834055
41272,11,31,12,12,13,4,83,38.250040218988204,-109.383136
41273,11,23,12,14,11,4,75,38.250040218988204,-109.3828665
41274,14,20,10,16,12,1,73,38.250040218988204,-109.382597
41275,22,29,12,10,12,2,87,38.250040218988204,-109.3823275
41276,14,36,12,9,13,2,86,38.250040218988204,-109.382058
41277,8,41,12,10,14,1,86,38.250040218988204,-109.3817885
41278,7,41,13,10,14,2,87,38.250040218988204,-109.381519
41279,7,41,13,9,13,4,87,38.250040218988204,-109.3812495
41280,8,42,14,10,11,5,90,38.250040218988204,-109.38098
41281,8,42,14,11,11,4,90,38.250040218988204,-109.3807105
41282,9,42,13,12,11,3,90,38.250040218988204,-109.380441
41283,11,40,13,13,11,2,90,38.250040218988204,-109.3801716
41284,11,41,14,12,12,1,91,38.250040218988204,-109.3799021
41285,8,42,14,7,14,6,91,38.250040218988204,-109.3796326
41286,6,39,13,4,13,9,84,38.250040218988204,-109.3793631
41287,9,37,13,7,10,9,85,38.250040218988204,-109.3790936
41288,14,37,13,11,8,5,88,38.250040218988204,-109.3788241
41289,13,38,14,11,11,3,90,38.250040218988204,-109.3785546
41290,14,33,14,10,10,7,88,38.250040218988204,-109.3782851
41291,17,27,14,10,8,10,86,38.250040218988204,-109.3780156
41292,24,22,13,12,7,9,87,38.250040218988204,-109.3777461
41293,33,18,12,12,7,6,88,38.250040218988204,-109.3774766
41294,33,23,12,8,7,5,88,38.250040218988204,-109.3772071
41295,24,26,13,13,9,3,88,38.250040218988204,-109.3769376
41296,15,27,14,14,10,4,84,38.250040218988204,-109.3766681
41297,11,24,14,12,10,7,78,38.250040218988204,-109.3763986
41298,12,23,15,13,8,9,80,38.250040218988204,-109.3761291
41299,20,22,15,14,10,6,87,38.250040218988204,-109.3758596
41300,13,22,14,15,9,8,81,38.250040218988204,-109.3755901
41301,8,24,14,12,11,9,78,38.250040218988204,-109.3753206
41302,6,23,14,10,10,13,76,38.250040218988204,-109.3750512
41303,9,21,13,16,14,10,83,38.250040218988204,-109.3747817
41304,19,19,14,23,14,2,91,38.250040218988204,-109.3745122
41305,21,15,12,29,14,1,92,38.250040218988204,-109.3742427
41306,21,11,11,31,16,2,92,38.250040218988204,-109.3739732
41307,19,11,12,27,16,5,90,38.250040218988204,-109.3737037
41308,17,18,15,14,15,12,91,38.250040218988204,-109.3734342
41309,7,22,17,5,10,23,84,38.250040218988204,-109.3731647
41310,3,30,15,0,5,25,78,38.250040218988204,-109.3728952
41311,0,30,15,0,2,24,71,38.250040218988204,-109.3726257
41312,2,27,14,2,2,20,67,38.250040218988204,-109.3723562
41313,6,31,15,3,7,17,79,38.250040218988204,-109.3720867
41314,3,28,15,3,5,21,75,38.250040218988204,-109.3718172
41315,2,29,16,4,3,23,77,38.250040218988204,-109.3715477
41316,1,26,13,1,10,19,70,38.250040218988204,-109.3712782
41317,1,25,15,2,11,21,75,38.250040218988204,-109.3710087
41318,1,22,14,3,10,20,70,38.250040218988204,-109.3707392
41319,4,26,14,3,11,18,76,38.250040218988204,-109.3704697
41320,3,27,14,13,15,9,81,38.250040218988204,-109.3702003
41321,4,28,11,16,15,3,77,38.250040218988204,-109.3699308
41322,3,35,11,9,9,9,76,38.250040218988204,-109.3696613
41323,9,27,9,13,10,2,70,38.250040218988204,-109.3693918
41324,14,31,8,22,10,0,85,38.250040218988204,-109.3691223
41325,6,30,11,21,19,0,87,38.250040218988204,-109.3688528
41326,8,9,11,32,18,2,80,38.250040218988204,-109.3685833
41327,3,9,12,25,15,5,69,38.250040218988204,-109.3683138
41328,3,10,10,23,14,2,62,38.250040218988204,-109.3680443
41329,3,13,9,20,11,1,57,38.250040218988204,-109.3677748
41330,1,20,10,12,13,4,60,38.250040218988204,-109.3675053
41331,1,28,15,2,10,20,76,38.250040218988204,-109.3672358
41332,1,28,17,0,7,27,80,38.250040218988204,-109.3669663
41333,0,24,16,0,4,31,75,38.250040218988204,-109.3666968
41334,0,23,16,0,2,32,73,38.250040218988204,-109.3664273
41335,0,22,17,0,2,33,74,38.250040218988204,-109.3661578
41336,1,22,17,0,2,33,75,38.250040218988204,-109.3658883
41337,1,21,16,0,1,31,70,38.250040218988204,-109.3656188
41338,1,20,16,0,1,29,67,38.250040218988204,-109.3653493
41339,0,21,15,0,0,28,64,38.250040218988204,-109.3650799
41340,0,22,15,0,1,26,64,38.250040218988204,-109.3648104
41341,1,26,13,0,3,24,67,38.250040218988204,-109.3645409
41342,1,25,14,0,3,24,67,38.250040218988204,-109.3642714
41343,1,23,14,0,3,23,64,38.250040218988204,-109.3640019
41344,2,22,14,0,2,23,63,38.250040218988204,-109.3637324
41345,2,23,14,0,3,23,65,38.250040218988204,-109.3634629
41346,1,22,14,0,1,25,63,38.250040218988204,-109.3631934
41347,1,22,15,0,1,27,66,38.250040218988204,-109.3629239
41348,0,25,14,0,3,26,68,38.250040218988204,-109.3626544
41349,0,27,13,0,6,22,68,38.250040218988204,-109.3623849
41350,1,25,14,0,2,25,67,38.250040218988204,-109.3621154
41351,0,24,14,0,1,26,65,38.250040218988204,-109.3618459
41352,1,24,14,0,1,26,66,38.250040218988204,-109.3615764
41353,0,26,14,0,1,26,67,38.250040218988204,-109.3613069
41354,0,28,12,0,1,22,63,38.250040218988204,-109.3610374
41355,0,36,10,0,6,15,67,38.250040218988204,-109.3607679
41356,1,33,10,0,6,16,66,38.250040218988204,-109.3604984
41357,1,30,11,1,4,18,65,38.250040218988204,-109.360229
41358,1,29,11,0,3,20,64,38.250040218988204,-109.3599595
41359,1,25,13,0,2,22,63,38.250040218988204,-109.35969
41360,1,21,12,1,3,19,57,38.250040218988204,-109.3594205
41361,0,20,10,3,4,15,52,38.250040218988204,-109.359151
41362,2,31,8,4,6,8,59,38.250040218988204,-109.3588815
41363,2,34,5,3,8,5,57,38.250040218988204,-109.358612
41364,3,35,6,3,9,5,61,38.250040218988204,-109.3583425
41365,3,45,7,6,10,3,74,38.250040218988204,-109.358073
41366,2,43,7,5,10,4,71,38.250040218988204,-109.3578035
41367,3,43,7,5,10,3,71,38.250040218988204,-109.357534
41368,2,47,7,4,9,4,73,38.250040218988204,-109.3572645
41369,2,50,8,4,9,5,78,38.250040218988204,-109.356995
41370,3,48,7,4,10,5,77,38.250040218988204,-109.3567255
41371,3,45,7,5,9,5,74,38.250040218988204,-109.356456
41372,2,42,6,5,8,3,66,38.250040218988204,-109.3561865
41373,3,45,5,3,9,2,67,38.250040218988204,-109.355917
41374,4,31,6,4,8,4,57,38.250040218988204,-109.3556475
41375,4,23,8,3,7,8,53,38.250040218988204,-109.355378
41376,1,24,11,2,6,16,60,38.250040218988204,-109.3551086
41377,2,30,11,1,7,17,68,38.250040218988204,-109.3548391
41378,1,35,11,2,11,11,71,38.250040218988204,-109.3545696
41379,2,27,9,4,9,7,58,38.250040218988204,-109.3543001
41380,2,24,9,4,7,7,53,38.250040218988204,-109.3540306
41381,2,27,9,4,9,5,56,38.250040218988204,-109.3537611
41382,2,24,9,5,9,7,56,38.250040218988204,-109.3534916
41383,2,22,11,5,9,10,59,38.250040218988204,-109.3532221
41384,1,20,11,4,7,13,56,38.250040218988204,-109.3529526
41385,1,26,10,6,7,10,60,38.250040218988204,-109.3526831
41386,2,37,11,6,7,6,69,38.250040218988204,-109.3524136
41387,3,42,10,8,7,2,72,38.250040218988204,-109.3521441
41388,2,29,9,5,7,4,56,38.250040218988204,-109.3518746
41389,2,29,7,4,8,4,54,38.250040218988204,-109.3516051
41390,1,30,6,3,8,4,52,38.250040218988204,-109.3513356
41391,1,29,6,3,8,4,51,38.250040218988204,-109.3510661
41392,1,22,9,5,9,4,50,38.250040218988204,-109.3507966
41393,1,23,11,8,8,7,58,38.250040218988204,-109.3505271
41394,1,24,9,9,11,6,60,38.250040218988204,-109.3502577
41395,6,28,8,10,9,2,63,38.250040218988204,-109.3499882
41396,4,33,7,7,8,2,61,38.250040218988204,-109.3497187
41397,1,26,9,5,6,9,56,38.250040218988204,-109.3494492
41398,1,23,12,1,5,19,61,38.250040218988204,-109.3491797
41399,3,29,12,5,9,10,68,38.250040218988204,-109.3489102
41400,3,39,7,6,9,2,66,38.250040218988204,-109.3486407
41401,2,54,4,3,6,2,71,38.250040218988204,-109.3483712
41402,4,39,7,5,8,3,66,38.250040218988204,-109.3481017
41403,4,27,10,10,9,4,64,38.250040218988204,-109.3478322
41404,4,28,10,8,7,6,63,38.250040218988204,-109.3475627
41405,4,34,8,7,9,2,64,38.250040218988204,-109.3472932
41406,3,32,7,6,8,2,58,38.250040218988204,-109.3470237
41407,3,31,7,4,8,4,57,38.250040218988204,-109.3467542
41408,1,30,9,2,7,8,57,38.250040218988204,-109.3464847
41409,2,29,11,2,7,11,62,38.250040218988204,-109.3462152
41410,2,36,11,2,7,8,66,38.250040218988204,-109.3459457
41411,5,31,12,4,8,8,68,38.250040218988204,-109.3456762
41412,2,25,13,2,4,17,63,38.250040218988204,-109.3454068
41413,2,24,12,2,4,19,63,38.250040218988204,-109.3451373
41414,2,21,12,4,6,16,61,38.250040218988204,-109.3448678
41415,3,20,12,2,4,18,59,38.250040218988204,-109.3445983
41416,3,25,12,1,4,17,62,38.250040218988204,-109.3443288
41417,3,27,11,0,4,18,63,38.250040218988204,-109.3440593
41418,2,26,11,0,4,19,62,38.250040218988204,-109.3437898
41419,3,27,11,0,5,17,63,38.250040218988204,-109.3435203
41420,2,23,11,1,3,19,59,38.250040218988204,-109.3432508
41421,5,31,12,5,9,8,70,38.250040218988204,-109.3429813
41422,4,26,10,7,8,5,60,38.250040218988204,-109.3427118
41423,4,30,8,7,7,5,61,38.250040218988204,-109.3424423
41424,8,25,10,11,9,4,67,38.250040218988204,-109.3421728
41425,6,24,9,7,8,7,61,38.250040218988204,-109.3419033
41426,3,23,12,10,10,5,63,38.250040218988204,-109.3416338
41427,3,20,12,15,14,5,69,38.250040218988204,-109.3413643
41428,2,19,12,17,17,6,73,38.250040218988204,-109.3410948
41429,4,15,12,16,15,5,67,38.250040218988204,-109.3408253
41430,5,27,9,11,10,4,66,38.250040218988204,-109.3405558
41431,5,38,9,12,6,3,73,38.250040218988204,-109.3402864
41432,7,41,8,9,8,1,74,38.250040218988204,-109.3400169
41433,4,35,8,7,8,3,65,38.250040218988204,-109.3397474
41434,1,33,8,6,6,6,60,38.250040218988204,-109.3394779
41435,8,25,9,10,9,4,65,38.250040218988204,-109.3392084
41436,5,29,10,8,6,8,66,38.250040218988204,-109.3389389
41437,4,33,10,7,5,9,68,38.250040218988204,-109.3386694
41438,11,37,9,10,8,1,76,38.250040218988204,-109.3383999
41439,7,25,8,9,9,3,61,38.250040218988204,-109.3381304
41440,4,33,14,24,12,2,89,38.250040218988204,-109.3378609
41441,9,18,11,27,24,1,90,38.250040218988204,-109.3375914
41442,4,7,9,34,21,1,76,38.250040218988204,-109.3373219
41443,3,16,11,16,13,5,64,38.250040218988204,-109.3370524
41444,2,22,10,12,14,7,67,38.250040218988204,-109.3367829
41445,1,21,10,6,9,11,58,38.250040218988204,-109.3365134
41446,1,21,10,4,7,12,55,38.250040218988204,-109.3362439
41447,2,22,10,5,7,11,57,38.250040218988204,-109.3359744
41448,3,24,11,4,9,11,62,38.250040218988204,-109.3357049
41449,1,20,12,4,8,14,59,38.250040218988204,-109.3354355
41450,1,19,12,4,6,17,59,38.250040218988204,-109.335166
41451,1,19,12,4,6,16,58,38.250040218988204,-109.3348965
41452,2,23,11,4,9,11,60,38.250040218988204,-109.334627
41453,1,22,11,1,8,14,57,38.250040218988204,-109.3343575
41454,0,27,9,0,8,13,57,38.250040218988204,-109.334088
41455,0,36,8,0,9,9,62,38.250040218988204,-109.3338185
41456,0,42,7,0,11,6,66,38.250040218988204,-109.333549
41457,1,49,6,1,11,3,71,38.250040218988204,-109.3332795
41458,0,46,7,2,11,4,70,38.250040218988204,-109.33301
41459,0,44,6,2,11,4,67,38.250040218988204,-109.3327405
41460,1,45,6,3,10,3,68,38.250040218988204,-109.332471
41461,1,47,7,4,9,2,70,38.250040218988204,-109.3322015
41462,2,50,7,4,10,1,74,38.250040218988204,-109.331932
41463,0,50,7,3,11,3,74,38.250040218988204,-109.3316625
41464,1,52,6,3,10,2,74,38.250040218988204,-109.331393
41465,4,33,9,6,15,3,70,38.249770724402964,-109.4402688
41466,4,43,11,7,16,1,82,38.249770724402964,-109.4399993
41467,5,46,11,5,18,1,86,38.249770724402964,-109.4397299
41468,4,45,12,3,17,4,85,38.249770724402964,-109.4394604
41469,2,41,12,2,15,8,80,38.249770724402964,-109.4391909
41470,3,40,12,2,16,9,82,38.249770724402964,-109.4389214
41471,3,38,11,2,15,9,78,38.249770724402964,-109.4386519
41472,4,39,11,5,16,4,79,38.249770724402964,-109.4383824
41473,7,42,12,10,16,0,87,38.249770724402964,-109.4381129
41474,12,41,13,12,14,0,92,38.249770724402964,-109.4378434
41475,10,42,13,13,14,0,92,38.249770724402964,-109.4375739
41476,8,41,13,14,13,1,90,38.249770724402964,-109.4373044
41477,7,42,13,14,13,1,90,38.249770724402964,-109.4370349
41478,6,44,13,14,13,1,91,38.249770724402964,-109.4367654
41479,5,44,12,14,13,1,89,38.249770724402964,-109.4364959
41480,8,42,13,14,13,1,91,38.249770724402964,-109.4362264
41481,6,43,13,11,13,2,88,38.249770724402964,-109.4359569
41482,4,43,11,7,12,4,81,38.249770724402964,-109.4356874
41483,3,46,10,5,13,4,81,38.249770724402964,-109.4354179
41484,2,48,10,2,15,6,83,38.249770724402964,-109.4351484
41485,2,44,11,0,14,10,81,38.249770724402964,-109.434879
41486,1,43,11,0,14,12,81,38.249770724402964,-109.4346095
41487,1,42,11,0,13,12,79,38.249770724402964,-109.43434
41488,2,40,11,0,14,11,78,38.249770724402964,-109.4340705
41489,2,38,11,0,15,10,76,38.249770724402964,-109.433801
41490,1,32,10,1,11,13,68,38.249770724402964,-109.4335315
41491,1,30,10,1,10,13,65,38.249770724402964,-109.433262
41492,1,36,10,2,13,9,71,38.249770724402964,-109.4329925
41493,2,45,10,3,15,6,81,38.249770724402964,-109.432723
41494,2,44,10,4,16,4,80,38.249770724402964,-109.4324535
41495,2,39,10,4,15,5,75,38.249770724402964,-109.432184
41496,3,35,10,4,12,7,71,38.249770724402964,-109.4319145
41497,3,34,9,5,10,5,66,38.249770724402964,-109.431645
41498,2,35,9,5,11,4,66,38.249770724402964,-109.4313755
41499,1,44,8,4,11,4,72,38.249770724402964,-109.431106
41500,2,47,9,5,12,4,79,38.249770724402964,-109.4308365
41501,4,46,11,8,12,3,84,38.249770724402964,-109.430567
41502,8,41,12,11,13,1,86,38.249770724402964,-109.4302975
41503,9,41,12,10,13,1,86,38.249770724402964,-109.430028
41504,9,39,13,11,13,1,86,38.249770724402964,-109.4297586
41505,10,37,13,12,13,1,86,38.249770724402964,-109.4294891
41506,10,37,14,13,13,1,88,38.249770724402964,-109.4292196
41507,10,39,14,14,13,0,90,38.249770724402964,-109.4289501
41508,11,40,14,14,14,0,93,38.249770724402964,-109.4286806
41509,10,42,14,14,14,0,94,38.249770724402964,-109.4284111
41510,9,45,13,12,14,1,94,38.249770724402964,-109.4281416
41511,8,48,13,12,13,1,95,38.249770724402964,-109.4278721
41512,8,46,14,13,12,1,94,38.249770724402964,-109.4276026
41513,6,47,12,12,13,1,91,38.249770724402964,-109.4273331
41514,6,45,12,12,14,1,90,38.249770724402964,-109.4270636
41515,7,44,13,12,14,1,91,38.249770724402964,-109.4267941
41516,5,41,13,12,13,1,85,38.249770724402964,-109.4265246
41517,5,41,11,8,13,1,79,38.249770724402964,-109.4262551
41518,5,37,10,7,12,2,73,38.249770724402964,-109.4259856
41519,6,36,10,6,13,2,73,38.249770724402964,-109.4257161
41520,6,37,11,8,14,2,78,38.249770724402964,-109.4254466
41521,9,36,13,12,13,1,84,38.249770724402964,-109.4251771
41522,8,31,12,9,12,2,74,38.249770724402964,-109.4249077
41523,7,33,11,9,13,2,75,38.249770724402964,-109.4246382
41524,9,39,12,11,13,1,85,38.249770724402964,-109.4243687
41525,11,40,14,13,12,1,91,38.249770724402964,-109.4240992
41526,6,44,11,8,11,1,81,38.249770724402964,-109.4238297
41527,4,48,10,7,12,1,82,38.249770724402964,-109.4235602
41528,5,51,9,8,12,1,86,38.249770724402964,-109.4232907
41529,6,54,9,9,12,0,90,38.249770724402964,-109.4230212
41530,8,54,10,10,12,0,94,38.249770724402964,-109.4227517
41531,8,49,11,12,13,1,94,38.249770724402964,-109.4224822
41532,10,43,13,12,14,1,93,38.249770724402964,-109.4222127
41533,10,41,14,12,14,1,92,38.249770724402964,-109.4219432
41534,10,40,14,13,13,1,91,38.249770724402964,-109.4216737
41535,9,39,14,13,13,1,89,38.249770724402964,-109.4214042
41536,8,38,14,14,13,1,88,38.249770724402964,-109.4211347
41537,8,41,15,14,13,1,92,38.249770724402964,-109.4208652
41538,10,42,14,13,13,0,92,38.249770724402964,-109.4205957
41539,10,42,13,14,14,0,93,38.249770724402964,-109.4203262
41540,9,43,14,15,13,0,94,38.249770724402964,-109.4200568
41541,11,42,13,14,13,0,93,38.249770724402964,-109.4197873
41542,12,41,13,13,14,0,93,38.249770724402964,-109.4195178
41543,12,40,14,14,14,0,94,38.249770724402964,-109.4192483
41544,8,41,13,14,14,1,91,38.249770724402964,-109.4189788
41545,7,44,13,12,15,0,91,38.249770724402964,-109.4187093
41546,7,41,13,14,14,1,90,38.249770724402964,-109.4184398
41547,9,40,13,15,13,0,90,38.249770724402964,-109.4181703
41548,11,38,14,14,13,0,90,38.249770724402964,-109.4179008
41549,12,38,14,14,13,0,91,38.249770724402964,-109.4176313
41550,12,38,14,14,13,0,91,38.249770724402964,-109.4173618
41551,6,41,13,12,14,1,87,38.249770724402964,-109.4170923
41552,3,40,11,7,13,4,78,38.249770724402964,-109.4168228
41553,2,34,10,3,10,7,66,38.249770724402964,-109.4165533
41554,2,32,9,3,9,8,63,38.249770724402964,-109.4162838
41555,1,30,10,3,10,11,65,38.249770724402964,-109.4160143
41556,1,32,9,1,8,12,63,38.249770724402964,-109.4157448
41557,1,37,9,0,8,11,66,38.249770724402964,-109.4154753
41558,1,33,10,2,9,12,67,38.249770724402964,-109.4152058
41559,2,40,11,4,15,5,77,38.249770724402964,-109.4149364
41560,3,43,11,7,14,3,81,38.249770724402964,-109.4146669
41561,4,45,10,8,13,2,82,38.249770724402964,-109.4143974
41562,3,45,10,7,12,2,79,38.249770724402964,-109.4141279
41563,3,46,9,2,12,6,78,38.249770724402964,-109.4138584
41564,2,44,10,3,15,5,79,38.249770724402964,-109.4135889
41565,2,44,10,4,15,4,79,38.249770724402964,-109.4133194
41566,2,43,10,5,13,3,76,38.249770724402964,-109.4130499
41567,3,40,10,6,11,3,73,38.249770724402964,-109.4127804
41568,3,41,11,5,12,4,76,38.249770724402964,-109.4125109
41569,3,43,11,4,14,6,81,38.249770724402964,-109.4122414
41570,2,43,11,3,14,6,79,38.249770724402964,-109.4119719
41571,2,42,11,3,14,6,78,38.249770724402964,-109.4117024
41572,2,41,11,4,13,5,76,38.249770724402964,-109.4114329
41573,2,42,9,2,9,7,71,38.249770724402964,-109.4111634
41574,3,29,11,7,10,7,67,38.249770724402964,-109.4108939
41575,6,28,13,12,11,6,76,38.249770724402964,-109.4106244
41576,11,35,14,12,13,4,89,38.249770724402964,-109.4103549
41577,10,36,11,16,9,2,84,38.249770724402964,-109.4100855
41578,6,37,9,20,10,1,83,38.249770724402964,-109.409816
41579,6,32,9,25,9,1,82,38.249770724402964,-109.4095465
41580,6,29,10,26,14,0,85,38.249770724402964,-109.409277
41581,1,31,12,20,18,3,85,38.249770724402964,-109.4090075
41582,1,33,14,11,19,6,84,38.249770724402964,-109.408738
41583,0,29,14,6,17,11,77,38.249770724402964,-109.4084685
41584,0,27,14,4,14,16,75,38.249770724402964,-109.408199
41585,0,27,14,1,13,19,74,38.249770724402964,-109.4079295
41586,0,28,14,0,11,20,73,38.249770724402964,-109.40766
41587,2,34,13,0,11,17,77,38.249770724402964,-109.4073905
41588,1,33,12,0,10,18,74,38.249770724402964,-109.407121
41589,0,31,13,0,9,20,73,38.249770724402964,-109.4068515
41590,0,31,14,0,9,20,74,38.249770724402964,-109.406582
41591,0,32,12,0,10,16,70,38.249770724402964,-109.4063125
41592,1,35,12,0,11,15,74,38.249770724402964,-109.406043
41593,1,32,12,0,10,16,71,38.249770724402964,-109.4057735
41594,1,30,12,0,9,17,69,38.249770724402964,-109.405504
41595,1,28,12,0,9,19,69,38.249770724402964,-109.4052345
41596,1,31,13,0,10,18,73,38.249770724402964,-109.4049651
41597,1,33,12,0,10,16,72,38.249770724402964,-109.4046956
41598,1,33,11,1,12,13,71,38.249770724402964,-109.4044261
41599,3,36,12,6,16,6,79,38.249770724402964,-109.4041566
41600,7,37,13,8,16,4,85,38.249770724402964,-109.4038871
41601,3,32,12,4,14,10,75,38.249770724402964,-109.4036176
41602,2,33,11,3,13,10,72,38.249770724402964,-109.4033481
41603,2,34,11,3,13,10,73,38.249770724402964,-109.4030786
41604,2,31,11,1,11,13,69,38.249770724402964,-109.4028091
41605,2,30,12,0,9,16,69,38.249770724402964,-109.4025396
41606,1,25,12,0,8,20,66,38.249770724402964,-109.4022701
41607,0,23,13,0,6,23,65,38.249770724402964,-109.4020006
41608,0,23,13,0,7,22,65,38.249770724402964,-109.4017311
41609,2,24,12,4,11,14,67,38.249770724402964,-109.4014616
41610,14,23,13,11,13,8,82,38.249770724402964,-109.4011921
41611,22,16,13,13,19,6,89,38.249770724402964,-109.4009226
41612,24,17,12,14,17,4,88,38.249770724402964,-109.4006531
41613,22,22,12,16,14,3,89,38.249770724402964,-109.4003836
41614,20,28,12,13,13,1,87,38.249770724402964,-109.4001142
41615,20,31,12,14,13,0,90,38.249770724402964,-109.3998447
41616,20,31,13,12,12,1,89,38.249770724402964,-109.3995752
41617,22,31,13,12,10,2,90,38.249770724402964,-109.3993057
41618,24,31,13,11,10,2,91,38.249770724402964,-109.3990362
41619,29,30,13,10,10,1,93,38.249770724402964,-109.3987667
41620,22,31,14,13,12,1,93,38.249770724402964,-109.3984972
41621,21,33,14,14,12,1,95,38.249770724402964,-109.3982277
41622,20,35,15,13,11,1,95,38.249770724402964,-109.3979582
41623,18,37,15,13,12,1,96,38.249770724402964,-109.3976887
41624,15,39,15,13,14,1,97,38.249770724402964,-109.3974192
41625,14,38,15,13,14,1,95,38.249770724402964,-109.3971497
41626,12,37,14,13,15,1,92,38.249770724402964,-109.3968802
41627,12,37,14,13,15,0,91,38.249770724402964,-109.3966107
41628,12,38,14,13,16,0,93,38.249770724402964,-109.3963412
41629,14,37,15,13,14,0,93,38.249770724402964,-109.3960717
41630,13,37,15,13,14,0,92,38.249770724402964,-109.3958022
41631,11,40,15,13,15,0,94,38.249770724402964,-109.3955327
41632,8,42,15,13,16,0,94,38.249770724402964,-109.3952632
41633,8,42,15,13,16,0,94,38.249770724402964,-109.3949938
41634,9,41,14,13,16,0,93,38.249770724402964,-109.3947243
41635,9,42,14,13,16,0,94,38.249770724402964,-109.3944548
41636,9,42,14,13,16,0,94,38.249770724402964,-109.3941853
41637,9,42,14,12,16,0,93,38.249770724402964,-109.3939158
41638,9,43,14,12,16,0,94,38.249770724402964,-109.3936463
41639,9,44,14,11,16,0,94,38.249770724402964,-109.3933768
41640,9,41,14,12,16,0,92,38.249770724402964,-109.3931073
41641,10,39,13,12,16,0,90,38.249770724402964,-109.3928378
41642,13,39,13,10,15,0,90,38.249770724402964,-109.3925683
41643,12,39,13,11,16,0,91,38.249770724402964,-109.3922988
41644,13,37,13,12,15,0,90,38.249770724402964,-109.3920293
41645,16,36,13,12,15,0,92,38.249770724402964,-109.3917598
41646,17,35,13,12,14,0,91,38.249770724402964,-109.3914903
41647,16,37,13,12,14,0,92,38.249770724402964,-109.3912208
41648,15,37,13,11,14,0,90,38.249770724402964,-109.3909513
41649,13,38,13,12,14,0,90,38.249770724402964,-109.3906818
41650,12,40,13,11,15,0,91,38.249770724402964,-109.3904123
41651,12,40,13,11,15,0,91,38.249770724402964,-109.3901429
41652,13,38,14,13,14,0,92,38.249770724402964,-109.3898734
41653,11,39,14,13,14,0,91,38.249770724402964,-109.3896039
41654,12,40,14,12,14,0,92,38.249770724402964,-109.3893344
41655,12,40,13,11,13,1,90,38.249770724402964,-109.3890649
41656,13,39,13,12,13,0,90,38.249770724402964,-109.3887954
41657,12,40,13,11,13,0,89,38.249770724402964,-109.3885259
41658,12,43,13,10,14,0,92,38.249770724402964,-109.3882564
41659,13,43,13,10,13,0,92,38.249770724402964,-109.3879869
41660,14,42,13,10,13,0,92,38.249770724402964,-109.3877174
41661,14,42,14,11,13,0,94,38.249770724402964,-109.3874479
41662,13,41,14,11,13,0,92,38.249770724402964,-109.3871784
41663,13,40,12,11,13,0,89,38.249770724402964,-109.3869089
41664,13,38,12,11,13,1,88,38.249770724402964,-109.3866394
41665,15,38,11,11,13,1,89,38.249770724402964,-109.3863699
41666,16,41,13,10,12,0,92,38.249770724402964,-109.3861004
41667,15,44,13,9,13,0,94,38.249770724402964,-109.3858309
41668,12,45,13,9,14,0,93,38.249770724402964,-109.3855614
41669,10,45,13,9,16,0,93,38.249770724402964,-109.3852919
41670,10,43,13,10,16,0,92,38.249770724402964,-109.3850225
41671,10,43,13,11,15,0,92,38.249770724402964,-109.384753
41672,9,44,13,10,15,0,91,38.249770724402964,-109.3844835
41673,7,45,12,9,16,1,90,38.249770724402964,-109.384214
41674,6,44,12,9,16,1,88,38.249770724402964,-109.3839445
41675,11,40,13,11,15,0,90,38.249770724402964,-109.383675
41676,13,41,13,12,13,0,92,38.249770724402964,-109.3834055
41677,14,36,12,12,13,1,88,38.249770724402964,-109.383136
41678,18,26,12,12,11,2,81,38.249770724402964,-109.3828665
41679,17,19,11,17,11,1,76,38.249770724402964,-109.382597
41680,22,29,12,10,10,3,86,38.249770724402964,-109.3823275
41681,14,38,12,10,12,2,88,38.249770724402964,-109.382058
41682,7,42,12,10,14,2,87,38.249770724402964,-109.3817885
41683,6,41,12,9,14,2,84,38.249770724402964,-109.381519
41684,8,42,13,9,14,3,89,38.249770724402964,-109.3812495
41685,8,42,13,10,13,4,90,38.249770724402964,-109.38098
41686,8,43,14,10,11,4,90,38.249770724402964,-109.3807105
41687,9,42,14,11,10,4,90,38.249770724402964,-109.380441
41688,10,41,14,12,9,4,90,38.249770724402964,-109.3801716
41689,10,41,14,13,10,3,91,38.249770724402964,-109.3799021
41690,15,38,14,14,9,2,92,38.249770724402964,-109.3796326
41691,18,37,14,14,8,1,92,38.249770724402964,-109.3793631
41692,21,37,13,13,8,1,93,38.249770724402964,-109.3790936
41693,24,35,13,11,7,1,91,38.249770724402964,-109.3788241
41694,26,31,12,9,6,0,84,38.249770724402964,-109.3785546
41695,31,27,10,7,5,0,80,38.249770724402964,-109.3782851
41696,37,23,8,5,5,0,78,38.249770724402964,-109.3780156
41697,40,20,7,4,4,0,75,38.249770724402964,-109.3777461
41698,43,19,8,4,5,0,79,38.249770724402964,-109.3774766
41699,43,23,10,6,6,2,90,38.249770724402964,-109.3772071
41700,33,24,12,12,7,2,90,38.249770724402964,-109.3769376
41701,22,26,13,14,8,3,86,38.249770724402964,-109.3766681
41702,18,28,13,15,9,3,86,38.249770724402964,-109.3763986
41703,10,25,15,15,7,10,82,38.249770724402964,-109.3761291
41704,8,23,14,18,9,9,81,38.249770724402964,-109.3758596
41705,8,24,14,13,9,11,79,38.249770724402964,-109.3755901
41706,8,26,14,9,11,12,80,38.249770724402964,-109.3753206
41707,6,26,14,6,9,14,75,38.249770724402964,-109.3750512
41708,5,23,14,8,10,13,73,38.249770724402964,-109.3747817
41709,6,22,15,9,10,16,78,38.249770724402964,-109.3745122
41710,6,22,15,13,15,15,86,38.249770724402964,-109.3742427
41711,6,24,14,13,21,15,93,38.249770724402964,-109.3739732
41712,8,24,16,8,18,16,90,38.249770724402964,-109.3737037
41713,3,26,17,3,10,21,80,38.249770724402964,-109.3734342
41714,1,27,15,0,6,23,72,38.249770724402964,-109.3731647
41715,2,29,15,0,8,21,75,38.249770724402964,-109.3728952
41716,2,28,15,0,8,21,74,38.249770724402964,-109.3726257
41717,0,25,13,0,7,22,67,38.249770724402964,-109.3723562
41718,2,30,12,0,10,17,71,38.249770724402964,-109.3720867
41719,2,29,13,1,10,17,72,38.249770724402964,-109.3718172
41720,1,28,14,0,9,21,73,38.249770724402964,-109.3715477
41721,2,30,15,1,8,23,79,38.249770724402964,-109.3712782
41722,3,30,16,4,13,19,85,38.249770724402964,-109.3710087
41723,2,31,15,8,14,14,84,38.249770724402964,-109.3707392
41724,3,28,14,17,13,7,82,38.249770724402964,-109.3704697
41725,3,26,15,21,11,6,82,38.249770724402964,-109.3702003
41726,5,34,10,19,16,0,84,38.249770724402964,-109.3699308
41727,9,30,11,24,16,0,90,38.249770724402964,-109.3696613
41728,14,24,11,30,15,0,94,38.249770724402964,-109.3693918
41729,6,22,11,23,20,2,84,38.249770724402964,-109.3691223
41730,3,14,13,29,16,2,77,38.249770724402964,-109.3688528
41731,4,13,11,34,14,3,79,38.249770724402964,-109.3685833
41732,2,15,10,27,17,3,74,38.249770724402964,-109.3683138
41733,4,18,11,21,14,5,73,38.249770724402964,-109.3680443
41734,4,25,11,11,15,6,72,38.249770724402964,-109.3677748
41735,3,23,12,9,13,7,67,38.249770724402964,-109.3675053
41736,2,24,16,3,7,24,76,38.249770724402964,-109.3672358
41737,0,24,16,0,4,30,74,38.249770724402964,-109.3669663
41738,0,23,16,0,2,31,72,38.249770724402964,-109.3666968
41739,0,23,16,0,1,30,70,38.249770724402964,-109.3664273
41740,1,23,16,0,1,30,71,38.249770724402964,-109.3661578
41741,1,23,16,0,2,30,72,38.249770724402964,-109.3658883
41742,1,24,16,0,2,28,71,38.249770724402964,-109.3656188
41743,1,23,15,0,1,27,67,38.249770724402964,-109.3653493
41744,0,21,15,0,2,27,65,38.249770724402964,-109.3650799
41745,1,21,15,0,2,26,65,38.249770724402964,-109.3648104
41746,1,23,14,0,2,25,65,38.249770724402964,-109.3645409
41747,1,24,15,0,2,25,67,38.249770724402964,-109.3642714
41748,1,23,15,0,2,23,64,38.249770724402964,-109.3640019
41749,1,23,14,0,2,23,63,38.249770724402964,-109.3637324
41750,0,23,14,0,2,24,63,38.249770724402964,-109.3634629
41751,0,21,14,0,2,25,62,38.249770724402964,-109.3631934
41752,0,24,14,0,2,25,65,38.249770724402964,-109.3629239
41753,1,24,13,0,2,24,64,38.249770724402964,-109.3626544
41754,1,22,12,0,2,22,59,38.249770724402964,-109.3623849
41755,0,22,13,0,2,23,60,38.249770724402964,-109.3621154
41756,1,23,14,0,1,25,64,38.249770724402964,-109.3618459
41757,0,25,14,0,1,24,64,38.249770724402964,-109.3615764
41758,0,28,12,0,2,22,64,38.249770724402964,-109.3613069
41759,1,29,11,0,3,19,63,38.249770724402964,-109.3610374
41760,0,33,10,0,5,17,65,38.249770724402964,-109.3607679
41761,1,31,11,0,5,18,66,38.249770724402964,-109.3604984
41762,1,25,12,0,3,20,61,38.249770724402964,-109.360229
41763,1,18,13,0,3,21,56,38.249770724402964,-109.3599595
41764,4,18,14,1,3,18,58,38.249770724402964,-109.35969
41765,2,19,11,4,4,15,55,38.249770724402964,-109.3594205
41766,1,23,10,3,6,11,54,38.249770724402964,-109.359151
41767,2,29,8,4,8,6,57,38.249770724402964,-109.3588815
41768,2,30,7,5,9,4,57,38.249770724402964,-109.358612
41769,0,28,3,0,7,6,44,38.249770724402964,-109.3583425
41770,2,31,8,6,10,7,64,38.249770724402964,-109.358073
41771,2,36,8,6,10,5,67,38.249770724402964,-109.3578035
41772,2,35,8,6,10,6,67,38.249770724402964,-109.357534
41773,2,32,8,5,9,7,63,38.249770724402964,-109.3572645
41774,2,29,8,6,8,8,61,38.249770724402964,-109.356995
41775,2,44,7,5,9,5,72,38.249770724402964,-109.3567255
41776,2,52,8,4,10,4,80,38.249770724402964,-109.356456
41777,2,53,7,5,10,4,81,38.249770724402964,-109.3561865
41778,3,46,7,5,9,3,73,38.249770724402964,-109.355917
41779,6,41,6,4,10,3,70,38.249770724402964,-109.3556475
41780,4,35,7,2,8,6,62,38.249770724402964,-109.355378
41781,2,31,9,2,8,11,63,38.249770724402964,-109.3551086
41782,1,34,9,1,8,12,65,38.249770724402964,-109.3548391
41783,1,35,9,3,12,6,66,38.249770724402964,-109.3545696
41784,2,28,8,3,8,6,55,38.249770724402964,-109.3543001
41785,1,23,8,3,7,7,49,38.249770724402964,-109.3540306
41786,2,26,9,5,9,6,57,38.249770724402964,-109.3537611
41787,2,26,10,4,10,9,61,38.249770724402964,-109.3534916
41788,1,22,11,5,9,12,60,38.249770724402964,-109.3532221
41789,1,22,10,5,6,10,54,38.249770724402964,-109.3529526
41790,1,26,9,6,5,8,55,38.249770724402964,-109.3526831
41791,1,34,10,5,6,7,63,38.249770724402964,-109.3524136
41792,2,37,8,6,7,3,63,38.249770724402964,-109.3521441
41793,2,31,7,5,8,4,57,38.249770724402964,-109.3518746
41794,1,30,6,3,7,4,51,38.249770724402964,-109.3516051
41795,1,32,6,3,8,3,53,38.249770724402964,-109.3513356
41796,1,30,6,3,8,3,51,38.249770724402964,-109.3510661
41797,4,23,10,11,10,3,61,38.249770724402964,-109.3507966
41798,2,22,11,11,9,7,62,38.249770724402964,-109.3505271
41799,2,26,9,8,10,5,60,38.249770724402964,-109.3502577
41800,5,31,9,9,9,2,65,38.249770724402964,-109.3499882
41801,4,34,8,7,8,2,63,38.249770724402964,-109.3497187
41802,2,24,9,6,6,8,55,38.249770724402964,-109.3494492
41803,3,26,12,4,9,11,65,38.249770724402964,-109.3491797
41804,2,28,11,3,8,9,61,38.249770724402964,-109.3489102
41805,2,33,6,5,9,3,58,38.249770724402964,-109.3486407
41806,3,51,4,2,6,2,68,38.249770724402964,-109.3483712
41807,4,29,7,6,8,5,59,38.249770724402964,-109.3481017
41808,3,21,11,9,9,8,61,38.249770724402964,-109.3478322
41809,5,25,11,7,8,8,64,38.249770724402964,-109.3475627
41810,4,37,8,7,8,2,66,38.249770724402964,-109.3472932
41811,2,32,6,6,8,2,56,38.249770724402964,-109.3470237
41812,3,35,6,6,8,2,60,38.249770724402964,-109.3467542
41813,3,29,8,5,8,4,57,38.249770724402964,-109.3464847
41814,3,29,9,5,7,5,58,38.249770724402964,-109.3462152
41815,2,36,8,4,7,4,61,38.249770724402964,-109.3459457
41816,3,33,8,5,8,4,61,38.249770724402964,-109.3456762
41817,2,26,9,4,7,8,56,38.249770724402964,-109.3454068
41818,2,19,10,5,8,9,53,38.249770724402964,-109.3451373
41819,6,19,10,6,11,7,59,38.249770724402964,-109.3448678
41820,5,22,11,2,5,14,59,38.249770724402964,-109.3445983
41821,2,21,12,2,4,18,59,38.249770724402964,-109.3443288
41822,3,24,13,1,3,21,65,38.249770724402964,-109.3440593
41823,3,24,13,0,3,22,65,38.249770724402964,-109.3437898
41824,2,24,12,0,3,22,63,38.249770724402964,-109.3435203
41825,2,23,12,0,3,21,61,38.249770724402964,-109.3432508
41826,3,28,11,6,10,8,66,38.249770724402964,-109.3429813
41827,7,33,8,6,7,3,64,38.249770724402964,-109.3427118
41828,4,39,7,5,8,3,66,38.249770724402964,-109.3424423
41829,4,31,8,6,8,5,62,38.249770724402964,-109.3421728
41830,5,24,8,10,8,6,61,38.249770724402964,-109.3419033
41831,5,22,10,25,18,1,81,38.249770724402964,-109.3416338
41832,2,16,11,23,25,4,81,38.249770724402964,-109.3413643
41833,2,14,13,18,13,8,68,38.249770724402964,-109.3410948
41834,6,18,12,16,18,1,71,38.249770724402964,-109.3408253
41835,8,45,9,12,6,1,81,38.249770724402964,-109.3405558
41836,4,39,7,7,9,2,68,38.249770724402964,-109.3402864
41837,7,37,8,8,10,2,72,38.249770724402964,-109.3400169
41838,4,35,10,9,10,3,71,38.249770724402964,-109.3397474
41839,3,47,7,7,8,3,75,38.249770724402964,-109.3394779
41840,4,37,7,7,8,3,66,38.249770724402964,-109.3392084
41841,5,40,7,6,8,2,68,38.249770724402964,-109.3389389
41842,4,39,7,8,7,2,67,38.249770724402964,-109.3386694
41843,7,34,8,9,10,2,70,38.249770724402964,-109.3383999
41844,4,29,13,24,12,1,83,38.249770724402964,-109.3381304
41845,11,14,9,30,15,5,84,38.249770724402964,-109.3378609
41846,4,11,11,22,27,5,80,38.249770724402964,-109.3375914
41847,3,15,8,21,17,2,66,38.249770724402964,-109.3373219
41848,1,21,10,13,11,7,63,38.249770724402964,-109.3370524
41849,1,23,10,7,12,9,62,38.249770724402964,-109.3367829
41850,2,23,10,4,7,12,58,38.249770724402964,-109.3365134
41851,1,24,10,5,8,11,59,38.249770724402964,-109.3362439
41852,1,23,10,8,10,10,62,38.249770724402964,-109.3359744
41853,2,25,11,6,9,10,63,38.249770724402964,-109.3357049
41854,3,23,11,5,10,11,63,38.249770724402964,-109.3354355
41855,2,19,12,6,8,13,60,38.249770724402964,-109.335166
41856,1,16,12,5,6,15,55,38.249770724402964,-109.3348965
41857,2,21,11,3,8,13,58,38.249770724402964,-109.334627
41858,1,26,9,2,7,11,56,38.249770724402964,-109.3343575
41859,1,36,8,3,8,6,62,38.249770724402964,-109.334088
41860,0,40,7,1,8,6,62,38.249770724402964,-109.3338185
41861,1,44,6,1,11,4,67,38.249770724402964,-109.333549
41862,2,58,7,4,11,1,83,38.249770724402964,-109.3332795
41863,1,47,6,2,10,3,69,38.249770724402964,-109.33301
41864,2,38,7,3,9,4,63,38.249770724402964,-109.3327405
41865,3,34,7,4,9,4,61,38.249770724402964,-109.332471
41866,3,34,7,4,9,4,61,38.249770724402964,-109.3322015
41867,3,38,7,4,8,4,64,38.249770724402964,-109.331932
41868,1,44,7,5,10,2,69,38.249770724402964,-109.3316625
41869,1,46,6,3,9,3,68,38.249770724402964,-109.331393
41870,2,26,9,5,11,6,59,38.24950122981773,-109.4402688
41871,9,38,10,8,14,1,80,38.24950122981773,-109.4399993
41872,12,41,12,11,15,0,91,38.24950122981773,-109.4397299
41873,9,44,13,12,15,0,93,38.24950122981773,-109.4394604
41874,5,46,12,11,14,1,89,38.24950122981773,-109.4391909
41875,4,43,12,9,16,1,85,38.24950122981773,-109.4389214
41876,6,43,12,9,17,0,87,38.24950122981773,-109.4386519
41877,8,42,12,10,16,0,88,38.24950122981773,-109.4383824
41878,9,42,12,11,15,0,89,38.24950122981773,-109.4381129
41879,9,43,13,11,14,0,90,38.24950122981773,-109.4378434
41880,11,42,13,12,14,0,92,38.24950122981773,-109.4375739
41881,9,42,13,13,14,0,91,38.24950122981773,-109.4373044
41882,8,42,13,13,13,1,90,38.24950122981773,-109.4370349
41883,6,44,13,13,13,1,90,38.24950122981773,-109.4367654
41884,4,45,12,12,12,1,86,38.24950122981773,-109.4364959
41885,4,43,13,12,12,2,86,38.24950122981773,-109.4362264
41886,4,42,12,8,12,4,82,38.24950122981773,-109.4359569
41887,3,42,11,5,12,6,79,38.24950122981773,-109.4356874
41888,2,42,11,3,12,8,78,38.24950122981773,-109.4354179
41889,3,39,11,0,11,12,76,38.24950122981773,-109.4351484
41890,2,35,11,0,11,13,72,38.24950122981773,-109.434879
41891,2,39,11,1,13,11,77,38.24950122981773,-109.4346095
41892,2,42,11,2,13,9,79,38.24950122981773,-109.43434
41893,2,39,10,0,11,13,75,38.24950122981773,-109.4340705
41894,1,37,10,0,10,13,71,38.24950122981773,-109.433801
41895,1,36,10,0,10,13,70,38.24950122981773,-109.4335315
41896,1,37,10,2,14,8,72,38.24950122981773,-109.433262
41897,3,39,9,5,14,4,74,38.24950122981773,-109.4329925
41898,2,41,9,4,12,4,72,38.24950122981773,-109.432723
41899,3,36,9,5,12,4,69,38.24950122981773,-109.4324535
41900,2,36,8,4,11,5,66,38.24950122981773,-109.432184
41901,2,38,8,3,10,7,68,38.24950122981773,-109.4319145
41902,2,38,8,4,9,5,66,38.24950122981773,-109.431645
41903,2,34,8,4,10,6,64,38.24950122981773,-109.4313755
41904,2,34,9,4,11,6,66,38.24950122981773,-109.431106
41905,4,38,10,6,13,3,74,38.24950122981773,-109.4308365
41906,5,40,11,8,14,2,80,38.24950122981773,-109.430567
41907,6,40,11,9,13,1,80,38.24950122981773,-109.4302975
41908,6,39,11,9,13,2,80,38.24950122981773,-109.430028
41909,7,41,11,9,13,2,83,38.24950122981773,-109.4297586
41910,8,41,12,11,13,1,86,38.24950122981773,-109.4294891
41911,10,38,14,13,13,1,89,38.24950122981773,-109.4292196
41912,12,40,14,14,14,0,94,38.24950122981773,-109.4289501
41913,12,40,14,14,14,0,94,38.24950122981773,-109.4286806
41914,11,42,14,15,14,0,96,38.24950122981773,-109.4284111
41915,9,45,13,14,14,0,95,38.24950122981773,-109.4281416
41916,6,47,12,12,13,1,91,38.24950122981773,-109.4278721
41917,5,43,12,12,12,1,85,38.24950122981773,-109.4276026
41918,4,43,11,11,12,1,82,38.24950122981773,-109.4273331
41919,5,44,12,13,13,1,88,38.24950122981773,-109.4270636
41920,6,42,12,13,13,1,87,38.24950122981773,-109.4267941
41921,5,41,12,10,13,2,83,38.24950122981773,-109.4265246
41922,4,43,10,7,12,2,78,38.24950122981773,-109.4262551
41923,4,43,10,8,13,1,79,38.24950122981773,-109.4259856
41924,6,42,12,10,13,1,84,38.24950122981773,-109.4257161
41925,10,39,14,14,13,1,91,38.24950122981773,-109.4254466
41926,13,32,15,17,12,1,90,38.24950122981773,-109.4251771
41927,13,27,16,16,10,1,83,38.24950122981773,-109.4249077
41928,10,31,13,13,12,1,80,38.24950122981773,-109.4246382
41929,8,38,12,11,13,1,83,38.24950122981773,-109.4243687
41930,10,41,13,12,13,1,90,38.24950122981773,-109.4240992
41931,7,44,12,10,12,1,86,38.24950122981773,-109.4238297
41932,5,48,10,9,13,1,86,38.24950122981773,-109.4235602
41933,5,51,10,9,13,1,89,38.24950122981773,-109.4232907
41934,6,52,10,10,12,0,90,38.24950122981773,-109.4230212
41935,8,51,11,11,12,0,93,38.24950122981773,-109.4227517
41936,8,50,11,11,11,0,91,38.24950122981773,-109.4224822
41937,9,45,12,12,13,0,91,38.24950122981773,-109.4222127
41938,10,42,13,11,14,0,90,38.24950122981773,-109.4219432
41939,9,41,13,12,13,1,89,38.24950122981773,-109.4216737
41940,10,39,14,13,12,1,89,38.24950122981773,-109.4214042
41941,10,39,14,14,13,0,90,38.24950122981773,-109.4211347
41942,9,42,14,14,14,0,93,38.24950122981773,-109.4208652
41943,8,44,14,14,14,0,94,38.24950122981773,-109.4205957
41944,8,44,14,14,14,0,94,38.24950122981773,-109.4203262
41945,6,45,14,14,14,1,94,38.24950122981773,-109.4200568
41946,7,44,13,14,14,0,92,38.24950122981773,-109.4197873
41947,10,42,13,13,14,0,92,38.24950122981773,-109.4195178
41948,12,40,14,13,14,0,93,38.24950122981773,-109.4192483
41949,8,41,13,14,14,1,91,38.24950122981773,-109.4189788
41950,6,42,12,12,15,1,88,38.24950122981773,-109.4187093
41951,6,42,13,13,14,1,89,38.24950122981773,-109.4184398
41952,7,41,13,14,14,1,90,38.24950122981773,-109.4181703
41953,9,39,14,14,14,0,90,38.24950122981773,-109.4179008
41954,10,39,14,15,13,0,91,38.24950122981773,-109.4176313
41955,11,39,13,12,14,1,90,38.24950122981773,-109.4173618
41956,5,39,11,10,13,2,80,38.24950122981773,-109.4170923
41957,3,35,10,5,11,4,68,38.24950122981773,-109.4168228
41958,2,32,8,2,9,6,59,38.24950122981773,-109.4165533
41959,3,33,9,5,12,5,67,38.24950122981773,-109.4162838
41960,1,35,10,2,12,9,69,38.24950122981773,-109.4160143
41961,1,36,9,2,10,10,68,38.24950122981773,-109.4157448
41962,2,36,9,3,10,9,69,38.24950122981773,-109.4154753
41963,2,33,11,3,10,11,70,38.24950122981773,-109.4152058
41964,2,37,10,4,14,6,73,38.24950122981773,-109.4149364
41965,2,41,10,5,14,4,76,38.24950122981773,-109.4146669
41966,3,43,10,6,13,3,78,38.24950122981773,-109.4143974
41967,3,46,10,6,14,2,81,38.24950122981773,-109.4141279
41968,4,50,10,5,15,2,86,38.24950122981773,-109.4138584
41969,3,51,11,5,15,3,88,38.24950122981773,-109.4135889
41970,3,51,11,4,15,3,87,38.24950122981773,-109.4133194
41971,3,50,11,4,14,3,85,38.24950122981773,-109.4130499
41972,3,48,11,5,14,3,84,38.24950122981773,-109.4127804
41973,3,47,12,5,15,3,85,38.24950122981773,-109.4125109
41974,3,47,12,4,16,5,87,38.24950122981773,-109.4122414
41975,2,45,11,4,15,5,82,38.24950122981773,-109.4119719
41976,2,40,11,4,14,5,76,38.24950122981773,-109.4117024
41977,2,37,10,5,12,4,70,38.24950122981773,-109.4114329
41978,2,33,9,4,10,6,64,38.24950122981773,-109.4111634
41979,3,31,10,6,9,5,64,38.24950122981773,-109.4108939
41980,4,36,12,9,11,5,77,38.24950122981773,-109.4106244
41981,4,37,12,18,12,3,86,38.24950122981773,-109.4103549
41982,4,34,10,22,13,0,83,38.24950122981773,-109.4100855
41983,1,33,11,16,19,3,83,38.24950122981773,-109.409816
41984,2,30,13,11,19,6,81,38.24950122981773,-109.4095465
41985,1,29,15,12,20,7,84,38.24950122981773,-109.409277
41986,0,31,14,9,19,9,82,38.24950122981773,-109.4090075
41987,0,32,14,4,16,13,79,38.24950122981773,-109.408738
41988,0,31,13,0,10,18,72,38.24950122981773,-109.4084685
41989,1,31,12,0,9,19,72,38.24950122981773,-109.408199
41990,1,30,13,0,9,20,73,38.24950122981773,-109.4079295
41991,1,30,13,0,9,19,72,38.24950122981773,-109.40766
41992,1,31,11,0,10,16,69,38.24950122981773,-109.4073905
41993,1,34,11,0,11,15,72,38.24950122981773,-109.407121
41994,1,33,11,0,10,16,71,38.24950122981773,-109.4068515
41995,0,31,11,0,9,18,69,38.24950122981773,-109.406582
41996,0,30,11,0,10,16,67,38.24950122981773,-109.4063125
41997,0,30,11,0,9,16,66,38.24950122981773,-109.406043
41998,0,32,10,0,10,15,67,38.24950122981773,-109.4057735
41999,1,33,10,0,11,13,68,38.24950122981773,-109.405504
42000,1,34,10,0,12,11,68,38.24950122981773,-109.4052345
42001,2,37,12,4,15,7,77,38.24950122981773,-109.4049651
42002,2,37,11,4,15,7,76,38.24950122981773,-109.4046956
42003,2,35,11,3,15,8,74,38.24950122981773,-109.4044261
42004,3,34,11,3,15,9,75,38.24950122981773,-109.4041566
42005,5,34,13,7,14,7,80,38.24950122981773,-109.4038871
42006,4,33,13,4,13,11,78,38.24950122981773,-109.4036176
42007,5,28,12,6,12,10,73,38.24950122981773,-109.4033481
42008,5,28,12,6,11,10,72,38.24950122981773,-109.4030786
42009,3,29,11,4,11,11,69,38.24950122981773,-109.4028091
42010,2,23,11,4,9,15,64,38.24950122981773,-109.4025396
42011,2,25,12,6,11,13,69,38.24950122981773,-109.4022701
42012,2,28,12,4,11,13,70,38.24950122981773,-109.4020006
42013,9,31,12,9,14,6,81,38.24950122981773,-109.4017311
42014,24,30,12,12,13,0,91,38.24950122981773,-109.4014616
42015,42,16,12,13,12,0,95,38.24950122981773,-109.4011921
42016,46,10,11,12,18,1,98,38.24950122981773,-109.4009226
42017,46,10,11,14,15,2,98,38.24950122981773,-109.4006531
42018,42,14,12,13,11,2,94,38.24950122981773,-109.4003836
42019,38,20,13,13,9,1,94,38.24950122981773,-109.4001142
42020,31,27,13,11,9,1,92,38.24950122981773,-109.3998447
42021,29,30,13,10,10,1,93,38.24950122981773,-109.3995752
42022,22,32,14,12,11,1,92,38.24950122981773,-109.3993057
42023,15,34,14,15,12,1,91,38.24950122981773,-109.3990362
42024,15,35,14,14,12,1,91,38.24950122981773,-109.3987667
42025,17,33,14,14,12,1,91,38.24950122981773,-109.3984972
42026,16,36,14,14,11,1,92,38.24950122981773,-109.3982277
42027,14,37,15,15,11,1,93,38.24950122981773,-109.3979582
42028,13,39,16,15,12,1,96,38.24950122981773,-109.3976887
42029,11,40,15,14,13,1,94,38.24950122981773,-109.3974192
42030,11,39,15,12,12,2,91,38.24950122981773,-109.3971497
42031,11,40,14,11,12,2,90,38.24950122981773,-109.3968802
42032,10,40,14,11,13,2,90,38.24950122981773,-109.3966107
42033,10,40,14,12,14,1,91,38.24950122981773,-109.3963412
42034,10,40,14,13,14,1,92,38.24950122981773,-109.3960717
42035,10,40,14,14,14,0,92,38.24950122981773,-109.3958022
42036,10,41,14,14,14,0,93,38.24950122981773,-109.3955327
42037,9,40,15,14,15,0,93,38.24950122981773,-109.3952632
42038,12,35,14,15,14,0,90,38.24950122981773,-109.3949938
42039,11,38,14,13,15,1,92,38.24950122981773,-109.3947243
42040,10,39,14,12,15,1,91,38.24950122981773,-109.3944548
42041,9,42,14,12,16,0,93,38.24950122981773,-109.3941853
42042,8,42,14,13,16,0,93,38.24950122981773,-109.3939158
42043,9,43,14,12,16,0,94,38.24950122981773,-109.3936463
42044,10,42,14,12,16,0,94,38.24950122981773,-109.3933768
42045,12,40,13,11,15,0,91,38.24950122981773,-109.3931073
42046,13,39,13,11,15,0,91,38.24950122981773,-109.3928378
42047,15,38,13,10,14,0,90,38.24950122981773,-109.3925683
42048,16,37,13,11,14,0,91,38.24950122981773,-109.3922988
42049,17,35,13,11,15,0,91,38.24950122981773,-109.3920293
42050,18,34,13,11,14,0,90,38.24950122981773,-109.3917598
42051,20,34,13,11,14,0,92,38.24950122981773,-109.3914903
42052,19,35,13,11,13,0,91,38.24950122981773,-109.3912208
42053,16,36,13,11,14,0,90,38.24950122981773,-109.3909513
42054,14,37,14,12,14,0,91,38.24950122981773,-109.3906818
42055,13,38,14,12,15,0,92,38.24950122981773,-109.3904123
42056,12,40,13,11,15,0,91,38.24950122981773,-109.3901429
42057,14,37,14,13,15,0,93,38.24950122981773,-109.3898734
42058,14,37,14,13,14,0,92,38.24950122981773,-109.3896039
42059,15,37,14,13,13,0,92,38.24950122981773,-109.3893344
42060,15,38,14,12,12,0,91,38.24950122981773,-109.3890649
42061,13,40,14,13,13,0,93,38.24950122981773,-109.3887954
42062,12,40,14,14,13,0,93,38.24950122981773,-109.3885259
42063,11,42,14,13,14,0,94,38.24950122981773,-109.3882564
42064,12,43,13,12,13,0,93,38.24950122981773,-109.3879869
42065,13,42,13,11,13,0,92,38.24950122981773,-109.3877174
42066,14,42,13,10,13,0,92,38.24950122981773,-109.3874479
42067,12,43,13,11,14,0,93,38.24950122981773,-109.3871784
42068,11,42,12,10,15,0,90,38.24950122981773,-109.3869089
42069,11,40,11,10,14,1,87,38.24950122981773,-109.3866394
42070,13,41,12,10,13,0,89,38.24950122981773,-109.3863699
42071,15,41,13,11,13,0,93,38.24950122981773,-109.3861004
42072,16,42,13,10,12,0,93,38.24950122981773,-109.3858309
42073,15,43,13,9,13,0,93,38.24950122981773,-109.3855614
42074,13,43,13,10,15,0,94,38.24950122981773,-109.3852919
42075,10,44,13,10,16,0,93,38.24950122981773,-109.3850225
42076,13,42,13,9,15,0,92,38.24950122981773,-109.384753
42077,15,40,13,10,14,0,92,38.24950122981773,-109.3844835
42078,12,40,12,10,15,0,89,38.24950122981773,-109.384214
42079,9,41,12,10,15,1,88,38.24950122981773,-109.3839445
42080,10,39,12,10,15,1,87,38.24950122981773,-109.383675
42081,13,39,13,11,14,0,90,38.24950122981773,-109.3834055
42082,15,35,12,12,13,1,88,38.24950122981773,-109.383136
42083,19,27,12,12,10,2,82,38.24950122981773,-109.3828665
42084,18,21,11,14,11,3,78,38.24950122981773,-109.382597
42085,24,28,13,7,9,5,86,38.24950122981773,-109.3823275
42086,14,35,13,9,13,3,87,38.24950122981773,-109.382058
42087,9,42,13,9,15,1,89,38.24950122981773,-109.3817885
42088,7,42,12,9,14,2,86,38.24950122981773,-109.381519
42089,9,44,13,9,13,2,90,38.24950122981773,-109.3812495
42090,8,44,13,9,13,3,90,38.24950122981773,-109.38098
42091,8,43,13,10,12,4,90,38.24950122981773,-109.3807105
42092,8,43,13,10,11,4,89,38.24950122981773,-109.380441
42093,10,42,14,11,10,3,90,38.24950122981773,-109.3801716
42094,13,40,14,13,9,3,92,38.24950122981773,-109.3799021
42095,13,40,14,12,9,2,90,38.24950122981773,-109.3796326
42096,13,41,14,12,9,2,91,38.24950122981773,-109.3793631
42097,17,39,14,13,9,2,94,38.24950122981773,-109.3790936
42098,23,36,13,11,7,1,91,38.24950122981773,-109.3788241
42099,28,31,10,5,5,0,79,38.24950122981773,-109.3785546
42100,29,26,7,2,3,0,67,38.24950122981773,-109.3782851
42101,27,25,6,1,4,0,63,38.24950122981773,-109.3780156
42102,30,24,6,0,4,0,64,38.24950122981773,-109.3777461
42103,33,21,7,0,5,0,66,38.24950122981773,-109.3774766
42104,45,17,8,0,4,1,75,38.24950122981773,-109.3772071
42105,41,19,9,3,4,1,77,38.24950122981773,-109.3769376
42106,37,20,11,9,4,2,83,38.24950122981773,-109.3766681
42107,35,22,13,12,5,2,89,38.24950122981773,-109.3763986
42108,27,27,14,14,7,2,91,38.24950122981773,-109.3761291
42109,21,29,14,14,7,3,88,38.24950122981773,-109.3758596
42110,20,28,14,14,8,4,88,38.24950122981773,-109.3755901
42111,21,27,15,14,8,3,88,38.24950122981773,-109.3753206
42112,20,27,14,15,7,4,87,38.24950122981773,-109.3750512
42113,14,30,14,14,8,6,86,38.24950122981773,-109.3747817
42114,12,30,14,11,10,8,85,38.24950122981773,-109.3745122
42115,13,27,15,10,10,10,85,38.24950122981773,-109.3742427
42116,11,27,15,3,9,19,84,38.24950122981773,-109.3739732
42117,7,26,16,0,9,23,81,38.24950122981773,-109.3737037
42118,2,27,14,1,8,20,72,38.24950122981773,-109.3734342
42119,1,29,13,0,8,19,70,38.24950122981773,-109.3731647
42120,1,28,13,0,8,20,70,38.24950122981773,-109.3728952
42121,2,30,15,1,5,24,77,38.24950122981773,-109.3726257
42122,2,29,15,0,5,27,78,38.24950122981773,-109.3723562
42123,2,26,14,4,7,20,73,38.24950122981773,-109.3720867
42124,5,30,12,7,13,9,76,38.24950122981773,-109.3718172
42125,3,32,12,4,8,15,74,38.24950122981773,-109.3715477
42126,3,31,12,6,7,15,74,38.24950122981773,-109.3712782
42127,6,27,14,16,13,11,87,38.24950122981773,-109.3710087
42128,6,23,15,18,16,7,85,38.24950122981773,-109.3707392
42129,4,25,14,19,17,4,83,38.24950122981773,-109.3704697
42130,5,30,11,21,21,0,88,38.24950122981773,-109.3702003
42131,7,22,12,20,26,2,89,38.24950122981773,-109.3699308
42132,7,14,11,28,19,1,80,38.24950122981773,-109.3696613
42133,7,15,11,25,22,2,82,38.24950122981773,-109.3693918
42134,1,17,12,32,17,2,81,38.24950122981773,-109.3691223
42135,2,22,12,26,12,3,77,38.24950122981773,-109.3688528
42136,3,24,11,22,11,3,74,38.24950122981773,-109.3685833
42137,1,22,11,13,15,5,67,38.24950122981773,-109.3683138
42138,0,27,12,10,14,10,73,38.24950122981773,-109.3680443
42139,2,28,14,6,9,16,75,38.24950122981773,-109.3677748
42140,1,24,16,3,7,24,75,38.24950122981773,-109.3675053
42141,1,27,16,1,7,26,78,38.24950122981773,-109.3672358
42142,1,24,15,0,3,26,69,38.24950122981773,-109.3669663
42143,1,23,15,0,2,28,69,38.24950122981773,-109.3666968
42144,1,23,16,0,1,30,71,38.24950122981773,-109.3664273
42145,2,23,16,0,2,30,73,38.24950122981773,-109.3661578
42146,2,23,16,0,3,29,73,38.24950122981773,-109.3658883
42147,2,24,16,0,3,27,72,38.24950122981773,-109.3656188
42148,2,23,15,0,2,27,69,38.24950122981773,-109.3653493
42149,1,22,15,0,2,26,66,38.24950122981773,-109.3650799
42150,1,22,15,1,2,25,66,38.24950122981773,-109.3648104
42151,1,21,16,0,1,27,66,38.24950122981773,-109.3645409
42152,1,24,14,0,2,24,65,38.24950122981773,-109.3642714
42153,1,26,13,0,3,21,64,38.24950122981773,-109.3640019
42154,1,26,12,0,4,21,64,38.24950122981773,-109.3637324
42155,1,26,12,0,4,21,64,38.24950122981773,-109.3634629
42156,0,26,12,0,4,20,62,38.24950122981773,-109.3631934
42157,0,25,12,0,3,22,62,38.24950122981773,-109.3629239
42158,0,24,12,0,2,22,60,38.24950122981773,-109.3626544
42159,0,24,12,0,2,22,60,38.24950122981773,-109.3623849
42160,0,25,12,0,3,20,60,38.24950122981773,-109.3621154
42161,0,26,13,0,2,22,63,38.24950122981773,-109.3618459
42162,0,28,12,0,3,20,63,38.24950122981773,-109.3615764
42163,0,30,11,0,5,17,63,38.24950122981773,-109.3613069
42164,0,28,11,2,5,16,62,38.24950122981773,-109.3610374
42165,0,32,11,0,4,18,65,38.24950122981773,-109.3607679
42166,1,29,12,0,4,20,66,38.24950122981773,-109.3604984
42167,1,21,14,0,1,23,60,38.24950122981773,-109.360229
42168,0,15,15,0,1,26,57,38.24950122981773,-109.3599595
42169,0,15,13,2,2,20,52,38.24950122981773,-109.35969
42170,1,21,9,4,5,11,51,38.24950122981773,-109.3594205
42171,2,34,7,4,7,6,60,38.24950122981773,-109.359151
42172,2,30,7,5,8,4,56,38.24950122981773,-109.3588815
42173,2,27,8,5,8,6,56,38.24950122981773,-109.358612
42174,0,28,5,0,8,8,49,38.24950122981773,-109.3583425
42175,1,32,9,5,10,9,66,38.24950122981773,-109.358073
42176,1,36,9,5,10,8,69,38.24950122981773,-109.3578035
42177,1,37,9,4,10,8,69,38.24950122981773,-109.357534
42178,1,29,9,4,8,11,62,38.24950122981773,-109.3572645
42179,4,28,12,3,4,15,66,38.24950122981773,-109.356995
42180,1,32,10,5,9,9,66,38.24950122981773,-109.3567255
42181,1,38,8,4,10,8,69,38.24950122981773,-109.356456
42182,2,47,8,5,11,4,77,38.24950122981773,-109.3561865
42183,3,42,9,6,10,4,74,38.24950122981773,-109.355917
42184,4,48,8,6,11,1,78,38.24950122981773,-109.3556475
42185,1,38,8,4,12,5,68,38.24950122981773,-109.355378
42186,1,36,9,1,9,9,65,38.24950122981773,-109.3551086
42187,2,40,9,1,10,7,69,38.24950122981773,-109.3548391
42188,2,29,8,2,10,6,57,38.24950122981773,-109.3545696
42189,2,25,8,4,8,5,52,38.24950122981773,-109.3543001
42190,1,24,8,4,8,5,50,38.24950122981773,-109.3540306
42191,1,23,9,5,8,7,53,38.24950122981773,-109.3537611
42192,4,29,11,5,11,6,66,38.24950122981773,-109.3534916
42193,2,22,10,5,8,11,58,38.24950122981773,-109.3532221
42194,1,24,9,5,6,10,55,38.24950122981773,-109.3529526
42195,2,30,8,4,7,7,58,38.24950122981773,-109.3526831
42196,3,37,8,4,8,5,65,38.24950122981773,-109.3524136
42197,3,35,8,5,8,3,62,38.24950122981773,-109.3521441
42198,1,30,8,4,7,5,55,38.24950122981773,-109.3518746
42199,1,28,7,4,8,4,52,38.24950122981773,-109.3516051
42200,3,35,5,4,6,4,57,38.24950122981773,-109.3513356
42201,3,38,6,5,7,3,62,38.24950122981773,-109.3510661
42202,9,27,8,13,10,3,70,38.24950122981773,-109.3507966
42203,3,23,11,16,10,7,70,38.24950122981773,-109.3505271
42204,1,25,9,7,8,8,58,38.24950122981773,-109.3502577
42205,3,34,9,6,8,4,64,38.24950122981773,-109.3499882
42206,4,37,8,6,9,2,66,38.24950122981773,-109.3497187
42207,2,28,9,5,6,7,57,38.24950122981773,-109.3494492
42208,3,27,11,4,7,10,62,38.24950122981773,-109.3491797
42209,2,29,10,3,8,7,59,38.24950122981773,-109.3489102
42210,1,31,6,5,9,3,55,38.24950122981773,-109.3486407
42211,2,52,5,2,6,3,70,38.24950122981773,-109.3483712
42212,7,20,11,10,7,6,61,38.24950122981773,-109.3481017
42213,3,13,13,4,4,19,56,38.24950122981773,-109.3478322
42214,2,16,12,5,8,17,60,38.24950122981773,-109.3475627
42215,4,29,10,5,8,6,62,38.24950122981773,-109.3472932
42216,3,31,7,5,8,4,58,38.24950122981773,-109.3470237
42217,5,35,7,6,8,2,63,38.24950122981773,-109.3467542
42218,4,34,7,6,8,2,61,38.24950122981773,-109.3464847
42219,5,33,8,5,8,3,62,38.24950122981773,-109.3462152
42220,3,35,6,5,8,2,59,38.24950122981773,-109.3459457
42221,1,32,6,4,7,3,53,38.24950122981773,-109.3456762
42222,2,29,7,5,7,4,54,38.24950122981773,-109.3454068
42223,2,24,8,5,7,7,53,38.24950122981773,-109.3451373
42224,2,24,8,4,8,8,54,38.24950122981773,-109.3448678
42225,4,22,10,4,5,10,55,38.24950122981773,-109.3445983
42226,2,21,12,5,7,14,61,38.24950122981773,-109.3443288
42227,3,23,12,6,7,13,64,38.24950122981773,-109.3440593
42228,2,22,12,3,5,18,62,38.24950122981773,-109.3437898
42229,2,24,12,0,4,20,62,38.24950122981773,-109.3435203
42230,3,31,14,2,5,16,71,38.24950122981773,-109.3432508
42231,4,34,8,7,9,3,65,38.24950122981773,-109.3429813
42232,3,38,6,4,8,4,63,38.24950122981773,-109.3427118
42233,4,33,7,4,8,5,61,38.24950122981773,-109.3424423
42234,6,20,9,10,11,5,61,38.24950122981773,-109.3421728
42235,8,22,14,33,12,1,90,38.24950122981773,-109.3419033
42236,2,14,12,23,25,5,81,38.24950122981773,-109.3416338
42237,2,20,13,18,15,9,77,38.24950122981773,-109.3413643
42238,1,21,10,15,16,5,68,38.24950122981773,-109.3410948
42239,23,28,15,7,11,0,84,38.24950122981773,-109.3408253
42240,3,37,9,6,9,6,70,38.24950122981773,-109.3405558
42241,5,35,10,7,10,2,69,38.24950122981773,-109.3402864
42242,5,30,8,7,11,4,65,38.24950122981773,-109.3400169
42243,3,40,8,7,8,3,69,38.24950122981773,-109.3397474
42244,3,46,7,5,9,3,73,38.24950122981773,-109.3394779
42245,4,30,8,7,9,3,61,38.24950122981773,-109.3392084
42246,4,29,8,9,9,3,62,38.24950122981773,-109.3389389
42247,3,30,9,12,9,3,66,38.24950122981773,-109.3386694
42248,19,28,13,23,9,0,92,38.24950122981773,-109.3383999
42249,4,19,10,31,18,3,85,38.24950122981773,-109.3381304
42250,1,10,10,22,24,12,79,38.24950122981773,-109.3378609
42251,1,9,10,24,21,3,68,38.24950122981773,-109.3375914
42252,0,21,8,12,12,7,60,38.24950122981773,-109.3373219
42253,2,24,11,7,12,8,64,38.24950122981773,-109.3370524
42254,1,22,11,3,6,15,58,38.24950122981773,-109.3367829
42255,1,23,11,3,7,15,60,38.24950122981773,-109.3365134
42256,1,23,11,5,11,12,63,38.24950122981773,-109.3362439
42257,0,23,11,6,12,12,64,38.24950122981773,-109.3359744
42258,1,22,11,5,8,13,60,38.24950122981773,-109.3357049
42259,1,20,12,3,8,15,59,38.24950122981773,-109.3354355
42260,1,19,12,3,9,15,59,38.24950122981773,-109.335166
42261,1,21,12,3,9,15,61,38.24950122981773,-109.3348965
42262,0,23,11,2,8,14,58,38.24950122981773,-109.334627
42263,1,30,9,1,6,11,58,38.24950122981773,-109.3343575
42264,1,39,8,3,8,5,64,38.24950122981773,-109.334088
42265,1,42,7,2,7,5,64,38.24950122981773,-109.3338185
42266,1,43,6,2,9,4,65,38.24950122981773,-109.333549
42267,3,53,7,5,10,1,79,38.24950122981773,-109.3332795
42268,2,40,7,3,9,4,65,38.24950122981773,-109.33301
42269,3,29,8,4,10,6,60,38.24950122981773,-109.3327405
42270,4,24,8,4,8,8,56,38.24950122981773,-109.332471
42271,2,24,9,2,5,12,54,38.24950122981773,-109.3322015
42272,3,35,9,4,5,7,63,38.24950122981773,-109.331932
42273,2,37,7,4,9,3,62,38.24950122981773,-109.3316625
42274,2,35,7,3,9,4,60,38.24950122981773,-109.331393
42275,3,35,10,2,14,6,70,38.24923174,-109.4402688
42276,7,38,10,6,15,1,77,38.24923174,-109.4399993
42277,8,43,11,9,15,0,86,38.24923174,-109.4397299
42278,7,45,12,12,14,0,90,38.24923174,-109.4394604
42279,6,44,13,13,14,1,91,38.24923174,-109.4391909
42280,10,42,13,13,13,0,91,38.24923174,-109.4389214
42281,11,40,13,12,14,0,90,38.24923174,-109.4386519
42282,12,39,13,12,14,0,90,38.24923174,-109.4383824
42283,13,39,13,12,14,0,91,38.24923174,-109.4381129
42284,14,40,13,11,14,0,92,38.24923174,-109.4378434
42285,13,40,13,12,13,0,91,38.24923174,-109.4375739
42286,15,37,13,13,13,0,91,38.24923174,-109.4373044
42287,14,36,13,14,13,0,90,38.24923174,-109.4370349
42288,10,39,14,15,13,0,91,38.24923174,-109.4367654
42289,7,42,13,13,13,1,89,38.24923174,-109.4364959
42290,6,42,13,10,13,2,86,38.24923174,-109.4362264
42291,4,40,12,7,12,5,80,38.24923174,-109.4359569
42292,3,39,12,3,12,9,78,38.24923174,-109.4356874
42293,2,36,11,0,11,14,74,38.24923174,-109.4354179
42294,3,35,12,0,9,18,77,38.24923174,-109.4351484
42295,2,38,11,0,12,13,76,38.24923174,-109.434879
42296,2,41,11,2,14,8,78,38.24923174,-109.4346095
42297,3,45,11,5,16,4,84,38.24923174,-109.43434
42298,3,41,11,4,16,6,81,38.24923174,-109.4340705
42299,2,39,10,2,12,9,74,38.24923174,-109.433801
42300,1,44,9,0,13,8,75,38.24923174,-109.4335315
42301,1,44,9,2,14,6,76,38.24923174,-109.433262
42302,2,40,9,4,13,5,73,38.24923174,-109.4329925
42303,2,38,9,3,11,6,69,38.24923174,-109.432723
42304,2,34,8,3,11,6,64,38.24923174,-109.4324535
42305,2,34,8,3,10,6,63,38.24923174,-109.432184
42306,2,37,7,3,9,5,63,38.24923174,-109.4319145
42307,2,39,7,4,9,4,65,38.24923174,-109.431645
42308,2,35,8,3,9,6,63,38.24923174,-109.4313755
42309,2,36,8,4,11,5,66,38.24923174,-109.431106
42310,2,36,9,5,12,4,68,38.24923174,-109.4308365
42311,3,36,10,6,13,3,71,38.24923174,-109.430567
42312,5,38,10,6,13,3,75,38.24923174,-109.4302975
42313,4,36,10,6,13,3,72,38.24923174,-109.430028
42314,5,36,10,6,13,3,73,38.24923174,-109.4297586
42315,7,38,11,8,13,2,79,38.24923174,-109.4294891
42316,9,38,13,12,13,1,86,38.24923174,-109.4292196
42317,13,37,15,15,14,0,94,38.24923174,-109.4289501
42318,15,38,15,14,14,0,96,38.24923174,-109.4286806
42319,11,42,14,14,14,0,95,38.24923174,-109.4284111
42320,7,48,13,13,14,0,95,38.24923174,-109.4281416
42321,4,47,11,11,13,1,87,38.24923174,-109.4278721
42322,3,40,10,10,12,2,77,38.24923174,-109.4276026
42323,5,41,10,9,11,1,77,38.24923174,-109.4273331
42324,6,39,11,11,13,1,81,38.24923174,-109.4270636
42325,6,40,12,13,14,1,86,38.24923174,-109.4267941
42326,5,40,12,10,13,2,82,38.24923174,-109.4265246
42327,4,45,11,9,13,1,83,38.24923174,-109.4262551
42328,5,45,12,10,13,1,86,38.24923174,-109.4259856
42329,9,43,14,14,13,1,94,38.24923174,-109.4257161
42330,12,37,15,15,13,1,93,38.24923174,-109.4254466
42331,16,27,15,13,10,1,82,38.24923174,-109.4251771
42332,19,29,16,14,10,1,89,38.24923174,-109.4249077
42333,12,33,14,14,12,1,86,38.24923174,-109.4246382
42334,8,36,12,11,13,1,81,38.24923174,-109.4243687
42335,9,37,12,12,14,1,85,38.24923174,-109.4240992
42336,10,46,12,11,12,1,92,38.24923174,-109.4238297
42337,8,49,12,11,13,1,94,38.24923174,-109.4235602
42338,6,49,10,10,14,1,90,38.24923174,-109.4232907
42339,6,48,10,9,13,1,87,38.24923174,-109.4230212
42340,8,49,11,10,12,0,90,38.24923174,-109.4227517
42341,8,47,11,11,13,0,90,38.24923174,-109.4224822
42342,9,47,12,11,13,0,92,38.24923174,-109.4222127
42343,9,45,12,10,14,0,90,38.24923174,-109.4219432
42344,10,42,13,12,14,0,91,38.24923174,-109.4216737
42345,10,40,13,14,14,0,91,38.24923174,-109.4214042
42346,10,40,14,15,14,0,93,38.24923174,-109.4211347
42347,9,40,14,16,14,0,93,38.24923174,-109.4208652
42348,9,40,14,15,14,0,92,38.24923174,-109.4205957
42349,10,41,13,14,14,0,92,38.24923174,-109.4203262
42350,9,41,14,14,14,1,93,38.24923174,-109.4200568
42351,8,44,13,13,14,0,92,38.24923174,-109.4197873
42352,8,42,13,13,13,1,90,38.24923174,-109.4195178
42353,8,40,13,14,14,1,90,38.24923174,-109.4192483
42354,7,40,13,14,14,1,89,38.24923174,-109.4189788
42355,5,43,12,11,14,1,86,38.24923174,-109.4187093
42356,4,44,12,11,14,1,86,38.24923174,-109.4184398
42357,5,44,12,11,14,1,87,38.24923174,-109.4181703
42358,5,43,13,11,14,1,87,38.24923174,-109.4179008
42359,5,44,12,9,16,0,86,38.24923174,-109.4176313
42360,4,42,10,7,13,2,78,38.24923174,-109.4173618
42361,2,34,9,4,10,4,63,38.24923174,-109.4170923
42362,1,33,8,2,9,5,58,38.24923174,-109.4168228
42363,2,37,8,1,7,6,61,38.24923174,-109.4165533
42364,2,36,8,2,9,7,64,38.24923174,-109.4162838
42365,1,39,9,2,10,8,69,38.24923174,-109.4160143
42366,1,41,9,2,11,7,71,38.24923174,-109.4157448
42367,1,41,9,1,12,7,71,38.24923174,-109.4154753
42368,1,40,9,0,11,10,71,38.24923174,-109.4152058
42369,1,35,8,1,8,9,62,38.24923174,-109.4149364
42370,3,39,8,4,10,4,68,38.24923174,-109.4146669
42371,4,41,9,5,12,3,74,38.24923174,-109.4143974
42372,3,47,10,5,14,2,81,38.24923174,-109.4141279
42373,3,52,10,3,14,5,87,38.24923174,-109.4138584
42374,3,53,11,5,14,3,89,38.24923174,-109.4135889
42375,3,53,11,5,13,3,88,38.24923174,-109.4133194
42376,3,53,11,5,13,3,88,38.24923174,-109.4130499
42377,3,51,11,3,13,5,86,38.24923174,-109.4127804
42378,2,46,10,3,14,5,80,38.24923174,-109.4125109
42379,3,46,10,3,13,4,79,38.24923174,-109.4122414
42380,2,38,9,4,11,5,69,38.24923174,-109.4119719
42381,2,29,9,4,11,6,61,38.24923174,-109.4117024
42382,2,29,10,3,9,7,60,38.24923174,-109.4114329
42383,3,35,9,4,11,4,66,38.24923174,-109.4111634
42384,4,37,10,8,10,3,72,38.24923174,-109.4108939
42385,5,35,13,13,12,4,82,38.24923174,-109.4106244
42386,3,31,13,19,17,5,88,38.24923174,-109.4103549
42387,1,29,12,12,25,3,82,38.24923174,-109.4100855
42388,0,30,13,5,19,9,76,38.24923174,-109.409816
42389,0,32,13,4,18,10,77,38.24923174,-109.4095465
42390,1,33,13,3,16,14,80,38.24923174,-109.409277
42391,0,30,14,2,14,17,77,38.24923174,-109.4090075
42392,1,29,13,1,12,17,73,38.24923174,-109.408738
42393,1,28,13,0,9,20,71,38.24923174,-109.4084685
42394,1,28,12,0,9,19,69,38.24923174,-109.408199
42395,0,30,12,0,11,16,69,38.24923174,-109.4079295
42396,0,30,11,1,12,13,67,38.24923174,-109.40766
42397,1,29,12,4,11,12,69,38.24923174,-109.4073905
42398,0,31,11,1,11,13,67,38.24923174,-109.407121
42399,1,31,10,0,11,14,67,38.24923174,-109.4068515
42400,1,30,11,0,10,16,68,38.24923174,-109.406582
42401,1,28,13,1,10,18,71,38.24923174,-109.4063125
42402,1,26,12,1,8,18,66,38.24923174,-109.406043
42403,1,28,11,1,9,16,66,38.24923174,-109.4057735
42404,2,29,11,2,11,15,70,38.24923174,-109.405504
42405,2,28,12,4,12,13,71,38.24923174,-109.4052345
42406,4,32,12,5,13,10,76,38.24923174,-109.4049651
42407,5,33,12,5,14,9,78,38.24923174,-109.4046956
42408,5,31,12,5,14,10,77,38.24923174,-109.4044261
42409,4,30,12,5,13,12,76,38.24923174,-109.4041566
42410,5,30,13,6,13,11,78,38.24923174,-109.4038871
42411,6,29,13,5,11,13,77,38.24923174,-109.4036176
42412,6,29,13,8,12,10,78,38.24923174,-109.4033481
42413,6,29,12,8,13,8,76,38.24923174,-109.4030786
42414,6,28,12,8,12,8,74,38.24923174,-109.4028091
42415,7,28,12,11,13,6,77,38.24923174,-109.4025396
42416,16,32,12,14,14,0,88,38.24923174,-109.4022701
42417,20,32,12,13,14,0,91,38.24923174,-109.4020006
42418,25,30,12,14,13,0,94,38.24923174,-109.4017311
42419,36,25,13,13,11,0,98,38.24923174,-109.4014616
42420,48,15,12,12,10,0,97,38.24923174,-109.4011921
42421,49,14,12,11,11,0,97,38.24923174,-109.4009226
42422,48,14,12,12,11,0,97,38.24923174,-109.4006531
42423,40,17,13,15,10,1,96,38.24923174,-109.4003836
42424,29,24,13,14,10,1,91,38.24923174,-109.4001142
42425,18,32,15,14,11,1,91,38.24923174,-109.3998447
42426,16,34,14,15,11,1,91,38.24923174,-109.3995752
42427,13,36,14,15,13,1,92,38.24923174,-109.3993057
42428,12,38,14,13,14,1,92,38.24923174,-109.3990362
42429,13,37,15,14,14,0,93,38.24923174,-109.3987667
42430,12,38,14,13,14,1,92,38.24923174,-109.3984972
42431,12,39,15,14,13,1,94,38.24923174,-109.3982277
42432,11,39,15,13,14,1,93,38.24923174,-109.3979582
42433,9,38,14,13,15,1,90,38.24923174,-109.3976887
42434,9,38,14,12,14,2,89,38.24923174,-109.3974192
42435,10,38,15,12,13,2,90,38.24923174,-109.3971497
42436,11,39,15,12,13,1,91,38.24923174,-109.3968802
42437,11,39,15,13,13,1,92,38.24923174,-109.3966107
42438,10,40,15,13,13,1,92,38.24923174,-109.3963412
42439,10,41,15,13,14,1,94,38.24923174,-109.3960717
42440,10,41,14,14,14,0,93,38.24923174,-109.3958022
42441,10,41,14,14,14,0,93,38.24923174,-109.3955327
42442,11,40,14,14,14,0,93,38.24923174,-109.3952632
42443,13,35,14,14,14,1,91,38.24923174,-109.3949938
42444,10,42,14,10,16,1,93,38.24923174,-109.3947243
42445,8,45,13,9,16,1,92,38.24923174,-109.3944548
42446,8,45,13,9,16,1,92,38.24923174,-109.3941853
42447,8,43,14,11,16,1,93,38.24923174,-109.3939158
42448,9,42,14,11,16,1,93,38.24923174,-109.3936463
42449,10,41,14,12,15,0,92,38.24923174,-109.3933768
42450,12,40,14,12,15,0,93,38.24923174,-109.3931073
42451,13,39,14,12,15,0,93,38.24923174,-109.3928378
42452,13,39,13,12,15,0,92,38.24923174,-109.3925683
42453,15,38,13,10,14,0,90,38.24923174,-109.3922988
42454,14,36,13,12,15,0,90,38.24923174,-109.3920293
42455,14,35,13,12,15,0,89,38.24923174,-109.3917598
42456,15,35,13,11,14,1,89,38.24923174,-109.3914903
42457,18,36,12,10,13,0,89,38.24923174,-109.3912208
42458,13,37,13,11,15,0,89,38.24923174,-109.3909513
42459,12,38,13,12,15,1,91,38.24923174,-109.3906818
42460,11,39,14,12,15,1,92,38.24923174,-109.3904123
42461,10,40,14,11,15,1,91,38.24923174,-109.3901429
42462,12,40,14,13,15,0,94,38.24923174,-109.3898734
42463,15,37,14,13,14,0,93,38.24923174,-109.3896039
42464,16,37,14,13,13,0,93,38.24923174,-109.3893344
42465,15,38,14,13,12,0,92,38.24923174,-109.3890649
42466,14,40,14,12,13,0,93,38.24923174,-109.3887954
42467,12,42,14,13,13,0,94,38.24923174,-109.3885259
42468,11,42,14,13,14,0,94,38.24923174,-109.3882564
42469,11,42,14,13,14,0,94,38.24923174,-109.3879869
42470,12,42,14,13,14,0,95,38.24923174,-109.3877174
42471,12,41,14,12,14,0,93,38.24923174,-109.3874479
42472,9,44,13,11,15,0,92,38.24923174,-109.3871784
42473,8,41,13,12,15,0,89,38.24923174,-109.3869089
42474,8,39,12,11,14,1,85,38.24923174,-109.3866394
42475,10,39,12,11,13,1,86,38.24923174,-109.3863699
42476,12,43,13,10,14,0,92,38.24923174,-109.3861004
42477,16,40,13,10,13,0,92,38.24923174,-109.3858309
42478,18,39,13,10,12,0,92,38.24923174,-109.3855614
42479,18,39,13,10,12,0,92,38.24923174,-109.3852919
42480,16,39,13,10,13,0,91,38.24923174,-109.3850225
42481,19,37,13,10,12,0,91,38.24923174,-109.384753
42482,21,35,13,10,12,0,91,38.24923174,-109.3844835
42483,17,37,13,11,14,0,92,38.24923174,-109.384214
42484,14,38,12,11,15,0,90,38.24923174,-109.3839445
42485,11,38,12,10,15,0,86,38.24923174,-109.383675
42486,15,37,13,11,14,0,90,38.24923174,-109.3834055
42487,19,33,12,10,12,1,87,38.24923174,-109.383136
42488,22,25,12,10,10,2,81,38.24923174,-109.3828665
42489,17,22,11,15,11,2,78,38.24923174,-109.382597
42490,19,29,12,8,10,5,83,38.24923174,-109.3823275
42491,14,38,13,9,13,2,89,38.24923174,-109.382058
42492,9,43,13,9,15,2,91,38.24923174,-109.3817885
42493,7,45,13,9,14,2,90,38.24923174,-109.381519
42494,7,45,12,9,13,2,88,38.24923174,-109.3812495
42495,7,45,13,9,12,3,89,38.24923174,-109.38098
42496,8,45,13,9,12,3,90,38.24923174,-109.3807105
42497,8,43,13,11,12,3,90,38.24923174,-109.380441
42498,9,41,14,12,11,2,89,38.24923174,-109.3801716
42499,12,40,14,13,10,2,91,38.24923174,-109.3799021
42500,11,41,13,13,10,2,90,38.24923174,-109.3796326
42501,12,42,13,12,10,2,91,38.24923174,-109.3793631
42502,18,39,13,12,9,1,92,38.24923174,-109.3790936
42503,25,35,12,9,7,1,89,38.24923174,-109.3788241
42504,28,31,9,5,6,0,79,38.24923174,-109.3785546
42505,29,29,10,5,5,0,78,38.24923174,-109.3782851
42506,30,26,9,4,5,0,74,38.24923174,-109.3780156
42507,33,26,10,5,6,0,80,38.24923174,-109.3777461
42508,34,26,11,6,7,1,85,38.24923174,-109.3774766
42509,34,23,11,5,6,1,80,38.24923174,-109.3772071
42510,40,20,10,6,4,1,81,38.24923174,-109.3769376
42511,40,21,11,9,4,1,86,38.24923174,-109.3766681
42512,36,22,13,13,5,1,90,38.24923174,-109.3763986
42513,31,25,14,15,6,1,92,38.24923174,-109.3761291
42514,26,27,15,16,6,1,91,38.24923174,-109.3758596
42515,27,25,15,17,6,1,91,38.24923174,-109.3755901
42516,29,23,15,17,5,1,90,38.24923174,-109.3753206
42517,29,23,16,17,5,1,91,38.24923174,-109.3750512
42518,25,27,15,17,5,1,90,38.24923174,-109.3747817
42519,19,29,14,17,8,2,89,38.24923174,-109.3745122
42520,14,32,15,13,8,6,88,38.24923174,-109.3742427
42521,13,32,16,7,10,10,88,38.24923174,-109.3739732
42522,14,30,18,4,10,13,89,38.24923174,-109.3737037
42523,9,34,15,11,9,8,86,38.24923174,-109.3734342
42524,9,33,16,5,8,12,83,38.24923174,-109.3731647
42525,6,33,15,2,9,16,81,38.24923174,-109.3728952
42526,3,31,13,0,12,18,77,38.24923174,-109.3726257
42527,4,29,13,5,11,13,75,38.24923174,-109.3723562
42528,7,31,14,15,8,7,82,38.24923174,-109.3720867
42529,4,28,14,18,10,8,82,38.24923174,-109.3718172
42530,8,28,11,21,13,1,82,38.24923174,-109.3715477
42531,9,29,11,21,13,1,84,38.24923174,-109.3712782
42532,3,23,15,17,16,9,83,38.24923174,-109.3710087
42533,5,19,14,20,21,5,84,38.24923174,-109.3707392
42534,5,27,11,17,25,0,85,38.24923174,-109.3704697
42535,5,21,11,22,24,0,83,38.24923174,-109.3702003
42536,5,9,11,31,18,3,77,38.24923174,-109.3699308
42537,0,10,11,28,16,5,70,38.24923174,-109.3696613
42538,3,17,11,19,19,2,71,38.24923174,-109.3693918
42539,1,22,12,15,15,5,70,38.24923174,-109.3691223
42540,2,24,14,3,8,20,71,38.24923174,-109.3688528
42541,2,28,14,4,6,21,75,38.24923174,-109.3685833
42542,4,28,15,6,10,14,77,38.24923174,-109.3683138
42543,3,27,17,8,5,18,78,38.24923174,-109.3680443
42544,0,26,18,0,6,26,76,38.24923174,-109.3677748
42545,0,24,17,0,4,29,74,38.24923174,-109.3675053
42546,0,23,16,0,3,30,72,38.24923174,-109.3672358
42547,1,24,15,0,3,27,70,38.24923174,-109.3669663
42548,1,22,16,0,2,29,70,38.24923174,-109.3666968
42549,1,21,17,0,2,32,73,38.24923174,-109.3664273
42550,1,20,18,0,1,33,73,38.24923174,-109.3661578
42551,2,23,16,0,3,29,73,38.24923174,-109.3658883
42552,2,23,15,0,4,26,70,38.24923174,-109.3656188
42553,2,24,15,0,3,25,69,38.24923174,-109.3653493
42554,2,24,14,0,3,23,66,38.24923174,-109.3650799
42555,2,25,14,0,4,22,67,38.24923174,-109.3648104
42556,1,23,14,0,2,24,64,38.24923174,-109.3645409
42557,1,23,13,0,2,23,62,38.24923174,-109.3642714
42558,1,24,13,0,3,22,63,38.24923174,-109.3640019
42559,1,25,13,0,3,23,65,38.24923174,-109.3637324
42560,0,26,13,0,3,23,65,38.24923174,-109.3634629
42561,2,28,14,0,5,21,70,38.24923174,-109.3631934
42562,1,25,14,0,3,23,66,38.24923174,-109.3629239
42563,0,25,12,0,3,22,62,38.24923174,-109.3626544
42564,0,31,11,0,5,18,65,38.24923174,-109.3623849
42565,0,29,11,0,6,19,65,38.24923174,-109.3621154
42566,0,27,12,0,2,20,61,38.24923174,-109.3618459
42567,0,31,11,0,4,18,64,38.24923174,-109.3615764
42568,0,35,10,0,6,15,66,38.24923174,-109.3613069
42569,1,36,10,1,7,14,69,38.24923174,-109.3610374
42570,0,34,11,1,7,16,69,38.24923174,-109.3607679
42571,1,30,12,0,5,20,68,38.24923174,-109.3604984
42572,0,23,14,0,2,24,63,38.24923174,-109.360229
42573,0,19,15,0,1,25,60,38.24923174,-109.3599595
42574,2,21,11,5,8,13,60,38.24923174,-109.35969
42575,2,32,7,2,9,5,57,38.24923174,-109.3594205
42576,2,37,5,4,8,3,59,38.24923174,-109.359151
42577,3,25,6,5,8,6,53,38.24923174,-109.3588815
42578,2,28,8,6,8,7,59,38.24923174,-109.358612
42579,2,35,9,3,9,10,68,38.24923174,-109.3583425
42580,1,31,9,3,8,12,64,38.24923174,-109.358073
42581,1,33,10,3,8,11,66,38.24923174,-109.3578035
42582,1,31,10,4,7,11,64,38.24923174,-109.357534
42583,1,28,10,4,7,12,62,38.24923174,-109.3572645
42584,3,34,11,3,7,12,70,38.24923174,-109.356995
42585,1,26,11,3,5,16,62,38.24923174,-109.3567255
42586,0,28,10,4,8,11,61,38.24923174,-109.356456
42587,2,33,11,5,9,8,68,38.24923174,-109.3561865
42588,8,31,14,5,4,6,68,38.24923174,-109.355917
42589,3,39,9,7,10,5,73,38.24923174,-109.3556475
42590,1,41,10,5,12,8,77,38.24923174,-109.355378
42591,1,40,9,2,11,8,71,38.24923174,-109.3551086
42592,1,32,9,3,10,8,63,38.24923174,-109.3548391
42593,1,28,9,4,7,6,55,38.24923174,-109.3545696
42594,3,29,8,5,8,4,57,38.24923174,-109.3543001
42595,2,28,7,4,8,4,53,38.24923174,-109.3540306
42596,1,27,7,5,7,5,52,38.24923174,-109.3537611
42597,3,32,10,6,9,4,64,38.24923174,-109.3534916
42598,5,28,9,6,10,6,64,38.24923174,-109.3532221
42599,2,25,9,4,6,9,55,38.24923174,-109.3529526
42600,2,30,9,3,6,8,58,38.24923174,-109.3526831
42601,3,37,9,2,7,7,65,38.24923174,-109.3524136
42602,2,29,9,3,7,7,57,38.24923174,-109.3521441
42603,2,31,8,4,8,5,58,38.24923174,-109.3518746
42604,2,33,7,4,8,4,58,38.24923174,-109.3516051
42605,3,40,5,4,7,3,62,38.24923174,-109.3513356
42606,5,32,7,8,9,3,64,38.24923174,-109.3510661
42607,17,27,11,13,9,4,81,38.24923174,-109.3507966
42608,1,25,11,13,9,9,68,38.24923174,-109.3505271
42609,1,21,10,6,7,10,55,38.24923174,-109.3502577
42610,2,27,9,5,7,7,57,38.24923174,-109.3499882
42611,4,34,9,7,9,2,65,38.24923174,-109.3497187
42612,4,35,9,7,9,3,67,38.24923174,-109.3494492
42613,3,30,10,5,8,6,62,38.24923174,-109.3491797
42614,3,30,9,3,8,5,58,38.24923174,-109.3489102
42615,4,42,4,5,6,3,64,38.24923174,-109.3486407
42616,1,38,5,2,8,2,56,38.24923174,-109.3483712
42617,1,16,9,7,11,6,50,38.24923174,-109.3481017
42618,1,15,14,4,4,19,57,38.24923174,-109.3478322
42619,1,16,13,4,5,21,60,38.24923174,-109.3475627
42620,3,24,11,4,9,11,62,38.24923174,-109.3472932
42621,1,31,9,5,8,8,62,38.24923174,-109.3470237
42622,2,32,9,5,9,6,63,38.24923174,-109.3467542
42623,3,32,8,5,8,5,61,38.24923174,-109.3464847
42624,4,38,7,5,8,2,64,38.24923174,-109.3462152
42625,2,38,5,4,8,2,59,38.24923174,-109.3459457
42626,4,51,5,3,8,1,72,38.24923174,-109.3456762
42627,5,35,6,6,8,4,64,38.24923174,-109.3454068
42628,4,30,7,6,8,5,60,38.24923174,-109.3451373
42629,6,36,7,7,9,3,68,38.24923174,-109.3448678
42630,4,33,8,6,7,6,64,38.24923174,-109.3445983
42631,7,29,10,6,8,8,68,38.24923174,-109.3443288
42632,5,26,10,7,7,9,64,38.24923174,-109.3440593
42633,5,24,11,6,7,11,64,38.24923174,-109.3437898
42634,8,25,9,4,8,9,63,38.24923174,-109.3435203
42635,3,30,8,3,6,9,59,38.24923174,-109.3432508
42636,3,35,7,5,8,4,62,38.24923174,-109.3429813
42637,2,38,6,3,7,4,60,38.24923174,-109.3427118
42638,3,30,7,5,9,4,58,38.24923174,-109.3424423
42639,6,20,10,15,13,4,68,38.24923174,-109.3421728
42640,4,14,15,25,18,8,84,38.24923174,-109.3419033
42641,3,19,12,15,21,8,78,38.24923174,-109.3416338
42642,1,22,11,13,17,8,72,38.24923174,-109.3413643
42643,0,21,9,15,14,4,63,38.24923174,-109.3410948
42644,14,34,13,12,9,1,83,38.24923174,-109.3408253
42645,2,26,10,7,7,9,61,38.24923174,-109.3405558
42646,2,22,10,7,10,7,58,38.24923174,-109.3402864
42647,5,29,8,8,9,4,63,38.24923174,-109.3400169
42648,4,36,7,6,8,3,64,38.24923174,-109.3397474
42649,6,34,10,9,10,3,72,38.24923174,-109.3394779
42650,10,34,16,24,9,1,94,38.24923174,-109.3392084
42651,11,31,11,19,14,1,87,38.24923174,-109.3389389
42652,5,24,10,23,18,1,81,38.24923174,-109.3386694
42653,4,10,11,32,23,2,82,38.24923174,-109.3383999
42654,0,7,9,34,21,10,81,38.24923174,-109.3381304
42655,0,11,9,30,17,7,74,38.24923174,-109.3378609
42656,2,14,10,21,15,12,74,38.24923174,-109.3375914
42657,1,25,11,11,13,7,68,38.24923174,-109.3373219
42658,1,25,12,6,11,14,69,38.24923174,-109.3370524
42659,2,27,12,5,11,15,72,38.24923174,-109.3367829
42660,0,26,11,4,11,15,67,38.24923174,-109.3365134
42661,0,26,11,4,12,13,66,38.24923174,-109.3362439
42662,0,24,11,5,12,11,63,38.24923174,-109.3359744
42663,0,23,11,7,9,11,61,38.24923174,-109.3357049
42664,1,22,11,4,9,12,59,38.24923174,-109.3354355
42665,1,23,11,2,7,15,59,38.24923174,-109.335166
42666,0,24,11,2,7,14,58,38.24923174,-109.3348965
42667,1,29,10,3,8,9,60,38.24923174,-109.334627
42668,0,32,9,2,8,8,59,38.24923174,-109.3343575
42669,2,39,8,5,10,3,67,38.24923174,-109.334088
42670,1,41,7,0,8,5,62,38.24923174,-109.3338185
42671,1,44,7,1,9,5,67,38.24923174,-109.333549
42672,2,45,7,3,11,3,71,38.24923174,-109.3332795
42673,3,31,8,3,8,7,60,38.24923174,-109.33301
42674,4,20,10,4,6,13,57,38.24923174,-109.3327405
42675,2,18,12,3,5,17,57,38.24923174,-109.332471
42676,2,19,11,1,5,15,53,38.24923174,-109.3322015
42677,2,34,8,2,5,9,60,38.24923174,-109.331932
42678,2,34,7,3,9,4,59,38.24923174,-109.3316625
42679,2,31,7,3,9,5,57,38.24923174,-109.331393
42680,6,39,11,8,16,2,82,38.24896224064726,-109.4402688
42681,6,40,11,8,18,1,84,38.24896224064726,-109.4399993
42682,6,43,12,8,17,0,86,38.24896224064726,-109.4397299
42683,6,45,12,9,17,0,89,38.24896224064726,-109.4394604
42684,8,43,13,12,15,0,91,38.24896224064726,-109.4391909
42685,14,37,13,13,13,0,90,38.24896224064726,-109.4389214
42686,15,36,14,13,13,0,91,38.24896224064726,-109.4386519
42687,14,38,13,13,14,0,92,38.24896224064726,-109.4383824
42688,12,40,13,12,14,0,91,38.24896224064726,-109.4381129
42689,14,40,13,11,13,0,91,38.24896224064726,-109.4378434
42690,13,39,13,13,13,0,91,38.24896224064726,-109.4375739
42691,15,38,13,12,13,0,91,38.24896224064726,-109.4373044
42692,15,38,13,13,13,0,92,38.24896224064726,-109.4370349
42693,13,39,13,14,13,0,92,38.24896224064726,-109.4367654
42694,9,41,12,11,13,2,88,38.24896224064726,-109.4364959
42695,5,38,11,8,11,4,77,38.24896224064726,-109.4362264
42696,4,39,11,7,10,6,77,38.24896224064726,-109.4359569
42697,3,40,12,4,11,9,79,38.24896224064726,-109.4356874
42698,2,36,12,1,10,14,75,38.24896224064726,-109.4354179
42699,2,31,11,0,9,15,68,38.24896224064726,-109.4351484
42700,1,33,10,2,11,11,68,38.24896224064726,-109.434879
42701,1,39,10,2,13,7,72,38.24896224064726,-109.4346095
42702,2,42,9,2,13,5,73,38.24896224064726,-109.43434
42703,2,39,9,3,12,6,71,38.24896224064726,-109.4340705
42704,2,38,9,4,11,5,69,38.24896224064726,-109.433801
42705,2,40,9,4,11,5,71,38.24896224064726,-109.4335315
42706,1,41,9,4,11,5,71,38.24896224064726,-109.433262
42707,1,41,9,3,11,6,71,38.24896224064726,-109.4329925
42708,1,41,9,3,12,7,73,38.24896224064726,-109.432723
42709,1,39,9,2,11,8,70,38.24896224064726,-109.4324535
42710,1,39,9,2,11,7,69,38.24896224064726,-109.432184
42711,2,38,8,3,10,5,66,38.24896224064726,-109.4319145
42712,1,36,7,3,9,6,62,38.24896224064726,-109.431645
42713,2,37,7,3,9,5,63,38.24896224064726,-109.4313755
42714,1,37,8,3,10,5,64,38.24896224064726,-109.431106
42715,1,39,8,3,10,5,66,38.24896224064726,-109.4308365
42716,2,39,8,4,11,4,68,38.24896224064726,-109.430567
42717,2,39,9,4,11,4,69,38.24896224064726,-109.4302975
42718,4,35,10,6,13,4,72,38.24896224064726,-109.430028
42719,6,33,10,7,13,3,72,38.24896224064726,-109.4297586
42720,8,32,11,8,13,2,74,38.24896224064726,-109.4294891
42721,11,31,12,10,13,1,78,38.24896224064726,-109.4292196
42722,12,33,14,14,14,1,88,38.24896224064726,-109.4289501
42723,15,37,14,14,14,0,94,38.24896224064726,-109.4286806
42724,11,42,14,13,15,0,95,38.24896224064726,-109.4284111
42725,8,46,13,12,14,0,93,38.24896224064726,-109.4281416
42726,5,46,12,12,14,1,90,38.24896224064726,-109.4278721
42727,3,41,10,10,12,2,78,38.24896224064726,-109.4276026
42728,6,39,10,10,12,1,78,38.24896224064726,-109.4273331
42729,6,38,12,12,13,1,82,38.24896224064726,-109.4270636
42730,7,39,13,13,14,1,87,38.24896224064726,-109.4267941
42731,8,40,13,13,13,1,88,38.24896224064726,-109.4265246
42732,7,44,13,13,13,1,91,38.24896224064726,-109.4262551
42733,8,43,13,13,14,1,92,38.24896224064726,-109.4259856
42734,9,41,14,16,13,1,94,38.24896224064726,-109.4257161
42735,11,38,15,16,12,1,93,38.24896224064726,-109.4254466
42736,12,36,15,15,12,1,91,38.24896224064726,-109.4251771
42737,11,38,15,15,12,1,92,38.24896224064726,-109.4249077
42738,9,37,13,13,13,1,86,38.24896224064726,-109.4246382
42739,7,36,12,10,13,2,80,38.24896224064726,-109.4243687
42740,5,39,10,8,14,2,78,38.24896224064726,-109.4240992
42741,7,46,11,12,12,1,89,38.24896224064726,-109.4238297
42742,7,45,11,12,13,1,89,38.24896224064726,-109.4235602
42743,6,46,11,10,14,1,88,38.24896224064726,-109.4232907
42744,5,46,10,9,13,1,84,38.24896224064726,-109.4230212
42745,6,47,10,10,12,1,86,38.24896224064726,-109.4227517
42746,8,48,12,11,12,0,91,38.24896224064726,-109.4224822
42747,8,46,12,12,14,0,92,38.24896224064726,-109.4222127
42748,9,44,12,12,14,0,91,38.24896224064726,-109.4219432
42749,9,43,12,12,14,0,90,38.24896224064726,-109.4216737
42750,11,42,12,12,14,0,91,38.24896224064726,-109.4214042
42751,8,41,13,14,14,0,90,38.24896224064726,-109.4211347
42752,8,39,14,15,14,1,91,38.24896224064726,-109.4208652
42753,9,40,14,15,13,1,92,38.24896224064726,-109.4205957
42754,9,41,14,14,14,0,92,38.24896224064726,-109.4203262
42755,8,41,13,13,14,1,90,38.24896224064726,-109.4200568
42756,7,42,13,13,14,0,89,38.24896224064726,-109.4197873
42757,8,42,14,14,14,0,92,38.24896224064726,-109.4195178
42758,10,40,14,14,14,0,92,38.24896224064726,-109.4192483
42759,10,39,14,15,13,0,91,38.24896224064726,-109.4189788
42760,6,41,13,14,13,1,88,38.24896224064726,-109.4187093
42761,4,44,12,12,13,1,86,38.24896224064726,-109.4184398
42762,3,45,12,11,14,1,86,38.24896224064726,-109.4181703
42763,3,44,11,8,14,1,81,38.24896224064726,-109.4179008
42764,1,39,8,3,11,4,66,38.24896224064726,-109.4176313
42765,2,39,7,3,10,3,64,38.24896224064726,-109.4173618
42766,1,35,7,2,9,4,58,38.24896224064726,-109.4170923
42767,1,34,7,2,9,5,58,38.24896224064726,-109.4168228
42768,2,38,7,2,8,5,62,38.24896224064726,-109.4165533
42769,2,35,7,3,8,5,60,38.24896224064726,-109.4162838
42770,2,39,8,3,10,4,66,38.24896224064726,-109.4160143
42771,1,42,8,2,10,5,68,38.24896224064726,-109.4157448
42772,1,41,9,2,10,5,68,38.24896224064726,-109.4154753
42773,2,39,8,2,9,6,66,38.24896224064726,-109.4152058
42774,1,37,7,2,8,7,62,38.24896224064726,-109.4149364
42775,2,38,8,3,9,5,65,38.24896224064726,-109.4146669
42776,2,38,9,3,10,5,67,38.24896224064726,-109.4143974
42777,2,42,9,2,10,5,70,38.24896224064726,-109.4141279
42778,2,50,9,1,10,6,78,38.24896224064726,-109.4138584
42779,3,51,10,2,12,6,84,38.24896224064726,-109.4135889
42780,3,53,10,2,13,5,86,38.24896224064726,-109.4133194
42781,3,53,10,2,12,5,85,38.24896224064726,-109.4130499
42782,2,46,9,2,10,6,75,38.24896224064726,-109.4127804
42783,2,38,9,2,8,7,66,38.24896224064726,-109.4125109
42784,3,38,9,3,10,4,67,38.24896224064726,-109.4122414
42785,4,33,9,4,10,5,65,38.24896224064726,-109.4119719
42786,5,29,10,8,10,4,66,38.24896224064726,-109.4117024
42787,5,30,11,12,11,3,72,38.24896224064726,-109.4114329
42788,4,40,11,12,13,1,81,38.24896224064726,-109.4111634
42789,6,30,13,17,14,2,82,38.24896224064726,-109.4108939
42790,3,27,13,20,19,7,89,38.24896224064726,-109.4106244
42791,1,22,14,16,20,12,85,38.24896224064726,-109.4103549
42792,1,26,12,12,22,8,81,38.24896224064726,-109.4100855
42793,1,33,13,5,18,9,79,38.24896224064726,-109.409816
42794,1,33,12,3,15,10,74,38.24896224064726,-109.4095465
42795,2,33,12,3,15,11,76,38.24896224064726,-109.409277
42796,1,30,13,3,13,15,75,38.24896224064726,-109.4090075
42797,1,29,13,0,9,21,73,38.24896224064726,-109.408738
42798,0,29,12,0,9,18,68,38.24896224064726,-109.4084685
42799,0,29,11,0,9,16,65,38.24896224064726,-109.408199
42800,0,31,10,0,10,14,65,38.24896224064726,-109.4079295
42801,0,32,10,1,12,12,67,38.24896224064726,-109.40766
42802,0,31,11,0,11,13,66,38.24896224064726,-109.4073905
42803,0,30,11,0,10,16,67,38.24896224064726,-109.407121
42804,0,28,11,1,10,17,67,38.24896224064726,-109.4068515
42805,2,27,12,5,12,12,70,38.24896224064726,-109.406582
42806,7,29,12,9,15,6,78,38.24896224064726,-109.4063125
42807,9,32,12,12,16,3,84,38.24896224064726,-109.406043
42808,10,32,13,13,15,3,86,38.24896224064726,-109.4057735
42809,9,31,13,11,14,5,83,38.24896224064726,-109.405504
42810,7,29,12,8,13,8,77,38.24896224064726,-109.4052345
42811,7,30,12,7,13,8,77,38.24896224064726,-109.4049651
42812,11,31,13,12,14,3,84,38.24896224064726,-109.4046956
42813,11,31,13,12,14,3,84,38.24896224064726,-109.4044261
42814,12,33,13,13,15,2,88,38.24896224064726,-109.4041566
42815,15,32,13,16,14,0,90,38.24896224064726,-109.4038871
42816,15,31,14,17,14,0,91,38.24896224064726,-109.4036176
42817,16,31,14,17,14,0,92,38.24896224064726,-109.4033481
42818,17,31,13,17,14,0,92,38.24896224064726,-109.4030786
42819,17,31,13,16,14,0,91,38.24896224064726,-109.4028091
42820,16,32,13,15,13,0,89,38.24896224064726,-109.4025396
42821,23,30,13,16,12,0,94,38.24896224064726,-109.4022701
42822,22,30,13,16,13,0,94,38.24896224064726,-109.4020006
42823,22,30,14,15,12,0,93,38.24896224064726,-109.4017311
42824,28,28,14,15,11,0,96,38.24896224064726,-109.4014616
42825,40,21,13,13,10,0,97,38.24896224064726,-109.4011921
42826,39,21,13,12,11,0,96,38.24896224064726,-109.4009226
42827,35,24,14,12,10,1,96,38.24896224064726,-109.4006531
42828,29,28,14,12,10,1,94,38.24896224064726,-109.4003836
42829,23,32,14,12,12,0,93,38.24896224064726,-109.4001142
42830,18,34,14,14,13,0,93,38.24896224064726,-109.3998447
42831,19,33,14,13,13,0,92,38.24896224064726,-109.3995752
42832,17,34,14,13,13,0,91,38.24896224064726,-109.3993057
42833,13,35,14,13,14,1,90,38.24896224064726,-109.3990362
42834,11,38,14,13,15,1,92,38.24896224064726,-109.3987667
42835,9,43,14,10,15,0,91,38.24896224064726,-109.3984972
42836,9,44,14,10,15,1,93,38.24896224064726,-109.3982277
42837,9,42,14,11,14,1,91,38.24896224064726,-109.3979582
42838,10,41,14,11,14,1,91,38.24896224064726,-109.3976887
42839,9,41,14,11,14,1,90,38.24896224064726,-109.3974192
42840,10,42,15,12,13,1,93,38.24896224064726,-109.3971497
42841,11,42,15,12,13,1,94,38.24896224064726,-109.3968802
42842,12,41,15,13,12,1,94,38.24896224064726,-109.3966107
42843,14,38,15,14,13,1,95,38.24896224064726,-109.3963412
42844,12,40,15,14,14,0,95,38.24896224064726,-109.3960717
42845,12,39,15,14,13,0,93,38.24896224064726,-109.3958022
42846,11,40,15,14,14,0,94,38.24896224064726,-109.3955327
42847,9,42,15,15,14,0,95,38.24896224064726,-109.3952632
42848,8,41,14,13,14,1,91,38.24896224064726,-109.3949938
42849,6,44,13,9,14,2,88,38.24896224064726,-109.3947243
42850,7,46,14,10,15,1,93,38.24896224064726,-109.3944548
42851,8,44,14,12,15,1,94,38.24896224064726,-109.3941853
42852,8,43,14,13,15,1,94,38.24896224064726,-109.3939158
42853,9,43,14,11,15,1,93,38.24896224064726,-109.3936463
42854,10,42,14,13,15,0,94,38.24896224064726,-109.3933768
42855,11,41,14,13,15,0,94,38.24896224064726,-109.3931073
42856,12,40,14,12,15,0,93,38.24896224064726,-109.3928378
42857,13,40,14,12,14,0,93,38.24896224064726,-109.3925683
42858,14,40,14,11,15,0,94,38.24896224064726,-109.3922988
42859,12,38,13,12,15,0,90,38.24896224064726,-109.3920293
42860,11,38,13,11,15,1,89,38.24896224064726,-109.3917598
42861,12,37,13,10,14,1,87,38.24896224064726,-109.3914903
42862,15,38,13,9,14,1,90,38.24896224064726,-109.3912208
42863,10,40,13,10,16,1,90,38.24896224064726,-109.3909513
42864,9,40,13,12,15,1,90,38.24896224064726,-109.3906818
42865,10,41,14,13,15,0,93,38.24896224064726,-109.3904123
42866,11,41,14,13,14,0,93,38.24896224064726,-109.3901429
42867,12,41,14,13,14,0,94,38.24896224064726,-109.3898734
42868,16,38,14,12,13,0,93,38.24896224064726,-109.3896039
42869,16,37,14,12,13,0,92,38.24896224064726,-109.3893344
42870,15,38,14,12,13,0,92,38.24896224064726,-109.3890649
42871,14,41,14,12,13,0,94,38.24896224064726,-109.3887954
42872,12,42,14,13,14,0,95,38.24896224064726,-109.3885259
42873,12,40,14,13,14,0,93,38.24896224064726,-109.3882564
42874,12,40,14,13,14,0,93,38.24896224064726,-109.3879869
42875,13,39,14,13,14,0,93,38.24896224064726,-109.3877174
42876,13,39,14,13,15,0,94,38.24896224064726,-109.3874479
42877,10,40,12,11,15,0,88,38.24896224064726,-109.3871784
42878,11,37,12,11,14,1,86,38.24896224064726,-109.3869089
42879,10,37,12,12,14,1,86,38.24896224064726,-109.3866394
42880,11,39,13,12,14,0,89,38.24896224064726,-109.3863699
42881,11,40,14,12,14,0,91,38.24896224064726,-109.3861004
42882,15,39,14,12,13,0,93,38.24896224064726,-109.3858309
42883,19,36,14,11,12,0,92,38.24896224064726,-109.3855614
42884,20,34,14,11,12,0,91,38.24896224064726,-109.3852919
42885,19,35,13,11,12,0,90,38.24896224064726,-109.3850225
42886,19,35,13,11,12,0,90,38.24896224064726,-109.384753
42887,20,35,13,11,12,0,91,38.24896224064726,-109.3844835
42888,19,35,13,10,13,0,90,38.24896224064726,-109.384214
42889,15,36,13,11,14,0,89,38.24896224064726,-109.3839445
42890,11,36,12,12,15,1,87,38.24896224064726,-109.383675
42891,16,35,13,12,14,0,90,38.24896224064726,-109.3834055
42892,21,32,12,10,12,1,88,38.24896224064726,-109.383136
42893,25,25,12,9,10,1,82,38.24896224064726,-109.3828665
42894,18,22,12,12,11,2,77,38.24896224064726,-109.382597
42895,21,32,12,7,10,3,85,38.24896224064726,-109.3823275
42896,15,40,12,9,13,1,90,38.24896224064726,-109.382058
42897,12,43,13,9,13,1,91,38.24896224064726,-109.3817885
42898,10,44,13,10,14,1,92,38.24896224064726,-109.381519
42899,8,45,13,10,14,1,91,38.24896224064726,-109.3812495
42900,7,45,13,9,14,2,90,38.24896224064726,-109.38098
42901,7,46,13,10,12,2,90,38.24896224064726,-109.3807105
42902,8,46,13,10,11,2,90,38.24896224064726,-109.380441
42903,8,45,13,10,11,2,89,38.24896224064726,-109.3801716
42904,9,43,14,12,11,2,91,38.24896224064726,-109.3799021
42905,9,42,13,12,10,3,89,38.24896224064726,-109.3796326
42906,9,43,14,12,10,3,91,38.24896224064726,-109.3793631
42907,14,40,14,13,9,2,92,38.24896224064726,-109.3790936
42908,22,35,13,11,7,1,89,38.24896224064726,-109.3788241
42909,26,33,10,5,5,0,79,38.24896224064726,-109.3785546
42910,26,30,10,4,5,0,75,38.24896224064726,-109.3782851
42911,28,29,11,5,5,0,78,38.24896224064726,-109.3780156
42912,32,27,12,8,6,1,86,38.24896224064726,-109.3777461
42913,36,26,12,9,7,1,91,38.24896224064726,-109.3774766
42914,37,22,11,9,6,1,86,38.24896224064726,-109.3772071
42915,41,21,11,8,5,1,87,38.24896224064726,-109.3769376
42916,38,22,12,11,5,1,89,38.24896224064726,-109.3766681
42917,35,24,13,13,5,1,91,38.24896224064726,-109.3763986
42918,33,24,14,15,5,1,92,38.24896224064726,-109.3761291
42919,27,25,14,17,6,1,90,38.24896224064726,-109.3758596
42920,29,24,15,18,5,1,92,38.24896224064726,-109.3755901
42921,29,25,14,17,5,1,91,38.24896224064726,-109.3753206
42922,26,27,14,16,6,1,90,38.24896224064726,-109.3750512
42923,19,30,14,15,5,5,88,38.24896224064726,-109.3747817
42924,18,30,15,14,6,6,89,38.24896224064726,-109.3745122
42925,18,29,15,15,6,6,89,38.24896224064726,-109.3742427
42926,17,29,16,15,6,6,89,38.24896224064726,-109.3739732
42927,17,29,19,12,8,7,92,38.24896224064726,-109.3737037
42928,16,28,18,9,10,8,89,38.24896224064726,-109.3734342
42929,14,30,17,7,11,10,89,38.24896224064726,-109.3731647
42930,10,30,17,4,13,13,87,38.24896224064726,-109.3728952
42931,9,31,14,15,8,7,84,38.24896224064726,-109.3726257
42932,12,32,10,21,8,1,84,38.24896224064726,-109.3723562
42933,7,31,12,21,8,3,82,38.24896224064726,-109.3720867
42934,3,23,15,19,13,8,81,38.24896224064726,-109.3718172
42935,6,28,13,18,20,1,86,38.24896224064726,-109.3715477
42936,4,29,13,16,25,1,88,38.24896224064726,-109.3712782
42937,1,24,14,18,25,4,86,38.24896224064726,-109.3710087
42938,8,14,12,24,20,1,79,38.24896224064726,-109.3707392
42939,9,14,11,23,21,0,78,38.24896224064726,-109.3704697
42940,1,13,10,25,17,1,67,38.24896224064726,-109.3702003
42941,1,17,11,18,13,8,68,38.24896224064726,-109.3699308
42942,0,17,11,13,14,8,63,38.24896224064726,-109.3696613
42943,3,27,15,7,12,12,76,38.24896224064726,-109.3693918
42944,2,26,17,1,9,22,77,38.24896224064726,-109.3691223
42945,0,24,17,0,4,28,73,38.24896224064726,-109.3688528
42946,0,26,17,0,5,28,76,38.24896224064726,-109.3685833
42947,1,25,16,0,7,24,73,38.24896224064726,-109.3683138
42948,0,24,14,0,8,23,69,38.24896224064726,-109.3680443
42949,0,21,14,0,4,25,64,38.24896224064726,-109.3677748
42950,0,22,15,0,2,28,67,38.24896224064726,-109.3675053
42951,1,23,16,0,1,29,70,38.24896224064726,-109.3672358
42952,1,23,15,0,1,28,68,38.24896224064726,-109.3669663
42953,1,22,15,0,2,27,67,38.24896224064726,-109.3666968
42954,1,21,16,0,1,29,68,38.24896224064726,-109.3664273
42955,2,20,17,0,2,30,71,38.24896224064726,-109.3661578
42956,3,24,16,0,3,26,72,38.24896224064726,-109.3658883
42957,3,26,14,0,5,22,70,38.24896224064726,-109.3656188
42958,1,24,13,0,4,21,63,38.24896224064726,-109.3653493
42959,1,23,13,0,3,22,62,38.24896224064726,-109.3650799
42960,2,26,12,0,4,19,63,38.24896224064726,-109.3648104
42961,1,21,13,0,2,24,61,38.24896224064726,-109.3645409
42962,0,20,14,0,1,26,61,38.24896224064726,-109.3642714
42963,0,22,15,0,2,27,66,38.24896224064726,-109.3640019
42964,0,24,15,0,2,28,69,38.24896224064726,-109.3637324
42965,0,25,16,0,2,28,71,38.24896224064726,-109.3634629
42966,1,23,15,0,2,25,66,38.24896224064726,-109.3631934
42967,0,24,13,0,2,24,63,38.24896224064726,-109.3629239
42968,0,28,11,0,3,22,64,38.24896224064726,-109.3626544
42969,1,29,12,0,3,22,67,38.24896224064726,-109.3623849
42970,0,24,12,0,2,23,61,38.24896224064726,-109.3621154
42971,0,23,12,0,2,23,60,38.24896224064726,-109.3618459
42972,0,27,11,0,3,20,61,38.24896224064726,-109.3615764
42973,0,31,11,0,5,17,64,38.24896224064726,-109.3613069
42974,1,36,11,0,8,15,71,38.24896224064726,-109.3610374
42975,0,34,11,1,7,17,70,38.24896224064726,-109.3607679
42976,0,31,11,0,4,20,66,38.24896224064726,-109.3604984
42977,1,27,12,1,3,20,64,38.24896224064726,-109.360229
42978,0,22,12,1,3,21,59,38.24896224064726,-109.3599595
42979,0,23,10,2,6,14,55,38.24896224064726,-109.35969
42980,3,30,8,2,9,5,57,38.24896224064726,-109.3594205
42981,2,26,7,4,8,8,55,38.24896224064726,-109.359151
42982,2,23,8,5,6,10,54,38.24896224064726,-109.3588815
42983,1,28,8,4,8,11,60,38.24896224064726,-109.358612
42984,2,32,8,3,9,11,65,38.24896224064726,-109.3583425
42985,1,34,10,1,8,13,67,38.24896224064726,-109.358073
42986,1,31,10,2,7,14,65,38.24896224064726,-109.3578035
42987,1,29,10,3,7,14,64,38.24896224064726,-109.357534
42988,1,33,11,3,10,11,69,38.24896224064726,-109.3572645
42989,1,29,11,4,7,13,65,38.24896224064726,-109.356995
42990,1,29,11,2,6,16,65,38.24896224064726,-109.3567255
42991,1,28,11,1,6,17,64,38.24896224064726,-109.356456
42992,1,28,10,1,6,15,61,38.24896224064726,-109.3561865
42993,6,30,12,5,7,6,66,38.24896224064726,-109.355917
42994,1,44,8,4,9,6,72,38.24896224064726,-109.3556475
42995,1,43,9,4,11,7,75,38.24896224064726,-109.355378
42996,1,46,9,1,14,5,76,38.24896224064726,-109.3551086
42997,1,33,10,2,8,10,64,38.24896224064726,-109.3548391
42998,1,27,9,5,6,7,55,38.24896224064726,-109.3545696
42999,2,29,8,4,7,4,54,38.24896224064726,-109.3543001
43000,2,27,8,5,8,4,54,38.24896224064726,-109.3540306
43001,2,27,8,8,8,3,56,38.24896224064726,-109.3537611
43002,2,34,10,6,7,5,64,38.24896224064726,-109.3534916
43003,6,32,9,7,9,5,68,38.24896224064726,-109.3532221
43004,2,25,9,5,7,9,57,38.24896224064726,-109.3529526
43005,2,28,9,3,7,9,58,38.24896224064726,-109.3526831
43006,1,34,9,2,7,8,61,38.24896224064726,-109.3524136
43007,0,30,9,2,6,9,56,38.24896224064726,-109.3521441
43008,4,34,9,5,8,4,64,38.24896224064726,-109.3518746
43009,2,36,7,4,9,3,61,38.24896224064726,-109.3516051
43010,2,33,6,3,8,5,57,38.24896224064726,-109.3513356
43011,4,21,8,8,9,8,58,38.24896224064726,-109.3510661
43012,20,22,14,10,6,8,80,38.24896224064726,-109.3507966
43013,1,22,11,9,10,11,64,38.24896224064726,-109.3505271
43014,1,20,10,5,8,12,56,38.24896224064726,-109.3502577
43015,2,21,10,5,8,11,57,38.24896224064726,-109.3499882
43016,6,27,11,7,9,5,65,38.24896224064726,-109.3497187
43017,4,31,9,5,8,5,62,38.24896224064726,-109.3494492
43018,5,37,9,5,9,3,68,38.24896224064726,-109.3491797
43019,6,40,4,5,6,2,63,38.24896224064726,-109.3489102
43020,2,46,4,4,6,3,65,38.24896224064726,-109.3486407
43021,2,50,4,3,6,2,67,38.24896224064726,-109.3483712
43022,5,24,7,6,7,6,55,38.24896224064726,-109.3481017
43023,2,17,14,6,5,16,60,38.24896224064726,-109.3478322
43024,1,16,14,3,4,24,62,38.24896224064726,-109.3475627
43025,2,20,12,3,6,17,60,38.24896224064726,-109.3472932
43026,1,31,9,5,7,8,61,38.24896224064726,-109.3470237
43027,1,30,9,3,8,9,60,38.24896224064726,-109.3467542
43028,3,33,8,5,8,6,63,38.24896224064726,-109.3464847
43029,4,38,7,6,7,3,65,38.24896224064726,-109.3462152
43030,4,40,7,6,8,2,67,38.24896224064726,-109.3459457
43031,4,33,7,3,7,4,58,38.24896224064726,-109.3456762
43032,3,34,7,6,9,4,63,38.24896224064726,-109.3454068
43033,2,34,7,5,9,4,61,38.24896224064726,-109.3451373
43034,3,33,7,5,9,5,62,38.24896224064726,-109.3448678
43035,3,33,8,7,9,6,66,38.24896224064726,-109.3445983
43036,4,38,7,7,10,3,69,38.24896224064726,-109.3443288
43037,3,35,8,6,9,5,66,38.24896224064726,-109.3440593
43038,3,32,8,6,9,6,64,38.24896224064726,-109.3437898
43039,6,28,8,7,9,4,62,38.24896224064726,-109.3435203
43040,5,36,7,5,9,4,66,38.24896224064726,-109.3432508
43041,4,28,7,5,8,4,56,38.24896224064726,-109.3429813
43042,4,26,8,6,8,4,56,38.24896224064726,-109.3427118
43043,5,22,9,11,12,4,63,38.24896224064726,-109.3424423
43044,8,22,12,17,13,4,76,38.24896224064726,-109.3421728
43045,2,21,13,14,18,13,81,38.24896224064726,-109.3419033
43046,4,23,12,13,17,8,77,38.24896224064726,-109.3416338
43047,2,21,11,8,12,9,63,38.24896224064726,-109.3413643
43048,3,26,9,5,6,8,57,38.24896224064726,-109.3410948
43049,16,33,9,10,8,1,77,38.24896224064726,-109.3408253
43050,6,30,9,7,7,6,65,38.24896224064726,-109.3405558
43051,4,19,11,10,10,6,60,38.24896224064726,-109.3402864
43052,11,28,12,14,11,1,77,38.24896224064726,-109.3400169
43053,4,32,12,24,12,1,85,38.24896224064726,-109.3397474
43054,23,31,12,17,13,0,96,38.24896224064726,-109.3394779
43055,7,22,11,22,24,1,87,38.24896224064726,-109.3392084
43056,2,20,13,22,24,1,82,38.24896224064726,-109.3389389
43057,0,18,12,25,21,1,77,38.24896224064726,-109.3386694
43058,0,16,12,26,19,2,75,38.24896224064726,-109.3383999
43059,2,17,10,24,15,1,69,38.24896224064726,-109.3381304
43060,1,26,11,15,14,8,75,38.24896224064726,-109.3378609
43061,4,27,12,10,11,11,75,38.24896224064726,-109.3375914
43062,2,24,11,7,16,8,68,38.24896224064726,-109.3373219
43063,2,24,10,7,16,7,66,38.24896224064726,-109.3370524
43064,3,24,10,5,14,10,66,38.24896224064726,-109.3367829
43065,1,21,10,7,9,10,58,38.24896224064726,-109.3365134
43066,2,26,10,8,8,6,60,38.24896224064726,-109.3362439
43067,4,32,9,7,8,4,64,38.24896224064726,-109.3359744
43068,2,31,9,7,9,5,63,38.24896224064726,-109.3357049
43069,5,27,10,5,9,6,62,38.24896224064726,-109.3354355
43070,3,23,11,3,8,12,60,38.24896224064726,-109.335166
43071,1,22,11,2,7,13,56,38.24896224064726,-109.3348965
43072,2,29,9,3,7,8,58,38.24896224064726,-109.334627
43073,3,41,8,5,8,4,69,38.24896224064726,-109.3343575
43074,3,41,8,8,10,1,71,38.24896224064726,-109.334088
43075,1,47,7,2,11,3,71,38.24896224064726,-109.3338185
43076,0,45,6,2,10,5,68,38.24896224064726,-109.333549
43077,3,40,7,3,10,3,66,38.24896224064726,-109.3332795
43078,6,25,9,5,9,7,61,38.24896224064726,-109.33301
43079,4,16,12,2,5,16,55,38.24896224064726,-109.3327405
43080,2,20,12,1,3,19,57,38.24896224064726,-109.332471
43081,1,25,10,1,5,16,58,38.24896224064726,-109.3322015
43082,2,33,7,2,7,7,58,38.24896224064726,-109.331932
43083,2,30,7,3,10,5,57,38.24896224064726,-109.3316625
43084,3,26,8,4,10,6,57,38.24896224064726,-109.331393
43085,5,46,13,8,17,1,90,38.24869274606203,-109.4402688
43086,8,45,12,9,17,0,91,38.24869274606203,-109.4399993
43087,7,44,13,11,16,0,91,38.24869274606203,-109.4397299
43088,10,41,13,13,15,0,92,38.24869274606203,-109.4394604
43089,15,36,14,13,13,0,91,38.24869274606203,-109.4391909
43090,16,35,13,13,14,0,91,38.24869274606203,-109.4389214
43091,17,34,14,12,14,0,91,38.24869274606203,-109.4386519
43092,15,36,13,12,13,0,89,38.24869274606203,-109.4383824
43093,13,39,13,13,13,0,91,38.24869274606203,-109.4381129
43094,14,39,13,12,14,0,92,38.24869274606203,-109.4378434
43095,15,40,13,12,13,0,93,38.24869274606203,-109.4375739
43096,11,42,13,12,14,0,92,38.24869274606203,-109.4373044
43097,9,43,12,11,13,1,89,38.24869274606203,-109.4370349
43098,8,42,12,9,13,1,85,38.24869274606203,-109.4367654
43099,6,39,11,8,12,2,78,38.24869274606203,-109.4364959
43100,5,39,11,8,11,3,77,38.24869274606203,-109.4362264
43101,5,43,11,8,12,3,82,38.24869274606203,-109.4359569
43102,4,44,11,6,15,4,84,38.24869274606203,-109.4356874
43103,2,38,11,3,14,8,76,38.24869274606203,-109.4354179
43104,3,33,10,1,8,12,67,38.24869274606203,-109.4351484
43105,3,30,9,3,9,9,63,38.24869274606203,-109.434879
43106,2,31,9,3,9,9,63,38.24869274606203,-109.4346095
43107,1,33,8,2,8,9,61,38.24869274606203,-109.43434
43108,4,34,8,2,8,8,64,38.24869274606203,-109.4340705
43109,1,32,8,1,7,9,58,38.24869274606203,-109.433801
43110,1,31,8,1,7,10,58,38.24869274606203,-109.4335315
43111,2,33,8,2,8,9,62,38.24869274606203,-109.433262
43112,1,38,8,2,11,7,67,38.24869274606203,-109.4329925
43113,1,42,9,2,12,7,73,38.24869274606203,-109.432723
43114,1,40,10,0,11,12,74,38.24869274606203,-109.4324535
43115,1,43,10,0,11,11,76,38.24869274606203,-109.432184
43116,1,41,10,0,12,10,74,38.24869274606203,-109.4319145
43117,1,35,9,2,11,10,68,38.24869274606203,-109.431645
43118,2,38,9,3,11,6,69,38.24869274606203,-109.4313755
43119,0,36,9,1,10,9,65,38.24869274606203,-109.431106
43120,1,38,8,2,10,8,67,38.24869274606203,-109.4308365
43121,2,39,9,3,11,5,69,38.24869274606203,-109.430567
43122,2,39,9,4,12,5,71,38.24869274606203,-109.4302975
43123,5,37,11,8,14,3,78,38.24869274606203,-109.430028
43124,7,32,12,11,13,3,78,38.24869274606203,-109.4297586
43125,11,28,14,14,12,2,81,38.24869274606203,-109.4294891
43126,14,28,15,14,11,1,83,38.24869274606203,-109.4292196
43127,12,33,14,14,13,1,87,38.24869274606203,-109.4289501
43128,12,36,14,14,14,1,91,38.24869274606203,-109.4286806
43129,10,42,13,13,15,0,93,38.24869274606203,-109.4284111
43130,8,46,13,13,14,0,94,38.24869274606203,-109.4281416
43131,7,45,13,13,14,0,92,38.24869274606203,-109.4278721
43132,7,41,12,13,14,1,88,38.24869274606203,-109.4276026
43133,8,39,13,14,13,1,88,38.24869274606203,-109.4273331
43134,8,39,13,14,14,1,89,38.24869274606203,-109.4270636
43135,8,38,13,14,14,1,88,38.24869274606203,-109.4267941
43136,8,39,13,13,14,1,88,38.24869274606203,-109.4265246
43137,7,44,13,12,13,1,90,38.24869274606203,-109.4262551
43138,8,45,13,13,14,1,94,38.24869274606203,-109.4259856
43139,9,43,14,14,13,1,94,38.24869274606203,-109.4257161
43140,10,42,15,14,13,1,95,38.24869274606203,-109.4254466
43141,9,43,14,14,13,1,94,38.24869274606203,-109.4251771
43142,9,43,14,14,14,1,95,38.24869274606203,-109.4249077
43143,9,38,13,14,13,1,88,38.24869274606203,-109.4246382
43144,8,39,12,11,14,1,85,38.24869274606203,-109.4243687
43145,6,41,11,9,14,1,82,38.24869274606203,-109.4240992
43146,7,42,11,12,14,1,87,38.24869274606203,-109.4238297
43147,7,40,11,11,14,1,84,38.24869274606203,-109.4235602
43148,5,42,11,10,14,1,83,38.24869274606203,-109.4232907
43149,4,44,11,10,13,1,83,38.24869274606203,-109.4230212
43150,4,44,10,10,12,1,81,38.24869274606203,-109.4227517
43151,5,47,11,11,13,1,88,38.24869274606203,-109.4224822
43152,6,43,12,12,14,1,88,38.24869274606203,-109.4222127
43153,8,42,13,13,14,0,90,38.24869274606203,-109.4219432
43154,9,41,13,13,14,0,90,38.24869274606203,-109.4216737
43155,10,41,13,13,14,0,91,38.24869274606203,-109.4214042
43156,9,40,13,14,14,0,90,38.24869274606203,-109.4211347
43157,7,39,13,15,13,1,88,38.24869274606203,-109.4208652
43158,7,40,13,14,13,1,88,38.24869274606203,-109.4205957
43159,7,42,14,13,13,1,90,38.24869274606203,-109.4203262
43160,8,43,14,14,14,1,94,38.24869274606203,-109.4200568
43161,9,42,14,14,14,0,93,38.24869274606203,-109.4197873
43162,10,41,14,14,14,0,93,38.24869274606203,-109.4195178
43163,10,39,14,15,14,0,92,38.24869274606203,-109.4192483
43164,9,39,14,13,14,1,90,38.24869274606203,-109.4189788
43165,8,42,13,12,14,1,90,38.24869274606203,-109.4187093
43166,4,43,12,10,15,1,85,38.24869274606203,-109.4184398
43167,3,42,11,7,14,2,79,38.24869274606203,-109.4181703
43168,2,38,9,3,11,4,67,38.24869274606203,-109.4179008
43169,1,34,7,1,9,6,58,38.24869274606203,-109.4176313
43170,2,39,7,2,9,3,62,38.24869274606203,-109.4173618
43171,2,35,7,3,9,4,60,38.24869274606203,-109.4170923
43172,2,34,7,3,8,5,59,38.24869274606203,-109.4168228
43173,3,42,7,4,8,3,67,38.24869274606203,-109.4165533
43174,1,37,8,2,8,5,61,38.24869274606203,-109.4162838
43175,1,38,8,2,9,7,65,38.24869274606203,-109.4160143
43176,1,38,8,2,10,6,65,38.24869274606203,-109.4157448
43177,2,38,8,3,10,5,66,38.24869274606203,-109.4154753
43178,2,37,8,3,10,5,65,38.24869274606203,-109.4152058
43179,2,39,9,4,10,4,68,38.24869274606203,-109.4149364
43180,2,38,9,3,10,4,66,38.24869274606203,-109.4146669
43181,1,36,9,1,9,6,62,38.24869274606203,-109.4143974
43182,1,37,9,1,8,6,62,38.24869274606203,-109.4141279
43183,2,41,9,1,8,6,67,38.24869274606203,-109.4138584
43184,2,43,10,1,11,6,73,38.24869274606203,-109.4135889
43185,1,43,10,0,12,7,73,38.24869274606203,-109.4133194
43186,2,41,9,1,10,6,69,38.24869274606203,-109.4130499
43187,2,39,8,2,9,5,65,38.24869274606203,-109.4127804
43188,2,36,8,2,10,5,63,38.24869274606203,-109.4125109
43189,5,38,10,7,11,2,73,38.24869274606203,-109.4122414
43190,4,36,11,14,14,2,81,38.24869274606203,-109.4119719
43191,7,34,13,19,15,1,89,38.24869274606203,-109.4117024
43192,8,33,12,16,18,1,88,38.24869274606203,-109.4114329
43193,6,31,11,26,14,0,88,38.24869274606203,-109.4111634
43194,3,25,13,26,17,2,86,38.24869274606203,-109.4108939
43195,2,20,13,26,19,7,87,38.24869274606203,-109.4106244
43196,2,17,13,23,19,10,84,38.24869274606203,-109.4103549
43197,1,23,14,11,16,13,78,38.24869274606203,-109.4100855
43198,0,31,13,1,14,16,75,38.24869274606203,-109.409816
43199,0,32,11,0,12,16,71,38.24869274606203,-109.4095465
43200,1,32,11,0,13,13,70,38.24869274606203,-109.409277
43201,1,32,12,2,14,12,73,38.24869274606203,-109.4090075
43202,1,31,14,0,12,17,75,38.24869274606203,-109.408738
43203,0,30,12,1,12,15,70,38.24869274606203,-109.4084685
43204,0,31,10,0,11,13,65,38.24869274606203,-109.408199
43205,0,31,10,0,11,13,65,38.24869274606203,-109.4079295
43206,0,30,11,0,10,17,68,38.24869274606203,-109.40766
43207,0,27,11,0,7,20,65,38.24869274606203,-109.4073905
43208,2,29,13,3,12,14,73,38.24869274606203,-109.407121
43209,7,30,13,8,15,8,81,38.24869274606203,-109.4068515
43210,11,34,13,14,17,1,90,38.24869274606203,-109.406582
43211,15,31,14,19,14,0,93,38.24869274606203,-109.4063125
43212,14,32,14,18,14,0,92,38.24869274606203,-109.406043
43213,14,32,14,16,14,0,90,38.24869274606203,-109.4057735
43214,14,32,14,16,14,0,90,38.24869274606203,-109.405504
43215,13,32,13,17,14,1,90,38.24869274606203,-109.4052345
43216,13,33,13,16,14,1,90,38.24869274606203,-109.4049651
43217,17,31,13,17,13,0,91,38.24869274606203,-109.4046956
43218,18,31,13,17,13,0,92,38.24869274606203,-109.4044261
43219,18,31,14,17,13,0,93,38.24869274606203,-109.4041566
43220,17,31,14,17,13,0,92,38.24869274606203,-109.4038871
43221,19,29,14,18,13,0,93,38.24869274606203,-109.4036176
43222,22,29,14,17,12,0,94,38.24869274606203,-109.4033481
43223,24,29,14,17,12,0,96,38.24869274606203,-109.4030786
43224,22,29,14,17,12,0,94,38.24869274606203,-109.4028091
43225,18,33,13,16,13,0,93,38.24869274606203,-109.4025396
43226,19,33,14,15,13,0,94,38.24869274606203,-109.4022701
43227,20,32,15,16,12,0,95,38.24869274606203,-109.4020006
43228,20,32,15,16,12,1,96,38.24869274606203,-109.4017311
43229,20,32,15,15,12,1,95,38.24869274606203,-109.4014616
43230,21,32,15,15,12,1,96,38.24869274606203,-109.4011921
43231,19,33,15,14,12,1,94,38.24869274606203,-109.4009226
43232,17,34,14,14,12,1,92,38.24869274606203,-109.4006531
43233,16,34,14,14,13,1,92,38.24869274606203,-109.4003836
43234,17,33,15,15,13,0,93,38.24869274606203,-109.4001142
43235,16,34,14,13,14,0,91,38.24869274606203,-109.3998447
43236,15,34,14,13,14,0,90,38.24869274606203,-109.3995752
43237,14,34,15,14,14,1,92,38.24869274606203,-109.3993057
43238,13,34,15,15,14,1,92,38.24869274606203,-109.3990362
43239,12,36,15,14,14,1,92,38.24869274606203,-109.3987667
43240,11,38,14,12,14,1,90,38.24869274606203,-109.3984972
43241,10,40,14,12,14,1,91,38.24869274606203,-109.3982277
43242,10,42,14,12,14,0,92,38.24869274606203,-109.3979582
43243,10,41,14,11,14,1,91,38.24869274606203,-109.3976887
43244,8,40,14,10,13,2,87,38.24869274606203,-109.3974192
43245,9,40,14,12,13,1,89,38.24869274606203,-109.3971497
43246,10,40,15,13,13,1,92,38.24869274606203,-109.3968802
43247,11,40,15,13,13,1,93,38.24869274606203,-109.3966107
43248,13,38,15,13,13,1,93,38.24869274606203,-109.3963412
43249,12,38,15,15,13,1,94,38.24869274606203,-109.3960717
43250,12,39,15,15,14,0,95,38.24869274606203,-109.3958022
43251,10,41,15,14,14,1,95,38.24869274606203,-109.3955327
43252,7,44,14,13,14,1,93,38.24869274606203,-109.3952632
43253,5,47,13,9,12,3,89,38.24869274606203,-109.3949938
43254,5,47,13,8,13,3,89,38.24869274606203,-109.3947243
43255,6,46,14,11,14,2,93,38.24869274606203,-109.3944548
43256,7,43,14,13,15,1,93,38.24869274606203,-109.3941853
43257,8,42,14,13,15,1,93,38.24869274606203,-109.3939158
43258,8,43,14,12,14,1,92,38.24869274606203,-109.3936463
43259,8,43,14,12,15,1,93,38.24869274606203,-109.3933768
43260,8,42,14,12,15,1,92,38.24869274606203,-109.3931073
43261,9,43,13,11,15,1,92,38.24869274606203,-109.3928378
43262,10,44,13,10,15,0,92,38.24869274606203,-109.3925683
43263,12,43,13,11,15,0,94,38.24869274606203,-109.3922988
43264,11,41,13,12,15,0,92,38.24869274606203,-109.3920293
43265,11,40,13,11,14,1,90,38.24869274606203,-109.3917598
43266,11,41,13,10,13,1,89,38.24869274606203,-109.3914903
43267,11,42,13,10,13,1,90,38.24869274606203,-109.3912208
43268,9,43,13,9,15,1,90,38.24869274606203,-109.3909513
43269,10,43,13,11,14,0,91,38.24869274606203,-109.3906818
43270,12,42,14,13,14,0,95,38.24869274606203,-109.3904123
43271,15,40,14,13,13,0,95,38.24869274606203,-109.3901429
43272,15,39,14,13,13,0,94,38.24869274606203,-109.3898734
43273,16,38,14,12,13,0,93,38.24869274606203,-109.3896039
43274,16,38,14,12,13,0,93,38.24869274606203,-109.3893344
43275,15,39,14,12,13,0,93,38.24869274606203,-109.3890649
43276,15,41,14,11,13,0,94,38.24869274606203,-109.3887954
43277,17,37,13,12,13,0,92,38.24869274606203,-109.3885259
43278,20,34,13,11,13,0,91,38.24869274606203,-109.3882564
43279,19,35,13,12,13,0,92,38.24869274606203,-109.3879869
43280,17,36,14,13,14,0,94,38.24869274606203,-109.3877174
43281,15,36,14,13,14,0,92,38.24869274606203,-109.3874479
43282,17,33,12,10,13,1,86,38.24869274606203,-109.3871784
43283,17,32,12,9,13,1,84,38.24869274606203,-109.3869089
43284,15,36,12,11,14,0,88,38.24869274606203,-109.3866394
43285,12,39,14,11,15,0,91,38.24869274606203,-109.3863699
43286,12,39,14,12,15,0,92,38.24869274606203,-109.3861004
43287,13,39,14,12,14,0,92,38.24869274606203,-109.3858309
43288,17,36,14,12,13,0,92,38.24869274606203,-109.3855614
43289,19,34,14,13,13,0,93,38.24869274606203,-109.3852919
43290,17,34,13,13,13,0,90,38.24869274606203,-109.3850225
43291,12,36,13,13,14,1,89,38.24869274606203,-109.384753
43292,12,36,13,12,14,1,88,38.24869274606203,-109.3844835
43293,14,36,13,11,14,1,89,38.24869274606203,-109.384214
43294,13,36,13,11,15,1,89,38.24869274606203,-109.3839445
43295,8,37,12,12,16,1,86,38.24869274606203,-109.383675
43296,12,36,13,12,15,1,89,38.24869274606203,-109.3834055
43297,18,33,12,10,12,1,86,38.24869274606203,-109.383136
43298,22,26,12,9,10,1,80,38.24869274606203,-109.3828665
43299,17,22,12,11,11,2,75,38.24869274606203,-109.382597
43300,18,33,11,8,11,2,83,38.24869274606203,-109.3823275
43301,15,41,12,8,13,1,90,38.24869274606203,-109.382058
43302,12,44,13,8,15,0,92,38.24869274606203,-109.3817885
43303,13,43,13,8,14,1,92,38.24869274606203,-109.381519
43304,14,40,13,9,13,1,90,38.24869274606203,-109.3812495
43305,13,40,13,10,13,1,90,38.24869274606203,-109.38098
43306,11,42,13,10,13,1,90,38.24869274606203,-109.3807105
43307,8,45,13,10,13,2,91,38.24869274606203,-109.380441
43308,7,45,13,11,12,2,90,38.24869274606203,-109.3801716
43309,7,44,14,12,11,2,90,38.24869274606203,-109.3799021
43310,11,42,14,12,10,2,91,38.24869274606203,-109.3796326
43311,12,42,14,12,10,2,92,38.24869274606203,-109.3793631
43312,14,40,14,13,9,2,92,38.24869274606203,-109.3790936
43313,18,37,14,13,8,1,91,38.24869274606203,-109.3788241
43314,23,36,13,10,7,1,90,38.24869274606203,-109.3785546
43315,23,33,11,7,6,0,80,38.24869274606203,-109.3782851
43316,27,31,12,10,7,1,88,38.24869274606203,-109.3780156
43317,35,26,12,11,7,1,92,38.24869274606203,-109.3777461
43318,44,20,11,10,6,1,92,38.24869274606203,-109.3774766
43319,40,18,11,10,5,1,85,38.24869274606203,-109.3772071
43320,38,17,11,10,5,1,82,38.24869274606203,-109.3769376
43321,38,17,10,11,4,0,80,38.24869274606203,-109.3766681
43322,37,18,11,13,4,0,83,38.24869274606203,-109.3763986
43323,37,17,12,15,5,1,87,38.24869274606203,-109.3761291
43324,40,16,13,15,5,1,90,38.24869274606203,-109.3758596
43325,37,18,14,16,5,1,91,38.24869274606203,-109.3755901
43326,32,24,14,15,6,1,92,38.24869274606203,-109.3753206
43327,16,28,15,14,3,5,81,38.24869274606203,-109.3750512
43328,15,29,14,15,4,7,84,38.24869274606203,-109.3747817
43329,19,30,15,14,6,6,90,38.24869274606203,-109.3745122
43330,16,26,16,12,4,10,84,38.24869274606203,-109.3742427
43331,12,26,15,13,3,11,80,38.24869274606203,-109.3739732
43332,7,29,14,11,5,11,77,38.24869274606203,-109.3737037
43333,6,28,15,10,5,14,78,38.24869274606203,-109.3734342
43334,18,25,16,13,12,6,90,38.24869274606203,-109.3731647
43335,13,25,16,14,17,4,89,38.24869274606203,-109.3728952
43336,10,22,15,21,13,5,86,38.24869274606203,-109.3726257
43337,14,25,13,18,12,4,86,38.24869274606203,-109.3723562
43338,2,27,17,15,9,11,81,38.24869274606203,-109.3720867
43339,5,20,11,17,20,7,80,38.24869274606203,-109.3718172
43340,9,19,12,21,21,3,85,38.24869274606203,-109.3715477
43341,8,20,12,25,19,1,85,38.24869274606203,-109.3712782
43342,1,17,12,27,17,1,75,38.24869274606203,-109.3710087
43343,2,17,12,27,17,3,78,38.24869274606203,-109.3707392
43344,4,22,12,21,13,4,76,38.24869274606203,-109.3704697
43345,2,24,11,11,15,5,68,38.24869274606203,-109.3702003
43346,2,24,13,3,8,19,69,38.24869274606203,-109.3699308
43347,2,22,15,0,5,28,72,38.24869274606203,-109.3696613
43348,0,21,16,0,4,27,68,38.24869274606203,-109.3693918
43349,1,22,15,0,3,26,67,38.24869274606203,-109.3691223
43350,2,23,14,0,3,24,66,38.24869274606203,-109.3688528
43351,0,24,13,0,2,24,63,38.24869274606203,-109.3685833
43352,1,23,12,0,4,18,58,38.24869274606203,-109.3683138
43353,1,22,12,0,6,17,58,38.24869274606203,-109.3680443
43354,1,23,13,1,5,18,61,38.24869274606203,-109.3677748
43355,1,23,14,0,4,21,63,38.24869274606203,-109.3675053
43356,2,22,14,0,2,24,64,38.24869274606203,-109.3672358
43357,1,21,13,0,2,22,59,38.24869274606203,-109.3669663
43358,1,20,14,0,3,23,61,38.24869274606203,-109.3666968
43359,1,19,15,0,3,24,62,38.24869274606203,-109.3664273
43360,2,20,15,0,3,24,64,38.24869274606203,-109.3661578
43361,2,21,14,0,3,23,63,38.24869274606203,-109.3658883
43362,1,25,12,0,4,20,62,38.24869274606203,-109.3656188
43363,1,28,11,0,5,19,64,38.24869274606203,-109.3653493
43364,0,26,11,0,4,19,60,38.24869274606203,-109.3650799
43365,1,23,12,0,3,22,61,38.24869274606203,-109.3648104
43366,0,19,15,0,0,28,62,38.24869274606203,-109.3645409
43367,0,21,15,0,1,28,65,38.24869274606203,-109.3642714
43368,0,23,14,0,1,26,64,38.24869274606203,-109.3640019
43369,1,23,14,0,1,27,66,38.24869274606203,-109.3637324
43370,0,21,15,0,1,28,65,38.24869274606203,-109.3634629
43371,1,28,13,0,3,21,66,38.24869274606203,-109.3631934
43372,0,28,12,0,3,20,63,38.24869274606203,-109.3629239
43373,0,26,12,0,3,22,63,38.24869274606203,-109.3626544
43374,0,26,13,0,3,23,65,38.24869274606203,-109.3623849
43375,0,28,12,0,3,21,64,38.24869274606203,-109.3621154
43376,0,30,12,0,4,20,66,38.24869274606203,-109.3618459
43377,0,30,11,0,5,19,65,38.24869274606203,-109.3615764
43378,1,31,11,0,5,17,65,38.24869274606203,-109.3613069
43379,0,31,11,0,5,18,65,38.24869274606203,-109.3610374
43380,0,32,11,0,5,18,66,38.24869274606203,-109.3607679
43381,0,33,11,0,4,18,66,38.24869274606203,-109.3604984
43382,1,29,12,0,3,19,64,38.24869274606203,-109.360229
43383,0,27,12,0,2,20,61,38.24869274606203,-109.3599595
43384,0,27,10,2,5,12,56,38.24869274606203,-109.35969
43385,3,31,8,3,9,4,58,38.24869274606203,-109.3594205
43386,3,25,7,4,7,9,55,38.24869274606203,-109.359151
43387,2,23,8,3,6,14,56,38.24869274606203,-109.3588815
43388,1,23,11,4,4,18,61,38.24869274606203,-109.358612
43389,1,23,15,2,1,26,68,38.24869274606203,-109.3583425
43390,2,26,15,1,2,23,69,38.24869274606203,-109.358073
43391,1,25,13,1,2,22,64,38.24869274606203,-109.3578035
43392,0,26,12,1,3,20,62,38.24869274606203,-109.357534
43393,1,31,11,0,5,18,66,38.24869274606203,-109.3572645
43394,1,33,11,1,7,15,68,38.24869274606203,-109.356995
43395,2,35,11,0,9,13,70,38.24869274606203,-109.3567255
43396,0,35,10,0,9,14,68,38.24869274606203,-109.356456
43397,0,35,10,0,10,12,67,38.24869274606203,-109.3561865
43398,6,36,10,7,7,5,71,38.24869274606203,-109.355917
43399,1,50,8,5,10,4,78,38.24869274606203,-109.3556475
43400,1,43,9,4,11,7,75,38.24869274606203,-109.355378
43401,1,49,9,1,13,5,78,38.24869274606203,-109.3551086
43402,0,36,10,1,10,11,68,38.24869274606203,-109.3548391
43403,1,32,9,4,5,7,58,38.24869274606203,-109.3545696
43404,1,27,9,5,7,6,55,38.24869274606203,-109.3543001
43405,2,24,9,6,9,5,55,38.24869274606203,-109.3540306
43406,1,22,10,7,8,6,54,38.24869274606203,-109.3537611
43407,2,27,11,6,9,6,61,38.24869274606203,-109.3534916
43408,4,27,9,6,10,4,60,38.24869274606203,-109.3532221
43409,3,30,8,6,7,5,59,38.24869274606203,-109.3529526
43410,3,34,9,3,7,6,62,38.24869274606203,-109.3526831
43411,2,33,9,3,7,7,61,38.24869274606203,-109.3524136
43412,1,33,9,2,5,8,58,38.24869274606203,-109.3521441
43413,4,36,8,4,7,4,63,38.24869274606203,-109.3518746
43414,3,35,7,4,8,3,60,38.24869274606203,-109.3516051
43415,0,21,7,5,11,5,49,38.24869274606203,-109.3513356
43416,1,16,11,9,8,10,55,38.24869274606203,-109.3510661
43417,15,19,16,7,10,13,80,38.24869274606203,-109.3507966
43418,2,18,11,5,9,15,60,38.24869274606203,-109.3505271
43419,1,22,10,6,9,9,57,38.24869274606203,-109.3502577
43420,1,23,10,4,10,10,58,38.24869274606203,-109.3499882
43421,3,28,12,4,9,9,65,38.24869274606203,-109.3497187
43422,5,24,10,5,9,10,63,38.24869274606203,-109.3494492
43423,4,33,10,2,9,5,63,38.24869274606203,-109.3491797
43424,6,39,4,4,6,2,61,38.24869274606203,-109.3489102
43425,2,48,4,2,6,2,64,38.24869274606203,-109.3486407
43426,2,47,5,3,6,2,65,38.24869274606203,-109.3483712
43427,4,24,7,6,8,7,56,38.24869274606203,-109.3481017
43428,2,19,14,8,6,15,64,38.24869274606203,-109.3478322
43429,2,17,15,5,5,24,68,38.24869274606203,-109.3475627
43430,1,19,11,3,5,17,56,38.24869274606203,-109.3472932
43431,3,38,8,4,8,5,66,38.24869274606203,-109.3470237
43432,3,31,10,4,11,7,66,38.24869274606203,-109.3467542
43433,2,25,11,7,9,9,63,38.24869274606203,-109.3464847
43434,1,25,10,6,7,9,58,38.24869274606203,-109.3462152
43435,7,38,5,4,5,3,62,38.24869274606203,-109.3459457
43436,5,43,6,6,8,1,69,38.24869274606203,-109.3456762
43437,3,30,8,6,9,5,61,38.24869274606203,-109.3454068
43438,3,28,8,6,9,8,62,38.24869274606203,-109.3451373
43439,2,27,7,5,9,8,58,38.24869274606203,-109.3448678
43440,4,32,8,6,8,7,65,38.24869274606203,-109.3445983
43441,13,35,9,9,9,1,76,38.24869274606203,-109.3443288
43442,4,31,7,7,9,5,63,38.24869274606203,-109.3440593
43443,3,30,9,6,9,8,65,38.24869274606203,-109.3437898
43444,6,25,9,8,10,6,64,38.24869274606203,-109.3435203
43445,5,31,9,9,11,3,68,38.24869274606203,-109.3432508
43446,5,28,9,14,11,5,72,38.24869274606203,-109.3429813
43447,8,26,12,24,9,4,83,38.24869274606203,-109.3427118
43448,9,23,13,22,17,2,86,38.24869274606203,-109.3424423
43449,3,19,13,14,18,10,77,38.24869274606203,-109.3421728
43450,3,20,13,12,16,10,74,38.24869274606203,-109.3419033
43451,2,21,12,12,15,8,70,38.24869274606203,-109.3416338
43452,2,26,12,10,11,8,69,38.24869274606203,-109.3413643
43453,5,24,11,7,8,7,62,38.24869274606203,-109.3410948
43454,7,23,9,9,8,5,61,38.24869274606203,-109.3408253
43455,7,24,12,14,11,4,72,38.24869274606203,-109.3405558
43456,4,33,12,30,10,1,90,38.24869274606203,-109.3402864
43457,6,26,9,27,17,0,85,38.24869274606203,-109.3400169
43458,1,20,12,20,23,8,84,38.24869274606203,-109.3397474
43459,12,14,11,26,17,5,85,38.24869274606203,-109.3394779
43460,0,19,12,14,25,4,74,38.24869274606203,-109.3392084
43461,0,19,12,15,23,4,73,38.24869274606203,-109.3389389
43462,0,19,11,18,16,4,68,38.24869274606203,-109.3386694
43463,0,21,11,16,17,3,68,38.24869274606203,-109.3383999
43464,9,30,12,9,17,2,79,38.24869274606203,-109.3381304
43465,2,29,12,14,15,7,79,38.24869274606203,-109.3378609
43466,1,27,12,10,16,9,75,38.24869274606203,-109.3375914
43467,2,20,12,14,15,7,70,38.24869274606203,-109.3373219
43468,2,24,11,11,16,6,70,38.24869274606203,-109.3370524
43469,4,28,11,12,16,3,74,38.24869274606203,-109.3367829
43470,1,21,10,11,12,7,62,38.24869274606203,-109.3365134
43471,1,23,10,13,9,6,62,38.24869274606203,-109.3362439
43472,2,27,9,12,9,4,63,38.24869274606203,-109.3359744
43473,1,23,9,6,8,8,55,38.24869274606203,-109.3357049
43474,3,25,11,1,9,13,62,38.24869274606203,-109.3354355
43475,1,21,12,0,4,19,57,38.24869274606203,-109.335166
43476,0,20,11,0,3,19,53,38.24869274606203,-109.3348965
43477,1,25,10,2,8,10,56,38.24869274606203,-109.334627
43478,4,40,7,4,9,2,66,38.24869274606203,-109.3343575
43479,2,46,8,8,10,1,75,38.24869274606203,-109.334088
43480,1,52,7,4,11,2,77,38.24869274606203,-109.3338185
43481,2,47,7,2,9,3,70,38.24869274606203,-109.333549
43482,3,33,8,4,10,4,62,38.24869274606203,-109.3332795
43483,10,26,9,5,9,5,64,38.24869274606203,-109.33301
43484,5,18,11,3,6,14,57,38.24869274606203,-109.3327405
43485,1,21,11,2,4,17,56,38.24869274606203,-109.332471
43486,1,28,9,1,6,13,58,38.24869274606203,-109.3322015
43487,1,29,8,2,8,8,56,38.24869274606203,-109.331932
43488,4,30,8,4,11,4,61,38.24869274606203,-109.3316625
43489,4,24,8,5,11,6,58,38.24869274606203,-109.331393
43490,6,50,11,7,16,1,91,38.24842325147679,-109.4402688
43491,10,45,12,10,15,0,92,38.24842325147679,-109.4399993
43492,11,42,13,12,14,0,92,38.24842325147679,-109.4397299
43493,10,42,13,13,14,0,92,38.24842325147679,-109.4394604
43494,8,42,13,13,14,1,91,38.24842325147679,-109.4391909
43495,11,39,13,13,15,0,91,38.24842325147679,-109.4389214
43496,13,36,13,13,14,0,89,38.24842325147679,-109.4386519
43497,16,34,14,14,13,0,91,38.24842325147679,-109.4383824
43498,16,35,14,14,13,0,92,38.24842325147679,-109.4381129
43499,11,40,13,13,14,0,91,38.24842325147679,-109.4378434
43500,6,41,11,8,13,3,82,38.24842325147679,-109.4375739
43501,4,45,10,7,12,3,81,38.24842325147679,-109.4373044
43502,5,43,10,8,12,2,80,38.24842325147679,-109.4370349
43503,5,40,11,8,11,2,77,38.24842325147679,-109.4367654
43504,5,40,12,9,12,2,80,38.24842325147679,-109.4364959
43505,4,42,12,10,11,2,81,38.24842325147679,-109.4362264
43506,5,45,11,9,12,2,84,38.24842325147679,-109.4359569
43507,4,49,11,8,13,2,87,38.24842325147679,-109.4356874
43508,2,47,10,5,15,3,82,38.24842325147679,-109.4354179
43509,2,38,10,4,14,8,76,38.24842325147679,-109.4351484
43510,2,34,10,3,11,9,69,38.24842325147679,-109.434879
43511,2,31,9,3,8,9,62,38.24842325147679,-109.4346095
43512,3,30,9,3,8,8,61,38.24842325147679,-109.43434
43513,5,30,9,2,8,8,62,38.24842325147679,-109.4340705
43514,2,30,9,2,8,9,60,38.24842325147679,-109.433801
43515,2,31,9,1,8,10,61,38.24842325147679,-109.4335315
43516,3,32,9,2,8,10,64,38.24842325147679,-109.433262
43517,2,35,10,1,10,11,69,38.24842325147679,-109.4329925
43518,1,39,10,0,12,12,74,38.24842325147679,-109.432723
43519,1,35,11,1,11,13,72,38.24842325147679,-109.4324535
43520,2,35,11,0,11,13,72,38.24842325147679,-109.432184
43521,2,35,11,0,11,14,73,38.24842325147679,-109.4319145
43522,2,35,10,1,11,13,72,38.24842325147679,-109.431645
43523,3,40,10,3,12,7,75,38.24842325147679,-109.4313755
43524,3,38,10,4,13,7,75,38.24842325147679,-109.431106
43525,3,40,10,5,14,5,77,38.24842325147679,-109.4308365
43526,3,42,10,6,14,3,78,38.24842325147679,-109.430567
43527,3,41,10,7,13,3,77,38.24842325147679,-109.4302975
43528,6,40,11,10,14,2,83,38.24842325147679,-109.430028
43529,9,35,13,14,13,2,86,38.24842325147679,-109.4297586
43530,13,32,14,15,12,1,87,38.24842325147679,-109.4294891
43531,17,31,15,15,12,1,91,38.24842325147679,-109.4292196
43532,16,32,14,15,12,1,90,38.24842325147679,-109.4289501
43533,13,36,14,14,13,1,91,38.24842325147679,-109.4286806
43534,10,41,13,13,14,1,92,38.24842325147679,-109.4284111
43535,7,45,13,12,14,1,92,38.24842325147679,-109.4281416
43536,6,44,12,13,14,1,90,38.24842325147679,-109.4278721
43537,9,41,13,14,14,1,92,38.24842325147679,-109.4276026
43538,9,38,13,14,14,1,89,38.24842325147679,-109.4273331
43539,9,38,13,14,14,1,89,38.24842325147679,-109.4270636
43540,9,38,14,13,14,1,89,38.24842325147679,-109.4267941
43541,10,39,14,13,14,1,91,38.24842325147679,-109.4265246
43542,7,45,13,12,14,1,92,38.24842325147679,-109.4262551
43543,9,46,13,12,14,0,94,38.24842325147679,-109.4259856
43544,10,44,13,13,14,0,94,38.24842325147679,-109.4257161
43545,10,43,13,13,14,1,94,38.24842325147679,-109.4254466
43546,9,43,14,14,14,0,94,38.24842325147679,-109.4251771
43547,11,40,13,13,14,0,91,38.24842325147679,-109.4249077
43548,13,38,13,13,14,0,91,38.24842325147679,-109.4246382
43549,11,39,13,13,14,0,90,38.24842325147679,-109.4243687
43550,9,41,12,11,14,0,87,38.24842325147679,-109.4240992
43551,12,39,12,12,14,0,89,38.24842325147679,-109.4238297
43552,10,38,12,11,15,1,87,38.24842325147679,-109.4235602
43553,6,42,12,11,14,1,86,38.24842325147679,-109.4232907
43554,5,44,12,11,14,1,87,38.24842325147679,-109.4230212
43555,6,40,12,12,13,1,84,38.24842325147679,-109.4227517
43556,5,42,11,11,12,1,82,38.24842325147679,-109.4224822
43557,6,41,11,10,15,1,84,38.24842325147679,-109.4222127
43558,7,43,12,11,14,1,88,38.24842325147679,-109.4219432
43559,9,42,14,12,14,0,91,38.24842325147679,-109.4216737
43560,8,41,14,14,14,1,92,38.24842325147679,-109.4214042
43561,9,40,14,14,14,0,91,38.24842325147679,-109.4211347
43562,7,42,13,13,14,1,90,38.24842325147679,-109.4208652
43563,5,43,13,13,13,1,88,38.24842325147679,-109.4205957
43564,5,42,13,14,12,1,87,38.24842325147679,-109.4203262
43565,7,43,14,13,14,1,92,38.24842325147679,-109.4200568
43566,7,44,14,14,13,0,92,38.24842325147679,-109.4197873
43567,7,44,14,14,13,0,92,38.24842325147679,-109.4195178
43568,7,43,13,13,14,0,90,38.24842325147679,-109.4192483
43569,7,45,13,10,15,0,90,38.24842325147679,-109.4189788
43570,4,44,11,8,14,2,83,38.24842325147679,-109.4187093
43571,2,41,10,4,12,4,73,38.24842325147679,-109.4184398
43572,1,38,9,2,10,5,65,38.24842325147679,-109.4181703
43573,2,37,8,3,10,4,64,38.24842325147679,-109.4179008
43574,3,35,7,3,8,4,60,38.24842325147679,-109.4176313
43575,3,31,8,4,10,6,62,38.24842325147679,-109.4173618
43576,2,28,10,6,9,9,64,38.24842325147679,-109.4170923
43577,2,28,10,5,8,10,63,38.24842325147679,-109.4168228
43578,4,37,9,4,10,6,70,38.24842325147679,-109.4165533
43579,1,35,10,2,8,12,68,38.24842325147679,-109.4162838
43580,2,43,9,0,10,9,73,38.24842325147679,-109.4160143
43581,2,40,8,2,10,6,68,38.24842325147679,-109.4157448
43582,2,36,8,2,9,5,62,38.24842325147679,-109.4154753
43583,2,34,9,2,9,6,62,38.24842325147679,-109.4152058
43584,3,38,9,5,10,3,68,38.24842325147679,-109.4149364
43585,2,36,8,2,9,4,61,38.24842325147679,-109.4146669
43586,1,33,8,1,8,6,57,38.24842325147679,-109.4143974
43587,1,32,9,1,7,7,57,38.24842325147679,-109.4141279
43588,2,38,10,2,9,7,68,38.24842325147679,-109.4138584
43589,2,39,11,2,12,5,71,38.24842325147679,-109.4135889
43590,2,36,9,3,10,5,65,38.24842325147679,-109.4133194
43591,2,40,8,2,10,4,66,38.24842325147679,-109.4130499
43592,3,44,9,3,10,3,72,38.24842325147679,-109.4127804
43593,3,34,11,12,14,3,77,38.24842325147679,-109.4125109
43594,6,30,11,21,15,2,85,38.24842325147679,-109.4122414
43595,4,28,11,26,16,0,85,38.24842325147679,-109.4119719
43596,3,27,11,27,17,0,85,38.24842325147679,-109.4117024
43597,6,29,11,19,18,2,85,38.24842325147679,-109.4114329
43598,3,29,11,22,17,2,84,38.24842325147679,-109.4111634
43599,3,25,14,18,20,6,86,38.24842325147679,-109.4108939
43600,1,23,14,19,18,8,83,38.24842325147679,-109.4106244
43601,1,22,14,18,18,9,82,38.24842325147679,-109.4103549
43602,0,27,14,5,14,16,76,38.24842325147679,-109.4100855
43603,0,34,12,0,13,15,74,38.24842325147679,-109.409816
43604,0,30,11,0,10,16,67,38.24842325147679,-109.4095465
43605,0,30,11,0,11,14,66,38.24842325147679,-109.409277
43606,0,32,11,0,13,13,69,38.24842325147679,-109.4090075
43607,1,33,12,0,14,15,75,38.24842325147679,-109.408738
43608,2,34,12,3,15,10,76,38.24842325147679,-109.4084685
43609,1,31,11,2,14,11,70,38.24842325147679,-109.408199
43610,2,30,12,2,13,13,72,38.24842325147679,-109.4079295
43611,4,31,12,4,13,10,74,38.24842325147679,-109.40766
43612,6,28,12,9,14,7,76,38.24842325147679,-109.4073905
43613,11,32,12,11,15,2,83,38.24842325147679,-109.407121
43614,15,33,13,14,14,0,89,38.24842325147679,-109.4068515
43615,15,33,14,18,13,0,93,38.24842325147679,-109.406582
43616,14,33,15,19,14,0,95,38.24842325147679,-109.4063125
43617,12,34,14,20,14,0,94,38.24842325147679,-109.406043
43618,12,34,14,16,15,0,91,38.24842325147679,-109.4057735
43619,13,33,14,16,14,0,90,38.24842325147679,-109.405504
43620,15,32,14,18,13,0,92,38.24842325147679,-109.4052345
43621,14,34,14,16,13,0,91,38.24842325147679,-109.4049651
43622,17,33,15,17,13,0,95,38.24842325147679,-109.4046956
43623,18,32,15,18,12,0,95,38.24842325147679,-109.4044261
43624,17,32,15,18,13,0,95,38.24842325147679,-109.4041566
43625,15,32,15,18,13,0,93,38.24842325147679,-109.4038871
43626,16,32,14,17,14,0,93,38.24842325147679,-109.4036176
43627,19,32,14,15,14,0,94,38.24842325147679,-109.4033481
43628,17,33,14,15,14,0,93,38.24842325147679,-109.4030786
43629,15,34,15,16,14,0,94,38.24842325147679,-109.4028091
43630,15,35,15,14,14,0,93,38.24842325147679,-109.4025396
43631,15,36,15,15,13,0,94,38.24842325147679,-109.4022701
43632,16,34,15,15,13,0,93,38.24842325147679,-109.4020006
43633,16,34,15,16,13,0,94,38.24842325147679,-109.4017311
43634,15,34,15,16,12,1,93,38.24842325147679,-109.4014616
43635,15,34,15,15,12,1,92,38.24842325147679,-109.4011921
43636,16,34,15,14,13,1,93,38.24842325147679,-109.4009226
43637,17,33,15,14,13,1,93,38.24842325147679,-109.4006531
43638,15,33,14,14,13,1,90,38.24842325147679,-109.4003836
43639,13,34,14,14,13,1,89,38.24842325147679,-109.4001142
43640,14,35,14,13,14,1,91,38.24842325147679,-109.3998447
43641,12,37,14,13,14,1,91,38.24842325147679,-109.3995752
43642,11,36,14,13,14,1,89,38.24842325147679,-109.3993057
43643,11,36,14,14,14,1,90,38.24842325147679,-109.3990362
43644,10,38,14,14,14,1,91,38.24842325147679,-109.3987667
43645,11,38,14,13,14,1,91,38.24842325147679,-109.3984972
43646,9,39,14,12,13,1,88,38.24842325147679,-109.3982277
43647,8,41,14,12,14,1,90,38.24842325147679,-109.3979582
43648,8,40,14,11,13,1,87,38.24842325147679,-109.3976887
43649,8,38,13,10,13,2,84,38.24842325147679,-109.3974192
43650,8,37,14,12,12,2,85,38.24842325147679,-109.3971497
43651,9,37,14,13,13,1,87,38.24842325147679,-109.3968802
43652,11,37,15,14,14,1,92,38.24842325147679,-109.3966107
43653,12,38,15,14,14,0,93,38.24842325147679,-109.3963412
43654,13,38,15,14,14,0,94,38.24842325147679,-109.3960717
43655,12,38,15,14,14,1,94,38.24842325147679,-109.3958022
43656,10,40,14,13,14,1,92,38.24842325147679,-109.3955327
43657,6,43,13,11,13,2,88,38.24842325147679,-109.3952632
43658,5,44,13,9,12,3,86,38.24842325147679,-109.3949938
43659,4,45,13,10,13,3,88,38.24842325147679,-109.3947243
43660,4,45,13,11,13,2,88,38.24842325147679,-109.3944548
43661,5,45,13,10,13,2,88,38.24842325147679,-109.3941853
43662,6,44,13,10,13,2,88,38.24842325147679,-109.3939158
43663,6,43,13,11,13,2,88,38.24842325147679,-109.3936463
43664,8,44,14,12,15,0,93,38.24842325147679,-109.3933768
43665,9,43,14,12,16,0,94,38.24842325147679,-109.3931073
43666,10,42,13,11,15,1,92,38.24842325147679,-109.3928378
43667,12,43,13,9,14,0,91,38.24842325147679,-109.3925683
43668,12,44,13,10,14,0,93,38.24842325147679,-109.3922988
43669,11,43,13,10,14,0,91,38.24842325147679,-109.3920293
43670,11,41,13,12,14,0,91,38.24842325147679,-109.3917598
43671,11,41,14,13,14,0,93,38.24842325147679,-109.3914903
43672,10,42,13,12,14,1,92,38.24842325147679,-109.3912208
43673,9,44,13,11,15,0,92,38.24842325147679,-109.3909513
43674,9,44,13,12,14,0,92,38.24842325147679,-109.3906818
43675,10,43,14,13,14,0,94,38.24842325147679,-109.3904123
43676,12,41,14,13,13,0,93,38.24842325147679,-109.3901429
43677,13,40,14,13,13,0,93,38.24842325147679,-109.3898734
43678,13,40,14,13,13,0,93,38.24842325147679,-109.3896039
43679,15,39,14,12,13,0,93,38.24842325147679,-109.3893344
43680,17,38,14,11,13,0,93,38.24842325147679,-109.3890649
43681,19,37,13,10,13,0,92,38.24842325147679,-109.3887954
43682,23,33,12,9,12,0,89,38.24842325147679,-109.3885259
43683,27,30,12,9,12,0,90,38.24842325147679,-109.3882564
43684,24,31,13,11,12,0,91,38.24842325147679,-109.3879869
43685,20,33,13,12,13,0,91,38.24842325147679,-109.3877174
43686,20,33,13,13,13,0,92,38.24842325147679,-109.3874479
43687,23,29,12,11,12,0,87,38.24842325147679,-109.3871784
43688,16,34,13,11,14,0,88,38.24842325147679,-109.3869089
43689,11,39,13,11,15,0,89,38.24842325147679,-109.3866394
43690,9,42,13,9,16,0,89,38.24842325147679,-109.3863699
43691,10,42,14,12,15,0,93,38.24842325147679,-109.3861004
43692,9,42,14,12,15,0,92,38.24842325147679,-109.3858309
43693,10,40,14,12,15,0,91,38.24842325147679,-109.3855614
43694,12,37,14,13,15,0,91,38.24842325147679,-109.3852919
43695,13,35,14,14,14,0,90,38.24842325147679,-109.3850225
43696,12,36,13,14,14,0,89,38.24842325147679,-109.384753
43697,11,36,13,13,15,1,89,38.24842325147679,-109.3844835
43698,14,36,13,11,14,0,88,38.24842325147679,-109.384214
43699,14,38,13,10,15,0,90,38.24842325147679,-109.3839445
43700,8,38,12,10,16,1,85,38.24842325147679,-109.383675
43701,8,36,12,9,15,2,82,38.24842325147679,-109.3834055
43702,13,36,12,10,14,1,86,38.24842325147679,-109.383136
43703,14,30,12,11,12,2,81,38.24842325147679,-109.3828665
43704,11,25,11,13,12,1,73,38.24842325147679,-109.382597
43705,15,32,11,9,12,2,81,38.24842325147679,-109.3823275
43706,16,40,12,7,13,1,89,38.24842325147679,-109.382058
43707,14,41,13,8,15,0,91,38.24842325147679,-109.3817885
43708,13,40,13,10,15,0,91,38.24842325147679,-109.381519
43709,13,39,13,10,14,1,90,38.24842325147679,-109.3812495
43710,15,39,13,9,13,1,90,38.24842325147679,-109.38098
43711,14,39,13,9,13,1,89,38.24842325147679,-109.3807105
43712,11,41,13,10,13,2,90,38.24842325147679,-109.380441
43713,8,43,13,10,13,2,89,38.24842325147679,-109.3801716
43714,9,43,14,12,11,1,90,38.24842325147679,-109.3799021
43715,13,42,13,12,10,1,91,38.24842325147679,-109.3796326
43716,15,40,13,11,10,1,90,38.24842325147679,-109.3793631
43717,18,39,13,10,10,1,91,38.24842325147679,-109.3790936
43718,20,37,13,10,10,1,91,38.24842325147679,-109.3788241
43719,20,38,12,10,10,1,91,38.24842325147679,-109.3785546
43720,25,37,13,10,8,1,94,38.24842325147679,-109.3782851
43721,26,34,13,10,8,1,92,38.24842325147679,-109.3780156
43722,33,27,13,12,7,1,93,38.24842325147679,-109.3777461
43723,38,22,13,13,5,1,92,38.24842325147679,-109.3774766
43724,39,17,12,15,5,1,89,38.24842325147679,-109.3772071
43725,39,16,11,14,5,1,86,38.24842325147679,-109.3769376
43726,38,16,11,14,5,1,85,38.24842325147679,-109.3766681
43727,40,17,11,13,5,1,87,38.24842325147679,-109.3763986
43728,40,20,12,13,4,0,89,38.24842325147679,-109.3761291
43729,39,21,12,14,5,1,92,38.24842325147679,-109.3758596
43730,36,24,13,14,5,1,93,38.24842325147679,-109.3755901
43731,29,28,14,14,6,1,92,38.24842325147679,-109.3753206
43732,15,27,14,14,2,5,77,38.24842325147679,-109.3750512
43733,15,30,14,14,3,6,82,38.24842325147679,-109.3747817
43734,15,32,15,13,2,8,85,38.24842325147679,-109.3745122
43735,6,26,14,6,3,16,71,38.24842325147679,-109.3742427
43736,6,26,15,8,4,17,76,38.24842325147679,-109.3739732
43737,13,26,14,19,8,5,85,38.24842325147679,-109.3737037
43738,8,28,14,11,11,10,82,38.24842325147679,-109.3734342
43739,13,24,15,18,14,4,88,38.24842325147679,-109.3731647
43740,10,24,15,20,15,3,87,38.24842325147679,-109.3728952
43741,7,22,15,19,19,4,86,38.24842325147679,-109.3726257
43742,3,22,14,16,26,3,84,38.24842325147679,-109.3723562
43743,0,18,14,21,22,4,79,38.24842325147679,-109.3720867
43744,6,18,11,23,21,2,81,38.24842325147679,-109.3718172
43745,6,16,10,26,19,1,78,38.24842325147679,-109.3715477
43746,2,18,12,23,13,3,71,38.24842325147679,-109.3712782
43747,1,19,11,13,14,7,65,38.24842325147679,-109.3710087
43748,5,24,15,9,10,13,76,38.24842325147679,-109.3707392
43749,3,27,16,8,7,16,77,38.24842325147679,-109.3704697
43750,4,28,17,4,5,21,79,38.24842325147679,-109.3702003
43751,1,22,15,0,3,26,67,38.24842325147679,-109.3699308
43752,2,24,14,0,2,24,66,38.24842325147679,-109.3696613
43753,2,23,12,0,3,19,59,38.24842325147679,-109.3693918
43754,2,25,11,0,5,16,59,38.24842325147679,-109.3691223
43755,2,28,11,0,6,15,62,38.24842325147679,-109.3688528
43756,2,30,11,0,7,14,64,38.24842325147679,-109.3685833
43757,2,30,11,0,7,13,63,38.24842325147679,-109.3683138
43758,2,26,12,0,6,16,62,38.24842325147679,-109.3680443
43759,2,24,13,0,5,17,61,38.24842325147679,-109.3677748
43760,2,25,13,0,5,19,64,38.24842325147679,-109.3675053
43761,2,24,13,0,4,19,62,38.24842325147679,-109.3672358
43762,2,26,12,0,5,17,62,38.24842325147679,-109.3669663
43763,2,25,13,0,5,17,62,38.24842325147679,-109.3666968
43764,2,24,13,0,4,20,63,38.24842325147679,-109.3664273
43765,2,23,13,0,2,23,63,38.24842325147679,-109.3661578
43766,1,20,13,0,2,23,59,38.24842325147679,-109.3658883
43767,1,25,11,0,4,19,60,38.24842325147679,-109.3656188
43768,1,28,11,0,5,18,63,38.24842325147679,-109.3653493
43769,1,25,12,0,3,20,61,38.24842325147679,-109.3650799
43770,0,21,14,0,1,26,62,38.24842325147679,-109.3648104
43771,0,19,15,0,1,28,63,38.24842325147679,-109.3645409
43772,0,21,13,0,1,25,60,38.24842325147679,-109.3642714
43773,0,24,12,0,2,21,59,38.24842325147679,-109.3640019
43774,1,26,12,0,4,19,62,38.24842325147679,-109.3637324
43775,1,25,12,0,3,21,62,38.24842325147679,-109.3634629
43776,0,24,12,0,3,22,61,38.24842325147679,-109.3631934
43777,0,23,13,0,2,24,62,38.24842325147679,-109.3629239
43778,0,23,13,0,1,25,62,38.24842325147679,-109.3626544
43779,0,25,13,1,2,23,64,38.24842325147679,-109.3623849
43780,0,28,12,0,4,21,65,38.24842325147679,-109.3621154
43781,0,31,12,0,5,19,67,38.24842325147679,-109.3618459
43782,0,29,12,0,6,19,66,38.24842325147679,-109.3615764
43783,0,28,12,1,6,19,66,38.24842325147679,-109.3613069
43784,1,29,12,1,5,19,67,38.24842325147679,-109.3610374
43785,0,27,13,0,3,22,65,38.24842325147679,-109.3607679
43786,0,26,13,0,4,22,65,38.24842325147679,-109.3604984
43787,1,21,14,0,3,23,62,38.24842325147679,-109.360229
43788,0,22,13,0,2,21,58,38.24842325147679,-109.3599595
43789,1,33,9,0,6,10,59,38.24842325147679,-109.35969
43790,2,24,8,3,7,6,50,38.24842325147679,-109.3594205
43791,3,24,11,6,9,8,61,38.24842325147679,-109.359151
43792,2,20,15,4,5,22,68,38.24842325147679,-109.3588815
43793,1,16,20,0,1,36,74,38.24842325147679,-109.358612
43794,3,23,20,1,2,32,81,38.24842325147679,-109.3583425
43795,2,23,19,0,1,31,76,38.24842325147679,-109.358073
43796,1,21,17,0,2,28,69,38.24842325147679,-109.3578035
43797,1,22,14,0,3,24,64,38.24842325147679,-109.357534
43798,1,23,13,1,3,23,64,38.24842325147679,-109.3572645
43799,1,29,12,1,4,20,67,38.24842325147679,-109.356995
43800,1,33,10,1,6,16,67,38.24842325147679,-109.3567255
43801,0,38,10,1,10,11,70,38.24842325147679,-109.356456
43802,0,41,9,0,11,10,71,38.24842325147679,-109.3561865
43803,0,40,9,1,13,7,70,38.24842325147679,-109.355917
43804,1,43,9,2,13,6,74,38.24842325147679,-109.3556475
43805,1,39,9,2,12,8,71,38.24842325147679,-109.355378
43806,1,41,10,1,13,8,74,38.24842325147679,-109.3551086
43807,0,39,10,1,13,8,71,38.24842325147679,-109.3548391
43808,1,34,9,2,7,7,60,38.24842325147679,-109.3545696
43809,1,25,9,5,6,7,53,38.24842325147679,-109.3543001
43810,0,26,9,4,6,7,52,38.24842325147679,-109.3540306
43811,1,24,10,6,8,7,56,38.24842325147679,-109.3537611
43812,3,26,12,7,11,7,66,38.24842325147679,-109.3534916
43813,4,25,9,8,11,5,62,38.24842325147679,-109.3532221
43814,3,28,9,6,7,6,59,38.24842325147679,-109.3529526
43815,4,36,9,3,9,5,66,38.24842325147679,-109.3526831
43816,4,34,9,2,8,6,63,38.24842325147679,-109.3524136
43817,2,31,9,4,7,7,60,38.24842325147679,-109.3521441
43818,3,33,7,5,8,3,59,38.24842325147679,-109.3518746
43819,6,41,6,5,7,4,69,38.24842325147679,-109.3516051
43820,5,29,8,8,9,6,65,38.24842325147679,-109.3513356
43821,4,23,14,13,11,9,74,38.24842325147679,-109.3510661
43822,10,17,15,11,11,15,79,38.24842325147679,-109.3507966
43823,2,17,12,7,8,15,61,38.24842325147679,-109.3505271
43824,1,22,10,5,7,11,56,38.24842325147679,-109.3502577
43825,1,23,10,4,7,11,56,38.24842325147679,-109.3499882
43826,2,26,11,3,9,11,62,38.24842325147679,-109.3497187
43827,3,24,12,4,8,15,66,38.24842325147679,-109.3494492
43828,2,31,10,2,7,10,62,38.24842325147679,-109.3491797
43829,6,37,5,3,6,4,61,38.24842325147679,-109.3489102
43830,1,32,5,2,8,3,51,38.24842325147679,-109.3486407
43831,1,30,6,2,7,4,50,38.24842325147679,-109.3483712
43832,1,19,9,6,9,7,51,38.24842325147679,-109.3481017
43833,2,19,14,7,7,17,66,38.24842325147679,-109.3478322
43834,2,16,14,7,7,21,67,38.24842325147679,-109.3475627
43835,2,19,13,7,7,15,63,38.24842325147679,-109.3472932
43836,2,27,10,7,11,6,63,38.24842325147679,-109.3470237
43837,3,28,10,7,12,6,66,38.24842325147679,-109.3467542
43838,1,26,10,6,9,8,60,38.24842325147679,-109.3464847
43839,3,32,9,8,4,7,63,38.24842325147679,-109.3462152
43840,6,41,5,5,6,2,65,38.24842325147679,-109.3459457
43841,5,44,7,5,9,2,72,38.24842325147679,-109.3456762
43842,6,30,8,8,7,5,64,38.24842325147679,-109.3454068
43843,1,22,11,5,6,12,57,38.24842325147679,-109.3451373
43844,2,28,10,4,6,12,62,38.24842325147679,-109.3448678
43845,2,26,10,6,8,7,59,38.24842325147679,-109.3445983
43846,2,31,9,9,10,5,66,38.24842325147679,-109.3443288
43847,3,30,11,12,12,5,73,38.24842325147679,-109.3440593
43848,3,27,12,14,14,4,74,38.24842325147679,-109.3437898
43849,4,26,12,16,15,3,76,38.24842325147679,-109.3435203
43850,8,27,11,20,15,1,82,38.24842325147679,-109.3432508
43851,7,21,11,23,16,1,79,38.24842325147679,-109.3429813
43852,4,22,14,22,23,5,90,38.24842325147679,-109.3427118
43853,2,16,15,24,23,11,91,38.24842325147679,-109.3424423
43854,2,18,14,17,19,11,81,38.24842325147679,-109.3421728
43855,4,16,13,16,23,6,78,38.24842325147679,-109.3419033
43856,5,18,12,20,23,1,79,38.24842325147679,-109.3416338
43857,5,23,12,23,17,2,82,38.24842325147679,-109.3413643
43858,5,22,11,27,16,0,81,38.24842325147679,-109.3410948
43859,6,21,10,25,16,1,79,38.24842325147679,-109.3408253
43860,3,18,9,31,21,2,84,38.24842325147679,-109.3405558
43861,2,14,13,27,26,3,85,38.24842325147679,-109.3402864
43862,1,16,12,21,28,3,81,38.24842325147679,-109.3400169
43863,6,20,11,20,15,7,79,38.24842325147679,-109.3397474
43864,10,24,12,18,15,2,81,38.24842325147679,-109.3394779
43865,3,29,14,10,17,8,81,38.24842325147679,-109.3392084
43866,0,30,11,10,18,6,75,38.24842325147679,-109.3389389
43867,1,28,10,14,16,3,72,38.24842325147679,-109.3386694
43868,2,28,10,13,15,3,71,38.24842325147679,-109.3383999
43869,2,26,10,15,16,3,72,38.24842325147679,-109.3381304
43870,1,23,12,12,16,8,72,38.24842325147679,-109.3378609
43871,0,21,13,13,14,11,72,38.24842325147679,-109.3375914
43872,0,22,12,13,16,8,71,38.24842325147679,-109.3373219
43873,0,25,11,9,15,8,68,38.24842325147679,-109.3370524
43874,0,28,11,4,13,11,67,38.24842325147679,-109.3367829
43875,0,26,11,5,10,14,66,38.24842325147679,-109.3365134
43876,0,24,11,5,6,16,62,38.24842325147679,-109.3362439
43877,0,25,10,4,6,14,59,38.24842325147679,-109.3359744
43878,0,26,10,3,9,12,60,38.24842325147679,-109.3357049
43879,0,26,11,0,7,18,62,38.24842325147679,-109.3354355
43880,0,26,10,0,5,19,60,38.24842325147679,-109.335166
43881,0,25,10,0,6,16,57,38.24842325147679,-109.3348965
43882,0,29,9,3,11,6,58,38.24842325147679,-109.334627
43883,1,41,6,5,9,2,64,38.24842325147679,-109.3343575
43884,2,58,7,5,11,1,84,38.24842325147679,-109.334088
43885,1,49,7,3,10,2,72,38.24842325147679,-109.3338185
43886,2,33,7,3,10,5,60,38.24842325147679,-109.333549
43887,4,24,10,5,8,9,60,38.24842325147679,-109.3332795
43888,9,29,10,2,7,9,66,38.24842325147679,-109.33301
43889,2,19,10,3,5,14,53,38.24842325147679,-109.3327405
43890,1,23,9,3,6,11,53,38.24842325147679,-109.332471
43891,2,27,8,3,9,8,57,38.24842325147679,-109.3322015
43892,1,30,8,3,9,7,58,38.24842325147679,-109.331932
43893,3,36,7,4,10,4,64,38.24842325147679,-109.3316625
43894,3,30,8,5,11,5,62,38.24842325147679,-109.331393
43895,7,45,11,9,15,1,88,38.248153756891554,-109.4402688
43896,11,42,12,12,14,0,91,38.248153756891554,-109.4399993
43897,10,41,13,12,15,1,92,38.248153756891554,-109.4397299
43898,8,42,12,11,14,1,88,38.248153756891554,-109.4394604
43899,8,42,12,11,14,1,88,38.248153756891554,-109.4391909
43900,11,39,13,12,14,0,89,38.248153756891554,-109.4389214
43901,12,38,13,12,14,0,89,38.248153756891554,-109.4386519
43902,14,36,13,13,14,0,90,38.248153756891554,-109.4383824
43903,13,37,13,13,14,1,91,38.248153756891554,-109.4381129
43904,8,42,13,11,13,1,88,38.248153756891554,-109.4378434
43905,6,43,11,8,12,4,84,38.248153756891554,-109.4375739
43906,3,44,9,6,12,4,78,38.248153756891554,-109.4373044
43907,3,42,9,6,11,3,74,38.248153756891554,-109.4370349
43908,4,42,9,7,11,2,75,38.248153756891554,-109.4367654
43909,3,43,9,6,11,3,75,38.248153756891554,-109.4364959
43910,3,47,9,8,11,2,80,38.248153756891554,-109.4362264
43911,3,50,10,8,12,2,85,38.248153756891554,-109.4359569
43912,4,51,11,8,13,2,89,38.248153756891554,-109.4356874
43913,4,50,11,8,14,1,88,38.248153756891554,-109.4354179
43914,4,45,12,8,15,2,86,38.248153756891554,-109.4351484
43915,3,44,11,6,14,4,82,38.248153756891554,-109.434879
43916,3,40,10,6,12,4,75,38.248153756891554,-109.4346095
43917,3,35,9,4,10,6,67,38.248153756891554,-109.43434
43918,4,33,9,3,10,6,65,38.248153756891554,-109.4340705
43919,1,36,10,2,10,9,68,38.248153756891554,-109.433801
43920,2,32,10,3,11,9,67,38.248153756891554,-109.4335315
43921,2,32,10,2,11,11,68,38.248153756891554,-109.433262
43922,2,36,10,0,11,12,71,38.248153756891554,-109.4329925
43923,2,42,11,0,13,12,80,38.248153756891554,-109.432723
43924,2,43,11,2,15,8,81,38.248153756891554,-109.4324535
43925,4,40,11,3,15,7,80,38.248153756891554,-109.432184
43926,6,39,12,5,14,6,82,38.248153756891554,-109.4319145
43927,8,38,12,8,13,4,83,38.248153756891554,-109.431645
43928,8,39,12,8,13,4,84,38.248153756891554,-109.4313755
43929,9,39,12,10,14,3,87,38.248153756891554,-109.431106
43930,7,41,12,10,13,2,85,38.248153756891554,-109.4308365
43931,5,44,11,9,13,2,84,38.248153756891554,-109.430567
43932,4,43,10,8,13,3,81,38.248153756891554,-109.4302975
43933,6,42,11,11,13,1,84,38.248153756891554,-109.430028
43934,9,39,13,14,13,1,89,38.248153756891554,-109.4297586
43935,11,37,14,14,13,1,90,38.248153756891554,-109.4294891
43936,13,35,14,14,13,1,90,38.248153756891554,-109.4292196
43937,15,32,14,14,13,1,89,38.248153756891554,-109.4289501
43938,14,36,14,13,13,1,91,38.248153756891554,-109.4286806
43939,10,39,13,13,13,1,89,38.248153756891554,-109.4284111
43940,6,41,12,13,13,1,86,38.248153756891554,-109.4281416
43941,5,43,11,13,13,1,86,38.248153756891554,-109.4278721
43942,5,44,11,11,14,1,86,38.248153756891554,-109.4276026
43943,5,42,12,12,13,1,85,38.248153756891554,-109.4273331
43944,7,40,13,13,13,1,87,38.248153756891554,-109.4270636
43945,7,42,13,13,14,1,90,38.248153756891554,-109.4267941
43946,7,45,13,12,14,1,92,38.248153756891554,-109.4265246
43947,8,45,13,12,15,0,93,38.248153756891554,-109.4262551
43948,10,42,13,13,14,0,92,38.248153756891554,-109.4259856
43949,11,40,13,14,14,0,92,38.248153756891554,-109.4257161
43950,12,40,13,13,14,0,92,38.248153756891554,-109.4254466
43951,12,40,14,14,14,0,94,38.248153756891554,-109.4251771
43952,14,38,14,13,15,0,94,38.248153756891554,-109.4249077
43953,17,34,14,12,14,0,91,38.248153756891554,-109.4246382
43954,19,34,14,12,13,0,92,38.248153756891554,-109.4243687
43955,16,35,14,13,13,0,91,38.248153756891554,-109.4240992
43956,14,36,14,14,14,0,92,38.248153756891554,-109.4238297
43957,15,35,14,15,13,0,92,38.248153756891554,-109.4235602
43958,11,37,14,15,14,0,91,38.248153756891554,-109.4232907
43959,11,36,14,15,13,0,89,38.248153756891554,-109.4230212
43960,15,32,14,16,12,1,90,38.248153756891554,-109.4227517
43961,14,32,15,15,11,1,88,38.248153756891554,-109.4224822
43962,9,39,11,9,14,1,83,38.248153756891554,-109.4222127
43963,8,40,12,10,14,1,85,38.248153756891554,-109.4219432
43964,8,42,13,12,14,1,90,38.248153756891554,-109.4216737
43965,7,42,13,12,13,1,88,38.248153756891554,-109.4214042
43966,8,41,14,14,14,1,92,38.248153756891554,-109.4211347
43967,7,41,14,14,14,1,91,38.248153756891554,-109.4208652
43968,6,42,13,13,14,1,89,38.248153756891554,-109.4205957
43969,5,43,13,13,14,1,89,38.248153756891554,-109.4203262
43970,6,45,13,13,13,1,91,38.248153756891554,-109.4200568
43971,6,45,13,13,14,1,92,38.248153756891554,-109.4197873
43972,7,42,13,14,14,1,91,38.248153756891554,-109.4195178
43973,9,40,13,14,14,1,91,38.248153756891554,-109.4192483
43974,7,41,12,9,14,1,84,38.248153756891554,-109.4189788
43975,2,37,10,5,12,4,70,38.248153756891554,-109.4187093
43976,2,37,8,3,10,5,65,38.248153756891554,-109.4184398
43977,2,37,8,3,10,4,64,38.248153756891554,-109.4181703
43978,2,35,8,3,10,5,63,38.248153756891554,-109.4179008
43979,3,41,8,3,9,5,69,38.248153756891554,-109.4176313
43980,1,45,10,0,13,8,77,38.248153756891554,-109.4173618
43981,1,45,11,0,12,13,82,38.248153756891554,-109.4170923
43982,1,41,11,0,10,16,79,38.248153756891554,-109.4168228
43983,2,38,11,0,10,15,76,38.248153756891554,-109.4165533
43984,2,44,11,0,13,12,82,38.248153756891554,-109.4162838
43985,2,39,10,1,12,8,72,38.248153756891554,-109.4160143
43986,2,36,9,2,10,5,64,38.248153756891554,-109.4157448
43987,2,37,8,2,9,4,62,38.248153756891554,-109.4154753
43988,2,35,8,1,9,5,60,38.248153756891554,-109.4152058
43989,2,37,8,2,9,4,62,38.248153756891554,-109.4149364
43990,2,34,8,1,8,5,58,38.248153756891554,-109.4146669
43991,2,31,9,3,10,5,60,38.248153756891554,-109.4143974
43992,2,30,10,5,10,6,63,38.248153756891554,-109.4141279
43993,3,34,11,6,8,8,70,38.248153756891554,-109.4138584
43994,5,36,11,5,9,6,72,38.248153756891554,-109.4135889
43995,3,37,9,3,10,4,66,38.248153756891554,-109.4133194
43996,3,44,9,5,12,2,75,38.248153756891554,-109.4130499
43997,5,42,12,11,14,1,85,38.248153756891554,-109.4127804
43998,1,26,13,22,21,3,86,38.248153756891554,-109.4125109
43999,0,22,13,22,20,7,84,38.248153756891554,-109.4122414
44000,1,23,13,22,18,6,83,38.248153756891554,-109.4119719
44001,3,29,12,12,20,5,81,38.248153756891554,-109.4117024
44002,3,33,11,8,21,5,81,38.248153756891554,-109.4114329
44003,3,36,11,4,16,7,77,38.248153756891554,-109.4111634
44004,1,32,12,3,18,11,77,38.248153756891554,-109.4108939
44005,0,29,13,4,16,14,76,38.248153756891554,-109.4106244
44006,0,30,13,5,17,13,78,38.248153756891554,-109.4103549
44007,0,30,12,3,15,13,73,38.248153756891554,-109.4100855
44008,1,35,11,1,15,10,73,38.248153756891554,-109.409816
44009,0,32,11,0,12,13,68,38.248153756891554,-109.4095465
44010,0,30,11,0,11,14,66,38.248153756891554,-109.409277
44011,0,31,10,0,10,16,67,38.248153756891554,-109.4090075
44012,0,29,11,0,10,18,68,38.248153756891554,-109.408738
44013,2,34,12,4,15,9,76,38.248153756891554,-109.4084685
44014,6,35,12,6,15,6,80,38.248153756891554,-109.408199
44015,9,35,13,10,16,3,86,38.248153756891554,-109.4079295
44016,14,34,13,13,16,0,90,38.248153756891554,-109.40766
44017,16,32,14,16,14,0,92,38.248153756891554,-109.4073905
44018,18,32,14,15,13,0,92,38.248153756891554,-109.407121
44019,17,32,14,15,13,0,91,38.248153756891554,-109.4068515
44020,15,33,15,16,13,0,92,38.248153756891554,-109.406582
44021,15,34,15,16,13,0,93,38.248153756891554,-109.4063125
44022,14,35,14,16,13,0,92,38.248153756891554,-109.406043
44023,14,36,14,15,14,0,93,38.248153756891554,-109.4057735
44024,14,35,14,16,14,0,93,38.248153756891554,-109.405504
44025,16,34,15,17,13,0,95,38.248153756891554,-109.4052345
44026,13,35,15,18,13,0,94,38.248153756891554,-109.4049651
44027,14,34,15,17,13,0,93,38.248153756891554,-109.4046956
44028,15,32,15,17,13,0,92,38.248153756891554,-109.4044261
44029,16,31,15,17,13,0,92,38.248153756891554,-109.4041566
44030,16,31,15,17,13,0,92,38.248153756891554,-109.4038871
44031,11,35,15,17,14,0,92,38.248153756891554,-109.4036176
44032,10,37,15,15,15,1,93,38.248153756891554,-109.4033481
44033,8,39,14,13,14,1,89,38.248153756891554,-109.4030786
44034,9,38,14,14,14,1,90,38.248153756891554,-109.4028091
44035,10,38,14,14,14,1,91,38.248153756891554,-109.4025396
44036,13,36,14,15,14,1,93,38.248153756891554,-109.4022701
44037,13,36,15,15,14,1,94,38.248153756891554,-109.4020006
44038,14,36,15,15,14,1,95,38.248153756891554,-109.4017311
44039,14,36,15,15,13,1,94,38.248153756891554,-109.4014616
44040,14,36,15,14,13,1,93,38.248153756891554,-109.4011921
44041,15,35,15,14,13,1,93,38.248153756891554,-109.4009226
44042,13,37,14,13,13,1,91,38.248153756891554,-109.4006531
44043,13,38,14,13,13,1,92,38.248153756891554,-109.4003836
44044,16,34,15,14,13,0,92,38.248153756891554,-109.4001142
44045,16,34,15,13,13,0,91,38.248153756891554,-109.3998447
44046,14,35,15,14,13,1,92,38.248153756891554,-109.3995752
44047,14,36,15,14,13,0,92,38.248153756891554,-109.3993057
44048,12,38,15,13,13,1,92,38.248153756891554,-109.3990362
44049,9,41,14,12,14,1,91,38.248153756891554,-109.3987667
44050,8,41,13,12,13,1,88,38.248153756891554,-109.3984972
44051,9,38,13,13,13,1,87,38.248153756891554,-109.3982277
44052,8,38,14,12,13,1,86,38.248153756891554,-109.3979582
44053,7,39,14,12,13,1,86,38.248153756891554,-109.3976887
44054,8,37,14,13,13,1,86,38.248153756891554,-109.3974192
44055,9,37,14,13,13,1,87,38.248153756891554,-109.3971497
44056,10,37,14,13,13,1,88,38.248153756891554,-109.3968802
44057,9,36,14,13,13,1,86,38.248153756891554,-109.3966107
44058,10,36,14,13,13,1,87,38.248153756891554,-109.3963412
44059,10,38,14,13,14,1,90,38.248153756891554,-109.3960717
44060,9,39,14,12,14,1,89,38.248153756891554,-109.3958022
44061,7,40,14,11,13,2,87,38.248153756891554,-109.3955327
44062,5,41,13,10,13,3,85,38.248153756891554,-109.3952632
44063,4,43,13,10,12,3,85,38.248153756891554,-109.3949938
44064,4,44,13,10,13,3,87,38.248153756891554,-109.3947243
44065,4,44,13,10,13,2,86,38.248153756891554,-109.3944548
44066,4,43,12,10,12,3,84,38.248153756891554,-109.3941853
44067,4,43,12,10,11,3,83,38.248153756891554,-109.3939158
44068,5,43,13,10,13,2,86,38.248153756891554,-109.3936463
44069,7,45,14,11,14,1,92,38.248153756891554,-109.3933768
44070,7,44,14,11,15,1,92,38.248153756891554,-109.3931073
44071,9,43,14,12,15,0,93,38.248153756891554,-109.3928378
44072,13,42,14,12,13,0,94,38.248153756891554,-109.3925683
44073,12,44,13,11,12,0,92,38.248153756891554,-109.3922988
44074,12,44,13,10,13,0,92,38.248153756891554,-109.3920293
44075,12,42,14,12,14,0,94,38.248153756891554,-109.3917598
44076,12,41,14,13,14,0,94,38.248153756891554,-109.3914903
44077,11,42,14,13,14,0,94,38.248153756891554,-109.3912208
44078,11,43,14,12,15,0,95,38.248153756891554,-109.3909513
44079,11,43,14,12,14,0,94,38.248153756891554,-109.3906818
44080,11,42,14,12,13,0,92,38.248153756891554,-109.3904123
44081,11,41,13,12,14,0,91,38.248153756891554,-109.3901429
44082,11,40,13,12,14,1,91,38.248153756891554,-109.3898734
44083,12,40,13,12,14,0,91,38.248153756891554,-109.3896039
44084,12,38,13,12,14,0,89,38.248153756891554,-109.3893344
44085,15,37,13,12,14,0,91,38.248153756891554,-109.3890649
44086,19,35,13,11,13,0,91,38.248153756891554,-109.3887954
44087,20,34,13,11,12,0,90,38.248153756891554,-109.3885259
44088,19,34,13,12,12,0,90,38.248153756891554,-109.3882564
44089,18,34,13,12,12,0,89,38.248153756891554,-109.3879869
44090,18,34,14,13,12,0,91,38.248153756891554,-109.3877174
44091,19,34,13,13,11,0,90,38.248153756891554,-109.3874479
44092,19,32,12,12,12,0,87,38.248153756891554,-109.3871784
44093,12,37,13,12,14,0,88,38.248153756891554,-109.3869089
44094,9,40,13,11,16,0,89,38.248153756891554,-109.3866394
44095,8,41,13,9,15,1,87,38.248153756891554,-109.3863699
44096,11,42,13,9,14,0,89,38.248153756891554,-109.3861004
44097,13,40,13,10,14,0,90,38.248153756891554,-109.3858309
44098,11,39,14,11,15,0,90,38.248153756891554,-109.3855614
44099,11,37,14,13,15,0,90,38.248153756891554,-109.3852919
44100,11,36,14,13,15,0,89,38.248153756891554,-109.3850225
44101,11,35,14,12,15,1,88,38.248153756891554,-109.384753
44102,12,35,14,13,15,1,90,38.248153756891554,-109.3844835
44103,14,37,14,13,14,0,92,38.248153756891554,-109.384214
44104,13,38,13,13,14,0,91,38.248153756891554,-109.3839445
44105,11,37,13,11,15,0,87,38.248153756891554,-109.383675
44106,11,38,11,8,15,1,84,38.248153756891554,-109.3834055
44107,12,37,12,8,14,2,85,38.248153756891554,-109.383136
44108,12,31,11,8,11,3,76,38.248153756891554,-109.3828665
44109,11,28,10,9,10,2,70,38.248153756891554,-109.382597
44110,14,29,10,8,10,2,73,38.248153756891554,-109.3823275
44111,19,35,11,8,13,1,87,38.248153756891554,-109.382058
44112,19,37,12,9,12,1,90,38.248153756891554,-109.3817885
44113,17,38,13,9,12,1,90,38.248153756891554,-109.381519
44114,16,38,13,10,12,1,90,38.248153756891554,-109.3812495
44115,16,38,13,10,12,1,90,38.248153756891554,-109.38098
44116,15,38,13,11,12,1,90,38.248153756891554,-109.3807105
44117,15,38,13,12,12,1,91,38.248153756891554,-109.380441
44118,16,40,13,12,12,0,93,38.248153756891554,-109.3801716
44119,15,41,14,12,11,0,93,38.248153756891554,-109.3799021
44120,14,39,13,14,11,1,92,38.248153756891554,-109.3796326
44121,18,37,12,11,11,1,90,38.248153756891554,-109.3793631
44122,19,37,12,9,11,1,89,38.248153756891554,-109.3790936
44123,18,38,12,9,12,0,89,38.248153756891554,-109.3788241
44124,20,36,13,11,12,0,92,38.248153756891554,-109.3785546
44125,25,33,12,11,10,0,91,38.248153756891554,-109.3782851
44126,32,29,12,12,7,0,92,38.248153756891554,-109.3780156
44127,33,26,14,14,6,1,94,38.248153756891554,-109.3777461
44128,35,22,15,14,5,1,92,38.248153756891554,-109.3774766
44129,36,20,14,17,5,1,93,38.248153756891554,-109.3772071
44130,40,19,13,15,5,1,93,38.248153756891554,-109.3769376
44131,38,22,13,14,5,1,93,38.248153756891554,-109.3766681
44132,35,25,13,13,5,1,92,38.248153756891554,-109.3763986
44133,33,27,14,13,4,1,92,38.248153756891554,-109.3761291
44134,32,28,14,14,5,1,94,38.248153756891554,-109.3758596
44135,26,30,14,15,5,2,92,38.248153756891554,-109.3755901
44136,22,29,14,15,6,3,89,38.248153756891554,-109.3753206
44137,20,28,15,17,6,3,89,38.248153756891554,-109.3750512
44138,21,27,15,15,6,5,89,38.248153756891554,-109.3747817
44139,21,26,17,16,5,6,91,38.248153756891554,-109.3745122
44140,13,28,17,15,7,7,87,38.248153756891554,-109.3742427
44141,13,26,17,16,10,6,88,38.248153756891554,-109.3739732
44142,15,23,16,15,14,5,88,38.248153756891554,-109.3737037
44143,6,26,16,12,16,12,88,38.248153756891554,-109.3734342
44144,2,23,16,14,16,12,83,38.248153756891554,-109.3731647
44145,1,21,14,16,20,9,81,38.248153756891554,-109.3728952
44146,5,16,13,20,23,2,79,38.248153756891554,-109.3726257
44147,2,16,10,26,18,1,73,38.248153756891554,-109.3723562
44148,2,20,11,23,13,3,72,38.248153756891554,-109.3720867
44149,4,26,12,14,15,3,74,38.248153756891554,-109.3718172
44150,6,28,14,9,13,6,76,38.248153756891554,-109.3715477
44151,3,25,15,4,6,21,74,38.248153756891554,-109.3712782
44152,2,26,15,0,6,27,76,38.248153756891554,-109.3710087
44153,0,24,13,0,5,23,65,38.248153756891554,-109.3707392
44154,1,23,15,0,3,25,67,38.248153756891554,-109.3704697
44155,2,23,15,0,2,24,66,38.248153756891554,-109.3702003
44156,2,23,13,0,3,22,63,38.248153756891554,-109.3699308
44157,4,28,13,0,6,15,66,38.248153756891554,-109.3696613
44158,2,25,11,1,4,15,58,38.248153756891554,-109.3693918
44159,3,26,11,1,6,13,60,38.248153756891554,-109.3691223
44160,2,28,11,0,7,13,61,38.248153756891554,-109.3688528
44161,2,28,11,0,5,15,61,38.248153756891554,-109.3685833
44162,2,23,12,0,3,19,59,38.248153756891554,-109.3683138
44163,2,23,13,0,3,20,61,38.248153756891554,-109.3680443
44164,2,23,12,0,2,19,58,38.248153756891554,-109.3677748
44165,1,24,11,0,3,18,57,38.248153756891554,-109.3675053
44166,2,27,11,0,5,17,62,38.248153756891554,-109.3672358
44167,1,27,11,0,5,17,61,38.248153756891554,-109.3669663
44168,1,25,12,0,3,20,61,38.248153756891554,-109.3666968
44169,1,23,13,0,2,22,61,38.248153756891554,-109.3664273
44170,1,22,13,0,1,22,59,38.248153756891554,-109.3661578
44171,2,21,13,0,1,22,59,38.248153756891554,-109.3658883
44172,1,25,11,0,3,20,60,38.248153756891554,-109.3656188
44173,1,27,11,0,3,20,62,38.248153756891554,-109.3653493
44174,1,26,13,0,2,23,65,38.248153756891554,-109.3650799
44175,0,24,14,0,1,27,66,38.248153756891554,-109.3648104
44176,0,22,12,0,1,24,59,38.248153756891554,-109.3645409
44177,1,25,11,0,3,19,59,38.248153756891554,-109.3642714
44178,1,26,12,0,3,20,62,38.248153756891554,-109.3640019
44179,0,25,12,0,2,22,61,38.248153756891554,-109.3637324
44180,1,24,14,1,3,24,67,38.248153756891554,-109.3634629
44181,1,22,16,1,2,29,71,38.248153756891554,-109.3631934
44182,1,21,17,1,1,31,72,38.248153756891554,-109.3629239
44183,0,21,16,1,0,30,68,38.248153756891554,-109.3626544
44184,0,24,13,1,1,24,63,38.248153756891554,-109.3623849
44185,1,30,12,1,5,19,68,38.248153756891554,-109.3621154
44186,0,27,12,1,4,18,62,38.248153756891554,-109.3618459
44187,0,22,13,1,2,22,60,38.248153756891554,-109.3615764
44188,0,20,14,0,1,25,60,38.248153756891554,-109.3613069
44189,0,23,13,0,2,23,61,38.248153756891554,-109.3610374
44190,1,28,13,2,4,21,69,38.248153756891554,-109.3607679
44191,1,27,12,0,4,21,65,38.248153756891554,-109.3604984
44192,1,23,13,0,2,22,61,38.248153756891554,-109.360229
44193,0,21,13,0,1,23,58,38.248153756891554,-109.3599595
44194,1,25,10,2,3,14,55,38.248153756891554,-109.35969
44195,1,24,8,4,6,8,51,38.248153756891554,-109.3594205
44196,6,24,11,6,9,7,63,38.248153756891554,-109.359151
44197,5,19,15,5,6,16,66,38.248153756891554,-109.3588815
44198,3,21,17,3,3,26,73,38.248153756891554,-109.358612
44199,2,25,16,0,3,24,70,38.248153756891554,-109.3583425
44200,2,23,16,1,2,25,69,38.248153756891554,-109.358073
44201,2,24,15,1,3,23,68,38.248153756891554,-109.3578035
44202,2,26,14,0,3,22,67,38.248153756891554,-109.357534
44203,1,23,14,0,3,23,64,38.248153756891554,-109.3572645
44204,0,24,13,0,2,23,62,38.248153756891554,-109.356995
44205,1,30,11,2,5,17,66,38.248153756891554,-109.3567255
44206,0,36,9,0,10,10,65,38.248153756891554,-109.356456
44207,0,40,8,1,10,6,65,38.248153756891554,-109.3561865
44208,1,41,8,3,11,4,68,38.248153756891554,-109.355917
44209,0,41,9,2,15,5,72,38.248153756891554,-109.3556475
44210,0,41,9,1,14,7,72,38.248153756891554,-109.355378
44211,0,40,9,1,13,8,71,38.248153756891554,-109.3551086
44212,1,37,8,2,11,6,65,38.248153756891554,-109.3548391
44213,1,30,8,3,9,5,56,38.248153756891554,-109.3545696
44214,2,30,8,3,6,5,54,38.248153756891554,-109.3543001
44215,1,33,7,4,8,4,57,38.248153756891554,-109.3540306
44216,0,29,9,5,8,5,56,38.248153756891554,-109.3537611
44217,4,25,12,6,11,7,65,38.248153756891554,-109.3534916
44218,2,23,9,6,9,9,58,38.248153756891554,-109.3532221
44219,2,26,8,5,8,8,57,38.248153756891554,-109.3529526
44220,5,34,10,3,10,5,67,38.248153756891554,-109.3526831
44221,5,34,11,2,10,6,68,38.248153756891554,-109.3524136
44222,2,29,9,3,7,8,58,38.248153756891554,-109.3521441
44223,2,34,6,5,8,3,58,38.248153756891554,-109.3518746
44224,5,36,7,6,8,4,66,38.248153756891554,-109.3516051
44225,7,24,10,15,10,5,71,38.248153756891554,-109.3513356
44226,9,25,16,13,17,8,88,38.248153756891554,-109.3510661
44227,3,18,16,6,15,21,79,38.248153756891554,-109.3507966
44228,1,17,13,5,6,20,62,38.248153756891554,-109.3505271
44229,1,23,10,5,9,11,59,38.248153756891554,-109.3502577
44230,0,25,10,5,10,9,59,38.248153756891554,-109.3499882
44231,1,24,11,4,10,11,61,38.248153756891554,-109.3497187
44232,4,24,12,7,8,10,65,38.248153756891554,-109.3494492
44233,3,33,8,4,6,6,60,38.248153756891554,-109.3491797
44234,2,32,6,3,7,4,54,38.248153756891554,-109.3489102
44235,2,33,6,3,8,3,55,38.248153756891554,-109.3486407
44236,1,29,7,5,8,4,54,38.248153756891554,-109.3483712
44237,2,24,12,6,7,8,59,38.248153756891554,-109.3481017
44238,2,18,14,7,7,17,65,38.248153756891554,-109.3478322
44239,2,17,14,7,8,21,69,38.248153756891554,-109.3475627
44240,1,20,13,6,9,17,66,38.248153756891554,-109.3472932
44241,1,25,12,6,11,12,67,38.248153756891554,-109.3470237
44242,3,30,9,6,12,5,65,38.248153756891554,-109.3467542
44243,3,31,10,6,7,7,64,38.248153756891554,-109.3464847
44244,6,36,7,7,5,4,65,38.248153756891554,-109.3462152
44245,3,43,6,4,7,3,66,38.248153756891554,-109.3459457
44246,5,42,7,5,9,2,70,38.248153756891554,-109.3456762
44247,7,26,10,9,8,6,66,38.248153756891554,-109.3454068
44248,2,21,13,8,8,9,61,38.248153756891554,-109.3451373
44249,3,26,11,7,9,8,64,38.248153756891554,-109.3448678
44250,5,28,12,10,11,5,71,38.248153756891554,-109.3445983
44251,5,25,14,17,17,4,82,38.248153756891554,-109.3443288
44252,4,23,12,18,19,3,79,38.248153756891554,-109.3440593
44253,3,20,12,18,23,5,81,38.248153756891554,-109.3437898
44254,4,17,11,18,21,5,76,38.248153756891554,-109.3435203
44255,2,17,12,16,25,6,78,38.248153756891554,-109.3432508
44256,3,15,13,22,21,4,78,38.248153756891554,-109.3429813
44257,3,16,13,25,22,4,83,38.248153756891554,-109.3427118
44258,4,19,12,22,21,4,82,38.248153756891554,-109.3424423
44259,4,21,13,20,20,4,82,38.248153756891554,-109.3421728
44260,5,17,11,24,22,2,81,38.248153756891554,-109.3419033
44261,5,16,11,22,21,3,78,38.248153756891554,-109.3416338
44262,2,11,12,26,31,5,87,38.248153756891554,-109.3413643
44263,2,9,12,22,35,5,85,38.248153756891554,-109.3410948
44264,2,17,12,24,19,9,83,38.248153756891554,-109.3408253
44265,4,19,13,23,18,6,83,38.248153756891554,-109.3405558
44266,3,21,13,16,21,5,79,38.248153756891554,-109.3402864
44267,4,25,14,10,18,7,78,38.248153756891554,-109.3400169
44268,3,30,13,10,14,8,78,38.248153756891554,-109.3397474
44269,2,29,14,6,14,13,78,38.248153756891554,-109.3394779
44270,6,31,13,7,15,8,80,38.248153756891554,-109.3392084
44271,4,35,12,11,13,5,80,38.248153756891554,-109.3389389
44272,2,33,11,11,14,6,77,38.248153756891554,-109.3386694
44273,2,32,11,10,13,8,76,38.248153756891554,-109.3383999
44274,0,25,9,14,13,4,65,38.248153756891554,-109.3381304
44275,0,26,11,8,18,6,69,38.248153756891554,-109.3378609
44276,1,29,13,5,16,11,75,38.248153756891554,-109.3375914
44277,0,30,13,3,14,15,75,38.248153756891554,-109.3373219
44278,0,27,12,0,9,18,66,38.248153756891554,-109.3370524
44279,1,26,12,0,7,20,66,38.248153756891554,-109.3367829
44280,0,24,11,0,5,19,59,38.248153756891554,-109.3365134
44281,0,25,10,0,5,18,58,38.248153756891554,-109.3362439
44282,0,27,9,0,5,16,57,38.248153756891554,-109.3359744
44283,0,35,8,0,7,12,62,38.248153756891554,-109.3357049
44284,0,35,8,0,9,11,63,38.248153756891554,-109.3354355
44285,0,33,8,0,7,12,60,38.248153756891554,-109.335166
44286,0,30,9,0,11,10,60,38.248153756891554,-109.3348965
44287,1,32,9,5,12,5,64,38.248153756891554,-109.334627
44288,1,47,7,4,10,3,72,38.248153756891554,-109.3343575
44289,1,51,6,3,10,2,73,38.248153756891554,-109.334088
44290,2,35,7,3,11,4,62,38.248153756891554,-109.3338185
44291,3,22,9,4,9,9,56,38.248153756891554,-109.333549
44292,3,24,9,2,6,13,57,38.248153756891554,-109.3332795
44293,5,28,9,4,10,7,63,38.248153756891554,-109.33301
44294,2,24,8,4,8,9,55,38.248153756891554,-109.3327405
44295,2,26,8,4,8,8,56,38.248153756891554,-109.332471
44296,2,28,8,4,10,6,58,38.248153756891554,-109.3322015
44297,2,32,7,3,10,5,59,38.248153756891554,-109.331932
44298,3,33,8,5,10,4,63,38.248153756891554,-109.3316625
44299,2,31,8,5,9,5,60,38.248153756891554,-109.331393
44300,6,42,10,8,14,2,82,38.247884262306314,-109.4402688
44301,7,43,11,9,12,2,84,38.247884262306314,-109.4399993
44302,8,42,11,10,12,1,84,38.247884262306314,-109.4397299
44303,7,41,11,10,13,1,83,38.247884262306314,-109.4394604
44304,7,42,12,10,13,1,85,38.247884262306314,-109.4391909
44305,8,44,13,11,14,1,91,38.247884262306314,-109.4389214
44306,11,40,13,13,14,0,91,38.247884262306314,-109.4386519
44307,9,39,13,13,14,1,89,38.247884262306314,-109.4383824
44308,8,41,13,12,13,1,88,38.247884262306314,-109.4381129
44309,7,45,12,11,12,1,88,38.247884262306314,-109.4378434
44310,6,46,11,9,12,2,86,38.247884262306314,-109.4375739
44311,2,48,9,4,12,4,79,38.247884262306314,-109.4373044
44312,2,52,8,5,12,3,82,38.247884262306314,-109.4370349
44313,3,54,9,7,12,2,87,38.247884262306314,-109.4367654
44314,2,53,9,6,12,2,84,38.247884262306314,-109.4364959
44315,3,55,10,8,12,1,89,38.247884262306314,-109.4362264
44316,4,54,10,9,13,1,91,38.247884262306314,-109.4359569
44317,5,53,11,8,14,1,92,38.247884262306314,-109.4356874
44318,5,51,12,8,14,1,91,38.247884262306314,-109.4354179
44319,6,46,13,12,13,1,91,38.247884262306314,-109.4351484
44320,5,44,12,12,13,1,87,38.247884262306314,-109.434879
44321,5,44,12,9,13,2,85,38.247884262306314,-109.4346095
44322,4,42,11,6,14,3,80,38.247884262306314,-109.43434
44323,4,42,11,6,14,4,81,38.247884262306314,-109.4340705
44324,3,43,11,4,15,5,81,38.247884262306314,-109.433801
44325,2,37,10,2,13,10,74,38.247884262306314,-109.4335315
44326,2,38,10,1,11,11,73,38.247884262306314,-109.433262
44327,2,42,10,0,11,11,76,38.247884262306314,-109.4329925
44328,2,46,10,1,13,8,80,38.247884262306314,-109.432723
44329,3,51,11,4,16,4,89,38.247884262306314,-109.4324535
44330,4,45,11,5,17,4,86,38.247884262306314,-109.432184
44331,6,42,12,7,15,3,85,38.247884262306314,-109.4319145
44332,9,40,13,10,14,2,88,38.247884262306314,-109.431645
44333,12,36,13,13,12,1,87,38.247884262306314,-109.4313755
44334,13,37,14,13,12,1,90,38.247884262306314,-109.431106
44335,9,41,13,12,12,1,88,38.247884262306314,-109.4308365
44336,5,46,11,9,12,1,84,38.247884262306314,-109.430567
44337,3,44,9,7,12,3,78,38.247884262306314,-109.4302975
44338,4,45,10,8,12,2,81,38.247884262306314,-109.430028
44339,5,44,11,10,12,2,84,38.247884262306314,-109.4297586
44340,6,43,12,11,13,1,86,38.247884262306314,-109.4294891
44341,8,40,12,12,13,1,86,38.247884262306314,-109.4292196
44342,9,38,13,12,13,1,86,38.247884262306314,-109.4289501
44343,10,40,13,12,13,1,89,38.247884262306314,-109.4286806
44344,8,42,13,12,14,1,90,38.247884262306314,-109.4284111
44345,5,42,12,12,13,1,85,38.247884262306314,-109.4281416
44346,5,43,11,11,13,1,84,38.247884262306314,-109.4278721
44347,5,43,11,10,14,1,84,38.247884262306314,-109.4276026
44348,5,45,12,11,13,1,87,38.247884262306314,-109.4273331
44349,5,48,12,10,13,1,89,38.247884262306314,-109.4270636
44350,5,49,12,10,13,1,90,38.247884262306314,-109.4267941
44351,4,49,11,8,14,3,89,38.247884262306314,-109.4265246
44352,5,46,12,9,15,2,89,38.247884262306314,-109.4262551
44353,7,43,12,12,15,1,90,38.247884262306314,-109.4259856
44354,9,41,13,13,15,0,91,38.247884262306314,-109.4257161
44355,12,40,13,12,15,0,92,38.247884262306314,-109.4254466
44356,13,36,14,13,14,0,90,38.247884262306314,-109.4251771
44357,13,36,14,13,14,0,90,38.247884262306314,-109.4249077
44358,12,37,14,14,14,0,91,38.247884262306314,-109.4246382
44359,10,37,14,15,13,1,90,38.247884262306314,-109.4243687
44360,9,37,13,14,13,1,87,38.247884262306314,-109.4240992
44361,8,37,13,14,14,1,87,38.247884262306314,-109.4238297
44362,13,37,14,14,14,0,92,38.247884262306314,-109.4235602
44363,13,36,14,15,13,0,91,38.247884262306314,-109.4232907
44364,16,34,14,15,12,0,91,38.247884262306314,-109.4230212
44365,19,32,14,14,12,0,91,38.247884262306314,-109.4227517
44366,21,30,15,13,11,1,91,38.247884262306314,-109.4224822
44367,12,34,12,11,14,1,84,38.247884262306314,-109.4222127
44368,7,41,11,9,14,1,83,38.247884262306314,-109.4219432
44369,5,44,11,9,14,1,84,38.247884262306314,-109.4216737
44370,6,44,12,10,13,2,87,38.247884262306314,-109.4214042
44371,8,40,13,13,13,1,88,38.247884262306314,-109.4211347
44372,7,41,13,13,14,1,89,38.247884262306314,-109.4208652
44373,5,43,13,11,13,2,87,38.247884262306314,-109.4205957
44374,6,42,13,12,14,1,88,38.247884262306314,-109.4203262
44375,8,43,13,13,14,1,92,38.247884262306314,-109.4200568
44376,8,44,13,12,15,1,93,38.247884262306314,-109.4197873
44377,9,43,13,13,14,0,92,38.247884262306314,-109.4195178
44378,8,43,13,11,14,1,90,38.247884262306314,-109.4192483
44379,4,45,10,6,12,2,79,38.247884262306314,-109.4189788
44380,1,40,8,2,10,5,66,38.247884262306314,-109.4187093
44381,2,40,8,3,10,5,68,38.247884262306314,-109.4184398
44382,1,37,9,2,10,7,66,38.247884262306314,-109.4181703
44383,0,37,9,0,10,11,67,38.247884262306314,-109.4179008
44384,1,36,10,0,9,15,71,38.247884262306314,-109.4176313
44385,2,37,12,0,8,18,77,38.247884262306314,-109.4173618
44386,1,46,11,0,14,12,84,38.247884262306314,-109.4170923
44387,1,48,11,0,14,11,85,38.247884262306314,-109.4168228
44388,2,45,11,0,14,11,83,38.247884262306314,-109.4165533
44389,2,48,10,1,14,7,82,38.247884262306314,-109.4162838
44390,2,43,10,3,14,5,77,38.247884262306314,-109.4160143
44391,3,37,10,4,11,4,69,38.247884262306314,-109.4157448
44392,2,34,9,4,10,4,63,38.247884262306314,-109.4154753
44393,2,35,9,4,10,4,64,38.247884262306314,-109.4152058
44394,2,35,9,5,10,4,65,38.247884262306314,-109.4149364
44395,3,38,10,10,12,3,76,38.247884262306314,-109.4146669
44396,4,32,12,15,14,3,80,38.247884262306314,-109.4143974
44397,9,25,13,20,14,2,83,38.247884262306314,-109.4141279
44398,11,27,14,16,15,4,87,38.247884262306314,-109.4138584
44399,7,31,13,11,13,4,79,38.247884262306314,-109.4135889
44400,4,39,12,15,14,2,86,38.247884262306314,-109.4133194
44401,3,32,11,21,14,2,83,38.247884262306314,-109.4130499
44402,2,28,13,13,19,7,82,38.247884262306314,-109.4127804
44403,2,25,12,10,20,8,77,38.247884262306314,-109.4125109
44404,3,27,12,17,21,4,84,38.247884262306314,-109.4122414
44405,7,31,12,16,18,1,85,38.247884262306314,-109.4119719
44406,9,35,12,11,17,2,86,38.247884262306314,-109.4117024
44407,6,38,11,4,16,6,81,38.247884262306314,-109.4114329
44408,3,37,11,0,14,11,76,38.247884262306314,-109.4111634
44409,1,35,12,0,14,12,74,38.247884262306314,-109.4108939
44410,1,36,12,1,15,10,75,38.247884262306314,-109.4106244
44411,0,35,11,3,16,9,74,38.247884262306314,-109.4103549
44412,0,35,11,3,15,9,73,38.247884262306314,-109.4100855
44413,0,34,10,1,14,10,69,38.247884262306314,-109.409816
44414,0,32,11,0,13,14,70,38.247884262306314,-109.4095465
44415,0,30,12,0,10,17,69,38.247884262306314,-109.409277
44416,1,30,12,1,12,15,71,38.247884262306314,-109.4090075
44417,2,30,12,4,13,11,72,38.247884262306314,-109.408738
44418,8,37,14,11,17,1,88,38.247884262306314,-109.4084685
44419,11,37,14,15,16,0,93,38.247884262306314,-109.408199
44420,13,35,15,16,14,0,93,38.247884262306314,-109.4079295
44421,16,34,15,17,13,0,95,38.247884262306314,-109.40766
44422,16,32,15,17,13,0,93,38.247884262306314,-109.4073905
44423,15,33,15,16,13,0,92,38.247884262306314,-109.407121
44424,15,33,15,16,13,0,92,38.247884262306314,-109.4068515
44425,14,33,14,17,13,0,91,38.247884262306314,-109.406582
44426,16,33,14,16,13,0,92,38.247884262306314,-109.4063125
44427,16,34,15,15,13,0,93,38.247884262306314,-109.406043
44428,15,35,15,14,14,0,93,38.247884262306314,-109.4057735
44429,17,34,14,14,13,0,92,38.247884262306314,-109.405504
44430,18,33,14,14,13,0,92,38.247884262306314,-109.4052345
44431,15,34,15,15,13,0,92,38.247884262306314,-109.4049651
44432,13,34,15,16,13,0,91,38.247884262306314,-109.4046956
44433,15,32,15,16,13,1,92,38.247884262306314,-109.4044261
44434,19,30,15,15,12,1,92,38.247884262306314,-109.4041566
44435,19,30,15,16,12,1,93,38.247884262306314,-109.4038871
44436,14,35,15,14,14,1,93,38.247884262306314,-109.4036176
44437,10,38,14,13,15,0,90,38.247884262306314,-109.4033481
44438,9,39,14,12,14,1,89,38.247884262306314,-109.4030786
44439,9,39,14,12,13,1,88,38.247884262306314,-109.4028091
44440,9,41,13,11,13,2,89,38.247884262306314,-109.4025396
44441,10,40,13,12,13,1,89,38.247884262306314,-109.4022701
44442,11,40,14,13,13,1,92,38.247884262306314,-109.4020006
44443,10,41,14,13,13,1,92,38.247884262306314,-109.4017311
44444,11,40,14,14,13,1,93,38.247884262306314,-109.4014616
44445,12,36,15,15,14,1,93,38.247884262306314,-109.4011921
44446,13,37,15,15,14,0,94,38.247884262306314,-109.4009226
44447,12,38,14,14,14,1,93,38.247884262306314,-109.4006531
44448,11,39,14,13,14,1,92,38.247884262306314,-109.4003836
44449,12,36,14,13,14,1,90,38.247884262306314,-109.4001142
44450,14,35,14,14,13,1,91,38.247884262306314,-109.3998447
44451,16,34,15,14,13,0,92,38.247884262306314,-109.3995752
44452,16,35,15,14,13,0,93,38.247884262306314,-109.3993057
44453,14,36,15,14,14,0,93,38.247884262306314,-109.3990362
44454,11,37,14,13,14,1,90,38.247884262306314,-109.3987667
44455,6,40,12,10,14,1,83,38.247884262306314,-109.3984972
44456,5,40,12,9,13,2,81,38.247884262306314,-109.3982277
44457,6,39,13,10,14,2,84,38.247884262306314,-109.3979582
44458,7,39,14,12,14,1,87,38.247884262306314,-109.3976887
44459,8,38,14,12,13,1,86,38.247884262306314,-109.3974192
44460,10,37,15,13,12,1,88,38.247884262306314,-109.3971497
44461,10,37,15,13,13,1,89,38.247884262306314,-109.3968802
44462,10,38,14,12,13,1,88,38.247884262306314,-109.3966107
44463,8,40,14,11,13,1,87,38.247884262306314,-109.3963412
44464,8,41,14,11,14,2,90,38.247884262306314,-109.3960717
44465,6,42,14,9,14,2,87,38.247884262306314,-109.3958022
44466,5,43,13,9,13,3,86,38.247884262306314,-109.3955327
44467,5,44,13,9,13,3,87,38.247884262306314,-109.3952632
44468,5,44,13,10,13,3,88,38.247884262306314,-109.3949938
44469,4,43,13,10,13,2,85,38.247884262306314,-109.3947243
44470,5,42,13,10,13,2,85,38.247884262306314,-109.3944548
44471,5,42,13,11,13,2,86,38.247884262306314,-109.3941853
44472,5,42,13,10,12,2,84,38.247884262306314,-109.3939158
44473,5,43,13,10,13,2,86,38.247884262306314,-109.3936463
44474,5,45,13,10,14,2,89,38.247884262306314,-109.3933768
44475,6,45,14,11,15,1,92,38.247884262306314,-109.3931073
44476,8,45,14,13,14,0,94,38.247884262306314,-109.3928378
44477,12,43,14,12,12,0,93,38.247884262306314,-109.3925683
44478,12,44,14,12,11,0,93,38.247884262306314,-109.3922988
44479,10,45,13,12,13,0,93,38.247884262306314,-109.3920293
44480,10,44,14,11,14,0,93,38.247884262306314,-109.3917598
44481,10,43,14,12,15,0,94,38.247884262306314,-109.3914903
44482,10,42,14,13,15,0,94,38.247884262306314,-109.3912208
44483,10,42,14,13,15,0,94,38.247884262306314,-109.3909513
44484,10,43,14,13,14,0,94,38.247884262306314,-109.3906818
44485,12,42,14,13,14,0,95,38.247884262306314,-109.3904123
44486,13,40,14,12,13,0,92,38.247884262306314,-109.3901429
44487,12,40,13,13,14,0,92,38.247884262306314,-109.3898734
44488,13,39,13,12,14,0,91,38.247884262306314,-109.3896039
44489,12,40,13,12,14,0,91,38.247884262306314,-109.3893344
44490,11,40,13,13,14,0,91,38.247884262306314,-109.3890649
44491,14,38,14,13,13,0,92,38.247884262306314,-109.3887954
44492,15,38,14,13,12,0,92,38.247884262306314,-109.3885259
44493,14,38,14,14,13,0,93,38.247884262306314,-109.3882564
44494,14,38,14,14,13,0,93,38.247884262306314,-109.3879869
44495,13,38,14,14,12,0,91,38.247884262306314,-109.3877174
44496,13,38,13,13,13,0,90,38.247884262306314,-109.3874479
44497,14,36,12,12,13,0,87,38.247884262306314,-109.3871784
44498,10,38,13,12,13,1,87,38.247884262306314,-109.3869089
44499,8,39,13,12,15,1,88,38.247884262306314,-109.3866394
44500,8,41,14,11,15,1,90,38.247884262306314,-109.3863699
44501,12,40,13,11,13,0,89,38.247884262306314,-109.3861004
44502,17,37,13,10,13,0,90,38.247884262306314,-109.3858309
44503,16,36,13,12,14,0,91,38.247884262306314,-109.3855614
44504,14,35,14,13,14,0,90,38.247884262306314,-109.3852919
44505,13,36,14,14,14,0,91,38.247884262306314,-109.3850225
44506,13,36,14,13,15,0,91,38.247884262306314,-109.384753
44507,11,37,15,14,15,0,92,38.247884262306314,-109.3844835
44508,11,40,14,14,14,0,93,38.247884262306314,-109.384214
44509,10,42,14,13,14,0,93,38.247884262306314,-109.3839445
44510,9,41,13,11,14,1,89,38.247884262306314,-109.383675
44511,10,41,11,8,15,1,86,38.247884262306314,-109.3834055
44512,12,38,12,10,14,1,87,38.247884262306314,-109.383136
44513,13,33,11,9,12,2,80,38.247884262306314,-109.3828665
44514,12,29,10,10,10,2,73,38.247884262306314,-109.382597
44515,11,31,10,10,11,2,75,38.247884262306314,-109.3823275
44516,17,35,11,9,13,2,87,38.247884262306314,-109.382058
44517,16,36,12,10,13,1,88,38.247884262306314,-109.3817885
44518,18,35,13,11,12,1,90,38.247884262306314,-109.381519
44519,20,35,12,11,12,0,90,38.247884262306314,-109.3812495
44520,19,34,13,11,12,0,89,38.247884262306314,-109.38098
44521,20,35,12,11,12,0,90,38.247884262306314,-109.3807105
44522,20,36,13,12,11,0,92,38.247884262306314,-109.380441
44523,18,38,14,13,11,0,94,38.247884262306314,-109.3801716
44524,17,37,14,14,10,0,92,38.247884262306314,-109.3799021
44525,22,32,14,15,9,0,92,38.247884262306314,-109.3796326
44526,23,31,13,13,10,0,90,38.247884262306314,-109.3793631
44527,23,31,12,11,11,0,88,38.247884262306314,-109.3790936
44528,24,32,12,10,10,0,88,38.247884262306314,-109.3788241
44529,24,30,13,13,9,1,90,38.247884262306314,-109.3785546
44530,23,29,15,15,7,1,90,38.247884262306314,-109.3782851
44531,26,27,15,15,7,1,91,38.247884262306314,-109.3780156
44532,27,26,15,15,6,1,90,38.247884262306314,-109.3777461
44533,26,26,16,14,5,3,90,38.247884262306314,-109.3774766
44534,27,25,15,16,6,2,91,38.247884262306314,-109.3772071
44535,30,23,15,17,6,1,92,38.247884262306314,-109.3769376
44536,29,24,15,17,5,1,91,38.247884262306314,-109.3766681
44537,26,25,15,17,6,2,91,38.247884262306314,-109.3763986
44538,24,26,15,17,6,2,90,38.247884262306314,-109.3761291
44539,24,26,14,17,6,2,89,38.247884262306314,-109.3758596
44540,16,30,15,15,7,5,88,38.247884262306314,-109.3755901
44541,12,32,15,15,9,5,88,38.247884262306314,-109.3753206
44542,13,32,16,14,8,6,89,38.247884262306314,-109.3750512
44543,15,31,16,13,8,6,89,38.247884262306314,-109.3747817
44544,14,30,16,12,8,7,87,38.247884262306314,-109.3745122
44545,8,30,15,8,10,12,83,38.247884262306314,-109.3742427
44546,7,26,16,12,13,10,84,38.247884262306314,-109.3739732
44547,9,23,15,19,14,7,87,38.247884262306314,-109.3737037
44548,3,23,13,22,13,11,85,38.247884262306314,-109.3734342
44549,4,16,13,13,14,13,73,38.247884262306314,-109.3731647
44550,5,14,10,13,16,7,65,38.247884262306314,-109.3728952
44551,6,17,10,20,16,3,72,38.247884262306314,-109.3726257
44552,2,23,10,16,14,3,68,38.247884262306314,-109.3723562
44553,2,29,13,11,11,10,76,38.247884262306314,-109.3720867
44554,4,29,15,5,10,14,77,38.247884262306314,-109.3718172
44555,1,27,13,0,7,19,67,38.247884262306314,-109.3715477
44556,1,25,12,0,4,19,61,38.247884262306314,-109.3712782
44557,2,25,12,0,3,20,62,38.247884262306314,-109.3710087
44558,2,23,13,0,3,19,60,38.247884262306314,-109.3707392
44559,2,21,12,1,3,18,57,38.247884262306314,-109.3704697
44560,3,21,12,2,4,16,58,38.247884262306314,-109.3702003
44561,3,22,12,2,4,16,59,38.247884262306314,-109.3699308
44562,2,22,13,1,4,18,60,38.247884262306314,-109.3696613
44563,1,19,12,1,3,18,54,38.247884262306314,-109.3693918
44564,2,19,11,3,4,15,54,38.247884262306314,-109.3691223
44565,2,21,11,3,4,15,56,38.247884262306314,-109.3688528
44566,2,21,12,2,3,17,57,38.247884262306314,-109.3685833
44567,2,19,13,0,2,21,57,38.247884262306314,-109.3683138
44568,3,20,13,0,2,21,59,38.247884262306314,-109.3680443
44569,3,22,12,0,3,19,59,38.247884262306314,-109.3677748
44570,2,24,12,0,5,16,59,38.247884262306314,-109.3675053
44571,2,27,12,0,6,16,63,38.247884262306314,-109.3672358
44572,1,24,12,0,3,20,60,38.247884262306314,-109.3669663
44573,2,23,14,0,2,23,64,38.247884262306314,-109.3666968
44574,2,22,13,0,2,23,62,38.247884262306314,-109.3664273
44575,1,21,13,0,2,23,60,38.247884262306314,-109.3661578
44576,2,24,14,0,1,25,66,38.247884262306314,-109.3658883
44577,1,26,12,0,3,20,62,38.247884262306314,-109.3656188
44578,1,26,12,0,1,23,63,38.247884262306314,-109.3653493
44579,1,25,14,0,0,26,66,38.247884262306314,-109.3650799
44580,1,23,14,0,1,26,65,38.247884262306314,-109.3648104
44581,0,25,12,0,3,21,61,38.247884262306314,-109.3645409
44582,1,27,11,0,4,18,61,38.247884262306314,-109.3642714
44583,1,26,11,0,4,19,61,38.247884262306314,-109.3640019
44584,2,24,13,1,2,22,64,38.247884262306314,-109.3637324
44585,2,23,15,2,1,27,70,38.247884262306314,-109.3634629
44586,2,26,16,2,3,27,76,38.247884262306314,-109.3631934
44587,1,26,15,3,3,25,73,38.247884262306314,-109.3629239
44588,1,24,14,1,2,25,67,38.247884262306314,-109.3626544
44589,0,24,13,0,1,24,62,38.247884262306314,-109.3623849
44590,0,28,11,0,3,20,62,38.247884262306314,-109.3621154
44591,0,24,13,0,2,23,62,38.247884262306314,-109.3618459
44592,0,20,15,0,1,27,63,38.247884262306314,-109.3615764
44593,0,19,15,1,2,27,64,38.247884262306314,-109.3613069
44594,0,23,13,1,2,24,63,38.247884262306314,-109.3610374
44595,1,29,11,0,4,20,65,38.247884262306314,-109.3607679
44596,0,28,12,0,3,21,64,38.247884262306314,-109.3604984
44597,0,23,13,0,2,22,60,38.247884262306314,-109.360229
44598,0,19,13,0,2,22,56,38.247884262306314,-109.3599595
44599,0,24,12,1,3,18,58,38.247884262306314,-109.35969
44600,1,31,8,4,6,7,57,38.247884262306314,-109.3594205
44601,2,30,8,5,7,4,56,38.247884262306314,-109.359151
44602,7,20,9,4,5,9,54,38.247884262306314,-109.3588815
44603,3,16,13,3,1,21,57,38.247884262306314,-109.358612
44604,0,20,13,1,1,26,61,38.247884262306314,-109.3583425
44605,2,22,18,0,1,30,73,38.247884262306314,-109.358073
44606,1,21,17,0,1,29,69,38.247884262306314,-109.3578035
44607,1,21,15,0,2,25,64,38.247884262306314,-109.357534
44608,0,27,12,0,4,20,63,38.247884262306314,-109.3572645
44609,1,34,11,0,7,16,69,38.247884262306314,-109.356995
44610,1,37,9,0,10,11,68,38.247884262306314,-109.3567255
44611,2,33,9,3,10,5,62,38.247884262306314,-109.356456
44612,3,36,9,5,9,3,65,38.247884262306314,-109.3561865
44613,3,38,9,6,9,3,68,38.247884262306314,-109.355917
44614,2,44,9,4,12,2,73,38.247884262306314,-109.3556475
44615,0,47,8,1,12,4,72,38.247884262306314,-109.355378
44616,0,38,8,1,10,6,63,38.247884262306314,-109.3551086
44617,1,30,8,2,9,6,56,38.247884262306314,-109.3548391
44618,1,26,8,2,7,7,51,38.247884262306314,-109.3545696
44619,1,31,7,3,7,5,54,38.247884262306314,-109.3543001
44620,1,33,7,3,8,4,56,38.247884262306314,-109.3540306
44621,0,29,9,4,8,6,56,38.247884262306314,-109.3537611
44622,2,23,13,7,9,8,62,38.247884262306314,-109.3534916
44623,2,22,11,7,10,11,63,38.247884262306314,-109.3532221
44624,1,25,9,6,7,8,56,38.247884262306314,-109.3529526
44625,3,27,10,6,10,6,62,38.247884262306314,-109.3526831
44626,7,27,11,5,11,5,66,38.247884262306314,-109.3524136
44627,5,28,8,4,4,9,58,38.247884262306314,-109.3521441
44628,4,38,5,3,6,3,59,38.247884262306314,-109.3518746
44629,5,22,8,9,11,5,60,38.247884262306314,-109.3516051
44630,10,19,12,12,11,7,71,38.247884262306314,-109.3513356
44631,12,17,15,9,19,10,82,38.247884262306314,-109.3510661
44632,2,15,15,5,6,26,69,38.247884262306314,-109.3507966
44633,1,20,11,4,8,15,59,38.247884262306314,-109.3505271
44634,1,25,10,6,12,8,62,38.247884262306314,-109.3502577
44635,0,27,10,7,13,7,64,38.247884262306314,-109.3499882
44636,1,27,10,7,11,7,63,38.247884262306314,-109.3497187
44637,4,32,11,5,9,5,66,38.247884262306314,-109.3494492
44638,2,35,7,5,7,4,60,38.247884262306314,-109.3491797
44639,2,35,7,4,7,3,58,38.247884262306314,-109.3489102
44640,2,30,8,6,7,3,56,38.247884262306314,-109.3486407
44641,2,26,10,7,7,5,57,38.247884262306314,-109.3483712
44642,2,21,13,7,7,10,60,38.247884262306314,-109.3481017
44643,2,17,14,7,7,18,65,38.247884262306314,-109.3478322
44644,1,19,14,5,7,22,68,38.247884262306314,-109.3475627
44645,1,25,13,4,9,18,70,38.247884262306314,-109.3472932
44646,0,25,11,4,9,13,62,38.247884262306314,-109.3470237
44647,4,30,9,9,9,4,65,38.247884262306314,-109.3467542
44648,5,40,9,5,8,3,70,38.247884262306314,-109.3464847
44649,4,39,6,5,7,3,64,38.247884262306314,-109.3462152
44650,3,39,7,4,7,3,63,38.247884262306314,-109.3459457
44651,6,31,8,7,10,2,64,38.247884262306314,-109.3456762
44652,6,26,10,11,7,5,65,38.247884262306314,-109.3454068
44653,2,25,13,11,8,9,68,38.247884262306314,-109.3451373
44654,3,23,13,14,12,8,73,38.247884262306314,-109.3448678
44655,12,23,12,20,19,1,87,38.247884262306314,-109.3445983
44656,2,18,12,17,22,9,80,38.247884262306314,-109.3443288
44657,2,15,15,18,24,11,85,38.247884262306314,-109.3440593
44658,2,18,15,17,23,10,85,38.247884262306314,-109.3437898
44659,3,18,13,16,19,9,78,38.247884262306314,-109.3435203
44660,1,16,15,17,13,12,74,38.247884262306314,-109.3432508
44661,2,24,13,7,15,12,73,38.247884262306314,-109.3429813
44662,1,29,14,1,14,18,77,38.247884262306314,-109.3427118
44663,0,31,14,0,14,18,77,38.247884262306314,-109.3424423
44664,0,28,11,1,9,15,64,38.247884262306314,-109.3421728
44665,1,29,11,5,13,10,69,38.247884262306314,-109.3419033
44666,1,31,13,7,15,9,76,38.247884262306314,-109.3416338
44667,3,32,14,10,18,6,83,38.247884262306314,-109.3413643
44668,2,31,13,10,21,5,82,38.247884262306314,-109.3410948
44669,1,25,13,11,19,6,75,38.247884262306314,-109.3408253
44670,2,25,13,10,16,7,73,38.247884262306314,-109.3405558
44671,0,24,13,1,8,21,67,38.247884262306314,-109.3402864
44672,0,25,14,1,9,21,70,38.247884262306314,-109.3400169
44673,0,27,14,1,11,19,72,38.247884262306314,-109.3397474
44674,3,32,16,5,11,16,83,38.247884262306314,-109.3394779
44675,5,30,16,5,13,14,83,38.247884262306314,-109.3392084
44676,1,32,14,10,14,11,82,38.247884262306314,-109.3389389
44677,2,31,14,8,17,9,81,38.247884262306314,-109.3386694
44678,1,25,11,10,18,6,71,38.247884262306314,-109.3383999
44679,0,27,8,17,14,1,67,38.247884262306314,-109.3381304
44680,2,32,12,6,19,5,76,38.247884262306314,-109.3378609
44681,1,30,12,1,10,15,69,38.247884262306314,-109.3375914
44682,1,25,13,0,6,20,65,38.247884262306314,-109.3373219
44683,1,27,12,1,8,17,66,38.247884262306314,-109.3370524
44684,2,33,11,2,11,12,71,38.247884262306314,-109.3367829
44685,1,27,11,1,7,16,63,38.247884262306314,-109.3365134
44686,1,26,10,0,6,17,60,38.247884262306314,-109.3362439
44687,0,29,9,0,6,15,59,38.247884262306314,-109.3359744
44688,0,36,8,0,8,11,63,38.247884262306314,-109.3357049
44689,1,37,10,2,12,7,69,38.247884262306314,-109.3354355
44690,0,32,10,1,11,10,64,38.247884262306314,-109.335166
44691,0,31,10,0,10,11,62,38.247884262306314,-109.3348965
44692,1,41,10,3,11,6,72,38.247884262306314,-109.334627
44693,0,46,7,2,11,4,70,38.247884262306314,-109.3343575
44694,1,40,7,2,10,4,64,38.247884262306314,-109.334088
44695,2,27,10,3,8,9,59,38.247884262306314,-109.3338185
44696,2,23,10,3,6,14,58,38.247884262306314,-109.333549
44697,1,27,9,2,7,12,58,38.247884262306314,-109.3332795
44698,2,27,9,3,10,8,59,38.247884262306314,-109.33301
44699,2,27,9,5,10,7,60,38.247884262306314,-109.3327405
44700,1,28,9,4,10,8,60,38.247884262306314,-109.332471
44701,1,29,9,3,9,8,59,38.247884262306314,-109.3322015
44702,2,28,9,4,11,5,59,38.247884262306314,-109.331932
44703,3,22,10,8,9,8,60,38.247884262306314,-109.3316625
44704,2,25,9,6,9,8,59,38.247884262306314,-109.331393
44705,4,38,8,5,12,3,70,38.24761476772108,-109.4402688
44706,6,42,10,8,12,2,80,38.24761476772108,-109.4399993
44707,7,41,10,8,12,2,80,38.24761476772108,-109.4397299
44708,7,43,11,9,12,1,83,38.24761476772108,-109.4394604
44709,6,46,12,9,13,1,87,38.24761476772108,-109.4391909
44710,5,44,12,10,14,1,86,38.24761476772108,-109.4389214
44711,6,43,13,10,13,1,86,38.24761476772108,-109.4386519
44712,6,42,13,10,13,1,85,38.24761476772108,-109.4383824
44713,7,42,12,10,13,1,85,38.24761476772108,-109.4381129
44714,6,45,12,9,12,1,85,38.24761476772108,-109.4378434
44715,5,47,11,8,12,2,85,38.24761476772108,-109.4375739
44716,2,50,9,5,12,3,81,38.24761476772108,-109.4373044
44717,2,54,9,6,12,2,85,38.24761476772108,-109.4370349
44718,5,54,10,8,13,1,91,38.24761476772108,-109.4367654
44719,6,51,11,10,13,1,92,38.24761476772108,-109.4364959
44720,6,50,11,11,13,1,92,38.24761476772108,-109.4362264
44721,7,49,12,11,13,1,93,38.24761476772108,-109.4359569
44722,7,51,11,10,13,1,93,38.24761476772108,-109.4356874
44723,5,51,11,9,13,1,90,38.24761476772108,-109.4354179
44724,6,47,12,11,13,1,90,38.24761476772108,-109.4351484
44725,6,46,13,14,12,1,92,38.24761476772108,-109.434879
44726,6,45,13,13,13,1,91,38.24761476772108,-109.4346095
44727,5,45,12,9,15,2,88,38.24761476772108,-109.43434
44728,4,43,12,6,15,5,85,38.24761476772108,-109.4340705
44729,5,42,12,7,16,4,86,38.24761476772108,-109.433801
44730,4,43,11,6,15,4,83,38.24761476772108,-109.4335315
44731,2,40,10,2,14,8,76,38.24761476772108,-109.433262
44732,2,40,10,1,12,9,74,38.24761476772108,-109.4329925
44733,2,47,10,1,14,7,81,38.24761476772108,-109.432723
44734,3,50,11,5,16,3,88,38.24761476772108,-109.4324535
44735,4,46,11,6,16,2,85,38.24761476772108,-109.432184
44736,6,42,11,7,15,3,84,38.24761476772108,-109.4319145
44737,8,39,12,9,14,3,85,38.24761476772108,-109.431645
44738,11,36,14,15,12,1,89,38.24761476772108,-109.4313755
44739,12,37,14,15,12,1,91,38.24761476772108,-109.431106
44740,9,39,13,14,12,1,88,38.24761476772108,-109.4308365
44741,7,42,12,11,12,1,85,38.24761476772108,-109.430567
44742,4,44,10,8,12,2,80,38.24761476772108,-109.4302975
44743,3,45,9,6,11,3,77,38.24761476772108,-109.430028
44744,2,47,9,5,12,4,79,38.24761476772108,-109.4297586
44745,3,46,9,7,12,3,80,38.24761476772108,-109.4294891
44746,5,44,10,8,12,2,81,38.24761476772108,-109.4292196
44747,6,40,11,9,12,2,80,38.24761476772108,-109.4289501
44748,7,43,12,11,12,1,86,38.24761476772108,-109.4286806
44749,7,44,13,12,13,1,90,38.24761476772108,-109.4284111
44750,6,43,12,11,13,1,86,38.24761476772108,-109.4281416
44751,6,43,12,11,13,1,86,38.24761476772108,-109.4278721
44752,9,43,13,12,14,1,92,38.24761476772108,-109.4276026
44753,6,45,12,11,14,1,89,38.24761476772108,-109.4273331
44754,4,50,11,8,14,2,89,38.24761476772108,-109.4270636
44755,3,52,11,7,14,2,89,38.24761476772108,-109.4267941
44756,3,50,11,6,16,3,89,38.24761476772108,-109.4265246
44757,5,49,11,7,15,2,89,38.24761476772108,-109.4262551
44758,6,45,12,11,15,1,90,38.24761476772108,-109.4259856
44759,9,41,12,12,15,1,90,38.24761476772108,-109.4257161
44760,13,38,13,12,15,0,91,38.24761476772108,-109.4254466
44761,17,34,14,11,13,1,90,38.24761476772108,-109.4251771
44762,15,35,14,11,13,1,89,38.24761476772108,-109.4249077
44763,14,36,14,12,13,1,90,38.24761476772108,-109.4246382
44764,11,38,14,12,13,0,88,38.24761476772108,-109.4243687
44765,8,39,13,12,14,1,87,38.24761476772108,-109.4240992
44766,8,39,13,12,14,1,87,38.24761476772108,-109.4238297
44767,11,39,14,13,14,0,91,38.24761476772108,-109.4235602
44768,13,38,14,12,14,0,91,38.24761476772108,-109.4232907
44769,14,37,14,12,14,0,91,38.24761476772108,-109.4230212
44770,14,35,14,13,14,0,90,38.24761476772108,-109.4227517
44771,14,36,14,13,14,0,91,38.24761476772108,-109.4224822
44772,13,37,13,13,14,0,90,38.24761476772108,-109.4222127
44773,9,40,12,10,13,1,85,38.24761476772108,-109.4219432
44774,8,43,11,9,13,1,85,38.24761476772108,-109.4216737
44775,5,43,11,11,13,1,84,38.24761476772108,-109.4214042
44776,8,44,13,10,14,1,90,38.24761476772108,-109.4211347
44777,7,43,13,10,15,1,89,38.24761476772108,-109.4208652
44778,6,43,13,11,15,1,89,38.24761476772108,-109.4205957
44779,6,43,13,12,14,1,89,38.24761476772108,-109.4203262
44780,7,43,13,11,15,1,90,38.24761476772108,-109.4200568
44781,7,43,12,8,15,2,87,38.24761476772108,-109.4197873
44782,5,44,11,7,15,3,85,38.24761476772108,-109.4195178
44783,3,44,10,6,12,4,79,38.24761476772108,-109.4192483
44784,2,42,9,2,11,6,72,38.24761476772108,-109.4189788
44785,1,40,9,2,10,5,67,38.24761476772108,-109.4187093
44786,1,37,9,3,11,6,67,38.24761476772108,-109.4184398
44787,1,35,9,2,11,8,66,38.24761476772108,-109.4181703
44788,1,34,10,1,9,13,68,38.24761476772108,-109.4179008
44789,2,42,11,0,11,14,80,38.24761476772108,-109.4176313
44790,2,37,12,0,10,18,79,38.24761476772108,-109.4173618
44791,2,38,12,1,12,15,80,38.24761476772108,-109.4170923
44792,1,43,11,0,13,13,81,38.24761476772108,-109.4168228
44793,1,45,11,0,14,11,82,38.24761476772108,-109.4165533
44794,2,45,11,0,16,8,82,38.24761476772108,-109.4162838
44795,2,44,10,1,13,6,76,38.24761476772108,-109.4160143
44796,1,38,9,2,10,6,66,38.24761476772108,-109.4157448
44797,3,40,9,5,11,3,71,38.24761476772108,-109.4154753
44798,5,40,11,11,11,2,80,38.24761476772108,-109.4152058
44799,5,32,13,24,13,2,89,38.24761476772108,-109.4149364
44800,6,33,13,19,14,2,87,38.24761476772108,-109.4146669
44801,7,34,12,14,14,4,85,38.24761476772108,-109.4143974
44802,8,30,12,18,16,3,87,38.24761476772108,-109.4141279
44803,7,30,13,17,17,6,90,38.24761476772108,-109.4138584
44804,8,34,12,16,16,2,88,38.24761476772108,-109.4135889
44805,5,30,11,24,17,1,88,38.24761476772108,-109.4133194
44806,1,26,12,26,19,3,87,38.24761476772108,-109.4130499
44807,1,21,13,20,19,6,80,38.24761476772108,-109.4127804
44808,4,31,12,8,24,1,80,38.24761476772108,-109.4125109
44809,7,36,12,10,18,1,84,38.24761476772108,-109.4122414
44810,8,40,12,11,17,1,89,38.24761476772108,-109.4119719
44811,9,39,12,11,17,1,89,38.24761476772108,-109.4117024
44812,6,39,11,3,15,7,81,38.24761476772108,-109.4114329
44813,1,34,10,0,11,15,71,38.24761476772108,-109.4111634
44814,1,37,11,0,14,12,75,38.24761476772108,-109.4108939
44815,1,36,11,1,13,10,72,38.24761476772108,-109.4106244
44816,1,35,11,2,14,9,72,38.24761476772108,-109.4103549
44817,0,35,11,0,15,11,72,38.24761476772108,-109.4100855
44818,1,36,11,1,17,9,75,38.24761476772108,-109.409816
44819,2,34,11,2,15,10,74,38.24761476772108,-109.4095465
44820,5,33,12,6,15,8,79,38.24761476772108,-109.409277
44821,8,33,13,9,16,4,83,38.24761476772108,-109.4090075
44822,10,37,14,12,16,1,90,38.24761476772108,-109.408738
44823,10,36,14,16,15,0,91,38.24761476772108,-109.4084685
44824,13,35,15,18,14,0,95,38.24761476772108,-109.408199
44825,15,34,15,17,13,0,94,38.24761476772108,-109.4079295
44826,16,34,15,17,13,0,95,38.24761476772108,-109.40766
44827,16,33,15,17,13,0,94,38.24761476772108,-109.4073905
44828,16,33,15,16,13,0,93,38.24761476772108,-109.407121
44829,16,33,15,16,13,0,93,38.24761476772108,-109.4068515
44830,17,32,15,17,13,0,94,38.24761476772108,-109.406582
44831,19,31,14,16,12,0,92,38.24761476772108,-109.4063125
44832,17,32,14,15,13,0,91,38.24761476772108,-109.406043
44833,17,32,14,15,13,0,91,38.24761476772108,-109.4057735
44834,19,32,14,14,13,0,92,38.24761476772108,-109.405504
44835,19,32,14,14,12,0,91,38.24761476772108,-109.4052345
44836,17,32,15,15,13,0,92,38.24761476772108,-109.4049651
44837,14,35,15,15,13,0,92,38.24761476772108,-109.4046956
44838,15,36,14,13,13,1,92,38.24761476772108,-109.4044261
44839,17,36,14,12,12,0,91,38.24761476772108,-109.4041566
44840,17,35,14,13,12,0,91,38.24761476772108,-109.4038871
44841,13,38,14,12,14,1,92,38.24761476772108,-109.4036176
44842,13,39,14,12,14,0,92,38.24761476772108,-109.4033481
44843,12,40,14,12,14,1,93,38.24761476772108,-109.4030786
44844,10,43,13,10,13,1,90,38.24761476772108,-109.4028091
44845,11,46,13,9,13,1,93,38.24761476772108,-109.4025396
44846,10,45,13,10,12,1,91,38.24761476772108,-109.4022701
44847,11,45,13,10,12,1,92,38.24761476772108,-109.4020006
44848,10,44,13,10,12,1,90,38.24761476772108,-109.4017311
44849,11,41,14,12,13,1,92,38.24761476772108,-109.4014616
44850,14,36,15,14,14,0,93,38.24761476772108,-109.4011921
44851,13,36,15,15,14,1,94,38.24761476772108,-109.4009226
44852,13,37,14,14,13,1,92,38.24761476772108,-109.4006531
44853,13,37,14,12,14,1,91,38.24761476772108,-109.4003836
44854,15,35,14,13,14,1,92,38.24761476772108,-109.4001142
44855,12,36,15,14,13,1,91,38.24761476772108,-109.3998447
44856,12,36,15,15,13,1,92,38.24761476772108,-109.3995752
44857,12,36,15,15,14,1,93,38.24761476772108,-109.3993057
44858,12,36,15,15,14,0,92,38.24761476772108,-109.3990362
44859,12,35,15,15,14,1,92,38.24761476772108,-109.3987667
44860,11,37,15,13,14,1,91,38.24761476772108,-109.3984972
44861,8,38,14,13,14,1,88,38.24761476772108,-109.3982277
44862,8,39,14,12,14,1,88,38.24761476772108,-109.3979582
44863,7,37,14,12,13,2,85,38.24761476772108,-109.3976887
44864,8,37,14,12,13,1,85,38.24761476772108,-109.3974192
44865,10,36,14,13,14,1,88,38.24761476772108,-109.3971497
44866,12,37,14,13,14,1,91,38.24761476772108,-109.3968802
44867,9,41,14,12,15,1,92,38.24761476772108,-109.3966107
44868,6,43,14,9,14,2,88,38.24761476772108,-109.3963412
44869,5,44,13,9,15,2,88,38.24761476772108,-109.3960717
44870,4,45,13,7,14,3,86,38.24761476772108,-109.3958022
44871,4,45,13,7,14,3,86,38.24761476772108,-109.3955327
44872,4,46,13,8,14,3,88,38.24761476772108,-109.3952632
44873,5,46,13,10,14,1,89,38.24761476772108,-109.3949938
44874,5,45,14,10,14,1,89,38.24761476772108,-109.3947243
44875,6,42,14,12,14,1,89,38.24761476772108,-109.3944548
44876,7,41,14,13,13,1,89,38.24761476772108,-109.3941853
44877,8,40,14,13,13,1,89,38.24761476772108,-109.3939158
44878,7,42,14,12,13,1,89,38.24761476772108,-109.3936463
44879,6,44,14,10,14,1,89,38.24761476772108,-109.3933768
44880,7,44,14,11,14,1,91,38.24761476772108,-109.3931073
44881,7,46,14,12,14,0,93,38.24761476772108,-109.3928378
44882,8,45,14,13,13,0,93,38.24761476772108,-109.3925683
44883,8,46,13,12,13,0,92,38.24761476772108,-109.3922988
44884,8,45,13,12,14,0,92,38.24761476772108,-109.3920293
44885,8,45,14,12,15,0,94,38.24761476772108,-109.3917598
44886,7,44,14,12,15,1,93,38.24761476772108,-109.3914903
44887,7,44,14,14,15,0,94,38.24761476772108,-109.3912208
44888,7,45,14,13,15,1,95,38.24761476772108,-109.3909513
44889,7,45,14,12,14,1,93,38.24761476772108,-109.3906818
44890,8,44,14,13,14,0,93,38.24761476772108,-109.3904123
44891,11,43,14,12,14,0,94,38.24761476772108,-109.3901429
44892,11,42,14,13,13,0,93,38.24761476772108,-109.3898734
44893,12,40,14,13,13,0,92,38.24761476772108,-109.3896039
44894,12,40,14,13,13,0,92,38.24761476772108,-109.3893344
44895,12,40,14,14,13,0,93,38.24761476772108,-109.3890649
44896,13,38,14,14,13,0,92,38.24761476772108,-109.3887954
44897,14,38,14,13,13,0,92,38.24761476772108,-109.3885259
44898,14,39,14,12,13,0,92,38.24761476772108,-109.3882564
44899,13,40,14,13,13,0,93,38.24761476772108,-109.3879869
44900,12,39,14,14,13,0,92,38.24761476772108,-109.3877174
44901,12,36,13,15,13,0,89,38.24761476772108,-109.3874479
44902,14,36,13,14,13,0,90,38.24761476772108,-109.3871784
44903,11,39,13,13,13,1,90,38.24761476772108,-109.3869089
44904,10,39,13,12,14,1,89,38.24761476772108,-109.3866394
44905,10,38,13,11,14,1,87,38.24761476772108,-109.3863699
44906,13,37,13,12,14,0,89,38.24761476772108,-109.3861004
44907,15,34,13,13,14,0,89,38.24761476772108,-109.3858309
44908,14,34,13,13,14,1,89,38.24761476772108,-109.3855614
44909,12,34,14,13,14,1,88,38.24761476772108,-109.3852919
44910,10,34,14,12,14,2,86,38.24761476772108,-109.3850225
44911,9,34,14,13,14,2,86,38.24761476772108,-109.384753
44912,7,36,14,12,14,2,85,38.24761476772108,-109.3844835
44913,7,41,14,12,14,1,89,38.24761476772108,-109.384214
44914,7,43,13,12,14,1,90,38.24761476772108,-109.3839445
44915,9,42,13,11,13,1,89,38.24761476772108,-109.383675
44916,10,41,11,8,14,1,85,38.24761476772108,-109.3834055
44917,10,41,11,9,14,1,86,38.24761476772108,-109.383136
44918,12,35,11,9,12,2,81,38.24761476772108,-109.3828665
44919,11,27,11,12,11,1,73,38.24761476772108,-109.382597
44920,9,28,10,17,11,0,75,38.24761476772108,-109.3823275
44921,20,32,11,11,12,0,86,38.24761476772108,-109.382058
44922,18,34,12,11,12,0,87,38.24761476772108,-109.3817885
44923,18,35,12,11,12,1,89,38.24761476772108,-109.381519
44924,18,35,12,11,12,1,89,38.24761476772108,-109.3812495
44925,19,35,12,10,11,1,88,38.24761476772108,-109.38098
44926,20,34,13,10,11,1,89,38.24761476772108,-109.3807105
44927,20,35,13,11,11,0,90,38.24761476772108,-109.380441
44928,23,33,13,13,10,0,92,38.24761476772108,-109.3801716
44929,26,30,13,12,8,1,90,38.24761476772108,-109.3799021
44930,25,29,14,14,7,1,90,38.24761476772108,-109.3796326
44931,28,27,14,14,7,1,91,38.24761476772108,-109.3793631
44932,33,24,14,14,6,1,92,38.24761476772108,-109.3790936
44933,34,22,14,15,6,1,92,38.24761476772108,-109.3788241
44934,28,24,15,16,6,1,90,38.24761476772108,-109.3785546
44935,24,25,15,18,6,1,89,38.24761476772108,-109.3782851
44936,26,24,15,18,5,2,90,38.24761476772108,-109.3780156
44937,26,24,15,17,6,2,90,38.24761476772108,-109.3777461
44938,24,25,15,15,6,3,88,38.24761476772108,-109.3774766
44939,20,26,15,16,7,3,87,38.24761476772108,-109.3772071
44940,22,25,15,18,7,3,90,38.24761476772108,-109.3769376
44941,23,24,15,16,7,3,88,38.24761476772108,-109.3766681
44942,21,25,15,16,7,4,88,38.24761476772108,-109.3763986
44943,17,27,15,16,8,4,87,38.24761476772108,-109.3761291
44944,8,33,15,13,8,8,85,38.24761476772108,-109.3758596
44945,8,32,15,9,8,10,82,38.24761476772108,-109.3755901
44946,9,33,15,7,8,11,83,38.24761476772108,-109.3753206
44947,8,31,14,6,8,13,80,38.24761476772108,-109.3750512
44948,8,30,14,8,9,12,81,38.24761476772108,-109.3747817
44949,6,28,14,7,10,12,77,38.24761476772108,-109.3745122
44950,7,25,15,16,11,8,82,38.24761476772108,-109.3742427
44951,6,23,15,21,14,7,86,38.24761476772108,-109.3739732
44952,4,20,13,22,14,8,81,38.24761476772108,-109.3737037
44953,4,17,11,12,10,11,65,38.24761476772108,-109.3734342
44954,4,10,11,10,11,11,57,38.24761476772108,-109.3731647
44955,5,15,10,20,12,4,66,38.24761476772108,-109.3728952
44956,4,25,12,15,14,5,75,38.24761476772108,-109.3726257
44957,2,27,13,3,7,19,71,38.24761476772108,-109.3723562
44958,2,24,14,0,4,24,68,38.24761476772108,-109.3720867
44959,1,22,13,0,2,23,61,38.24761476772108,-109.3718172
44960,2,25,12,0,5,16,60,38.24761476772108,-109.3715477
44961,3,28,11,1,7,12,62,38.24761476772108,-109.3712782
44962,3,25,13,1,4,16,62,38.24761476772108,-109.3710087
44963,3,20,14,1,2,19,59,38.24761476772108,-109.3707392
44964,4,22,12,6,5,12,61,38.24761476772108,-109.3704697
44965,4,23,11,6,6,10,60,38.24761476772108,-109.3702003
44966,3,21,10,6,5,12,57,38.24761476772108,-109.3699308
44967,2,19,10,5,6,12,54,38.24761476772108,-109.3696613
44968,3,22,8,4,8,9,54,38.24761476772108,-109.3693918
44969,2,26,8,4,8,8,56,38.24761476772108,-109.3691223
44970,3,27,8,4,8,7,57,38.24761476772108,-109.3688528
44971,4,27,8,4,9,7,59,38.24761476772108,-109.3685833
44972,2,19,10,3,7,12,53,38.24761476772108,-109.3683138
44973,2,19,12,1,4,18,56,38.24761476772108,-109.3680443
44974,2,20,13,1,4,18,58,38.24761476772108,-109.3677748
44975,2,23,12,1,5,18,61,38.24761476772108,-109.3675053
44976,2,25,13,0,5,21,66,38.24761476772108,-109.3672358
44977,0,26,15,0,5,25,71,38.24761476772108,-109.3669663
44978,0,25,17,0,3,29,74,38.24761476772108,-109.3666968
44979,1,25,17,0,2,30,75,38.24761476772108,-109.3664273
44980,1,24,17,0,2,31,75,38.24761476772108,-109.3661578
44981,2,22,17,0,2,31,74,38.24761476772108,-109.3658883
44982,1,22,15,0,0,28,66,38.24761476772108,-109.3656188
44983,1,22,16,0,0,29,68,38.24761476772108,-109.3653493
44984,1,22,16,0,0,30,69,38.24761476772108,-109.3650799
44985,0,22,15,0,0,29,66,38.24761476772108,-109.3648104
44986,0,23,15,0,2,27,67,38.24761476772108,-109.3645409
44987,0,24,12,0,2,23,61,38.24761476772108,-109.3642714
44988,1,25,13,0,2,23,64,38.24761476772108,-109.3640019
44989,2,26,14,0,2,24,68,38.24761476772108,-109.3637324
44990,3,28,15,2,4,24,76,38.24761476772108,-109.3634629
44991,3,33,15,2,6,22,81,38.24761476772108,-109.3631934
44992,3,31,14,3,6,21,78,38.24761476772108,-109.3629239
44993,2,26,14,3,4,23,72,38.24761476772108,-109.3626544
44994,1,23,14,1,2,24,65,38.24761476772108,-109.3623849
44995,0,25,13,0,2,22,62,38.24761476772108,-109.3621154
44996,0,24,13,0,1,24,62,38.24761476772108,-109.3618459
44997,0,22,15,1,1,27,66,38.24761476772108,-109.3615764
44998,0,20,15,1,1,27,64,38.24761476772108,-109.3613069
44999,0,22,13,1,1,24,61,38.24761476772108,-109.3610374
45000,1,27,12,1,4,20,65,38.24761476772108,-109.3607679
45001,0,22,13,1,2,23,61,38.24761476772108,-109.3604984
45002,0,22,13,0,1,24,60,38.24761476772108,-109.360229
45003,0,22,13,0,1,23,59,38.24761476772108,-109.3599595
45004,0,23,11,1,2,20,57,38.24761476772108,-109.35969
45005,2,31,9,5,7,6,60,38.24761476772108,-109.3594205
45006,2,33,7,3,6,5,56,38.24761476772108,-109.359151
45007,5,22,8,3,4,10,52,38.24761476772108,-109.3588815
45008,4,17,12,4,3,19,59,38.24761476772108,-109.358612
45009,0,23,17,2,3,28,73,38.24761476772108,-109.3583425
45010,0,18,17,0,1,30,66,38.24761476772108,-109.358073
45011,0,21,14,0,2,25,62,38.24761476772108,-109.3578035
45012,1,29,12,0,4,20,66,38.24761476772108,-109.357534
45013,0,33,11,0,6,17,67,38.24761476772108,-109.3572645
45014,1,32,11,1,8,14,67,38.24761476772108,-109.356995
45015,0,32,10,1,8,13,64,38.24761476772108,-109.3567255
45016,1,25,9,3,7,10,55,38.24761476772108,-109.356456
45017,3,26,9,3,7,8,56,38.24761476772108,-109.3561865
45018,2,24,10,3,7,8,54,38.24761476772108,-109.355917
45019,3,34,9,6,9,4,65,38.24761476772108,-109.3556475
45020,2,39,9,4,11,3,68,38.24761476772108,-109.355378
45021,2,31,9,3,10,6,61,38.24761476772108,-109.3551086
45022,1,25,10,4,8,9,57,38.24761476772108,-109.3548391
45023,1,25,9,4,7,7,53,38.24761476772108,-109.3545696
45024,1,32,7,4,9,4,57,38.24761476772108,-109.3543001
45025,1,29,7,4,9,4,54,38.24761476772108,-109.3540306
45026,1,20,9,6,11,6,53,38.24761476772108,-109.3537611
45027,3,25,14,18,8,6,74,38.24761476772108,-109.3534916
45028,2,26,13,6,10,14,71,38.24761476772108,-109.3532221
45029,2,23,11,8,13,7,64,38.24761476772108,-109.3529526
45030,7,26,11,8,15,4,71,38.24761476772108,-109.3526831
45031,8,32,12,6,11,3,72,38.24761476772108,-109.3524136
45032,4,31,6,4,4,7,56,38.24761476772108,-109.3521441
45033,4,32,6,5,6,4,57,38.24761476772108,-109.3518746
45034,4,16,10,10,12,8,60,38.24761476772108,-109.3516051
45035,11,20,18,11,17,7,84,38.24761476772108,-109.3513356
45036,11,15,14,10,18,11,79,38.24761476772108,-109.3510661
45037,2,18,13,4,5,21,63,38.24761476772108,-109.3507966
45038,1,22,10,8,14,8,63,38.24761476772108,-109.3505271
45039,1,26,10,8,15,6,66,38.24761476772108,-109.3502577
45040,1,26,10,7,13,6,63,38.24761476772108,-109.3499882
45041,2,28,9,7,7,7,60,38.24761476772108,-109.3497187
45042,3,36,9,4,7,4,63,38.24761476772108,-109.3494492
45043,3,37,8,6,7,3,64,38.24761476772108,-109.3491797
45044,1,33,9,6,7,4,60,38.24761476772108,-109.3489102
45045,2,30,10,5,8,6,61,38.24761476772108,-109.3486407
45046,3,30,11,4,8,6,62,38.24761476772108,-109.3483712
45047,2,23,13,6,7,11,62,38.24761476772108,-109.3481017
45048,2,19,15,7,8,17,68,38.24761476772108,-109.3478322
45049,2,19,14,8,10,17,70,38.24761476772108,-109.3475627
45050,2,22,13,5,9,16,67,38.24761476772108,-109.3472932
45051,4,28,10,11,12,4,69,38.24761476772108,-109.3470237
45052,7,36,9,10,12,1,75,38.24761476772108,-109.3467542
45053,3,37,7,5,7,3,62,38.24761476772108,-109.3464847
45054,4,43,6,3,8,3,67,38.24761476772108,-109.3462152
45055,4,28,7,5,8,5,57,38.24761476772108,-109.3459457
45056,5,21,11,10,7,9,63,38.24761476772108,-109.3456762
45057,2,26,13,8,6,13,68,38.24761476772108,-109.3454068
45058,5,27,13,14,14,7,80,38.24761476772108,-109.3451373
45059,5,23,13,17,19,6,83,38.24761476772108,-109.3448678
45060,5,17,11,25,21,6,85,38.24761476772108,-109.3445983
45061,4,11,11,17,16,10,69,38.24761476772108,-109.3443288
45062,2,15,12,21,14,5,69,38.24761476772108,-109.3440593
45063,1,20,12,11,12,12,68,38.24761476772108,-109.3437898
45064,1,27,14,3,11,21,77,38.24761476772108,-109.3435203
45065,2,27,16,1,9,24,79,38.24761476772108,-109.3432508
45066,1,27,17,0,8,26,79,38.24761476772108,-109.3429813
45067,1,26,17,0,7,27,78,38.24761476772108,-109.3427118
45068,0,25,14,0,5,25,69,38.24761476772108,-109.3424423
45069,0,27,11,0,7,17,62,38.24761476772108,-109.3421728
45070,1,32,11,2,13,9,68,38.24761476772108,-109.3419033
45071,1,30,11,4,13,8,67,38.24761476772108,-109.3416338
45072,2,33,11,6,14,6,72,38.24761476772108,-109.3413643
45073,2,34,11,6,12,5,70,38.24761476772108,-109.3410948
45074,1,30,9,5,8,8,61,38.24761476772108,-109.3408253
45075,0,26,9,5,9,9,58,38.24761476772108,-109.3405558
45076,1,27,11,0,10,13,62,38.24761476772108,-109.3402864
45077,0,28,13,0,10,18,69,38.24761476772108,-109.3400169
45078,1,25,14,1,11,19,71,38.24761476772108,-109.3397474
45079,9,24,16,14,7,10,80,38.24761476772108,-109.3394779
45080,5,34,14,12,10,9,84,38.24761476772108,-109.3392084
45081,3,28,16,9,14,10,80,38.24761476772108,-109.3389389
45082,2,24,13,11,18,7,75,38.24761476772108,-109.3386694
45083,2,26,10,10,19,4,71,38.24761476772108,-109.3383999
45084,0,29,9,2,15,9,64,38.24761476772108,-109.3381304
45085,2,32,13,0,12,14,73,38.24761476772108,-109.3378609
45086,0,24,12,0,5,20,61,38.24761476772108,-109.3375914
45087,0,26,11,1,4,19,61,38.24761476772108,-109.3373219
45088,1,28,10,1,5,15,60,38.24761476772108,-109.3370524
45089,3,27,10,3,7,11,61,38.24761476772108,-109.3367829
45090,1,21,11,0,4,17,54,38.24761476772108,-109.3365134
45091,1,21,11,0,4,18,55,38.24761476772108,-109.3362439
45092,1,26,10,1,8,14,60,38.24761476772108,-109.3359744
45093,0,27,10,0,9,13,59,38.24761476772108,-109.3357049
45094,2,29,11,2,13,9,66,38.24761476772108,-109.3354355
45095,0,28,10,1,10,12,61,38.24761476772108,-109.335166
45096,0,33,10,0,8,14,65,38.24761476772108,-109.3348965
45097,1,39,9,1,10,9,69,38.24761476772108,-109.334627
45098,1,42,8,2,10,6,69,38.24761476772108,-109.3343575
45099,1,33,9,2,7,9,61,38.24761476772108,-109.334088
45100,1,28,10,2,5,14,60,38.24761476772108,-109.3338185
45101,1,24,11,2,4,17,59,38.24761476772108,-109.333549
45102,0,26,10,2,6,14,58,38.24761476772108,-109.3332795
45103,0,24,9,3,7,12,55,38.24761476772108,-109.33301
45104,2,29,10,6,11,8,66,38.24761476772108,-109.3327405
45105,1,29,9,5,10,8,62,38.24761476772108,-109.332471
45106,1,28,9,4,9,9,60,38.24761476772108,-109.3322015
45107,1,26,10,4,9,9,59,38.24761476772108,-109.331932
45108,4,20,12,5,9,11,61,38.24761476772108,-109.3316625
45109,3,18,12,4,8,13,58,38.24761476772108,-109.331393
45110,3,30,8,3,11,5,60,38.24734527313585,-109.4402688
45111,3,31,8,4,10,4,60,38.24734527313585,-109.4399993
45112,5,34,9,6,12,2,68,38.24734527313585,-109.4397299
45113,5,44,11,8,14,1,83,38.24734527313585,-109.4394604
45114,4,50,12,7,16,1,90,38.24734527313585,-109.4391909
45115,5,47,12,8,14,1,87,38.24734527313585,-109.4389214
45116,6,44,12,9,14,1,86,38.24734527313585,-109.4386519
45117,6,42,12,10,13,1,84,38.24734527313585,-109.4383824
45118,6,42,11,8,11,2,80,38.24734527313585,-109.4381129
45119,4,40,10,6,11,2,73,38.24734527313585,-109.4378434
45120,4,40,9,6,11,2,72,38.24734527313585,-109.4375739
45121,2,41,9,5,11,3,71,38.24734527313585,-109.4373044
45122,3,47,10,7,13,1,81,38.24734527313585,-109.4370349
45123,4,50,11,7,16,0,88,38.24734527313585,-109.4367654
45124,7,49,13,9,15,0,93,38.24734527313585,-109.4364959
45125,5,47,13,11,14,1,91,38.24734527313585,-109.4362264
45126,6,47,13,11,14,1,92,38.24734527313585,-109.4359569
45127,5,48,12,10,14,1,90,38.24734527313585,-109.4356874
45128,4,51,12,9,14,1,91,38.24734527313585,-109.4354179
45129,5,50,11,10,12,1,89,38.24734527313585,-109.4351484
45130,6,48,12,13,13,1,93,38.24734527313585,-109.434879
45131,6,47,13,13,13,0,92,38.24734527313585,-109.4346095
45132,5,46,13,12,14,1,91,38.24734527313585,-109.43434
45133,5,46,12,8,15,2,88,38.24734527313585,-109.4340705
45134,4,44,11,8,16,2,85,38.24734527313585,-109.433801
45135,3,44,11,5,14,5,82,38.24734527313585,-109.4335315
45136,2,38,10,2,12,10,74,38.24734527313585,-109.433262
45137,1,36,10,0,12,11,70,38.24734527313585,-109.4329925
45138,2,43,10,1,14,8,78,38.24734527313585,-109.432723
45139,3,49,11,4,16,4,87,38.24734527313585,-109.4324535
45140,5,46,12,7,15,2,87,38.24734527313585,-109.432184
45141,6,43,12,10,14,2,87,38.24734527313585,-109.4319145
45142,7,42,12,11,13,1,86,38.24734527313585,-109.431645
45143,8,41,13,14,12,1,89,38.24734527313585,-109.4313755
45144,7,40,13,15,12,1,88,38.24734527313585,-109.431106
45145,9,38,13,15,12,1,88,38.24734527313585,-109.4308365
45146,10,39,13,14,12,1,89,38.24734527313585,-109.430567
45147,7,42,12,11,12,1,85,38.24734527313585,-109.4302975
45148,3,46,10,7,12,2,80,38.24734527313585,-109.430028
45149,2,48,9,4,12,4,79,38.24734527313585,-109.4297586
45150,3,46,9,5,12,4,79,38.24734527313585,-109.4294891
45151,3,43,10,6,12,3,77,38.24734527313585,-109.4292196
45152,4,40,10,6,12,3,75,38.24734527313585,-109.4289501
45153,3,43,11,8,12,3,80,38.24734527313585,-109.4286806
45154,5,44,12,11,13,1,86,38.24734527313585,-109.4284111
45155,6,44,12,10,13,1,86,38.24734527313585,-109.4281416
45156,6,45,11,10,13,1,86,38.24734527313585,-109.4278721
45157,9,45,13,12,14,1,94,38.24734527313585,-109.4276026
45158,7,45,13,10,14,2,91,38.24734527313585,-109.4273331
45159,5,47,12,8,15,2,89,38.24734527313585,-109.4270636
45160,5,46,12,8,16,1,88,38.24734527313585,-109.4267941
45161,6,45,12,10,16,0,89,38.24734527313585,-109.4265246
45162,6,49,12,7,16,0,90,38.24734527313585,-109.4262551
45163,7,48,12,8,15,0,90,38.24734527313585,-109.4259856
45164,10,44,12,10,15,0,91,38.24734527313585,-109.4257161
45165,15,38,13,12,14,0,92,38.24734527313585,-109.4254466
45166,18,33,13,12,13,0,89,38.24734527313585,-109.4251771
45167,17,36,13,11,13,0,90,38.24734527313585,-109.4249077
45168,19,36,13,10,13,0,91,38.24734527313585,-109.4246382
45169,19,35,13,10,13,0,90,38.24734527313585,-109.4243687
45170,17,34,13,11,14,0,89,38.24734527313585,-109.4240992
45171,15,36,13,11,13,0,88,38.24734527313585,-109.4238297
45172,13,37,14,12,14,0,90,38.24734527313585,-109.4235602
45173,14,38,13,12,14,0,91,38.24734527313585,-109.4232907
45174,13,39,13,12,14,0,91,38.24734527313585,-109.4230212
45175,11,39,14,13,15,0,92,38.24734527313585,-109.4227517
45176,10,40,14,12,15,0,91,38.24734527313585,-109.4224822
45177,9,42,13,11,15,1,91,38.24734527313585,-109.4222127
45178,6,42,12,11,14,1,86,38.24734527313585,-109.4219432
45179,5,44,11,9,14,1,84,38.24734527313585,-109.4216737
45180,5,47,11,9,15,1,88,38.24734527313585,-109.4214042
45181,8,44,13,11,15,1,92,38.24734527313585,-109.4211347
45182,9,42,13,12,15,1,92,38.24734527313585,-109.4208652
45183,7,42,13,12,14,1,89,38.24734527313585,-109.4205957
45184,5,44,13,12,13,1,88,38.24734527313585,-109.4203262
45185,7,46,13,10,14,1,91,38.24734527313585,-109.4200568
45186,8,42,12,8,14,4,88,38.24734527313585,-109.4197873
45187,3,45,10,6,12,3,79,38.24734527313585,-109.4195178
45188,2,43,9,4,11,4,73,38.24734527313585,-109.4192483
45189,1,40,9,3,11,5,69,38.24734527313585,-109.4189788
45190,1,39,9,3,10,6,68,38.24734527313585,-109.4187093
45191,3,41,10,2,11,6,73,38.24734527313585,-109.4184398
45192,1,36,10,0,10,12,69,38.24734527313585,-109.4181703
45193,1,32,12,0,7,18,70,38.24734527313585,-109.4179008
45194,2,40,12,0,10,17,81,38.24734527313585,-109.4176313
45195,2,45,12,1,12,12,84,38.24734527313585,-109.4173618
45196,2,48,12,1,14,10,87,38.24734527313585,-109.4170923
45197,2,50,11,2,15,8,88,38.24734527313585,-109.4168228
45198,2,48,11,1,15,7,84,38.24734527313585,-109.4165533
45199,1,43,10,1,14,6,75,38.24734527313585,-109.4162838
45200,2,42,9,3,11,3,70,38.24734527313585,-109.4160143
45201,1,38,9,4,11,4,67,38.24734527313585,-109.4157448
45202,3,38,11,11,12,2,77,38.24734527313585,-109.4154753
45203,8,35,13,16,14,2,88,38.24734527313585,-109.4152058
45204,3,26,16,20,20,7,92,38.24734527313585,-109.4149364
45205,2,27,15,17,19,8,88,38.24734527313585,-109.4146669
45206,4,29,12,18,17,4,84,38.24734527313585,-109.4143974
45207,7,31,12,16,17,4,87,38.24734527313585,-109.4141279
45208,9,33,12,14,16,3,87,38.24734527313585,-109.4138584
45209,12,26,12,23,16,0,89,38.24734527313585,-109.4135889
45210,2,24,12,26,18,2,84,38.24734527313585,-109.4133194
45211,1,22,13,20,19,6,81,38.24734527313585,-109.4130499
45212,0,27,13,14,21,6,81,38.24734527313585,-109.4127804
45213,3,34,11,5,21,4,78,38.24734527313585,-109.4125109
45214,3,35,12,5,17,6,78,38.24734527313585,-109.4122414
45215,3,37,11,3,16,8,78,38.24734527313585,-109.4119719
45216,3,37,11,4,16,7,78,38.24734527313585,-109.4117024
45217,3,38,11,3,16,7,78,38.24734527313585,-109.4114329
45218,1,35,10,0,13,13,72,38.24734527313585,-109.4111634
45219,1,34,11,1,16,9,72,38.24734527313585,-109.4108939
45220,1,33,11,1,15,11,72,38.24734527313585,-109.4106244
45221,1,33,11,1,14,11,71,38.24734527313585,-109.4103549
45222,1,35,10,0,14,13,73,38.24734527313585,-109.4100855
45223,3,39,12,4,17,6,81,38.24734527313585,-109.409816
45224,6,38,13,8,18,3,86,38.24734527313585,-109.4095465
45225,9,38,14,12,17,1,91,38.24734527313585,-109.409277
45226,11,36,14,13,16,0,90,38.24734527313585,-109.4090075
45227,12,36,15,15,15,0,93,38.24734527313585,-109.408738
45228,13,35,15,17,13,0,93,38.24734527313585,-109.4084685
45229,16,33,15,17,13,0,94,38.24734527313585,-109.408199
45230,17,32,15,17,12,0,93,38.24734527313585,-109.4079295
45231,17,33,15,18,12,0,95,38.24734527313585,-109.40766
45232,16,34,15,17,12,0,94,38.24734527313585,-109.4073905
45233,19,31,15,17,11,0,93,38.24734527313585,-109.407121
45234,20,31,15,16,12,0,94,38.24734527313585,-109.4068515
45235,19,32,14,15,12,0,92,38.24734527313585,-109.406582
45236,19,31,14,16,12,0,92,38.24734527313585,-109.4063125
45237,19,31,14,15,12,0,91,38.24734527313585,-109.406043
45238,18,32,14,15,12,0,91,38.24734527313585,-109.4057735
45239,19,32,14,15,12,0,92,38.24734527313585,-109.405504
45240,18,32,15,15,12,0,92,38.24734527313585,-109.4052345
45241,19,32,15,14,13,0,93,38.24734527313585,-109.4049651
45242,15,35,15,14,13,0,92,38.24734527313585,-109.4046956
45243,13,39,14,13,13,0,92,38.24734527313585,-109.4044261
45244,12,41,14,12,12,0,91,38.24734527313585,-109.4041566
45245,12,42,14,12,13,0,93,38.24734527313585,-109.4038871
45246,12,40,14,13,13,1,93,38.24734527313585,-109.4036176
45247,14,38,14,13,13,1,93,38.24734527313585,-109.4033481
45248,15,37,14,13,13,0,92,38.24734527313585,-109.4030786
45249,14,41,13,11,13,0,92,38.24734527313585,-109.4028091
45250,11,45,13,10,12,1,92,38.24734527313585,-109.4025396
45251,10,44,13,10,13,1,91,38.24734527313585,-109.4022701
45252,11,41,14,12,13,1,92,38.24734527313585,-109.4020006
45253,11,41,14,12,13,1,92,38.24734527313585,-109.4017311
45254,12,41,14,12,13,1,93,38.24734527313585,-109.4014616
45255,15,37,15,13,14,0,94,38.24734527313585,-109.4011921
45256,14,37,15,13,13,0,92,38.24734527313585,-109.4009226
45257,14,38,14,13,13,0,92,38.24734527313585,-109.4006531
45258,15,36,14,13,13,0,91,38.24734527313585,-109.4003836
45259,17,34,14,13,13,0,91,38.24734527313585,-109.4001142
45260,15,35,14,14,13,1,92,38.24734527313585,-109.3998447
45261,12,37,15,14,14,1,93,38.24734527313585,-109.3995752
45262,13,36,15,14,14,0,92,38.24734527313585,-109.3993057
45263,13,35,15,14,14,0,91,38.24734527313585,-109.3990362
45264,12,36,15,15,14,1,93,38.24734527313585,-109.3987667
45265,11,36,15,15,13,1,91,38.24734527313585,-109.3984972
45266,9,37,15,15,13,1,90,38.24734527313585,-109.3982277
45267,8,38,14,13,14,1,88,38.24734527313585,-109.3979582
45268,7,36,14,13,13,2,85,38.24734527313585,-109.3976887
45269,10,35,14,14,13,1,87,38.24734527313585,-109.3974192
45270,9,36,14,13,14,1,87,38.24734527313585,-109.3971497
45271,8,39,14,12,14,1,88,38.24734527313585,-109.3968802
45272,6,42,14,11,15,2,90,38.24734527313585,-109.3966107
45273,5,45,14,10,14,2,90,38.24734527313585,-109.3963412
45274,5,47,14,10,15,1,92,38.24734527313585,-109.3960717
45275,4,46,13,8,15,3,89,38.24734527313585,-109.3958022
45276,4,46,13,7,14,3,87,38.24734527313585,-109.3955327
45277,4,46,13,7,14,3,87,38.24734527313585,-109.3952632
45278,4,44,13,8,14,3,86,38.24734527313585,-109.3949938
45279,5,44,14,10,15,1,89,38.24734527313585,-109.3947243
45280,6,40,14,12,14,2,88,38.24734527313585,-109.3944548
45281,7,39,14,13,13,1,87,38.24734527313585,-109.3941853
45282,7,39,14,13,13,1,87,38.24734527313585,-109.3939158
45283,7,40,14,12,13,2,88,38.24734527313585,-109.3936463
45284,6,41,14,12,14,1,88,38.24734527313585,-109.3933768
45285,7,42,14,12,15,1,91,38.24734527313585,-109.3931073
45286,7,45,14,12,15,1,94,38.24734527313585,-109.3928378
45287,6,47,14,11,14,1,93,38.24734527313585,-109.3925683
45288,7,46,13,11,14,1,92,38.24734527313585,-109.3922988
45289,6,46,14,10,16,1,93,38.24734527313585,-109.3920293
45290,5,45,14,11,16,1,92,38.24734527313585,-109.3917598
45291,6,44,14,12,15,1,92,38.24734527313585,-109.3914903
45292,6,44,14,13,15,1,93,38.24734527313585,-109.3912208
45293,6,45,14,12,14,1,92,38.24734527313585,-109.3909513
45294,7,46,14,12,14,1,94,38.24734527313585,-109.3906818
45295,8,45,14,13,14,0,94,38.24734527313585,-109.3904123
45296,8,45,14,13,14,0,94,38.24734527313585,-109.3901429
45297,9,43,14,13,14,0,93,38.24734527313585,-109.3898734
45298,10,42,14,13,13,0,92,38.24734527313585,-109.3896039
45299,12,40,14,13,13,0,92,38.24734527313585,-109.3893344
45300,15,37,14,13,13,0,92,38.24734527313585,-109.3890649
45301,17,36,14,13,13,0,93,38.24734527313585,-109.3887954
45302,17,35,14,13,13,0,92,38.24734527313585,-109.3885259
45303,13,39,14,13,13,0,92,38.24734527313585,-109.3882564
45304,13,38,14,13,13,0,91,38.24734527313585,-109.3879869
45305,13,36,13,13,13,1,89,38.24734527313585,-109.3877174
45306,15,33,13,14,13,0,88,38.24734527313585,-109.3874479
45307,16,36,14,14,12,0,92,38.24734527313585,-109.3871784
45308,14,38,14,14,12,0,92,38.24734527313585,-109.3869089
45309,13,37,14,13,14,0,91,38.24734527313585,-109.3866394
45310,14,36,13,13,14,0,90,38.24734527313585,-109.3863699
45311,16,36,13,13,14,0,92,38.24734527313585,-109.3861004
45312,15,36,13,13,13,0,90,38.24734527313585,-109.3858309
45313,14,35,13,13,13,1,89,38.24734527313585,-109.3855614
45314,12,35,13,13,14,1,88,38.24734527313585,-109.3852919
45315,11,35,13,11,13,2,85,38.24734527313585,-109.3850225
45316,11,37,13,11,13,2,87,38.24734527313585,-109.384753
45317,9,39,13,11,12,2,86,38.24734527313585,-109.3844835
45318,8,41,13,11,12,2,87,38.24734527313585,-109.384214
45319,7,41,13,11,13,2,87,38.24734527313585,-109.3839445
45320,8,41,13,11,13,2,88,38.24734527313585,-109.383675
45321,9,39,13,10,13,1,85,38.24734527313585,-109.3834055
45322,9,37,12,10,14,1,83,38.24734527313585,-109.383136
45323,10,33,11,9,11,4,78,38.24734527313585,-109.3828665
45324,11,24,11,11,10,3,70,38.24734527313585,-109.382597
45325,8,25,10,17,12,0,72,38.24734527313585,-109.3823275
45326,22,30,11,10,11,0,84,38.24734527313585,-109.382058
45327,21,33,12,10,12,0,88,38.24734527313585,-109.3817885
45328,18,35,13,10,11,1,88,38.24734527313585,-109.381519
45329,17,36,13,9,12,2,89,38.24734527313585,-109.3812495
45330,17,37,13,9,11,1,88,38.24734527313585,-109.38098
45331,18,36,13,10,11,1,89,38.24734527313585,-109.3807105
45332,18,35,13,11,10,1,88,38.24734527313585,-109.380441
45333,20,33,13,13,9,1,89,38.24734527313585,-109.3801716
45334,23,29,13,16,7,1,89,38.24734527313585,-109.3799021
45335,24,27,15,19,6,1,92,38.24734527313585,-109.3796326
45336,26,26,15,17,6,1,91,38.24734527313585,-109.3793631
45337,30,24,16,15,6,1,92,38.24734527313585,-109.3790936
45338,30,22,15,17,6,1,91,38.24734527313585,-109.3788241
45339,24,23,16,20,6,2,91,38.24734527313585,-109.3785546
45340,26,23,16,17,6,2,90,38.24734527313585,-109.3782851
45341,27,22,16,18,6,2,91,38.24734527313585,-109.3780156
45342,23,24,16,19,7,3,92,38.24734527313585,-109.3777461
45343,19,25,16,18,7,4,89,38.24734527313585,-109.3774766
45344,17,26,16,16,7,6,88,38.24734527313585,-109.3772071
45345,15,27,16,15,8,6,87,38.24734527313585,-109.3769376
45346,16,28,15,15,8,6,88,38.24734527313585,-109.3766681
45347,15,29,15,13,8,6,86,38.24734527313585,-109.3763986
45348,10,32,15,11,8,9,85,38.24734527313585,-109.3761291
45349,4,32,15,3,8,15,77,38.24734527313585,-109.3758596
45350,8,33,15,5,9,13,83,38.24734527313585,-109.3755901
45351,7,33,14,5,9,14,82,38.24734527313585,-109.3753206
45352,5,29,14,5,11,15,79,38.24734527313585,-109.3750512
45353,4,26,15,13,13,10,81,38.24734527313585,-109.3747817
45354,3,24,15,13,13,12,80,38.24734527313585,-109.3745122
45355,5,20,13,22,17,5,82,38.24734527313585,-109.3742427
45356,4,19,12,19,17,7,78,38.24734527313585,-109.3739732
45357,5,17,11,14,11,9,67,38.24734527313585,-109.3737037
45358,3,16,10,12,11,10,62,38.24734527313585,-109.3734342
45359,4,21,11,11,13,8,68,38.24734527313585,-109.3731647
45360,2,24,10,9,14,7,66,38.24734527313585,-109.3728952
45361,3,24,11,6,13,8,65,38.24734527313585,-109.3726257
45362,3,20,11,6,8,10,58,38.24734527313585,-109.3723562
45363,4,19,11,7,8,10,59,38.24734527313585,-109.3720867
45364,3,22,11,6,7,11,60,38.24734527313585,-109.3718172
45365,3,28,11,5,10,9,66,38.24734527313585,-109.3715477
45366,3,28,11,3,8,10,63,38.24734527313585,-109.3712782
45367,3,19,12,3,3,15,55,38.24734527313585,-109.3710087
45368,3,16,11,7,5,13,55,38.24734527313585,-109.3707392
45369,3,23,8,4,8,8,54,38.24734527313585,-109.3704697
45370,2,24,8,3,10,7,54,38.24734527313585,-109.3702003
45371,2,24,8,4,9,7,54,38.24734527313585,-109.3699308
45372,3,26,7,5,8,6,55,38.24734527313585,-109.3696613
45373,3,29,7,5,7,5,56,38.24734527313585,-109.3693918
45374,3,33,6,6,7,4,59,38.24734527313585,-109.3691223
45375,3,37,6,6,6,4,62,38.24734527313585,-109.3688528
45376,4,36,7,5,7,4,63,38.24734527313585,-109.3685833
45377,3,23,10,3,9,9,57,38.24734527313585,-109.3683138
45378,1,22,12,1,6,17,59,38.24734527313585,-109.3680443
45379,1,23,13,0,3,23,63,38.24734527313585,-109.3677748
45380,1,23,15,0,3,26,68,38.24734527313585,-109.3675053
45381,1,26,19,0,5,28,79,38.24734527313585,-109.3672358
45382,0,27,18,0,5,30,80,38.24734527313585,-109.3669663
45383,0,26,19,0,4,32,81,38.24734527313585,-109.3666968
45384,0,26,19,0,4,32,81,38.24734527313585,-109.3664273
45385,1,25,18,0,3,32,79,38.24734527313585,-109.3661578
45386,0,22,18,0,2,32,74,38.24734527313585,-109.3658883
45387,1,23,19,0,3,33,79,38.24734527313585,-109.3656188
45388,1,22,18,0,2,31,74,38.24734527313585,-109.3653493
45389,1,22,15,0,1,27,66,38.24734527313585,-109.3650799
45390,2,22,15,0,1,25,65,38.24734527313585,-109.3648104
45391,1,22,16,0,1,29,69,38.24734527313585,-109.3645409
45392,1,23,17,0,1,31,73,38.24734527313585,-109.3642714
45393,1,24,17,0,2,31,75,38.24734527313585,-109.3640019
45394,1,27,16,0,4,28,76,38.24734527313585,-109.3637324
45395,3,29,16,2,5,25,80,38.24734527313585,-109.3634629
45396,2,30,14,2,6,22,76,38.24734527313585,-109.3631934
45397,3,30,14,3,5,22,77,38.24734527313585,-109.3629239
45398,2,28,14,3,4,22,73,38.24734527313585,-109.3626544
45399,1,27,13,1,2,22,66,38.24734527313585,-109.3623849
45400,1,29,12,0,2,21,65,38.24734527313585,-109.3621154
45401,1,26,13,1,2,23,66,38.24734527313585,-109.3618459
45402,1,25,14,1,2,25,68,38.24734527313585,-109.3615764
45403,1,23,14,1,1,25,65,38.24734527313585,-109.3613069
45404,1,23,13,1,1,24,63,38.24734527313585,-109.3610374
45405,1,26,13,2,3,22,67,38.24734527313585,-109.3607679
45406,0,23,14,1,1,25,64,38.24734527313585,-109.3604984
45407,1,24,13,0,1,24,63,38.24734527313585,-109.360229
45408,1,22,13,0,2,22,60,38.24734527313585,-109.3599595
45409,0,22,12,0,2,21,57,38.24734527313585,-109.35969
45410,2,33,9,3,8,8,63,38.24734527313585,-109.3594205
45411,2,33,8,4,6,5,58,38.24734527313585,-109.359151
45412,4,23,8,2,2,12,51,38.24734527313585,-109.3588815
45413,2,23,11,2,2,19,59,38.24734527313585,-109.358612
45414,5,25,14,3,3,23,73,38.24734527313585,-109.3583425
45415,1,22,14,0,2,24,63,38.24734527313585,-109.358073
45416,1,29,12,0,5,20,67,38.24734527313585,-109.3578035
45417,1,32,12,0,5,20,70,38.24734527313585,-109.357534
45418,1,30,12,0,3,22,68,38.24734527313585,-109.3572645
45419,0,28,11,0,3,21,63,38.24734527313585,-109.356995
45420,0,36,9,0,9,12,66,38.24734527313585,-109.3567255
45421,1,28,10,4,8,7,58,38.24734527313585,-109.356456
45422,2,26,8,5,8,5,54,38.24734527313585,-109.3561865
45423,3,28,7,5,7,5,55,38.24734527313585,-109.355917
45424,5,31,8,5,8,4,61,38.24734527313585,-109.3556475
45425,2,28,9,5,9,5,58,38.24734527313585,-109.355378
45426,2,25,10,5,10,8,60,38.24734527313585,-109.3551086
45427,1,27,10,4,6,11,59,38.24734527313585,-109.3548391
45428,2,29,10,3,6,8,58,38.24734527313585,-109.3545696
45429,2,37,7,4,9,3,62,38.24734527313585,-109.3543001
45430,2,29,8,5,12,3,59,38.24734527313585,-109.3540306
45431,4,23,12,10,12,5,66,38.24734527313585,-109.3537611
45432,4,23,13,22,12,9,83,38.24734527313585,-109.3534916
45433,3,25,12,10,15,9,74,38.24734527313585,-109.3532221
45434,1,26,12,9,14,8,70,38.24734527313585,-109.3529526
45435,6,26,10,7,12,5,66,38.24734527313585,-109.3526831
45436,4,36,9,5,9,3,66,38.24734527313585,-109.3524136
45437,0,32,7,3,8,4,54,38.24734527313585,-109.3521441
45438,3,20,10,9,11,5,58,38.24734527313585,-109.3518746
45439,6,22,15,14,15,4,76,38.24734527313585,-109.3516051
45440,13,15,17,17,17,5,84,38.24734527313585,-109.3513356
45441,7,18,13,19,20,8,85,38.24734527313585,-109.3510661
45442,1,21,12,5,8,17,64,38.24734527313585,-109.3507966
45443,0,24,10,9,14,7,64,38.24734527313585,-109.3505271
45444,0,26,10,9,14,5,64,38.24734527313585,-109.3502577
45445,2,25,10,8,10,6,61,38.24734527313585,-109.3499882
45446,2,29,10,5,7,7,60,38.24734527313585,-109.3497187
45447,2,35,8,6,7,3,61,38.24734527313585,-109.3494492
45448,1,30,9,6,7,6,59,38.24734527313585,-109.3491797
45449,1,26,11,4,6,9,57,38.24734527313585,-109.3489102
45450,2,29,11,3,8,8,61,38.24734527313585,-109.3486407
45451,2,32,10,4,7,7,62,38.24734527313585,-109.3483712
45452,4,25,11,6,9,6,61,38.24734527313585,-109.3481017
45453,2,17,14,8,8,14,63,38.24734527313585,-109.3478322
45454,1,18,13,6,8,21,67,38.24734527313585,-109.3475627
45455,1,19,12,5,8,16,61,38.24734527313585,-109.3472932
45456,6,32,9,10,11,1,69,38.24734527313585,-109.3470237
45457,7,47,9,7,8,1,79,38.24734527313585,-109.3467542
45458,3,38,7,4,8,3,63,38.24734527313585,-109.3464847
45459,2,25,8,5,8,5,53,38.24734527313585,-109.3462152
45460,3,21,11,10,10,6,61,38.24734527313585,-109.3459457
45461,5,27,13,17,9,8,79,38.24734527313585,-109.3456762
45462,2,25,13,8,11,16,75,38.24734527313585,-109.3454068
45463,1,25,13,11,15,15,80,38.24734527313585,-109.3451373
45464,2,18,13,19,19,7,78,38.24734527313585,-109.3448678
45465,3,15,12,23,19,4,76,38.24734527313585,-109.3445983
45466,4,17,11,22,17,2,73,38.24734527313585,-109.3443288
45467,0,25,12,5,14,13,69,38.24734527313585,-109.3440593
45468,0,27,14,0,10,21,72,38.24734527313585,-109.3437898
45469,1,26,14,0,6,25,72,38.24734527313585,-109.3435203
45470,1,23,15,0,5,25,69,38.24734527313585,-109.3432508
45471,1,25,14,0,5,24,69,38.24734527313585,-109.3429813
45472,1,24,14,0,3,25,67,38.24734527313585,-109.3427118
45473,1,24,14,0,4,25,68,38.24734527313585,-109.3424423
45474,2,25,14,0,5,23,69,38.24734527313585,-109.3421728
45475,2,28,13,1,8,18,70,38.24734527313585,-109.3419033
45476,0,27,11,0,6,19,63,38.24734527313585,-109.3416338
45477,0,28,10,1,8,13,60,38.24734527313585,-109.3413643
45478,1,34,9,2,10,7,63,38.24734527313585,-109.3410948
45479,1,31,9,2,8,9,60,38.24734527313585,-109.3408253
45480,1,28,11,1,7,14,62,38.24734527313585,-109.3405558
45481,0,26,13,0,6,21,66,38.24734527313585,-109.3402864
45482,0,27,15,0,7,24,73,38.24734527313585,-109.3400169
45483,0,28,15,0,9,23,75,38.24734527313585,-109.3397474
45484,6,22,15,11,6,17,77,38.24734527313585,-109.3394779
45485,3,25,16,9,6,21,80,38.24734527313585,-109.3392084
45486,3,26,15,6,14,13,77,38.24734527313585,-109.3389389
45487,2,28,12,4,18,9,73,38.24734527313585,-109.3386694
45488,0,28,11,0,12,16,67,38.24734527313585,-109.3383999
45489,1,24,12,0,5,20,62,38.24734527313585,-109.3381304
45490,3,25,13,0,5,17,63,38.24734527313585,-109.3378609
45491,1,25,10,2,5,15,58,38.24734527313585,-109.3375914
45492,2,28,9,3,7,10,59,38.24734527313585,-109.3373219
45493,6,30,10,3,10,7,66,38.24734527313585,-109.3370524
45494,3,24,12,1,8,13,61,38.24734527313585,-109.3367829
45495,2,24,11,0,5,16,58,38.24734527313585,-109.3365134
45496,1,28,10,0,6,15,60,38.24734527313585,-109.3362439
45497,0,27,10,0,8,13,58,38.24734527313585,-109.3359744
45498,0,26,10,0,9,13,58,38.24734527313585,-109.3357049
45499,1,30,11,1,13,11,67,38.24734527313585,-109.3354355
45500,1,31,11,0,10,12,65,38.24734527313585,-109.335166
45501,2,40,11,0,11,9,73,38.24734527313585,-109.3348965
45502,1,43,9,0,12,7,72,38.24734527313585,-109.334627
45503,1,38,9,0,8,13,69,38.24734527313585,-109.3343575
45504,1,31,10,2,8,11,63,38.24734527313585,-109.334088
45505,1,26,11,3,5,15,61,38.24734527313585,-109.3338185
45506,1,24,11,2,4,17,59,38.24734527313585,-109.333549
45507,2,30,11,4,7,12,66,38.24734527313585,-109.3332795
45508,1,27,9,4,9,10,60,38.24734527313585,-109.33301
45509,2,28,10,5,9,8,62,38.24734527313585,-109.3327405
45510,1,27,9,5,10,8,60,38.24734527313585,-109.332471
45511,2,28,9,5,10,7,61,38.24734527313585,-109.3322015
45512,4,27,10,5,8,8,62,38.24734527313585,-109.331932
45513,3,21,13,5,9,11,62,38.24734527313585,-109.3316625
45514,2,22,12,2,6,19,63,38.24734527313585,-109.331393
45515,1,32,8,1,8,9,59,38.24707577855061,-109.4402688
45516,1,32,9,0,6,10,58,38.24707577855061,-109.4399993
45517,4,32,9,3,10,6,64,38.24707577855061,-109.4397299
45518,5,41,10,7,15,2,80,38.24707577855061,-109.4394604
45519,4,48,11,8,14,2,87,38.24707577855061,-109.4391909
45520,4,45,11,9,13,2,84,38.24707577855061,-109.4389214
45521,5,43,11,9,13,2,83,38.24707577855061,-109.4386519
45522,5,43,9,8,12,2,79,38.24707577855061,-109.4383824
45523,3,39,8,5,11,2,68,38.24707577855061,-109.4381129
45524,2,34,8,3,9,4,60,38.24707577855061,-109.4378434
45525,3,35,9,4,9,4,64,38.24707577855061,-109.4375739
45526,2,38,10,7,13,4,74,38.24707577855061,-109.4373044
45527,4,41,12,9,17,1,84,38.24707577855061,-109.4370349
45528,7,45,13,9,17,0,91,38.24707577855061,-109.4367654
45529,6,48,13,8,16,1,92,38.24707577855061,-109.4364959
45530,5,48,12,8,15,1,89,38.24707577855061,-109.4362264
45531,5,47,13,10,14,1,90,38.24707577855061,-109.4359569
45532,5,46,13,12,14,1,91,38.24707577855061,-109.4356874
45533,5,46,13,12,14,1,91,38.24707577855061,-109.4354179
45534,5,47,12,10,14,1,89,38.24707577855061,-109.4351484
45535,5,47,12,10,14,1,89,38.24707577855061,-109.434879
45536,5,46,12,10,14,1,88,38.24707577855061,-109.4346095
45537,5,45,12,10,14,1,87,38.24707577855061,-109.43434
45538,5,46,12,9,14,1,87,38.24707577855061,-109.4340705
45539,4,48,11,7,14,2,86,38.24707577855061,-109.433801
45540,3,45,10,4,13,6,81,38.24707577855061,-109.4335315
45541,2,39,10,1,10,11,73,38.24707577855061,-109.433262
45542,2,35,10,0,10,12,69,38.24707577855061,-109.4329925
45543,2,42,10,1,14,9,78,38.24707577855061,-109.432723
45544,3,50,10,2,15,6,86,38.24707577855061,-109.4324535
45545,3,48,11,5,15,5,87,38.24707577855061,-109.432184
45546,4,45,11,7,14,4,85,38.24707577855061,-109.4319145
45547,4,46,11,9,13,2,85,38.24707577855061,-109.431645
45548,5,46,11,9,13,2,86,38.24707577855061,-109.4313755
45549,5,44,11,10,13,2,85,38.24707577855061,-109.431106
45550,5,45,11,10,12,1,84,38.24707577855061,-109.4308365
45551,6,45,11,10,12,2,86,38.24707577855061,-109.430567
45552,5,47,11,9,12,2,86,38.24707577855061,-109.4302975
45553,3,48,10,6,13,3,83,38.24707577855061,-109.430028
45554,3,50,9,6,12,3,83,38.24707577855061,-109.4297586
45555,4,46,10,7,12,3,82,38.24707577855061,-109.4294891
45556,4,44,10,7,13,3,81,38.24707577855061,-109.4292196
45557,3,44,10,6,12,3,78,38.24707577855061,-109.4289501
45558,2,43,9,6,12,4,76,38.24707577855061,-109.4286806
45559,3,45,10,7,13,4,82,38.24707577855061,-109.4284111
45560,5,46,11,9,13,3,87,38.24707577855061,-109.4281416
45561,8,46,12,12,14,1,93,38.24707577855061,-109.4278721
45562,10,42,14,13,14,0,93,38.24707577855061,-109.4276026
45563,8,44,13,10,16,1,92,38.24707577855061,-109.4273331
45564,8,45,13,10,15,0,91,38.24707577855061,-109.4270636
45565,9,45,12,9,16,0,91,38.24707577855061,-109.4267941
45566,6,45,12,8,17,1,89,38.24707577855061,-109.4265246
45567,5,48,11,7,17,1,89,38.24707577855061,-109.4262551
45568,7,48,12,8,16,0,91,38.24707577855061,-109.4259856
45569,10,45,13,9,15,0,92,38.24707577855061,-109.4257161
45570,13,42,13,9,15,0,92,38.24707577855061,-109.4254466
45571,15,39,13,9,14,0,90,38.24707577855061,-109.4251771
45572,15,39,13,10,15,0,92,38.24707577855061,-109.4249077
45573,15,39,13,11,15,0,93,38.24707577855061,-109.4246382
45574,16,37,13,11,14,0,91,38.24707577855061,-109.4243687
45575,18,36,13,11,14,0,92,38.24707577855061,-109.4240992
45576,18,35,13,13,13,0,92,38.24707577855061,-109.4238297
45577,16,35,13,13,14,0,91,38.24707577855061,-109.4235602
45578,15,36,13,13,14,0,91,38.24707577855061,-109.4232907
45579,14,37,13,13,14,0,91,38.24707577855061,-109.4230212
45580,12,38,14,13,14,0,91,38.24707577855061,-109.4227517
45581,11,39,14,12,15,0,91,38.24707577855061,-109.4224822
45582,10,39,14,12,15,0,90,38.24707577855061,-109.4222127
45583,9,41,13,10,15,1,89,38.24707577855061,-109.4219432
45584,6,43,11,9,14,1,84,38.24707577855061,-109.4216737
45585,5,47,10,9,13,1,85,38.24707577855061,-109.4214042
45586,5,47,11,7,15,2,87,38.24707577855061,-109.4211347
45587,6,44,12,10,15,1,88,38.24707577855061,-109.4208652
45588,5,44,13,10,14,2,88,38.24707577855061,-109.4205957
45589,4,45,12,8,14,3,86,38.24707577855061,-109.4203262
45590,4,45,12,6,15,4,86,38.24707577855061,-109.4200568
45591,5,43,12,7,14,5,86,38.24707577855061,-109.4197873
45592,6,42,12,8,14,2,84,38.24707577855061,-109.4195178
45593,5,43,11,9,13,1,82,38.24707577855061,-109.4192483
45594,3,44,10,7,11,3,78,38.24707577855061,-109.4189788
45595,3,41,10,6,11,4,75,38.24707577855061,-109.4187093
45596,2,41,10,5,12,5,75,38.24707577855061,-109.4184398
45597,1,39,10,2,13,8,73,38.24707577855061,-109.4181703
45598,1,39,11,0,14,10,75,38.24707577855061,-109.4179008
45599,1,45,11,0,14,10,81,38.24707577855061,-109.4176313
45600,2,51,11,2,15,6,87,38.24707577855061,-109.4173618
45601,2,51,11,2,16,6,88,38.24707577855061,-109.4170923
45602,2,52,11,3,15,5,88,38.24707577855061,-109.4168228
45603,1,51,10,2,14,5,83,38.24707577855061,-109.4165533
45604,1,41,9,2,11,5,69,38.24707577855061,-109.4162838
45605,4,43,9,4,10,2,72,38.24707577855061,-109.4160143
45606,2,40,10,6,10,3,71,38.24707577855061,-109.4157448
45607,3,37,12,12,12,3,79,38.24707577855061,-109.4154753
45608,6,30,14,16,14,5,85,38.24707577855061,-109.4152058
45609,1,24,17,10,20,14,86,38.24707577855061,-109.4149364
45610,1,27,16,9,14,16,83,38.24707577855061,-109.4146669
45611,0,27,12,6,14,13,72,38.24707577855061,-109.4143974
45612,0,32,11,7,18,6,74,38.24707577855061,-109.4141279
45613,2,33,12,13,20,1,81,38.24707577855061,-109.4138584
45614,2,31,12,18,21,2,86,38.24707577855061,-109.4135889
45615,1,29,12,20,22,1,85,38.24707577855061,-109.4133194
45616,1,31,11,14,22,4,83,38.24707577855061,-109.4130499
45617,1,33,11,6,19,8,78,38.24707577855061,-109.4127804
45618,3,36,12,3,17,8,79,38.24707577855061,-109.4125109
45619,1,30,12,2,12,15,72,38.24707577855061,-109.4122414
45620,1,33,11,0,12,14,71,38.24707577855061,-109.4119719
45621,1,36,11,1,16,8,73,38.24707577855061,-109.4117024
45622,2,39,11,3,17,5,77,38.24707577855061,-109.4114329
45623,2,38,11,2,17,6,76,38.24707577855061,-109.4111634
45624,3,36,10,3,17,6,75,38.24707577855061,-109.4108939
45625,2,34,11,5,17,6,75,38.24707577855061,-109.4106244
45626,2,34,11,3,17,8,75,38.24707577855061,-109.4103549
45627,2,34,12,3,15,9,75,38.24707577855061,-109.4100855
45628,6,41,13,7,17,3,87,38.24707577855061,-109.409816
45629,7,41,14,12,16,1,91,38.24707577855061,-109.4095465
45630,10,37,15,16,15,0,93,38.24707577855061,-109.409277
45631,12,36,15,16,15,0,94,38.24707577855061,-109.4090075
45632,13,35,15,18,13,0,94,38.24707577855061,-109.408738
45633,15,33,15,17,13,0,93,38.24707577855061,-109.4084685
45634,16,33,15,17,13,0,94,38.24707577855061,-109.408199
45635,19,31,15,17,12,0,94,38.24707577855061,-109.4079295
45636,20,31,15,17,11,0,94,38.24707577855061,-109.40766
45637,17,32,15,17,12,0,93,38.24707577855061,-109.4073905
45638,20,32,14,16,12,0,94,38.24707577855061,-109.407121
45639,22,31,14,14,12,0,93,38.24707577855061,-109.4068515
45640,21,32,14,14,13,0,94,38.24707577855061,-109.406582
45641,20,32,14,14,12,0,92,38.24707577855061,-109.4063125
45642,20,31,14,14,13,0,92,38.24707577855061,-109.406043
45643,20,31,14,14,12,0,91,38.24707577855061,-109.4057735
45644,20,31,14,15,12,0,92,38.24707577855061,-109.405504
45645,18,32,15,16,12,0,93,38.24707577855061,-109.4052345
45646,16,34,15,14,13,0,92,38.24707577855061,-109.4049651
45647,12,39,15,13,13,0,92,38.24707577855061,-109.4046956
45648,12,40,14,13,13,0,92,38.24707577855061,-109.4044261
45649,13,40,14,13,12,0,92,38.24707577855061,-109.4041566
45650,14,39,14,13,12,0,92,38.24707577855061,-109.4038871
45651,16,38,14,12,13,0,93,38.24707577855061,-109.4036176
45652,16,37,14,12,13,0,92,38.24707577855061,-109.4033481
45653,16,37,14,13,13,0,93,38.24707577855061,-109.4030786
45654,13,40,14,13,13,0,93,38.24707577855061,-109.4028091
45655,12,42,14,12,13,0,93,38.24707577855061,-109.4025396
45656,11,42,14,12,13,0,92,38.24707577855061,-109.4022701
45657,11,40,14,13,13,0,91,38.24707577855061,-109.4020006
45658,12,39,15,13,13,1,93,38.24707577855061,-109.4017311
45659,12,40,14,12,12,1,91,38.24707577855061,-109.4014616
45660,12,41,14,12,12,1,92,38.24707577855061,-109.4011921
45661,13,39,14,13,13,0,92,38.24707577855061,-109.4009226
45662,15,35,15,14,13,0,92,38.24707577855061,-109.4006531
45663,18,33,15,13,13,0,92,38.24707577855061,-109.4003836
45664,17,34,14,13,13,0,91,38.24707577855061,-109.4001142
45665,12,39,14,12,13,1,91,38.24707577855061,-109.3998447
45666,11,40,14,12,14,1,92,38.24707577855061,-109.3995752
45667,12,39,14,13,13,0,91,38.24707577855061,-109.3993057
45668,13,37,14,14,14,0,92,38.24707577855061,-109.3990362
45669,15,35,14,14,14,0,92,38.24707577855061,-109.3987667
45670,14,36,15,15,14,0,94,38.24707577855061,-109.3984972
45671,9,41,15,14,14,1,94,38.24707577855061,-109.3982277
45672,7,42,14,12,13,1,89,38.24707577855061,-109.3979582
45673,8,40,14,12,13,1,88,38.24707577855061,-109.3976887
45674,12,37,15,13,14,1,92,38.24707577855061,-109.3974192
45675,9,40,14,12,14,1,90,38.24707577855061,-109.3971497
45676,7,41,14,10,14,2,88,38.24707577855061,-109.3968802
45677,5,42,14,10,14,2,87,38.24707577855061,-109.3966107
45678,5,44,13,10,14,2,88,38.24707577855061,-109.3963412
45679,5,47,13,8,13,2,88,38.24707577855061,-109.3960717
45680,4,47,13,7,13,3,87,38.24707577855061,-109.3958022
45681,4,48,13,7,13,3,88,38.24707577855061,-109.3955327
45682,4,47,13,7,12,3,86,38.24707577855061,-109.3952632
45683,4,45,13,8,13,3,86,38.24707577855061,-109.3949938
45684,5,43,14,9,15,2,88,38.24707577855061,-109.3947243
45685,5,39,14,10,14,3,85,38.24707577855061,-109.3944548
45686,5,39,14,11,14,2,85,38.24707577855061,-109.3941853
45687,5,40,14,12,14,2,87,38.24707577855061,-109.3939158
45688,6,40,14,11,14,2,87,38.24707577855061,-109.3936463
45689,7,42,14,13,14,1,91,38.24707577855061,-109.3933768
45690,6,43,14,11,16,1,91,38.24707577855061,-109.3931073
45691,5,44,14,10,16,1,90,38.24707577855061,-109.3928378
45692,6,47,14,11,16,1,95,38.24707577855061,-109.3925683
45693,6,47,14,10,16,0,93,38.24707577855061,-109.3922988
45694,4,46,14,9,17,1,91,38.24707577855061,-109.3920293
45695,4,44,14,9,16,2,89,38.24707577855061,-109.3917598
45696,5,44,14,10,16,1,90,38.24707577855061,-109.3914903
45697,6,44,14,11,16,1,92,38.24707577855061,-109.3912208
45698,7,45,14,13,15,0,94,38.24707577855061,-109.3909513
45699,8,44,14,14,14,0,94,38.24707577855061,-109.3906818
45700,9,45,14,13,13,0,94,38.24707577855061,-109.3904123
45701,8,45,14,12,13,0,92,38.24707577855061,-109.3901429
45702,8,44,14,13,14,0,93,38.24707577855061,-109.3898734
45703,9,43,14,13,14,0,93,38.24707577855061,-109.3896039
45704,12,41,14,14,13,0,94,38.24707577855061,-109.3893344
45705,16,37,14,14,12,0,93,38.24707577855061,-109.3890649
45706,18,35,14,14,13,0,94,38.24707577855061,-109.3887954
45707,16,36,14,15,13,0,94,38.24707577855061,-109.3885259
45708,13,38,14,14,12,0,91,38.24707577855061,-109.3882564
45709,14,35,13,14,12,0,88,38.24707577855061,-109.3879869
45710,15,33,13,14,13,0,88,38.24707577855061,-109.3877174
45711,14,35,13,14,13,1,90,38.24707577855061,-109.3874479
45712,13,37,15,16,12,0,93,38.24707577855061,-109.3871784
45713,12,38,14,15,13,0,92,38.24707577855061,-109.3869089
45714,13,36,14,14,14,0,91,38.24707577855061,-109.3866394
45715,14,35,13,13,14,0,89,38.24707577855061,-109.3863699
45716,16,35,13,14,13,0,91,38.24707577855061,-109.3861004
45717,16,36,13,13,12,0,90,38.24707577855061,-109.3858309
45718,15,37,13,13,12,0,90,38.24707577855061,-109.3855614
45719,14,37,14,13,12,1,91,38.24707577855061,-109.3852919
45720,12,38,14,12,12,1,89,38.24707577855061,-109.3850225
45721,13,40,14,12,13,0,92,38.24707577855061,-109.384753
45722,12,39,14,13,12,1,91,38.24707577855061,-109.3844835
45723,9,42,14,12,13,1,91,38.24707577855061,-109.384214
45724,7,44,13,10,13,2,89,38.24707577855061,-109.3839445
45725,7,44,13,10,13,1,88,38.24707577855061,-109.383675
45726,9,41,14,13,12,1,90,38.24707577855061,-109.3834055
45727,11,37,13,14,13,1,89,38.24707577855061,-109.383136
45728,14,30,12,12,13,2,83,38.24707577855061,-109.3828665
45729,16,23,12,11,10,2,74,38.24707577855061,-109.382597
45730,14,23,10,14,11,0,72,38.24707577855061,-109.3823275
45731,18,29,11,11,12,1,82,38.24707577855061,-109.382058
45732,19,34,11,9,12,1,86,38.24707577855061,-109.3817885
45733,18,36,13,10,12,1,90,38.24707577855061,-109.381519
45734,14,36,14,11,12,1,88,38.24707577855061,-109.3812495
45735,12,39,14,11,13,2,91,38.24707577855061,-109.38098
45736,13,40,14,12,12,1,92,38.24707577855061,-109.3807105
45737,17,37,13,14,10,1,92,38.24707577855061,-109.380441
45738,23,31,14,15,8,1,92,38.24707577855061,-109.3801716
45739,27,26,14,17,6,1,91,38.24707577855061,-109.3799021
45740,31,23,15,17,5,1,92,38.24707577855061,-109.3796326
45741,31,23,15,17,5,1,92,38.24707577855061,-109.3793631
45742,31,21,15,16,4,1,88,38.24707577855061,-109.3790936
45743,31,21,14,15,5,1,87,38.24707577855061,-109.3788241
45744,31,22,15,15,6,2,91,38.24707577855061,-109.3785546
45745,31,22,15,14,6,2,90,38.24707577855061,-109.3782851
45746,28,22,15,16,7,2,90,38.24707577855061,-109.3780156
45747,23,23,15,19,8,3,91,38.24707577855061,-109.3777461
45748,19,24,15,19,8,4,89,38.24707577855061,-109.3774766
45749,19,26,15,16,9,4,89,38.24707577855061,-109.3772071
45750,12,28,15,13,8,8,84,38.24707577855061,-109.3769376
45751,8,30,15,11,10,10,84,38.24707577855061,-109.3766681
45752,9,30,15,11,11,9,85,38.24707577855061,-109.3763986
45753,10,29,14,10,11,10,84,38.24707577855061,-109.3761291
45754,7,28,15,7,13,14,84,38.24707577855061,-109.3758596
45755,7,26,16,10,14,11,84,38.24707577855061,-109.3755901
45756,3,29,15,13,14,9,83,38.24707577855061,-109.3753206
45757,3,25,13,17,17,6,81,38.24707577855061,-109.3750512
45758,7,23,11,24,17,3,85,38.24707577855061,-109.3747817
45759,5,23,13,17,17,5,80,38.24707577855061,-109.3745122
45760,1,21,11,13,19,4,69,38.24707577855061,-109.3742427
45761,1,21,10,12,18,6,68,38.24707577855061,-109.3739732
45762,2,16,9,11,15,7,60,38.24707577855061,-109.3737037
45763,4,15,10,7,13,9,58,38.24707577855061,-109.3734342
45764,3,17,10,5,10,10,55,38.24707577855061,-109.3731647
45765,4,25,10,4,8,8,59,38.24707577855061,-109.3728952
45766,5,27,8,6,8,5,59,38.24707577855061,-109.3726257
45767,4,27,8,5,10,4,58,38.24707577855061,-109.3723562
45768,3,26,8,5,9,5,56,38.24707577855061,-109.3720867
45769,7,28,8,6,10,4,63,38.24707577855061,-109.3718172
45770,6,28,8,5,10,4,61,38.24707577855061,-109.3715477
45771,5,29,8,5,10,4,61,38.24707577855061,-109.3712782
45772,9,31,8,5,8,4,65,38.24707577855061,-109.3710087
45773,7,34,7,4,8,3,63,38.24707577855061,-109.3707392
45774,4,29,7,4,8,4,56,38.24707577855061,-109.3704697
45775,5,30,7,5,9,3,59,38.24707577855061,-109.3702003
45776,4,22,9,6,9,5,55,38.24707577855061,-109.3699308
45777,6,16,10,10,10,4,56,38.24707577855061,-109.3696613
45778,4,16,10,11,10,5,56,38.24707577855061,-109.3693918
45779,4,26,9,10,8,4,61,38.24707577855061,-109.3691223
45780,3,29,9,8,7,5,61,38.24707577855061,-109.3688528
45781,5,27,10,6,9,5,62,38.24707577855061,-109.3685833
45782,3,28,12,2,9,12,66,38.24707577855061,-109.3683138
45783,2,28,14,0,5,22,71,38.24707577855061,-109.3680443
45784,1,27,17,0,4,28,77,38.24707577855061,-109.3677748
45785,1,26,19,0,4,29,79,38.24707577855061,-109.3675053
45786,1,26,18,0,5,29,79,38.24707577855061,-109.3672358
45787,2,26,16,1,3,29,77,38.24707577855061,-109.3669663
45788,2,25,16,0,3,29,75,38.24707577855061,-109.3666968
45789,1,25,15,0,3,27,71,38.24707577855061,-109.3664273
45790,1,25,15,0,3,28,72,38.24707577855061,-109.3661578
45791,1,24,17,0,3,30,75,38.24707577855061,-109.3658883
45792,0,23,19,0,3,34,79,38.24707577855061,-109.3656188
45793,1,22,18,0,2,31,74,38.24707577855061,-109.3653493
45794,1,22,16,0,1,29,69,38.24707577855061,-109.3650799
45795,0,22,14,0,1,27,64,38.24707577855061,-109.3648104
45796,1,21,15,0,0,29,66,38.24707577855061,-109.3645409
45797,1,21,16,0,1,31,70,38.24707577855061,-109.3642714
45798,1,22,17,0,2,32,74,38.24707577855061,-109.3640019
45799,1,22,17,0,2,31,73,38.24707577855061,-109.3637324
45800,1,24,16,1,2,28,72,38.24707577855061,-109.3634629
45801,1,25,14,2,2,25,69,38.24707577855061,-109.3631934
45802,2,30,13,1,4,19,69,38.24707577855061,-109.3629239
45803,2,31,13,2,4,20,72,38.24707577855061,-109.3626544
45804,2,28,13,2,2,23,70,38.24707577855061,-109.3623849
45805,1,27,13,1,2,23,67,38.24707577855061,-109.3621154
45806,2,26,14,1,2,23,68,38.24707577855061,-109.3618459
45807,2,23,15,0,1,26,67,38.24707577855061,-109.3615764
45808,1,21,15,0,0,28,65,38.24707577855061,-109.3613069
45809,1,21,15,0,0,27,64,38.24707577855061,-109.3610374
45810,1,23,14,2,2,25,67,38.24707577855061,-109.3607679
45811,1,23,14,1,1,25,65,38.24707577855061,-109.3604984
45812,0,24,14,0,2,24,64,38.24707577855061,-109.360229
45813,1,23,14,0,2,23,63,38.24707577855061,-109.3599595
45814,0,20,14,0,2,24,60,38.24707577855061,-109.35969
45815,0,26,12,0,0,22,60,38.24707577855061,-109.3594205
45816,1,30,10,3,5,9,58,38.24707577855061,-109.359151
45817,1,28,10,3,5,11,58,38.24707577855061,-109.3588815
45818,1,22,13,1,4,19,60,38.24707577855061,-109.358612
45819,6,30,17,0,3,20,76,38.24707577855061,-109.3583425
45820,2,23,15,0,1,25,66,38.24707577855061,-109.358073
45821,2,25,14,0,1,24,66,38.24707577855061,-109.3578035
45822,2,27,14,0,1,24,68,38.24707577855061,-109.357534
45823,1,28,13,0,1,23,66,38.24707577855061,-109.3572645
45824,0,29,10,0,4,19,62,38.24707577855061,-109.356995
45825,0,37,9,0,9,12,67,38.24707577855061,-109.3567255
45826,2,33,9,4,7,5,60,38.24707577855061,-109.356456
45827,2,33,7,5,7,3,57,38.24707577855061,-109.3561865
45828,3,34,7,5,7,3,59,38.24707577855061,-109.355917
45829,8,32,8,5,9,3,65,38.24707577855061,-109.3556475
45830,3,26,9,4,8,7,57,38.24707577855061,-109.355378
45831,1,28,10,3,8,9,59,38.24707577855061,-109.3551086
45832,1,30,10,3,8,8,60,38.24707577855061,-109.3548391
45833,3,34,9,5,7,4,62,38.24707577855061,-109.3545696
45834,1,39,6,3,9,3,61,38.24707577855061,-109.3543001
45835,4,28,10,10,13,3,68,38.24707577855061,-109.3540306
45836,4,30,12,15,15,5,81,38.24707577855061,-109.3537611
45837,1,23,13,7,10,20,74,38.24707577855061,-109.3534916
45838,2,25,10,9,18,6,70,38.24707577855061,-109.3532221
45839,1,27,10,9,10,7,64,38.24707577855061,-109.3529526
45840,4,38,10,6,10,3,71,38.24707577855061,-109.3526831
45841,2,39,7,6,10,2,66,38.24707577855061,-109.3524136
45842,1,28,8,6,11,4,58,38.24707577855061,-109.3521441
45843,5,20,14,14,11,7,71,38.24707577855061,-109.3518746
45844,13,16,17,21,14,4,85,38.24707577855061,-109.3516051
45845,8,16,15,19,16,10,84,38.24707577855061,-109.3513356
45846,3,22,14,13,13,15,80,38.24707577855061,-109.3510661
45847,1,26,12,8,13,11,71,38.24707577855061,-109.3507966
45848,1,29,10,7,16,5,68,38.24707577855061,-109.3505271
45849,1,26,10,7,13,7,64,38.24707577855061,-109.3502577
45850,2,25,11,8,10,7,63,38.24707577855061,-109.3499882
45851,1,32,9,4,7,8,61,38.24707577855061,-109.3497187
45852,3,31,9,6,8,3,60,38.24707577855061,-109.3494492
45853,1,25,11,6,8,7,58,38.24707577855061,-109.3491797
45854,1,24,12,3,6,11,57,38.24707577855061,-109.3489102
45855,1,29,10,3,7,8,58,38.24707577855061,-109.3486407
45856,2,35,8,5,7,5,62,38.24707577855061,-109.3483712
45857,5,32,8,7,9,3,64,38.24707577855061,-109.3481017
45858,4,23,12,9,11,8,67,38.24707577855061,-109.3478322
45859,1,21,13,5,8,17,65,38.24707577855061,-109.3475627
45860,3,25,9,8,9,7,61,38.24707577855061,-109.3472932
45861,4,45,8,6,9,1,73,38.24707577855061,-109.3470237
45862,4,42,7,5,8,2,68,38.24707577855061,-109.3467542
45863,2,31,7,4,9,4,57,38.24707577855061,-109.3464847
45864,2,24,10,10,11,5,62,38.24707577855061,-109.3462152
45865,4,31,13,18,14,4,84,38.24707577855061,-109.3459457
45866,5,24,14,7,20,15,85,38.24707577855061,-109.3456762
45867,2,24,13,10,18,14,81,38.24707577855061,-109.3454068
45868,3,18,12,14,18,7,72,38.24707577855061,-109.3451373
45869,1,20,11,17,20,3,72,38.24707577855061,-109.3448678
45870,0,24,11,9,18,5,67,38.24707577855061,-109.3445983
45871,0,26,10,3,16,7,62,38.24707577855061,-109.3443288
45872,0,27,12,0,10,19,68,38.24707577855061,-109.3440593
45873,1,25,13,0,8,21,68,38.24707577855061,-109.3437898
45874,0,24,13,1,7,20,65,38.24707577855061,-109.3435203
45875,1,23,13,0,5,22,64,38.24707577855061,-109.3432508
45876,1,24,13,0,5,22,65,38.24707577855061,-109.3429813
45877,1,24,12,0,4,21,62,38.24707577855061,-109.3427118
45878,2,21,13,0,3,23,62,38.24707577855061,-109.3424423
45879,2,20,14,0,3,26,65,38.24707577855061,-109.3421728
45880,2,20,15,0,2,26,65,38.24707577855061,-109.3419033
45881,2,23,13,0,3,24,65,38.24707577855061,-109.3416338
45882,3,23,12,0,3,21,62,38.24707577855061,-109.3413643
45883,3,22,12,0,3,19,59,38.24707577855061,-109.3410948
45884,3,22,12,0,4,19,60,38.24707577855061,-109.3408253
45885,2,24,14,0,4,22,66,38.24707577855061,-109.3405558
45886,2,24,14,0,5,24,69,38.24707577855061,-109.3402864
45887,1,26,15,0,6,24,72,38.24707577855061,-109.3400169
45888,1,28,14,0,8,21,72,38.24707577855061,-109.3397474
45889,1,26,13,0,8,21,69,38.24707577855061,-109.3394779
45890,0,25,13,1,7,20,66,38.24707577855061,-109.3392084
45891,4,28,12,9,5,15,73,38.24707577855061,-109.3389389
45892,5,27,12,7,4,12,67,38.24707577855061,-109.3386694
45893,3,22,11,4,9,10,59,38.24707577855061,-109.3383999
45894,1,26,10,3,6,13,59,38.24707577855061,-109.3381304
45895,3,29,10,4,7,10,63,38.24707577855061,-109.3378609
45896,2,21,11,4,8,12,58,38.24707577855061,-109.3375914
45897,2,20,12,4,7,14,59,38.24707577855061,-109.3373219
45898,1,24,13,1,7,18,64,38.24707577855061,-109.3370524
45899,0,27,12,0,4,21,64,38.24707577855061,-109.3367829
45900,0,26,11,0,4,19,60,38.24707577855061,-109.3365134
45901,1,29,10,0,6,15,61,38.24707577855061,-109.3362439
45902,1,30,9,0,8,13,61,38.24707577855061,-109.3359744
45903,0,28,9,0,10,11,58,38.24707577855061,-109.3357049
45904,0,29,10,0,11,12,62,38.24707577855061,-109.3354355
45905,0,39,8,0,10,10,67,38.24707577855061,-109.335166
45906,1,43,9,0,10,8,71,38.24707577855061,-109.3348965
45907,2,43,10,0,12,9,76,38.24707577855061,-109.334627
45908,2,34,11,0,7,16,70,38.24707577855061,-109.3343575
45909,0,28,10,0,5,16,59,38.24707577855061,-109.334088
45910,2,24,10,4,8,10,58,38.24707577855061,-109.3338185
45911,3,30,9,4,7,10,63,38.24707577855061,-109.333549
45912,3,34,9,6,9,7,68,38.24707577855061,-109.3332795
45913,8,42,8,8,8,3,77,38.24707577855061,-109.33301
45914,3,34,10,5,9,6,67,38.24707577855061,-109.3327405
45915,1,29,9,3,8,9,59,38.24707577855061,-109.332471
45916,4,29,9,5,10,8,65,38.24707577855061,-109.3322015
45917,6,25,13,5,8,10,67,38.24707577855061,-109.331932
45918,3,21,12,5,8,13,62,38.24707577855061,-109.3316625
45919,2,20,12,4,7,15,60,38.24707577855061,-109.331393
45920,1,32,8,2,9,10,62,38.24680628396537,-109.4402688
45921,1,30,9,1,5,15,61,38.24680628396537,-109.4399993
45922,2,28,9,3,8,11,61,38.24680628396537,-109.4397299
45923,3,35,10,5,13,5,71,38.24680628396537,-109.4394604
45924,4,43,10,7,15,2,81,38.24680628396537,-109.4391909
45925,5,47,10,8,12,2,84,38.24680628396537,-109.4389214
45926,6,44,10,8,12,2,82,38.24680628396537,-109.4386519
45927,3,40,8,4,10,3,68,38.24680628396537,-109.4383824
45928,4,36,9,5,10,3,67,38.24680628396537,-109.4381129
45929,5,34,10,7,12,2,70,38.24680628396537,-109.4378434
45930,3,39,11,3,14,6,76,38.24680628396537,-109.4375739
45931,5,41,12,8,17,2,85,38.24680628396537,-109.4373044
45932,5,43,12,11,16,1,88,38.24680628396537,-109.4370349
45933,5,45,13,12,15,1,91,38.24680628396537,-109.4367654
45934,5,46,13,13,14,0,91,38.24680628396537,-109.4364959
45935,4,48,13,10,16,0,91,38.24680628396537,-109.4362264
45936,4,49,13,11,15,0,92,38.24680628396537,-109.4359569
45937,4,47,13,13,13,1,91,38.24680628396537,-109.4356874
45938,6,45,14,15,13,0,93,38.24680628396537,-109.4354179
45939,7,44,14,14,14,0,93,38.24680628396537,-109.4351484
45940,4,46,13,12,15,0,90,38.24680628396537,-109.434879
45941,4,45,13,12,14,1,89,38.24680628396537,-109.4346095
45942,5,44,13,13,14,1,90,38.24680628396537,-109.43434
45943,6,44,13,12,15,1,91,38.24680628396537,-109.4340705
45944,6,45,12,9,15,1,88,38.24680628396537,-109.433801
45945,4,46,11,4,14,5,84,38.24680628396537,-109.4335315
45946,2,38,10,1,10,10,71,38.24680628396537,-109.433262
45947,2,35,10,2,9,11,69,38.24680628396537,-109.4329925
45948,2,42,9,1,12,8,74,38.24680628396537,-109.432723
45949,2,48,10,3,14,6,83,38.24680628396537,-109.4324535
45950,3,44,11,3,13,8,82,38.24680628396537,-109.432184
45951,3,45,10,5,11,7,81,38.24680628396537,-109.4319145
45952,3,47,9,5,11,6,81,38.24680628396537,-109.431645
45953,2,47,9,4,11,7,80,38.24680628396537,-109.4313755
45954,2,49,9,4,12,5,81,38.24680628396537,-109.431106
45955,2,51,9,4,13,4,83,38.24680628396537,-109.4308365
45956,2,52,9,5,13,3,84,38.24680628396537,-109.430567
45957,3,52,9,6,12,3,85,38.24680628396537,-109.4302975
45958,2,51,9,5,13,3,83,38.24680628396537,-109.430028
45959,3,53,10,7,12,2,87,38.24680628396537,-109.4297586
45960,5,48,11,10,13,1,88,38.24680628396537,-109.4294891
45961,6,47,12,11,13,1,90,38.24680628396537,-109.4292196
45962,5,46,11,10,13,1,86,38.24680628396537,-109.4289501
45963,5,45,11,10,13,1,85,38.24680628396537,-109.4286806
45964,5,46,11,10,13,2,87,38.24680628396537,-109.4284111
45965,7,46,13,12,13,1,92,38.24680628396537,-109.4281416
45966,9,43,14,14,13,0,93,38.24680628396537,-109.4278721
45967,10,43,14,12,14,0,93,38.24680628396537,-109.4276026
45968,7,44,13,11,15,1,91,38.24680628396537,-109.4273331
45969,7,45,13,10,16,0,91,38.24680628396537,-109.4270636
45970,7,44,11,9,16,0,87,38.24680628396537,-109.4267941
45971,6,43,11,9,15,1,85,38.24680628396537,-109.4265246
45972,7,44,12,9,16,1,89,38.24680628396537,-109.4262551
45973,7,47,12,9,16,0,91,38.24680628396537,-109.4259856
45974,8,47,12,9,15,0,91,38.24680628396537,-109.4257161
45975,10,45,12,9,15,0,91,38.24680628396537,-109.4254466
45976,13,41,13,10,15,0,92,38.24680628396537,-109.4251771
45977,13,38,13,11,15,0,90,38.24680628396537,-109.4249077
45978,12,39,13,12,15,0,91,38.24680628396537,-109.4246382
45979,15,38,13,11,15,0,92,38.24680628396537,-109.4243687
45980,18,36,13,11,14,0,92,38.24680628396537,-109.4240992
45981,18,34,13,12,14,0,91,38.24680628396537,-109.4238297
45982,18,35,13,11,14,0,91,38.24680628396537,-109.4235602
45983,17,36,13,12,13,0,91,38.24680628396537,-109.4232907
45984,16,36,13,12,13,0,90,38.24680628396537,-109.4230212
45985,15,36,13,12,14,0,90,38.24680628396537,-109.4227517
45986,15,37,13,11,15,0,91,38.24680628396537,-109.4224822
45987,12,39,13,10,15,1,90,38.24680628396537,-109.4222127
45988,9,39,13,9,14,2,86,38.24680628396537,-109.4219432
45989,6,38,11,7,12,5,79,38.24680628396537,-109.4216737
45990,4,43,9,6,13,3,78,38.24680628396537,-109.4214042
45991,5,49,10,9,13,1,87,38.24680628396537,-109.4211347
45992,6,49,11,10,14,1,91,38.24680628396537,-109.4208652
45993,4,46,12,7,15,3,87,38.24680628396537,-109.4205957
45994,3,44,12,5,14,6,84,38.24680628396537,-109.4203262
45995,3,44,11,2,13,9,82,38.24680628396537,-109.4200568
45996,6,45,12,3,14,6,86,38.24680628396537,-109.4197873
45997,5,45,12,6,14,5,87,38.24680628396537,-109.4195178
45998,4,47,12,6,14,3,86,38.24680628396537,-109.4192483
45999,2,47,11,5,14,4,83,38.24680628396537,-109.4189788
46000,2,44,10,4,10,6,76,38.24680628396537,-109.4187093
46001,1,40,9,4,11,6,71,38.24680628396537,-109.4184398
46002,1,38,9,3,11,6,68,38.24680628396537,-109.4181703
46003,1,39,10,1,13,9,73,38.24680628396537,-109.4179008
46004,1,40,11,0,12,14,78,38.24680628396537,-109.4176313
46005,3,40,12,1,14,11,81,38.24680628396537,-109.4173618
46006,3,44,12,1,15,10,85,38.24680628396537,-109.4170923
46007,1,46,11,2,15,8,83,38.24680628396537,-109.4168228
46008,1,43,10,3,13,6,76,38.24680628396537,-109.4165533
46009,1,38,10,3,11,5,68,38.24680628396537,-109.4162838
46010,2,34,9,3,11,5,64,38.24680628396537,-109.4160143
46011,3,40,10,7,12,4,76,38.24680628396537,-109.4157448
46012,4,37,12,11,13,4,81,38.24680628396537,-109.4154753
46013,4,29,15,16,15,7,86,38.24680628396537,-109.4152058
46014,2,24,16,9,17,15,83,38.24680628396537,-109.4149364
46015,1,27,13,10,13,13,77,38.24680628396537,-109.4146669
46016,0,31,11,7,15,10,74,38.24680628396537,-109.4143974
46017,0,32,11,6,17,5,71,38.24680628396537,-109.4141279
46018,3,34,11,7,20,2,77,38.24680628396537,-109.4138584
46019,4,37,11,16,16,1,85,38.24680628396537,-109.4135889
46020,6,40,12,14,17,0,89,38.24680628396537,-109.4133194
46021,6,42,12,12,17,0,89,38.24680628396537,-109.4130499
46022,6,43,12,9,18,1,89,38.24680628396537,-109.4127804
46023,4,41,12,5,17,5,84,38.24680628396537,-109.4125109
46024,1,33,12,0,13,13,72,38.24680628396537,-109.4122414
46025,1,36,10,0,11,14,72,38.24680628396537,-109.4119719
46026,1,39,11,0,15,9,75,38.24680628396537,-109.4117024
46027,2,38,11,1,17,6,75,38.24680628396537,-109.4114329
46028,2,37,10,3,16,5,73,38.24680628396537,-109.4111634
46029,4,35,10,6,16,4,75,38.24680628396537,-109.4108939
46030,5,34,11,10,17,2,79,38.24680628396537,-109.4106244
46031,6,36,12,9,17,3,83,38.24680628396537,-109.4103549
46032,7,37,13,10,17,3,87,38.24680628396537,-109.4100855
46033,9,40,14,12,17,0,92,38.24680628396537,-109.409816
46034,8,40,14,15,16,0,93,38.24680628396537,-109.4095465
46035,10,37,15,17,15,0,94,38.24680628396537,-109.409277
46036,13,36,15,16,15,0,95,38.24680628396537,-109.4090075
46037,12,35,15,16,14,0,92,38.24680628396537,-109.408738
46038,17,32,15,16,13,0,93,38.24680628396537,-109.4084685
46039,17,33,15,15,13,0,93,38.24680628396537,-109.408199
46040,19,32,15,16,12,0,94,38.24680628396537,-109.4079295
46041,19,30,15,17,12,0,93,38.24680628396537,-109.40766
46042,17,32,14,16,13,0,92,38.24680628396537,-109.4073905
46043,19,32,14,14,12,0,91,38.24680628396537,-109.407121
46044,21,31,14,14,12,0,92,38.24680628396537,-109.4068515
46045,22,31,14,13,12,0,92,38.24680628396537,-109.406582
46046,23,30,14,12,12,0,91,38.24680628396537,-109.4063125
46047,19,31,14,13,13,0,90,38.24680628396537,-109.406043
46048,20,31,14,13,13,0,91,38.24680628396537,-109.4057735
46049,19,32,14,14,12,0,91,38.24680628396537,-109.405504
46050,17,33,15,15,13,0,93,38.24680628396537,-109.4052345
46051,15,35,15,14,13,0,92,38.24680628396537,-109.4049651
46052,14,36,14,13,14,0,91,38.24680628396537,-109.4046956
46053,14,36,15,13,13,0,91,38.24680628396537,-109.4044261
46054,15,35,15,13,13,0,91,38.24680628396537,-109.4041566
46055,16,35,14,14,13,0,92,38.24680628396537,-109.4038871
46056,18,33,14,13,13,0,91,38.24680628396537,-109.4036176
46057,16,34,14,13,13,0,90,38.24680628396537,-109.4033481
46058,16,34,14,13,13,0,90,38.24680628396537,-109.4030786
46059,16,35,14,13,13,0,91,38.24680628396537,-109.4028091
46060,15,36,15,13,13,0,92,38.24680628396537,-109.4025396
46061,15,36,15,13,13,0,92,38.24680628396537,-109.4022701
46062,14,36,14,13,14,0,91,38.24680628396537,-109.4020006
46063,12,37,15,14,14,0,92,38.24680628396537,-109.4017311
46064,11,40,15,13,13,1,93,38.24680628396537,-109.4014616
46065,10,41,14,13,13,1,92,38.24680628396537,-109.4011921
46066,13,38,15,14,13,0,93,38.24680628396537,-109.4009226
46067,17,34,15,15,12,0,93,38.24680628396537,-109.4006531
46068,16,33,14,14,13,0,90,38.24680628396537,-109.4003836
46069,15,35,14,14,14,0,92,38.24680628396537,-109.4001142
46070,12,39,15,14,13,0,93,38.24680628396537,-109.3998447
46071,12,39,15,14,14,0,94,38.24680628396537,-109.3995752
46072,12,38,15,14,14,0,93,38.24680628396537,-109.3993057
46073,14,37,15,14,14,0,94,38.24680628396537,-109.3990362
46074,15,36,15,14,14,0,94,38.24680628396537,-109.3987667
46075,9,40,15,14,15,0,93,38.24680628396537,-109.3984972
46076,8,43,15,12,14,1,93,38.24680628396537,-109.3982277
46077,7,44,15,11,14,1,92,38.24680628396537,-109.3979582
46078,8,43,15,12,14,1,93,38.24680628396537,-109.3976887
46079,10,41,14,12,14,1,92,38.24680628396537,-109.3974192
46080,7,42,14,10,14,2,89,38.24680628396537,-109.3971497
46081,6,43,13,10,14,2,88,38.24680628396537,-109.3968802
46082,5,43,13,9,14,2,86,38.24680628396537,-109.3966107
46083,5,44,13,9,13,3,87,38.24680628396537,-109.3963412
46084,5,45,13,8,12,2,85,38.24680628396537,-109.3960717
46085,5,46,13,9,13,2,88,38.24680628396537,-109.3958022
46086,5,47,13,9,13,2,89,38.24680628396537,-109.3955327
46087,5,47,13,8,13,2,88,38.24680628396537,-109.3952632
46088,5,46,13,7,14,2,87,38.24680628396537,-109.3949938
46089,5,43,13,9,15,2,87,38.24680628396537,-109.3947243
46090,5,42,14,9,15,2,87,38.24680628396537,-109.3944548
46091,4,42,14,9,15,2,86,38.24680628396537,-109.3941853
46092,4,42,14,10,15,2,87,38.24680628396537,-109.3939158
46093,5,42,14,11,14,2,88,38.24680628396537,-109.3936463
46094,6,43,14,12,15,1,91,38.24680628396537,-109.3933768
46095,5,44,14,10,16,2,91,38.24680628396537,-109.3931073
46096,4,45,14,10,16,2,91,38.24680628396537,-109.3928378
46097,4,47,14,9,16,2,92,38.24680628396537,-109.3925683
46098,4,48,14,8,16,2,92,38.24680628396537,-109.3922988
46099,4,47,13,8,16,1,89,38.24680628396537,-109.3920293
46100,4,45,14,8,16,2,89,38.24680628396537,-109.3917598
46101,4,44,14,10,17,1,90,38.24680628396537,-109.3914903
46102,5,44,14,11,17,1,92,38.24680628396537,-109.3912208
46103,6,44,14,12,16,1,93,38.24680628396537,-109.3909513
46104,8,43,14,13,15,0,93,38.24680628396537,-109.3906818
46105,8,44,14,14,14,0,94,38.24680628396537,-109.3904123
46106,8,45,14,13,13,0,93,38.24680628396537,-109.3901429
46107,8,45,14,13,14,0,94,38.24680628396537,-109.3898734
46108,9,45,14,13,14,0,95,38.24680628396537,-109.3896039
46109,12,42,14,14,13,0,95,38.24680628396537,-109.3893344
46110,15,39,14,14,12,0,94,38.24680628396537,-109.3890649
46111,16,37,14,14,12,0,93,38.24680628396537,-109.3887954
46112,13,39,14,15,13,0,94,38.24680628396537,-109.3885259
46113,13,37,14,15,12,0,91,38.24680628396537,-109.3882564
46114,15,33,13,16,12,0,89,38.24680628396537,-109.3879869
46115,15,33,13,15,12,0,88,38.24680628396537,-109.3877174
46116,10,39,14,15,13,0,91,38.24680628396537,-109.3874479
46117,10,39,15,16,12,1,93,38.24680628396537,-109.3871784
46118,10,39,14,15,13,1,92,38.24680628396537,-109.3869089
46119,11,38,14,15,14,0,92,38.24680628396537,-109.3866394
46120,13,36,14,15,14,0,92,38.24680628396537,-109.3863699
46121,17,34,14,15,12,0,92,38.24680628396537,-109.3861004
46122,19,34,13,15,11,0,92,38.24680628396537,-109.3858309
46123,16,35,14,14,12,0,91,38.24680628396537,-109.3855614
46124,14,36,14,13,12,1,90,38.24680628396537,-109.3852919
46125,12,37,14,15,12,0,90,38.24680628396537,-109.3850225
46126,12,38,14,15,13,0,92,38.24680628396537,-109.384753
46127,12,39,14,14,13,0,92,38.24680628396537,-109.3844835
46128,9,40,14,13,13,1,90,38.24680628396537,-109.384214
46129,7,43,13,10,13,2,88,38.24680628396537,-109.3839445
46130,6,43,13,9,13,2,86,38.24680628396537,-109.383675
46131,8,43,14,13,12,1,91,38.24680628396537,-109.3834055
46132,9,38,13,13,13,1,87,38.24680628396537,-109.383136
46133,12,36,12,11,13,2,86,38.24680628396537,-109.3828665
46134,17,26,13,11,11,2,80,38.24680628396537,-109.382597
46135,16,21,10,17,10,0,74,38.24680628396537,-109.3823275
46136,22,27,12,10,11,1,83,38.24680628396537,-109.382058
46137,22,34,11,8,11,1,87,38.24680628396537,-109.3817885
46138,19,36,13,9,11,1,89,38.24680628396537,-109.381519
46139,16,38,13,10,11,1,89,38.24680628396537,-109.3812495
46140,11,41,14,13,12,1,92,38.24680628396537,-109.38098
46141,12,40,14,14,12,1,93,38.24680628396537,-109.3807105
46142,19,35,14,16,9,1,94,38.24680628396537,-109.380441
46143,27,28,13,17,6,1,92,38.24680628396537,-109.3801716
46144,32,23,13,19,5,1,93,38.24680628396537,-109.3799021
46145,33,21,13,20,4,1,92,38.24680628396537,-109.3796326
46146,31,21,15,18,4,2,91,38.24680628396537,-109.3793631
46147,30,21,15,16,3,2,87,38.24680628396537,-109.3790936
46148,28,21,15,17,4,2,87,38.24680628396537,-109.3788241
46149,25,22,14,17,6,5,89,38.24680628396537,-109.3785546
46150,17,24,15,14,7,9,86,38.24680628396537,-109.3782851
46151,12,25,16,14,8,10,85,38.24680628396537,-109.3780156
46152,12,24,17,13,7,11,84,38.24680628396537,-109.3777461
46153,14,24,16,12,7,10,83,38.24680628396537,-109.3774766
46154,14,26,15,10,7,11,83,38.24680628396537,-109.3772071
46155,4,29,15,5,11,14,78,38.24680628396537,-109.3769376
46156,1,29,15,6,8,19,78,38.24680628396537,-109.3766681
46157,1,33,16,6,9,20,85,38.24680628396537,-109.3763986
46158,1,33,15,8,9,18,84,38.24680628396537,-109.3761291
46159,2,28,15,9,17,12,83,38.24680628396537,-109.3758596
46160,0,28,12,8,18,11,77,38.24680628396537,-109.3755901
46161,2,20,11,14,17,5,69,38.24680628396537,-109.3753206
46162,5,17,10,10,13,5,60,38.24680628396537,-109.3750512
46163,4,20,10,6,11,6,57,38.24680628396537,-109.3747817
46164,3,25,8,6,11,6,59,38.24680628396537,-109.3745122
46165,4,25,8,5,8,6,56,38.24680628396537,-109.3742427
46166,2,31,7,4,6,7,57,38.24680628396537,-109.3739732
46167,1,33,7,4,7,6,58,38.24680628396537,-109.3737037
46168,2,34,7,4,7,6,60,38.24680628396537,-109.3734342
46169,2,33,6,3,6,6,56,38.24680628396537,-109.3731647
46170,2,34,6,3,7,5,57,38.24680628396537,-109.3728952
46171,2,33,6,3,7,5,56,38.24680628396537,-109.3726257
46172,2,31,6,3,8,5,55,38.24680628396537,-109.3723562
46173,2,28,7,4,8,5,54,38.24680628396537,-109.3720867
46174,3,32,7,5,8,4,59,38.24680628396537,-109.3718172
46175,3,37,6,4,8,4,62,38.24680628396537,-109.3715477
46176,2,36,7,3,9,3,60,38.24680628396537,-109.3712782
46177,4,35,7,5,9,3,63,38.24680628396537,-109.3710087
46178,1,35,9,6,11,5,67,38.24680628396537,-109.3707392
46179,3,29,11,11,13,2,69,38.24680628396537,-109.3704697
46180,3,23,12,14,16,1,69,38.24680628396537,-109.3702003
46181,5,23,14,18,13,2,75,38.24680628396537,-109.3699308
46182,2,19,13,16,12,8,70,38.24680628396537,-109.3696613
46183,3,24,10,14,12,4,67,38.24680628396537,-109.3693918
46184,3,28,11,8,13,6,69,38.24680628396537,-109.3691223
46185,2,27,11,2,8,12,62,38.24680628396537,-109.3688528
46186,4,28,13,0,5,18,68,38.24680628396537,-109.3685833
46187,3,28,14,0,5,22,72,38.24680628396537,-109.3683138
46188,1,27,16,0,5,28,77,38.24680628396537,-109.3680443
46189,2,27,18,0,5,28,80,38.24680628396537,-109.3677748
46190,2,27,17,0,4,28,78,38.24680628396537,-109.3675053
46191,2,26,14,0,2,27,71,38.24680628396537,-109.3672358
46192,2,26,14,0,3,25,70,38.24680628396537,-109.3669663
46193,3,30,14,0,5,21,73,38.24680628396537,-109.3666968
46194,2,30,13,0,5,21,71,38.24680628396537,-109.3664273
46195,2,27,14,2,4,24,73,38.24680628396537,-109.3661578
46196,2,27,16,1,4,27,77,38.24680628396537,-109.3658883
46197,2,25,17,1,3,30,78,38.24680628396537,-109.3656188
46198,1,24,19,0,4,33,81,38.24680628396537,-109.3653493
46199,1,22,18,0,2,32,75,38.24680628396537,-109.3650799
46200,1,22,15,0,1,29,68,38.24680628396537,-109.3648104
46201,0,24,14,0,1,26,65,38.24680628396537,-109.3645409
46202,1,24,15,0,2,28,70,38.24680628396537,-109.3642714
46203,1,23,16,1,2,30,73,38.24680628396537,-109.3640019
46204,1,22,16,1,1,29,70,38.24680628396537,-109.3637324
46205,1,24,13,1,1,24,64,38.24680628396537,-109.3634629
46206,1,30,10,0,3,17,61,38.24680628396537,-109.3631934
46207,1,32,10,0,5,16,64,38.24680628396537,-109.3629239
46208,1,32,11,0,4,19,67,38.24680628396537,-109.3626544
46209,1,29,12,1,3,21,67,38.24680628396537,-109.3623849
46210,1,27,13,1,2,22,66,38.24680628396537,-109.3621154
46211,2,25,14,0,2,23,66,38.24680628396537,-109.3618459
46212,1,22,15,0,1,27,66,38.24680628396537,-109.3615764
46213,1,21,15,0,1,28,66,38.24680628396537,-109.3613069
46214,1,21,15,1,1,27,66,38.24680628396537,-109.3610374
46215,1,22,15,2,1,27,68,38.24680628396537,-109.3607679
46216,1,21,16,1,2,28,69,38.24680628396537,-109.3604984
46217,2,22,16,1,2,27,70,38.24680628396537,-109.360229
46218,1,22,16,0,1,27,67,38.24680628396537,-109.3599595
46219,1,20,15,0,1,27,64,38.24680628396537,-109.35969
46220,3,26,16,0,2,21,68,38.24680628396537,-109.3594205
46221,1,27,10,1,3,16,58,38.24680628396537,-109.359151
46222,1,30,10,2,5,11,59,38.24680628396537,-109.3588815
46223,2,30,12,2,5,12,63,38.24680628396537,-109.358612
46224,2,32,11,2,6,12,65,38.24680628396537,-109.3583425
46225,0,24,13,0,2,23,62,38.24680628396537,-109.358073
46226,1,22,14,0,2,23,62,38.24680628396537,-109.3578035
46227,2,23,14,0,2,22,63,38.24680628396537,-109.357534
46228,1,24,13,0,2,22,62,38.24680628396537,-109.3572645
46229,1,28,11,0,3,19,62,38.24680628396537,-109.356995
46230,0,36,10,0,7,15,68,38.24680628396537,-109.3567255
46231,1,33,9,3,7,8,61,38.24680628396537,-109.356456
46232,1,32,8,5,5,7,58,38.24680628396537,-109.3561865
46233,1,29,8,4,5,7,54,38.24680628396537,-109.355917
46234,7,27,9,3,9,5,60,38.24680628396537,-109.3556475
46235,4,26,9,5,8,7,59,38.24680628396537,-109.355378
46236,4,30,9,3,8,7,61,38.24680628396537,-109.3551086
46237,4,31,8,5,8,5,61,38.24680628396537,-109.3548391
46238,2,32,7,4,7,3,55,38.24680628396537,-109.3545696
46239,1,32,6,4,9,3,55,38.24680628396537,-109.3543001
46240,4,25,11,10,12,5,67,38.24680628396537,-109.3540306
46241,2,26,11,8,14,12,73,38.24680628396537,-109.3537611
46242,1,27,10,9,12,11,70,38.24680628396537,-109.3534916
46243,2,27,8,11,17,2,67,38.24680628396537,-109.3532221
46244,2,28,9,7,6,7,59,38.24680628396537,-109.3529526
46245,3,37,8,6,9,2,65,38.24680628396537,-109.3526831
46246,3,34,8,7,11,2,65,38.24680628396537,-109.3524136
46247,7,25,11,13,12,2,70,38.24680628396537,-109.3521441
46248,12,19,18,15,13,9,86,38.24680628396537,-109.3518746
46249,21,13,17,17,12,8,88,38.24680628396537,-109.3516051
46250,7,17,15,15,12,15,81,38.24680628396537,-109.3513356
46251,2,22,13,11,12,13,73,38.24680628396537,-109.3510661
46252,1,26,12,8,13,10,70,38.24680628396537,-109.3507966
46253,1,27,10,10,17,4,69,38.24680628396537,-109.3505271
46254,0,29,11,7,14,9,70,38.24680628396537,-109.3502577
46255,3,26,11,5,10,8,63,38.24680628396537,-109.3499882
46256,4,34,10,3,8,7,66,38.24680628396537,-109.3497187
46257,2,30,8,6,9,4,59,38.24680628396537,-109.3494492
46258,1,25,12,4,8,9,59,38.24680628396537,-109.3491797
46259,2,26,12,3,7,10,60,38.24680628396537,-109.3489102
46260,2,31,10,2,8,8,61,38.24680628396537,-109.3486407
46261,2,33,9,3,7,6,60,38.24680628396537,-109.3483712
46262,3,32,9,6,9,3,62,38.24680628396537,-109.3481017
46263,3,22,12,6,10,7,60,38.24680628396537,-109.3478322
46264,3,23,11,6,11,7,61,38.24680628396537,-109.3475627
46265,3,33,8,7,8,4,63,38.24680628396537,-109.3472932
46266,4,43,8,6,8,2,71,38.24680628396537,-109.3470237
46267,4,31,9,6,11,3,64,38.24680628396537,-109.3467542
46268,1,22,11,7,9,9,59,38.24680628396537,-109.3464847
46269,2,27,13,13,14,8,77,38.24680628396537,-109.3462152
46270,6,25,14,16,17,9,87,38.24680628396537,-109.3459457
46271,1,21,15,9,15,20,81,38.24680628396537,-109.3456762
46272,2,25,12,10,20,8,77,38.24680628396537,-109.3454068
46273,1,24,10,12,18,4,69,38.24680628396537,-109.3451373
46274,1,22,10,13,15,3,64,38.24680628396537,-109.3448678
46275,3,22,10,9,11,4,59,38.24680628396537,-109.3445983
46276,3,29,10,8,10,4,64,38.24680628396537,-109.3443288
46277,2,18,12,6,9,11,58,38.24680628396537,-109.3440593
46278,1,21,13,5,8,16,64,38.24680628396537,-109.3437898
46279,1,27,12,0,9,17,66,38.24680628396537,-109.3435203
46280,1,24,12,0,6,19,62,38.24680628396537,-109.3432508
46281,1,23,12,0,4,19,59,38.24680628396537,-109.3429813
46282,1,25,11,0,5,18,60,38.24680628396537,-109.3427118
46283,2,21,13,1,5,20,62,38.24680628396537,-109.3424423
46284,2,16,14,1,3,24,60,38.24680628396537,-109.3421728
46285,2,15,15,0,2,25,59,38.24680628396537,-109.3419033
46286,2,16,14,1,2,22,57,38.24680628396537,-109.3416338
46287,3,20,13,1,4,17,58,38.24680628396537,-109.3413643
46288,3,23,11,1,5,15,58,38.24680628396537,-109.3410948
46289,2,22,11,1,4,17,57,38.24680628396537,-109.3408253
46290,3,21,12,2,4,19,61,38.24680628396537,-109.3405558
46291,2,24,12,1,5,19,63,38.24680628396537,-109.3402864
46292,2,24,13,0,6,21,66,38.24680628396537,-109.3400169
46293,2,22,12,0,4,21,61,38.24680628396537,-109.3397474
46294,2,22,11,2,5,15,57,38.24680628396537,-109.3394779
46295,2,28,9,3,7,9,58,38.24680628396537,-109.3392084
46296,2,30,8,4,8,6,58,38.24680628396537,-109.3389389
46297,1,26,8,4,10,7,56,38.24680628396537,-109.3386694
46298,1,23,9,4,7,11,55,38.24680628396537,-109.3383999
46299,2,21,11,4,8,11,57,38.24680628396537,-109.3381304
46300,1,17,12,4,5,17,56,38.24680628396537,-109.3378609
46301,0,20,12,0,3,23,58,38.24680628396537,-109.3375914
46302,0,22,13,0,3,24,62,38.24680628396537,-109.3373219
46303,0,24,12,0,3,22,61,38.24680628396537,-109.3370524
46304,0,29,10,0,3,19,61,38.24680628396537,-109.3367829
46305,0,27,9,0,4,17,57,38.24680628396537,-109.3365134
46306,0,26,9,0,5,15,55,38.24680628396537,-109.3362439
46307,0,26,9,0,7,13,55,38.24680628396537,-109.3359744
46308,0,29,9,0,10,10,58,38.24680628396537,-109.3357049
46309,0,40,8,0,12,7,67,38.24680628396537,-109.3354355
46310,1,45,8,1,11,6,72,38.24680628396537,-109.335166
46311,2,43,10,1,11,9,76,38.24680628396537,-109.3348965
46312,2,35,10,0,8,14,69,38.24680628396537,-109.334627
46313,3,24,10,1,1,20,59,38.24680628396537,-109.3343575
46314,2,28,8,2,5,12,57,38.24680628396537,-109.334088
46315,2,31,6,4,8,6,57,38.24680628396537,-109.3338185
46316,3,32,6,5,9,4,59,38.24680628396537,-109.333549
46317,4,37,7,7,10,3,68,38.24680628396537,-109.3332795
46318,10,41,9,9,8,2,79,38.24680628396537,-109.33301
46319,3,35,9,5,7,5,64,38.24680628396537,-109.3327405
46320,2,35,8,4,7,6,62,38.24680628396537,-109.332471
46321,6,33,10,6,9,5,69,38.24680628396537,-109.3322015
46322,4,29,12,3,8,11,67,38.24680628396537,-109.331932
46323,3,26,10,6,9,10,64,38.24680628396537,-109.3316625
46324,3,24,11,6,9,9,62,38.24680628396537,-109.331393
46325,1,34,8,1,9,8,61,38.24653678938014,-109.4402688
46326,0,35,9,0,8,12,64,38.24653678938014,-109.4399993
46327,1,34,9,0,8,12,64,38.24653678938014,-109.4397299
46328,1,36,9,0,10,10,66,38.24653678938014,-109.4394604
46329,2,40,9,3,12,5,71,38.24653678938014,-109.4391909
46330,3,44,9,5,12,2,75,38.24653678938014,-109.4389214
46331,4,38,8,5,11,2,68,38.24653678938014,-109.4386519
46332,2,36,8,2,9,4,61,38.24653678938014,-109.4383824
46333,3,36,9,6,11,3,68,38.24653678938014,-109.4381129
46334,6,37,11,10,15,1,80,38.24653678938014,-109.4378434
46335,4,45,12,8,16,2,87,38.24653678938014,-109.4375739
46336,5,46,12,9,15,1,88,38.24653678938014,-109.4373044
46337,4,45,12,8,14,2,85,38.24653678938014,-109.4370349
46338,4,46,13,11,13,2,89,38.24653678938014,-109.4367654
46339,4,46,13,12,14,1,90,38.24653678938014,-109.4364959
46340,4,48,13,10,15,1,91,38.24653678938014,-109.4362264
46341,4,47,12,9,15,2,89,38.24653678938014,-109.4359569
46342,5,45,13,14,13,1,91,38.24653678938014,-109.4356874
46343,7,44,14,14,13,0,92,38.24653678938014,-109.4354179
46344,7,44,14,14,13,0,92,38.24653678938014,-109.4351484
46345,7,44,14,14,14,0,93,38.24653678938014,-109.434879
46346,7,43,14,14,14,0,92,38.24653678938014,-109.4346095
46347,6,43,15,16,13,0,93,38.24653678938014,-109.43434
46348,6,43,15,16,14,0,94,38.24653678938014,-109.4340705
46349,5,42,13,12,15,1,88,38.24653678938014,-109.433801
46350,3,41,11,3,13,7,78,38.24653678938014,-109.4335315
46351,2,36,10,1,10,10,69,38.24653678938014,-109.433262
46352,1,35,10,1,11,10,68,38.24653678938014,-109.4329925
46353,1,40,9,1,12,8,71,38.24653678938014,-109.432723
46354,2,45,10,0,13,9,79,38.24653678938014,-109.4324535
46355,3,48,10,2,11,8,82,38.24653678938014,-109.432184
46356,3,50,9,3,11,6,82,38.24653678938014,-109.4319145
46357,3,50,9,3,12,6,83,38.24653678938014,-109.431645
46358,2,50,9,2,12,7,82,38.24653678938014,-109.4313755
46359,2,53,9,3,12,5,84,38.24653678938014,-109.431106
46360,2,53,9,3,13,5,85,38.24653678938014,-109.4308365
46361,3,52,9,5,13,4,86,38.24653678938014,-109.430567
46362,4,51,10,7,13,2,87,38.24653678938014,-109.4302975
46363,3,50,11,7,15,2,88,38.24653678938014,-109.430028
46364,4,50,11,7,15,1,88,38.24653678938014,-109.4297586
46365,6,48,13,11,14,0,92,38.24653678938014,-109.4294891
46366,9,45,13,13,14,0,94,38.24653678938014,-109.4292196
46367,10,42,13,14,13,0,92,38.24653678938014,-109.4289501
46368,13,40,14,14,12,1,94,38.24653678938014,-109.4286806
46369,15,39,14,13,12,1,94,38.24653678938014,-109.4284111
46370,14,38,14,13,12,1,92,38.24653678938014,-109.4281416
46371,13,40,14,11,14,1,93,38.24653678938014,-109.4278721
46372,9,44,13,9,15,1,91,38.24653678938014,-109.4276026
46373,8,44,13,9,16,1,91,38.24653678938014,-109.4273331
46374,7,45,13,9,16,0,90,38.24653678938014,-109.4270636
46375,6,45,12,9,16,1,89,38.24653678938014,-109.4267941
46376,5,44,11,7,16,1,84,38.24653678938014,-109.4265246
46377,5,41,11,7,15,2,81,38.24653678938014,-109.4262551
46378,5,46,11,7,16,1,86,38.24653678938014,-109.4259856
46379,7,47,12,9,16,0,91,38.24653678938014,-109.4257161
46380,9,45,13,10,16,0,93,38.24653678938014,-109.4254466
46381,9,43,13,10,16,0,91,38.24653678938014,-109.4251771
46382,8,41,13,12,16,0,90,38.24653678938014,-109.4249077
46383,9,41,13,14,15,0,92,38.24653678938014,-109.4246382
46384,14,38,13,12,14,0,91,38.24653678938014,-109.4243687
46385,21,35,12,11,13,0,92,38.24653678938014,-109.4240992
46386,23,34,12,9,13,0,91,38.24653678938014,-109.4238297
46387,25,33,12,9,13,0,92,38.24653678938014,-109.4235602
46388,22,35,12,9,13,0,91,38.24653678938014,-109.4232907
46389,20,35,12,10,13,0,90,38.24653678938014,-109.4230212
46390,18,35,13,11,13,0,90,38.24653678938014,-109.4227517
46391,12,38,13,11,15,1,90,38.24653678938014,-109.4224822
46392,10,41,13,10,16,1,91,38.24653678938014,-109.4222127
46393,7,42,12,9,16,2,88,38.24653678938014,-109.4219432
46394,6,42,11,8,15,2,84,38.24653678938014,-109.4216737
46395,5,43,10,8,13,3,82,38.24653678938014,-109.4214042
46396,5,49,9,9,12,1,85,38.24653678938014,-109.4211347
46397,3,48,9,4,14,3,81,38.24653678938014,-109.4208652
46398,2,40,10,3,12,6,73,38.24653678938014,-109.4205957
46399,2,37,10,2,11,9,71,38.24653678938014,-109.4203262
46400,3,46,11,1,13,9,83,38.24653678938014,-109.4200568
46401,3,47,12,4,15,5,86,38.24653678938014,-109.4197873
46402,3,46,11,5,15,5,85,38.24653678938014,-109.4195178
46403,4,47,11,5,16,4,87,38.24653678938014,-109.4192483
46404,5,50,12,6,15,3,91,38.24653678938014,-109.4189788
46405,5,49,11,7,14,3,89,38.24653678938014,-109.4187093
46406,2,44,10,3,13,6,78,38.24653678938014,-109.4184398
46407,2,41,10,3,13,6,75,38.24653678938014,-109.4181703
46408,2,41,11,2,13,9,78,38.24653678938014,-109.4179008
46409,2,44,11,2,15,8,82,38.24653678938014,-109.4176313
46410,3,50,11,4,14,5,87,38.24653678938014,-109.4173618
46411,2,52,11,3,14,6,88,38.24653678938014,-109.4170923
46412,1,49,11,1,14,8,84,38.24653678938014,-109.4168228
46413,1,41,10,2,12,9,75,38.24653678938014,-109.4165533
46414,1,33,10,2,10,8,64,38.24653678938014,-109.4162838
46415,2,31,10,5,11,7,66,38.24653678938014,-109.4160143
46416,3,39,11,7,12,5,77,38.24653678938014,-109.4157448
46417,6,36,12,11,14,4,83,38.24653678938014,-109.4154753
46418,5,29,12,18,16,4,84,38.24653678938014,-109.4152058
46419,2,27,15,9,17,15,85,38.24653678938014,-109.4149364
46420,0,28,13,6,11,15,73,38.24653678938014,-109.4146669
46421,0,31,11,4,14,10,70,38.24653678938014,-109.4143974
46422,0,31,10,6,13,7,67,38.24653678938014,-109.4141279
46423,3,34,11,6,16,4,74,38.24653678938014,-109.4138584
46424,6,43,11,8,16,2,86,38.24653678938014,-109.4135889
46425,6,47,12,9,16,0,90,38.24653678938014,-109.4133194
46426,7,46,12,10,16,0,91,38.24653678938014,-109.4130499
46427,7,45,12,11,16,0,91,38.24653678938014,-109.4127804
46428,5,44,12,7,16,3,87,38.24653678938014,-109.4125109
46429,3,39,11,2,15,8,78,38.24653678938014,-109.4122414
46430,2,41,10,0,13,9,75,38.24653678938014,-109.4119719
46431,1,42,9,0,14,8,74,38.24653678938014,-109.4117024
46432,1,39,10,0,15,7,72,38.24653678938014,-109.4114329
46433,1,33,10,3,14,8,69,38.24653678938014,-109.4111634
46434,3,32,10,8,15,3,71,38.24653678938014,-109.4108939
46435,10,33,12,12,15,1,83,38.24653678938014,-109.4106244
46436,12,36,13,12,16,0,89,38.24653678938014,-109.4103549
46437,12,36,13,14,15,0,90,38.24653678938014,-109.4100855
46438,12,36,14,15,15,0,92,38.24653678938014,-109.409816
46439,10,39,15,15,15,0,94,38.24653678938014,-109.4095465
46440,10,38,15,16,15,0,94,38.24653678938014,-109.409277
46441,12,36,15,16,14,0,93,38.24653678938014,-109.4090075
46442,15,33,15,16,14,0,93,38.24653678938014,-109.408738
46443,20,32,15,14,12,0,93,38.24653678938014,-109.4084685
46444,19,32,14,14,13,0,92,38.24653678938014,-109.408199
46445,18,32,14,15,13,0,92,38.24653678938014,-109.4079295
46446,16,32,14,15,13,0,90,38.24653678938014,-109.40766
46447,16,33,14,14,13,0,90,38.24653678938014,-109.4073905
46448,17,34,14,13,13,0,91,38.24653678938014,-109.407121
46449,19,32,14,14,12,0,91,38.24653678938014,-109.4068515
46450,21,31,14,13,13,0,92,38.24653678938014,-109.406582
46451,22,31,14,12,13,0,92,38.24653678938014,-109.4063125
46452,18,32,14,13,13,0,90,38.24653678938014,-109.406043
46453,17,31,14,15,13,0,90,38.24653678938014,-109.4057735
46454,16,31,14,15,13,0,89,38.24653678938014,-109.405504
46455,15,32,15,15,13,0,90,38.24653678938014,-109.4052345
46456,14,33,14,15,13,1,90,38.24653678938014,-109.4049651
46457,15,33,14,15,13,0,90,38.24653678938014,-109.4046956
46458,14,33,15,14,14,1,91,38.24653678938014,-109.4044261
46459,16,34,15,13,14,0,92,38.24653678938014,-109.4041566
46460,15,36,14,13,14,0,92,38.24653678938014,-109.4038871
46461,16,34,14,13,13,0,90,38.24653678938014,-109.4036176
46462,17,33,14,12,13,0,89,38.24653678938014,-109.4033481
46463,17,33,14,13,13,0,90,38.24653678938014,-109.4030786
46464,16,33,14,14,13,0,90,38.24653678938014,-109.4028091
46465,15,34,15,14,13,0,91,38.24653678938014,-109.4025396
46466,17,34,15,14,12,0,92,38.24653678938014,-109.4022701
46467,18,33,15,14,13,0,93,38.24653678938014,-109.4020006
46468,16,34,15,14,13,0,92,38.24653678938014,-109.4017311
46469,15,36,15,14,13,0,93,38.24653678938014,-109.4014616
46470,13,38,15,15,12,0,93,38.24653678938014,-109.4011921
46471,16,34,14,14,13,0,91,38.24653678938014,-109.4009226
46472,19,33,14,15,12,0,93,38.24653678938014,-109.4006531
46473,20,33,14,14,12,0,93,38.24653678938014,-109.4003836
46474,18,34,14,13,13,0,92,38.24653678938014,-109.4001142
46475,11,39,14,14,14,0,92,38.24653678938014,-109.3998447
46476,13,39,15,13,13,0,93,38.24653678938014,-109.3995752
46477,13,39,15,14,13,0,94,38.24653678938014,-109.3993057
46478,13,38,15,14,14,0,94,38.24653678938014,-109.3990362
46479,11,39,15,14,14,0,93,38.24653678938014,-109.3987667
46480,9,41,15,13,14,1,93,38.24653678938014,-109.3984972
46481,8,43,15,12,14,1,93,38.24653678938014,-109.3982277
46482,7,45,14,10,14,1,91,38.24653678938014,-109.3979582
46483,6,43,14,11,15,1,90,38.24653678938014,-109.3976887
46484,9,41,14,12,16,1,93,38.24653678938014,-109.3974192
46485,8,41,14,12,14,1,90,38.24653678938014,-109.3971497
46486,6,44,14,10,14,1,89,38.24653678938014,-109.3968802
46487,6,44,13,9,13,2,87,38.24653678938014,-109.3966107
46488,5,44,13,8,12,2,84,38.24653678938014,-109.3963412
46489,5,44,14,8,13,2,86,38.24653678938014,-109.3960717
46490,5,44,14,9,13,2,87,38.24653678938014,-109.3958022
46491,6,45,14,8,12,2,87,38.24653678938014,-109.3955327
46492,6,45,14,9,13,2,89,38.24653678938014,-109.3952632
46493,6,47,14,9,14,1,91,38.24653678938014,-109.3949938
46494,6,48,13,8,15,1,91,38.24653678938014,-109.3947243
46495,5,46,13,8,16,1,89,38.24653678938014,-109.3944548
46496,4,47,12,6,16,2,87,38.24653678938014,-109.3941853
46497,3,47,13,7,16,2,88,38.24653678938014,-109.3939158
46498,4,44,14,10,15,2,89,38.24653678938014,-109.3936463
46499,5,43,15,12,14,1,90,38.24653678938014,-109.3933768
46500,4,44,15,11,15,1,90,38.24653678938014,-109.3931073
46501,4,44,14,10,16,1,89,38.24653678938014,-109.3928378
46502,4,45,14,10,16,1,90,38.24653678938014,-109.3925683
46503,4,45,14,9,16,2,90,38.24653678938014,-109.3922988
46504,4,48,14,8,15,2,91,38.24653678938014,-109.3920293
46505,4,46,14,10,16,2,92,38.24653678938014,-109.3917598
46506,4,45,14,11,16,1,91,38.24653678938014,-109.3914903
46507,4,44,14,12,16,1,91,38.24653678938014,-109.3912208
46508,5,42,15,12,15,1,90,38.24653678938014,-109.3909513
46509,6,42,15,13,16,1,93,38.24653678938014,-109.3906818
46510,6,44,14,13,16,0,93,38.24653678938014,-109.3904123
46511,6,44,14,13,15,0,92,38.24653678938014,-109.3901429
46512,7,45,14,11,15,1,93,38.24653678938014,-109.3898734
46513,6,47,14,11,15,1,94,38.24653678938014,-109.3896039
46514,10,44,14,13,13,0,94,38.24653678938014,-109.3893344
46515,13,41,14,14,13,0,95,38.24653678938014,-109.3890649
46516,14,39,14,14,13,0,94,38.24653678938014,-109.3887954
46517,12,39,14,15,13,0,93,38.24653678938014,-109.3885259
46518,12,36,13,15,13,1,90,38.24653678938014,-109.3882564
46519,15,32,13,16,13,0,89,38.24653678938014,-109.3879869
46520,14,36,13,14,13,0,90,38.24653678938014,-109.3877174
46521,10,41,14,13,13,1,92,38.24653678938014,-109.3874479
46522,9,41,15,15,12,1,93,38.24653678938014,-109.3871784
46523,9,40,15,15,13,1,93,38.24653678938014,-109.3869089
46524,9,39,14,15,13,1,91,38.24653678938014,-109.3866394
46525,11,37,14,17,13,1,93,38.24653678938014,-109.3863699
46526,13,36,14,18,12,0,93,38.24653678938014,-109.3861004
46527,13,36,14,18,12,0,93,38.24653678938014,-109.3858309
46528,11,36,14,17,12,0,90,38.24653678938014,-109.3855614
46529,12,36,14,14,13,1,90,38.24653678938014,-109.3852919
46530,13,36,14,14,13,1,91,38.24653678938014,-109.3850225
46531,12,36,14,15,14,0,91,38.24653678938014,-109.384753
46532,11,37,14,14,14,1,91,38.24653678938014,-109.3844835
46533,11,38,14,13,13,1,90,38.24653678938014,-109.384214
46534,9,41,14,12,13,1,90,38.24653678938014,-109.3839445
46535,7,43,13,10,13,1,87,38.24653678938014,-109.383675
46536,7,44,14,11,13,1,90,38.24653678938014,-109.3834055
46537,9,40,13,12,13,1,88,38.24653678938014,-109.383136
46538,11,37,12,11,14,1,86,38.24653678938014,-109.3828665
46539,14,26,13,13,11,2,79,38.24653678938014,-109.382597
46540,13,19,11,20,12,1,76,38.24653678938014,-109.3823275
46541,22,22,12,14,10,1,81,38.24653678938014,-109.382058
46542,25,30,12,9,11,1,88,38.24653678938014,-109.3817885
46543,17,38,13,11,11,1,91,38.24653678938014,-109.381519
46544,13,40,13,12,12,1,91,38.24653678938014,-109.3812495
46545,11,40,13,13,11,2,90,38.24653678938014,-109.38098
46546,15,37,13,13,9,3,90,38.24653678938014,-109.3807105
46547,19,33,13,15,9,2,91,38.24653678938014,-109.380441
46548,24,27,14,15,7,2,89,38.24653678938014,-109.3801716
46549,29,23,15,15,5,2,89,38.24653678938014,-109.3799021
46550,33,21,15,14,4,2,89,38.24653678938014,-109.3796326
46551,35,21,15,14,4,2,91,38.24653678938014,-109.3793631
46552,31,20,15,17,5,3,91,38.24653678938014,-109.3790936
46553,24,22,15,18,6,3,88,38.24653678938014,-109.3788241
46554,12,28,15,15,8,6,84,38.24653678938014,-109.3785546
46555,7,29,11,7,8,8,70,38.24653678938014,-109.3782851
46556,2,32,9,2,10,10,65,38.24653678938014,-109.3780156
46557,2,28,10,2,8,13,63,38.24653678938014,-109.3777461
46558,2,22,12,5,5,16,62,38.24653678938014,-109.3774766
46559,4,20,12,8,8,13,65,38.24653678938014,-109.3772071
46560,5,22,11,14,11,4,67,38.24653678938014,-109.3769376
46561,6,22,10,9,12,5,64,38.24653678938014,-109.3766681
46562,2,24,9,6,12,8,61,38.24653678938014,-109.3763986
46563,0,28,10,8,7,14,67,38.24653678938014,-109.3761291
46564,1,27,10,8,6,12,64,38.24653678938014,-109.3758596
46565,5,34,7,3,5,7,61,38.24653678938014,-109.3755901
46566,4,39,6,5,8,4,66,38.24653678938014,-109.3753206
46567,3,41,6,6,9,3,68,38.24653678938014,-109.3750512
46568,2,42,6,4,9,3,66,38.24653678938014,-109.3747817
46569,2,45,6,4,8,3,68,38.24653678938014,-109.3745122
46570,2,43,6,4,8,4,67,38.24653678938014,-109.3742427
46571,2,43,7,4,8,5,69,38.24653678938014,-109.3739732
46572,1,39,6,1,8,5,60,38.24653678938014,-109.3737037
46573,1,42,6,1,9,5,64,38.24653678938014,-109.3734342
46574,1,42,6,2,9,4,64,38.24653678938014,-109.3731647
46575,2,39,6,2,8,4,61,38.24653678938014,-109.3728952
46576,2,36,7,3,9,4,61,38.24653678938014,-109.3726257
46577,3,34,7,4,9,4,61,38.24653678938014,-109.3723562
46578,2,33,7,4,10,5,61,38.24653678938014,-109.3720867
46579,2,33,7,4,10,4,60,38.24653678938014,-109.3718172
46580,3,36,8,6,11,3,67,38.24653678938014,-109.3715477
46581,2,37,9,9,12,3,72,38.24653678938014,-109.3712782
46582,4,37,11,11,15,1,79,38.24653678938014,-109.3710087
46583,2,26,11,17,19,2,77,38.24653678938014,-109.3707392
46584,2,26,12,11,22,3,76,38.24653678938014,-109.3704697
46585,2,17,12,10,16,8,65,38.24653678938014,-109.3702003
46586,2,16,12,10,14,10,64,38.24653678938014,-109.3699308
46587,5,24,13,11,13,7,73,38.24653678938014,-109.3696613
46588,5,28,13,8,11,8,73,38.24653678938014,-109.3693918
46589,4,30,13,0,10,14,71,38.24653678938014,-109.3691223
46590,3,27,14,0,5,22,71,38.24653678938014,-109.3688528
46591,2,25,15,0,3,25,70,38.24653678938014,-109.3685833
46592,3,28,16,0,4,25,76,38.24653678938014,-109.3683138
46593,2,26,17,0,4,30,79,38.24653678938014,-109.3680443
46594,2,25,17,0,4,29,77,38.24653678938014,-109.3677748
46595,2,26,14,0,3,26,71,38.24653678938014,-109.3675053
46596,1,28,13,0,4,23,69,38.24653678938014,-109.3672358
46597,2,30,13,0,6,20,71,38.24653678938014,-109.3669663
46598,2,30,13,1,5,21,72,38.24653678938014,-109.3666968
46599,1,28,13,1,4,23,70,38.24653678938014,-109.3664273
46600,1,25,14,1,3,26,70,38.24653678938014,-109.3661578
46601,2,26,16,1,3,28,76,38.24653678938014,-109.3658883
46602,2,25,17,2,4,29,79,38.24653678938014,-109.3656188
46603,2,25,17,2,4,29,79,38.24653678938014,-109.3653493
46604,3,26,16,1,5,27,78,38.24653678938014,-109.3650799
46605,3,28,15,1,5,24,76,38.24653678938014,-109.3648104
46606,3,29,14,1,5,23,75,38.24653678938014,-109.3645409
46607,2,29,15,2,6,25,79,38.24653678938014,-109.3642714
46608,2,26,15,2,4,26,75,38.24653678938014,-109.3640019
46609,2,25,13,1,2,24,67,38.24653678938014,-109.3637324
46610,1,29,11,0,4,18,63,38.24653678938014,-109.3634629
46611,1,32,9,0,6,14,62,38.24653678938014,-109.3631934
46612,1,32,10,0,4,17,64,38.24653678938014,-109.3629239
46613,1,32,11,0,4,18,66,38.24653678938014,-109.3626544
46614,1,32,11,0,4,19,67,38.24653678938014,-109.3623849
46615,1,29,11,1,4,19,65,38.24653678938014,-109.3621154
46616,1,25,13,1,2,23,65,38.24653678938014,-109.3618459
46617,2,24,15,1,1,26,69,38.24653678938014,-109.3615764
46618,1,22,16,1,1,29,70,38.24653678938014,-109.3613069
46619,1,20,16,1,2,30,70,38.24653678938014,-109.3610374
46620,2,21,16,1,2,29,71,38.24653678938014,-109.3607679
46621,2,22,16,2,2,28,72,38.24653678938014,-109.3604984
46622,2,22,16,2,2,26,70,38.24653678938014,-109.360229
46623,1,22,16,1,2,26,68,38.24653678938014,-109.3599595
46624,1,21,15,0,1,25,63,38.24653678938014,-109.35969
46625,1,21,14,0,2,22,60,38.24653678938014,-109.3594205
46626,2,27,13,0,4,17,63,38.24653678938014,-109.359151
46627,2,31,10,2,5,10,60,38.24653678938014,-109.3588815
46628,2,32,9,4,6,7,60,38.24653678938014,-109.358612
46629,6,30,9,5,9,4,63,38.24653678938014,-109.3583425
46630,3,29,10,1,3,16,62,38.24653678938014,-109.358073
46631,2,26,13,1,4,21,67,38.24653678938014,-109.3578035
46632,2,23,15,0,3,24,67,38.24653678938014,-109.357534
46633,2,23,15,0,3,24,67,38.24653678938014,-109.3572645
46634,2,30,12,0,3,19,66,38.24653678938014,-109.356995
46635,1,36,9,0,7,14,67,38.24653678938014,-109.3567255
46636,1,30,9,3,7,9,59,38.24653678938014,-109.356456
46637,2,31,8,5,6,6,58,38.24653678938014,-109.3561865
46638,2,32,7,5,7,4,57,38.24653678938014,-109.355917
46639,4,36,7,4,7,3,61,38.24653678938014,-109.3556475
46640,3,32,7,4,7,4,57,38.24653678938014,-109.355378
46641,3,33,6,5,8,4,59,38.24653678938014,-109.3551086
46642,1,34,6,4,8,4,57,38.24653678938014,-109.3548391
46643,4,37,5,4,6,3,59,38.24653678938014,-109.3545696
46644,3,36,5,5,6,4,59,38.24653678938014,-109.3543001
46645,6,17,9,6,6,11,55,38.24653678938014,-109.3540306
46646,2,13,11,7,9,15,57,38.24653678938014,-109.3537611
46647,1,19,8,13,11,4,56,38.24653678938014,-109.3534916
46648,6,25,8,9,10,3,61,38.24653678938014,-109.3532221
46649,2,29,10,4,6,8,59,38.24653678938014,-109.3529526
46650,2,30,7,6,8,4,57,38.24653678938014,-109.3526831
46651,4,27,8,8,12,3,62,38.24653678938014,-109.3524136
46652,11,25,13,15,12,2,78,38.24653678938014,-109.3521441
46653,18,14,18,15,13,10,88,38.24653678938014,-109.3518746
46654,27,12,16,16,9,9,89,38.24653678938014,-109.3516051
46655,7,17,14,16,11,15,80,38.24653678938014,-109.3513356
46656,1,19,12,11,10,14,67,38.24653678938014,-109.3510661
46657,0,25,10,10,13,9,67,38.24653678938014,-109.3507966
46658,1,27,10,10,15,5,68,38.24653678938014,-109.3505271
46659,1,28,11,3,10,14,67,38.24653678938014,-109.3502577
46660,2,29,11,2,9,10,63,38.24653678938014,-109.3499882
46661,5,33,11,4,8,6,67,38.24653678938014,-109.3497187
46662,2,30,9,5,8,6,60,38.24653678938014,-109.3494492
46663,2,27,11,3,7,9,59,38.24653678938014,-109.3491797
46664,2,28,11,2,7,9,59,38.24653678938014,-109.3489102
46665,2,29,10,3,8,8,60,38.24653678938014,-109.3486407
46666,3,29,10,5,8,6,61,38.24653678938014,-109.3483712
46667,2,25,11,5,8,6,57,38.24653678938014,-109.3481017
46668,1,18,12,7,9,11,58,38.24653678938014,-109.3478322
46669,4,24,11,9,12,6,66,38.24653678938014,-109.3475627
46670,3,30,10,4,9,6,62,38.24653678938014,-109.3472932
46671,1,27,9,5,8,6,56,38.24653678938014,-109.3470237
46672,3,17,11,10,10,7,58,38.24653678938014,-109.3467542
46673,5,24,14,13,11,10,77,38.24653678938014,-109.3464847
46674,9,22,13,14,15,11,84,38.24653678938014,-109.3462152
46675,2,23,13,12,16,14,80,38.24653678938014,-109.3459457
46676,1,22,13,9,13,14,72,38.24653678938014,-109.3456762
46677,2,26,12,8,15,8,71,38.24653678938014,-109.3454068
46678,2,25,9,11,12,6,65,38.24653678938014,-109.3451373
46679,4,29,9,7,9,4,62,38.24653678938014,-109.3448678
46680,7,37,7,9,8,2,70,38.24653678938014,-109.3445983
46681,4,37,7,8,9,3,68,38.24653678938014,-109.3443288
46682,2,20,10,7,8,8,55,38.24653678938014,-109.3440593
46683,1,18,12,4,9,15,59,38.24653678938014,-109.3437898
46684,1,26,13,1,9,17,67,38.24653678938014,-109.3435203
46685,1,22,11,2,6,16,58,38.24653678938014,-109.3432508
46686,1,25,11,2,8,13,60,38.24653678938014,-109.3429813
46687,1,24,11,2,7,14,59,38.24653678938014,-109.3427118
46688,2,22,11,5,8,12,60,38.24653678938014,-109.3424423
46689,3,20,11,6,9,10,59,38.24653678938014,-109.3421728
46690,3,27,8,5,9,8,60,38.24653678938014,-109.3419033
46691,2,37,7,5,9,5,65,38.24653678938014,-109.3416338
46692,2,39,7,5,10,5,68,38.24653678938014,-109.3413643
46693,3,41,7,5,10,3,69,38.24653678938014,-109.3410948
46694,4,45,8,5,10,2,74,38.24653678938014,-109.3408253
46695,3,37,8,6,9,4,67,38.24653678938014,-109.3405558
46696,1,25,10,4,9,9,58,38.24653678938014,-109.3402864
46697,3,21,11,5,11,10,61,38.24653678938014,-109.3400169
46698,2,22,11,3,9,11,58,38.24653678938014,-109.3397474
46699,3,32,8,3,8,6,60,38.24653678938014,-109.3394779
46700,2,27,8,4,10,5,56,38.24653678938014,-109.3392084
46701,1,27,8,5,10,6,57,38.24653678938014,-109.3389389
46702,1,22,10,6,8,9,56,38.24653678938014,-109.3386694
46703,2,18,11,3,5,15,54,38.24653678938014,-109.3383999
46704,0,18,12,2,5,18,55,38.24653678938014,-109.3381304
46705,0,18,12,0,1,23,54,38.24653678938014,-109.3378609
46706,0,18,11,2,3,20,54,38.24653678938014,-109.3375914
46707,0,28,10,3,7,14,62,38.24653678938014,-109.3373219
46708,1,39,9,0,11,10,70,38.24653678938014,-109.3370524
46709,0,42,8,0,13,7,70,38.24653678938014,-109.3367829
46710,0,30,9,1,7,12,59,38.24653678938014,-109.3365134
46711,0,23,9,0,6,14,52,38.24653678938014,-109.3362439
46712,0,29,9,0,11,9,58,38.24653678938014,-109.3359744
46713,1,44,9,2,13,3,72,38.24653678938014,-109.3357049
46714,1,47,8,2,10,4,72,38.24653678938014,-109.3354355
46715,1,39,9,2,11,9,71,38.24653678938014,-109.335166
46716,2,34,11,0,7,16,70,38.24653678938014,-109.3348965
46717,1,28,11,0,2,20,62,38.24653678938014,-109.334627
46718,3,29,9,2,2,13,58,38.24653678938014,-109.3343575
46719,2,41,5,4,8,3,63,38.24653678938014,-109.334088
46720,2,39,5,3,7,3,59,38.24653678938014,-109.3338185
46721,6,35,7,4,7,3,62,38.24653678938014,-109.333549
46722,9,31,8,7,7,3,65,38.24653678938014,-109.3332795
46723,1,35,9,3,4,9,61,38.24653678938014,-109.33301
46724,3,37,7,4,7,3,61,38.24653678938014,-109.3327405
46725,4,38,8,5,7,4,66,38.24653678938014,-109.332471
46726,6,37,10,5,9,4,71,38.24653678938014,-109.3322015
46727,3,30,10,4,7,8,62,38.24653678938014,-109.331932
46728,2,30,9,7,7,7,62,38.24653678938014,-109.3316625
46729,2,26,11,6,11,8,64,38.24653678938014,-109.331393
46730,3,31,9,3,10,6,62,38.246267294794905,-109.4402688
46731,2,32,9,1,6,13,63,38.246267294794905,-109.4399993
46732,2,32,9,2,7,11,63,38.246267294794905,-109.4397299
46733,1,34,8,2,7,9,61,38.246267294794905,-109.4394604
46734,1,35,7,3,9,6,61,38.246267294794905,-109.4391909
46735,3,33,8,4,10,4,62,38.246267294794905,-109.4389214
46736,3,30,8,4,11,4,60,38.246267294794905,-109.4386519
46737,4,36,10,6,11,4,71,38.246267294794905,-109.4383824
46738,3,37,11,6,16,4,77,38.246267294794905,-109.4381129
46739,5,42,12,8,17,2,86,38.246267294794905,-109.4378434
46740,4,47,13,10,14,1,89,38.246267294794905,-109.4375739
46741,5,44,13,12,13,1,88,38.246267294794905,-109.4373044
46742,5,44,13,11,13,2,88,38.246267294794905,-109.4370349
46743,4,46,13,11,14,1,89,38.246267294794905,-109.4367654
46744,5,47,13,11,15,0,91,38.246267294794905,-109.4364959
46745,5,45,13,12,15,1,91,38.246267294794905,-109.4362264
46746,4,45,13,10,15,2,89,38.246267294794905,-109.4359569
46747,5,44,13,14,14,1,91,38.246267294794905,-109.4356874
46748,6,43,14,15,13,1,92,38.246267294794905,-109.4354179
46749,7,42,14,16,13,1,93,38.246267294794905,-109.4351484
46750,10,39,14,16,13,0,92,38.246267294794905,-109.434879
46751,9,40,14,16,13,0,92,38.246267294794905,-109.4346095
46752,7,42,14,16,14,0,93,38.246267294794905,-109.43434
46753,6,43,14,15,14,1,93,38.246267294794905,-109.4340705
46754,5,43,14,13,15,1,91,38.246267294794905,-109.433801
46755,4,41,12,6,15,4,82,38.246267294794905,-109.4335315
46756,2,40,10,2,13,7,74,38.246267294794905,-109.433262
46757,1,38,10,3,12,7,71,38.246267294794905,-109.4329925
46758,1,38,9,3,11,7,69,38.246267294794905,-109.432723
46759,1,43,9,0,13,7,73,38.246267294794905,-109.4324535
46760,2,49,9,1,13,7,81,38.246267294794905,-109.432184
46761,3,51,10,3,14,5,86,38.246267294794905,-109.4319145
46762,4,49,11,5,15,4,88,38.246267294794905,-109.431645
46763,4,46,11,4,15,5,85,38.246267294794905,-109.4313755
46764,4,49,11,5,15,4,88,38.246267294794905,-109.431106
46765,4,48,11,5,15,4,87,38.246267294794905,-109.4308365
46766,4,48,12,7,16,2,89,38.246267294794905,-109.430567
46767,5,45,13,10,16,1,90,38.246267294794905,-109.4302975
46768,5,46,12,9,16,0,88,38.246267294794905,-109.430028
46769,6,46,13,9,16,0,90,38.246267294794905,-109.4297586
46770,8,44,14,11,15,0,92,38.246267294794905,-109.4294891
46771,10,42,14,13,14,0,93,38.246267294794905,-109.4292196
46772,12,41,14,13,14,0,94,38.246267294794905,-109.4289501
46773,14,39,14,13,14,0,94,38.246267294794905,-109.4286806
46774,16,36,14,13,12,1,92,38.246267294794905,-109.4284111
46775,16,36,13,11,13,1,90,38.246267294794905,-109.4281416
46776,13,41,13,9,14,1,91,38.246267294794905,-109.4278721
46777,8,45,12,6,15,3,89,38.246267294794905,-109.4276026
46778,8,48,12,7,16,1,92,38.246267294794905,-109.4273331
46779,10,46,13,8,16,0,93,38.246267294794905,-109.4270636
46780,8,43,13,10,16,0,90,38.246267294794905,-109.4267941
46781,7,41,11,8,14,2,83,38.246267294794905,-109.4265246
46782,5,40,10,4,14,4,77,38.246267294794905,-109.4262551
46783,6,46,11,7,16,1,87,38.246267294794905,-109.4259856
46784,9,45,12,9,15,0,90,38.246267294794905,-109.4257161
46785,11,44,12,9,14,0,90,38.246267294794905,-109.4254466
46786,10,45,12,8,15,0,90,38.246267294794905,-109.4251771
46787,8,46,11,9,15,0,89,38.246267294794905,-109.4249077
46788,8,44,12,10,15,0,89,38.246267294794905,-109.4246382
46789,14,41,12,11,14,0,92,38.246267294794905,-109.4243687
46790,20,36,12,10,12,0,90,38.246267294794905,-109.4240992
46791,22,35,12,10,12,0,91,38.246267294794905,-109.4238297
46792,26,32,12,10,12,0,92,38.246267294794905,-109.4235602
46793,21,35,12,10,13,0,91,38.246267294794905,-109.4232907
46794,14,38,12,11,14,0,89,38.246267294794905,-109.4230212
46795,9,40,13,12,16,1,91,38.246267294794905,-109.4227517
46796,7,40,12,10,15,2,86,38.246267294794905,-109.4224822
46797,6,41,13,9,15,2,86,38.246267294794905,-109.4222127
46798,7,43,13,10,15,2,90,38.246267294794905,-109.4219432
46799,7,45,13,9,15,1,90,38.246267294794905,-109.4216737
46800,5,47,11,8,16,1,88,38.246267294794905,-109.4214042
46801,4,48,8,8,12,1,81,38.246267294794905,-109.4211347
46802,2,45,9,4,13,3,76,38.246267294794905,-109.4208652
46803,2,41,9,5,12,4,73,38.246267294794905,-109.4205957
46804,2,38,10,4,11,7,72,38.246267294794905,-109.4203262
46805,3,43,10,0,12,10,78,38.246267294794905,-109.4200568
46806,2,43,11,0,11,12,79,38.246267294794905,-109.4197873
46807,2,49,11,0,13,10,85,38.246267294794905,-109.4195178
46808,3,49,11,5,14,5,87,38.246267294794905,-109.4192483
46809,3,50,10,7,13,4,87,38.246267294794905,-109.4189788
46810,3,53,10,7,12,4,89,38.246267294794905,-109.4187093
46811,2,49,9,3,12,6,81,38.246267294794905,-109.4184398
46812,1,41,9,1,9,9,70,38.246267294794905,-109.4181703
46813,0,42,10,0,11,10,73,38.246267294794905,-109.4179008
46814,1,47,11,0,13,11,83,38.246267294794905,-109.4176313
46815,1,55,10,2,14,6,88,38.246267294794905,-109.4173618
46816,1,54,9,3,14,5,86,38.246267294794905,-109.4170923
46817,1,50,10,1,14,7,83,38.246267294794905,-109.4168228
46818,1,43,10,0,12,10,76,38.246267294794905,-109.4165533
46819,1,39,10,0,10,12,72,38.246267294794905,-109.4162838
46820,3,35,12,5,10,10,75,38.246267294794905,-109.4160143
46821,4,34,12,10,12,7,79,38.246267294794905,-109.4157448
46822,7,34,12,12,14,4,83,38.246267294794905,-109.4154753
46823,7,32,12,15,14,5,85,38.246267294794905,-109.4152058
46824,2,28,15,8,15,14,82,38.246267294794905,-109.4149364
46825,1,29,11,5,13,11,70,38.246267294794905,-109.4146669
46826,0,29,9,4,10,8,60,38.246267294794905,-109.4143974
46827,1,31,9,6,9,7,63,38.246267294794905,-109.4141279
46828,1,31,10,5,13,7,67,38.246267294794905,-109.4138584
46829,4,43,11,4,16,4,82,38.246267294794905,-109.4135889
46830,6,47,12,9,16,1,91,38.246267294794905,-109.4133194
46831,7,47,12,11,14,0,91,38.246267294794905,-109.4130499
46832,7,46,13,11,14,0,91,38.246267294794905,-109.4127804
46833,8,45,13,10,15,0,91,38.246267294794905,-109.4125109
46834,7,45,12,7,16,2,89,38.246267294794905,-109.4122414
46835,4,44,10,4,15,3,80,38.246267294794905,-109.4119719
46836,3,43,9,3,13,5,76,38.246267294794905,-109.4117024
46837,2,39,8,2,11,6,68,38.246267294794905,-109.4114329
46838,1,34,9,1,12,9,66,38.246267294794905,-109.4111634
46839,3,35,10,7,14,4,73,38.246267294794905,-109.4108939
46840,8,34,12,11,14,1,80,38.246267294794905,-109.4106244
46841,12,33,13,13,14,1,86,38.246267294794905,-109.4103549
46842,14,34,14,16,14,0,92,38.246267294794905,-109.4100855
46843,14,34,15,16,13,0,92,38.246267294794905,-109.409816
46844,12,36,15,15,14,0,92,38.246267294794905,-109.4095465
46845,13,36,15,15,14,0,93,38.246267294794905,-109.409277
46846,14,35,15,15,14,0,93,38.246267294794905,-109.4090075
46847,16,32,15,15,13,0,91,38.246267294794905,-109.408738
46848,19,32,15,15,13,0,94,38.246267294794905,-109.4084685
46849,17,33,14,13,13,0,90,38.246267294794905,-109.408199
46850,17,33,14,13,13,0,90,38.246267294794905,-109.4079295
46851,15,34,14,14,14,0,91,38.246267294794905,-109.40766
46852,14,35,14,14,14,0,91,38.246267294794905,-109.4073905
46853,16,34,15,14,13,0,92,38.246267294794905,-109.407121
46854,17,33,14,15,13,0,92,38.246267294794905,-109.4068515
46855,19,32,14,14,13,0,92,38.246267294794905,-109.406582
46856,19,31,14,14,13,0,91,38.246267294794905,-109.4063125
46857,16,33,14,14,13,0,90,38.246267294794905,-109.406043
46858,18,31,14,15,13,0,91,38.246267294794905,-109.4057735
46859,17,32,14,15,13,0,91,38.246267294794905,-109.405504
46860,16,33,14,14,13,0,90,38.246267294794905,-109.4052345
46861,15,33,14,15,13,0,90,38.246267294794905,-109.4049651
46862,16,32,14,15,13,0,90,38.246267294794905,-109.4046956
46863,18,32,14,13,13,0,90,38.246267294794905,-109.4044261
46864,17,32,14,13,13,0,89,38.246267294794905,-109.4041566
46865,16,34,14,13,14,0,91,38.246267294794905,-109.4038871
46866,17,33,14,13,13,0,90,38.246267294794905,-109.4036176
46867,20,32,14,12,13,0,91,38.246267294794905,-109.4033481
46868,19,32,14,13,13,0,91,38.246267294794905,-109.4030786
46869,18,33,14,14,13,0,92,38.246267294794905,-109.4028091
46870,18,33,14,13,13,0,91,38.246267294794905,-109.4025396
46871,18,33,14,13,13,0,91,38.246267294794905,-109.4022701
46872,17,34,15,14,13,0,93,38.246267294794905,-109.4020006
46873,15,34,15,14,13,0,91,38.246267294794905,-109.4017311
46874,15,36,15,15,13,0,94,38.246267294794905,-109.4014616
46875,14,37,15,14,13,0,93,38.246267294794905,-109.4011921
46876,14,36,14,15,14,0,93,38.246267294794905,-109.4009226
46877,16,34,14,15,13,0,92,38.246267294794905,-109.4006531
46878,16,35,14,13,13,0,91,38.246267294794905,-109.4003836
46879,15,36,14,13,14,0,92,38.246267294794905,-109.4001142
46880,16,36,14,13,14,0,93,38.246267294794905,-109.3998447
46881,14,36,14,13,14,0,91,38.246267294794905,-109.3995752
46882,16,36,15,12,13,0,92,38.246267294794905,-109.3993057
46883,13,38,14,13,13,0,91,38.246267294794905,-109.3990362
46884,11,40,15,13,14,1,94,38.246267294794905,-109.3987667
46885,10,39,15,13,14,1,92,38.246267294794905,-109.3984972
46886,8,43,15,12,14,1,93,38.246267294794905,-109.3982277
46887,7,44,14,11,14,1,91,38.246267294794905,-109.3979582
46888,7,44,14,11,15,1,92,38.246267294794905,-109.3976887
46889,8,42,14,12,15,0,91,38.246267294794905,-109.3974192
46890,9,42,14,12,15,1,93,38.246267294794905,-109.3971497
46891,7,42,14,11,15,1,90,38.246267294794905,-109.3968802
46892,7,42,14,10,13,2,88,38.246267294794905,-109.3966107
46893,7,42,14,10,12,2,87,38.246267294794905,-109.3963412
46894,7,43,14,9,13,2,88,38.246267294794905,-109.3960717
46895,6,43,14,10,13,1,87,38.246267294794905,-109.3958022
46896,7,44,14,10,12,2,89,38.246267294794905,-109.3955327
46897,7,45,14,10,14,1,91,38.246267294794905,-109.3952632
46898,7,47,14,9,15,0,92,38.246267294794905,-109.3949938
46899,7,46,14,9,16,0,92,38.246267294794905,-109.3947243
46900,5,44,14,10,17,1,91,38.246267294794905,-109.3944548
46901,3,46,13,6,16,2,86,38.246267294794905,-109.3941853
46902,3,47,13,6,15,3,87,38.246267294794905,-109.3939158
46903,4,44,14,9,15,2,88,38.246267294794905,-109.3936463
46904,5,43,15,12,14,1,90,38.246267294794905,-109.3933768
46905,4,44,15,12,15,1,91,38.246267294794905,-109.3931073
46906,4,44,15,11,16,1,91,38.246267294794905,-109.3928378
46907,4,43,14,10,15,2,88,38.246267294794905,-109.3925683
46908,4,43,14,9,16,2,88,38.246267294794905,-109.3922988
46909,4,47,14,7,17,2,91,38.246267294794905,-109.3920293
46910,4,48,14,7,16,2,91,38.246267294794905,-109.3917598
46911,4,46,14,9,16,1,90,38.246267294794905,-109.3914903
46912,5,45,14,11,16,1,92,38.246267294794905,-109.3912208
46913,5,41,14,11,15,2,88,38.246267294794905,-109.3909513
46914,5,42,14,10,15,2,88,38.246267294794905,-109.3906818
46915,5,43,14,12,16,1,91,38.246267294794905,-109.3904123
46916,5,45,14,11,16,1,92,38.246267294794905,-109.3901429
46917,5,46,14,9,15,2,91,38.246267294794905,-109.3898734
46918,5,48,14,9,15,2,93,38.246267294794905,-109.3896039
46919,8,46,14,12,14,0,94,38.246267294794905,-109.3893344
46920,10,43,14,14,13,0,94,38.246267294794905,-109.3890649
46921,11,41,14,16,13,0,95,38.246267294794905,-109.3887954
46922,10,40,14,16,13,0,93,38.246267294794905,-109.3885259
46923,11,35,13,17,13,1,90,38.246267294794905,-109.3882564
46924,13,36,13,16,13,0,91,38.246267294794905,-109.3879869
46925,11,39,14,14,13,0,91,38.246267294794905,-109.3877174
46926,9,42,14,13,13,1,92,38.246267294794905,-109.3874479
46927,9,42,15,15,13,0,94,38.246267294794905,-109.3871784
46928,8,42,15,14,13,1,93,38.246267294794905,-109.3869089
46929,8,40,14,14,13,1,90,38.246267294794905,-109.3866394
46930,9,39,15,17,13,1,94,38.246267294794905,-109.3863699
46931,11,37,15,18,12,1,94,38.246267294794905,-109.3861004
46932,10,37,15,18,13,0,93,38.246267294794905,-109.3858309
46933,11,38,14,17,13,1,94,38.246267294794905,-109.3855614
46934,12,37,14,15,13,1,92,38.246267294794905,-109.3852919
46935,13,36,14,14,13,0,90,38.246267294794905,-109.3850225
46936,13,37,14,15,13,0,92,38.246267294794905,-109.384753
46937,13,37,14,15,13,0,92,38.246267294794905,-109.3844835
46938,14,37,14,15,12,0,92,38.246267294794905,-109.384214
46939,11,39,14,14,13,1,92,38.246267294794905,-109.3839445
46940,8,42,14,13,13,1,91,38.246267294794905,-109.383675
46941,8,42,14,14,13,1,92,38.246267294794905,-109.3834055
46942,13,38,14,14,12,0,91,38.246267294794905,-109.383136
46943,15,34,13,13,13,1,89,38.246267294794905,-109.3828665
46944,15,26,13,12,12,3,81,38.246267294794905,-109.382597
46945,14,20,12,19,11,3,79,38.246267294794905,-109.3823275
46946,17,18,10,23,10,0,78,38.246267294794905,-109.382058
46947,20,29,12,12,10,2,85,38.246267294794905,-109.3817885
46948,13,37,13,12,11,2,88,38.246267294794905,-109.381519
46949,10,39,14,12,12,3,90,38.246267294794905,-109.3812495
46950,9,40,14,13,11,3,90,38.246267294794905,-109.38098
46951,11,39,13,11,10,4,88,38.246267294794905,-109.3807105
46952,12,37,13,12,10,2,86,38.246267294794905,-109.380441
46953,12,36,12,10,9,4,83,38.246267294794905,-109.3801716
46954,14,34,12,9,9,4,82,38.246267294794905,-109.3799021
46955,16,34,13,10,10,3,86,38.246267294794905,-109.3796326
46956,24,29,14,14,8,1,90,38.246267294794905,-109.3793631
46957,26,24,14,17,7,2,90,38.246267294794905,-109.3790936
46958,27,23,15,13,8,2,88,38.246267294794905,-109.3788241
46959,16,31,13,11,9,3,83,38.246267294794905,-109.3785546
46960,10,33,11,7,8,5,74,38.246267294794905,-109.3782851
46961,8,29,10,6,8,5,66,38.246267294794905,-109.3780156
46962,9,28,10,7,7,6,67,38.246267294794905,-109.3777461
46963,9,26,11,8,7,8,69,38.246267294794905,-109.3774766
46964,13,24,14,8,5,9,73,38.246267294794905,-109.3772071
46965,8,24,10,6,9,6,63,38.246267294794905,-109.3769376
46966,6,26,9,4,8,7,60,38.246267294794905,-109.3766681
46967,3,27,8,3,9,8,58,38.246267294794905,-109.3763986
46968,5,34,7,4,6,7,63,38.246267294794905,-109.3761291
46969,3,39,6,5,9,4,66,38.246267294794905,-109.3758596
46970,2,44,6,4,8,3,67,38.246267294794905,-109.3755901
46971,2,47,6,4,8,3,70,38.246267294794905,-109.3753206
46972,2,46,6,4,9,3,70,38.246267294794905,-109.3750512
46973,1,48,6,3,9,3,70,38.246267294794905,-109.3747817
46974,1,52,6,3,9,3,74,38.246267294794905,-109.3745122
46975,0,51,6,2,9,4,72,38.246267294794905,-109.3742427
46976,0,49,7,4,10,4,74,38.246267294794905,-109.3739732
46977,4,37,7,8,8,5,69,38.246267294794905,-109.3737037
46978,3,41,10,6,9,7,76,38.246267294794905,-109.3734342
46979,2,38,9,4,11,8,72,38.246267294794905,-109.3731647
46980,2,36,10,5,11,8,72,38.246267294794905,-109.3728952
46981,1,39,9,3,11,7,70,38.246267294794905,-109.3726257
46982,3,45,9,5,9,9,80,38.246267294794905,-109.3723562
46983,7,43,11,8,13,1,83,38.246267294794905,-109.3720867
46984,7,39,11,9,14,1,81,38.246267294794905,-109.3718172
46985,6,35,11,10,16,2,80,38.246267294794905,-109.3715477
46986,4,30,12,11,16,4,77,38.246267294794905,-109.3712782
46987,3,28,12,15,21,3,82,38.246267294794905,-109.3710087
46988,1,19,12,9,14,10,65,38.246267294794905,-109.3707392
46989,1,15,12,7,14,10,59,38.246267294794905,-109.3704697
46990,2,15,12,10,11,11,61,38.246267294794905,-109.3702003
46991,2,22,12,7,9,14,66,38.246267294794905,-109.3699308
46992,4,27,15,0,7,20,73,38.246267294794905,-109.3696613
46993,2,25,17,0,6,25,75,38.246267294794905,-109.3693918
46994,3,26,17,0,5,25,76,38.246267294794905,-109.3691223
46995,3,27,17,0,4,26,77,38.246267294794905,-109.3688528
46996,2,28,17,0,4,28,79,38.246267294794905,-109.3685833
46997,2,27,18,0,4,29,80,38.246267294794905,-109.3683138
46998,2,26,17,0,3,31,79,38.246267294794905,-109.3680443
46999,2,24,16,0,2,30,74,38.246267294794905,-109.3677748
47000,2,25,15,0,2,28,72,38.246267294794905,-109.3675053
47001,1,27,14,0,3,25,70,38.246267294794905,-109.3672358
47002,2,29,14,0,4,24,73,38.246267294794905,-109.3669663
47003,2,28,14,1,3,24,72,38.246267294794905,-109.3666968
47004,1,26,14,0,3,25,69,38.246267294794905,-109.3664273
47005,1,24,14,0,3,26,68,38.246267294794905,-109.3661578
47006,2,23,15,1,2,27,70,38.246267294794905,-109.3658883
47007,2,23,14,1,2,25,67,38.246267294794905,-109.3656188
47008,3,27,14,1,4,24,73,38.246267294794905,-109.3653493
47009,3,30,15,2,6,21,77,38.246267294794905,-109.3650799
47010,4,32,15,2,7,20,80,38.246267294794905,-109.3648104
47011,4,32,15,2,7,22,82,38.246267294794905,-109.3645409
47012,3,29,16,2,7,26,83,38.246267294794905,-109.3642714
47013,2,25,15,1,3,26,72,38.246267294794905,-109.3640019
47014,2,27,13,1,3,20,66,38.246267294794905,-109.3637324
47015,1,35,10,0,6,14,66,38.246267294794905,-109.3634629
47016,1,33,10,0,7,13,64,38.246267294794905,-109.3631934
47017,2,31,11,0,5,16,65,38.246267294794905,-109.3629239
47018,2,32,11,0,6,16,67,38.246267294794905,-109.3626544
47019,1,32,10,0,6,16,65,38.246267294794905,-109.3623849
47020,1,30,11,0,5,17,64,38.246267294794905,-109.3621154
47021,1,25,13,1,2,24,66,38.246267294794905,-109.3618459
47022,1,23,14,1,2,27,68,38.246267294794905,-109.3615764
47023,1,22,16,1,2,28,70,38.246267294794905,-109.3613069
47024,1,20,16,1,2,29,69,38.246267294794905,-109.3610374
47025,2,22,15,2,3,26,70,38.246267294794905,-109.3607679
47026,3,30,13,3,6,19,74,38.246267294794905,-109.3604984
47027,2,26,13,3,4,21,69,38.246267294794905,-109.360229
47028,2,23,13,2,3,21,64,38.246267294794905,-109.3599595
47029,3,21,14,2,3,18,61,38.246267294794905,-109.35969
47030,3,23,14,3,4,17,64,38.246267294794905,-109.3594205
47031,6,29,13,4,6,11,69,38.246267294794905,-109.359151
47032,3,28,9,3,7,7,57,38.246267294794905,-109.3588815
47033,2,30,8,3,8,5,56,38.246267294794905,-109.358612
47034,6,34,6,3,7,5,61,38.246267294794905,-109.3583425
47035,7,23,8,3,3,11,55,38.246267294794905,-109.358073
47036,4,23,11,3,3,16,60,38.246267294794905,-109.3578035
47037,2,29,11,1,5,18,66,38.246267294794905,-109.357534
47038,2,31,11,1,6,16,67,38.246267294794905,-109.3572645
47039,1,32,10,0,6,15,64,38.246267294794905,-109.356995
47040,1,38,9,0,9,12,69,38.246267294794905,-109.3567255
47041,1,30,9,2,7,10,59,38.246267294794905,-109.356456
47042,2,28,9,4,6,7,56,38.246267294794905,-109.3561865
47043,3,29,8,5,8,4,57,38.246267294794905,-109.355917
47044,2,29,7,5,9,3,55,38.246267294794905,-109.3556475
47045,2,34,6,5,8,3,58,38.246267294794905,-109.355378
47046,1,31,6,4,7,3,52,38.246267294794905,-109.3551086
47047,1,32,6,3,7,4,53,38.246267294794905,-109.3548391
47048,4,37,4,3,5,4,57,38.246267294794905,-109.3545696
47049,4,28,6,6,8,5,57,38.246267294794905,-109.3543001
47050,4,17,9,5,4,15,54,38.246267294794905,-109.3540306
47051,2,12,12,6,8,16,56,38.246267294794905,-109.3537611
47052,5,23,8,9,9,4,58,38.246267294794905,-109.3534916
47053,4,30,7,7,7,3,58,38.246267294794905,-109.3532221
47054,5,34,8,5,8,3,63,38.246267294794905,-109.3529526
47055,2,35,6,5,8,3,59,38.246267294794905,-109.3526831
47056,2,29,7,6,11,3,58,38.246267294794905,-109.3524136
47057,4,24,12,11,12,5,68,38.246267294794905,-109.3521441
47058,19,14,18,11,14,9,85,38.246267294794905,-109.3518746
47059,27,11,15,16,11,8,88,38.246267294794905,-109.3516051
47060,6,17,13,19,13,13,81,38.246267294794905,-109.3513356
47061,1,19,10,14,13,7,64,38.246267294794905,-109.3510661
47062,1,25,9,12,10,4,61,38.246267294794905,-109.3507966
47063,2,26,10,5,13,8,64,38.246267294794905,-109.3505271
47064,1,27,10,2,5,15,60,38.246267294794905,-109.3502577
47065,1,35,10,1,7,11,65,38.246267294794905,-109.3499882
47066,3,33,10,3,7,7,63,38.246267294794905,-109.3497187
47067,3,30,9,4,8,6,60,38.246267294794905,-109.3494492
47068,3,31,9,5,7,5,60,38.246267294794905,-109.3491797
47069,1,28,9,3,6,8,55,38.246267294794905,-109.3489102
47070,1,26,9,3,7,8,54,38.246267294794905,-109.3486407
47071,1,20,10,4,8,8,51,38.246267294794905,-109.3483712
47072,3,20,12,9,8,8,60,38.246267294794905,-109.3481017
47073,1,17,15,5,6,21,65,38.246267294794905,-109.3478322
47074,2,21,13,6,10,15,67,38.246267294794905,-109.3475627
47075,4,26,13,7,13,7,70,38.246267294794905,-109.3472932
47076,3,21,14,9,7,9,63,38.246267294794905,-109.3470237
47077,3,17,13,12,8,12,65,38.246267294794905,-109.3467542
47078,8,18,14,12,13,13,78,38.246267294794905,-109.3464847
47079,5,21,13,13,13,13,78,38.246267294794905,-109.3462152
47080,2,22,13,7,11,13,68,38.246267294794905,-109.3459457
47081,2,24,12,6,12,9,65,38.246267294794905,-109.3456762
47082,2,27,12,6,12,10,69,38.246267294794905,-109.3454068
47083,2,24,12,6,11,9,64,38.246267294794905,-109.3451373
47084,2,21,11,6,11,8,59,38.246267294794905,-109.3448678
47085,3,23,11,8,9,8,62,38.246267294794905,-109.3445983
47086,9,21,11,13,12,3,69,38.246267294794905,-109.3443288
47087,3,18,10,9,12,5,57,38.246267294794905,-109.3440593
47088,3,19,13,7,12,8,62,38.246267294794905,-109.3437898
47089,1,22,12,5,9,13,62,38.246267294794905,-109.3435203
47090,2,24,11,2,6,15,60,38.246267294794905,-109.3432508
47091,1,25,11,2,7,14,60,38.246267294794905,-109.3429813
47092,2,28,9,2,9,10,60,38.246267294794905,-109.3427118
47093,3,33,7,5,11,5,64,38.246267294794905,-109.3424423
47094,3,34,7,5,10,5,64,38.246267294794905,-109.3421728
47095,3,39,7,5,9,4,67,38.246267294794905,-109.3419033
47096,2,36,7,4,9,5,63,38.246267294794905,-109.3416338
47097,2,35,7,5,10,5,64,38.246267294794905,-109.3413643
47098,2,33,7,6,10,5,63,38.246267294794905,-109.3410948
47099,3,33,8,5,10,6,65,38.246267294794905,-109.3408253
47100,4,37,8,5,8,4,66,38.246267294794905,-109.3405558
47101,1,33,7,4,8,5,58,38.246267294794905,-109.3402864
47102,2,29,8,4,10,6,59,38.246267294794905,-109.3400169
47103,1,26,9,4,9,8,57,38.246267294794905,-109.3397474
47104,2,23,9,3,7,11,55,38.246267294794905,-109.3394779
47105,9,23,13,8,12,6,71,38.246267294794905,-109.3392084
47106,0,19,11,2,5,19,56,38.246267294794905,-109.3389389
47107,0,18,11,2,5,19,55,38.246267294794905,-109.3386694
47108,1,16,11,4,5,18,55,38.246267294794905,-109.3383999
47109,0,15,11,1,2,21,50,38.246267294794905,-109.3381304
47110,0,19,12,1,2,21,55,38.246267294794905,-109.3378609
47111,2,19,11,5,4,17,58,38.246267294794905,-109.3375914
47112,3,29,10,5,8,11,66,38.246267294794905,-109.3373219
47113,1,42,9,2,12,7,73,38.246267294794905,-109.3370524
47114,1,49,8,1,15,3,77,38.246267294794905,-109.3367829
47115,1,32,9,2,8,10,62,38.246267294794905,-109.3365134
47116,0,26,9,0,6,13,54,38.246267294794905,-109.3362439
47117,1,35,9,0,11,7,63,38.246267294794905,-109.3359744
47118,1,46,8,3,11,3,72,38.246267294794905,-109.3357049
47119,1,46,8,2,10,5,72,38.246267294794905,-109.3354355
47120,3,36,11,3,11,10,74,38.246267294794905,-109.335166
47121,2,26,13,0,3,21,65,38.246267294794905,-109.3348965
47122,0,25,10,0,2,20,57,38.246267294794905,-109.334627
47123,4,40,5,4,7,3,63,38.246267294794905,-109.3343575
47124,3,45,5,4,8,2,67,38.246267294794905,-109.334088
47125,4,37,6,4,7,3,61,38.246267294794905,-109.3338185
47126,5,33,6,5,6,4,59,38.246267294794905,-109.333549
47127,5,37,9,4,7,4,66,38.246267294794905,-109.3332795
47128,1,39,8,3,6,5,62,38.246267294794905,-109.33301
47129,4,36,7,5,8,2,62,38.246267294794905,-109.3327405
47130,4,37,9,6,8,3,67,38.246267294794905,-109.332471
47131,3,30,9,7,9,6,64,38.246267294794905,-109.3322015
47132,1,24,10,6,8,9,58,38.246267294794905,-109.331932
47133,1,25,9,7,7,8,57,38.246267294794905,-109.3316625
47134,1,24,10,6,11,10,62,38.246267294794905,-109.331393
47135,1,36,9,0,6,12,64,38.245997800209665,-109.4402688
47136,1,39,9,1,10,10,70,38.245997800209665,-109.4399993
47137,1,39,9,2,8,8,67,38.245997800209665,-109.4397299
47138,1,37,8,1,7,8,62,38.245997800209665,-109.4394604
47139,1,35,8,1,8,7,60,38.245997800209665,-109.4391909
47140,2,33,8,3,9,6,61,38.245997800209665,-109.4389214
47141,2,33,10,5,11,7,68,38.245997800209665,-109.4386519
47142,3,33,12,5,13,7,73,38.245997800209665,-109.4383824
47143,4,42,11,5,17,3,82,38.245997800209665,-109.4381129
47144,5,51,11,7,15,2,91,38.245997800209665,-109.4378434
47145,5,46,11,9,12,2,85,38.245997800209665,-109.4375739
47146,6,46,13,10,14,1,90,38.245997800209665,-109.4373044
47147,5,46,13,10,14,1,89,38.245997800209665,-109.4370349
47148,5,46,12,9,15,1,88,38.245997800209665,-109.4367654
47149,5,44,12,8,15,2,86,38.245997800209665,-109.4364959
47150,6,42,12,14,15,1,90,38.245997800209665,-109.4362264
47151,5,42,12,15,13,1,88,38.245997800209665,-109.4359569
47152,5,43,13,14,13,1,89,38.245997800209665,-109.4356874
47153,5,43,13,14,13,1,89,38.245997800209665,-109.4354179
47154,5,41,13,15,13,1,88,38.245997800209665,-109.4351484
47155,8,39,15,18,13,0,93,38.245997800209665,-109.434879
47156,8,40,14,16,14,0,92,38.245997800209665,-109.4346095
47157,6,44,13,13,14,1,91,38.245997800209665,-109.43434
47158,6,44,13,12,15,1,91,38.245997800209665,-109.4340705
47159,7,43,14,14,14,1,93,38.245997800209665,-109.433801
47160,5,44,13,11,15,0,88,38.245997800209665,-109.4335315
47161,3,43,11,5,15,3,80,38.245997800209665,-109.433262
47162,2,38,9,3,12,7,71,38.245997800209665,-109.4329925
47163,0,35,9,1,11,9,65,38.245997800209665,-109.432723
47164,1,43,8,0,11,6,69,38.245997800209665,-109.4324535
47165,2,50,9,1,13,5,80,38.245997800209665,-109.432184
47166,4,49,10,4,15,3,85,38.245997800209665,-109.4319145
47167,8,46,12,8,15,2,91,38.245997800209665,-109.431645
47168,9,45,13,9,15,1,92,38.245997800209665,-109.4313755
47169,6,45,12,7,15,2,87,38.245997800209665,-109.431106
47170,6,47,12,7,15,2,89,38.245997800209665,-109.4308365
47171,6,44,12,10,15,0,87,38.245997800209665,-109.430567
47172,7,42,13,13,14,0,89,38.245997800209665,-109.4302975
47173,8,43,13,12,15,0,91,38.245997800209665,-109.430028
47174,8,43,13,10,16,0,90,38.245997800209665,-109.4297586
47175,11,40,14,12,14,0,91,38.245997800209665,-109.4294891
47176,12,38,14,15,14,0,93,38.245997800209665,-109.4292196
47177,11,39,14,14,14,0,92,38.245997800209665,-109.4289501
47178,12,39,13,12,14,0,90,38.245997800209665,-109.4286806
47179,15,37,13,10,15,0,90,38.245997800209665,-109.4284111
47180,13,37,12,10,14,1,87,38.245997800209665,-109.4281416
47181,7,41,11,8,13,3,83,38.245997800209665,-109.4278721
47182,5,46,11,6,16,2,86,38.245997800209665,-109.4276026
47183,7,49,12,7,16,1,92,38.245997800209665,-109.4273331
47184,10,45,13,9,16,0,93,38.245997800209665,-109.4270636
47185,11,42,13,10,15,0,91,38.245997800209665,-109.4267941
47186,9,42,12,10,15,1,89,38.245997800209665,-109.4265246
47187,7,44,10,6,15,1,83,38.245997800209665,-109.4262551
47188,7,45,11,8,16,0,87,38.245997800209665,-109.4259856
47189,8,45,12,9,15,0,89,38.245997800209665,-109.4257161
47190,8,47,11,8,15,0,89,38.245997800209665,-109.4254466
47191,8,48,11,7,15,0,89,38.245997800209665,-109.4251771
47192,9,45,11,10,15,0,90,38.245997800209665,-109.4249077
47193,9,42,12,12,14,1,90,38.245997800209665,-109.4246382
47194,13,39,12,11,14,0,89,38.245997800209665,-109.4243687
47195,20,36,12,10,12,0,90,38.245997800209665,-109.4240992
47196,22,34,12,10,12,0,90,38.245997800209665,-109.4238297
47197,20,35,12,11,12,0,90,38.245997800209665,-109.4235602
47198,17,37,12,11,13,0,90,38.245997800209665,-109.4232907
47199,11,40,13,12,15,0,91,38.245997800209665,-109.4230212
47200,7,42,13,11,15,1,89,38.245997800209665,-109.4227517
47201,7,43,13,10,15,1,89,38.245997800209665,-109.4224822
47202,6,41,13,11,15,1,87,38.245997800209665,-109.4222127
47203,7,42,14,12,15,1,91,38.245997800209665,-109.4219432
47204,6,44,13,11,15,1,90,38.245997800209665,-109.4216737
47205,4,47,11,8,16,1,87,38.245997800209665,-109.4214042
47206,5,49,9,7,13,1,84,38.245997800209665,-109.4211347
47207,2,47,8,3,13,3,76,38.245997800209665,-109.4208652
47208,1,43,9,3,12,4,72,38.245997800209665,-109.4205957
47209,2,38,9,3,11,6,69,38.245997800209665,-109.4203262
47210,2,37,10,2,10,10,71,38.245997800209665,-109.4200568
47211,2,38,10,0,10,13,73,38.245997800209665,-109.4197873
47212,2,48,11,0,12,10,83,38.245997800209665,-109.4195178
47213,2,50,11,0,12,10,85,38.245997800209665,-109.4192483
47214,2,50,11,2,13,7,85,38.245997800209665,-109.4189788
47215,2,44,10,5,11,5,77,38.245997800209665,-109.4187093
47216,3,41,9,4,10,5,72,38.245997800209665,-109.4184398
47217,1,37,9,2,7,9,65,38.245997800209665,-109.4181703
47218,1,37,10,0,9,12,69,38.245997800209665,-109.4179008
47219,2,42,11,0,12,12,79,38.245997800209665,-109.4176313
47220,1,50,10,1,13,7,82,38.245997800209665,-109.4173618
47221,1,51,10,2,13,6,83,38.245997800209665,-109.4170923
47222,1,48,10,2,13,7,81,38.245997800209665,-109.4168228
47223,1,45,10,0,12,9,77,38.245997800209665,-109.4165533
47224,1,42,10,0,10,12,75,38.245997800209665,-109.4162838
47225,5,41,13,5,12,8,84,38.245997800209665,-109.4160143
47226,9,36,14,11,14,4,88,38.245997800209665,-109.4157448
47227,9,36,13,13,15,3,89,38.245997800209665,-109.4154753
47228,5,32,12,11,14,6,80,38.245997800209665,-109.4152058
47229,2,28,13,7,10,15,75,38.245997800209665,-109.4149364
47230,0,27,11,3,12,11,64,38.245997800209665,-109.4146669
47231,1,29,9,5,10,7,61,38.245997800209665,-109.4143974
47232,1,32,8,8,9,5,63,38.245997800209665,-109.4141279
47233,2,32,9,8,11,5,67,38.245997800209665,-109.4138584
47234,2,40,10,1,13,8,74,38.245997800209665,-109.4135889
47235,6,40,11,8,16,2,83,38.245997800209665,-109.4133194
47236,9,43,12,11,14,0,89,38.245997800209665,-109.4130499
47237,10,44,13,12,13,0,92,38.245997800209665,-109.4127804
47238,8,45,13,11,14,0,91,38.245997800209665,-109.4125109
47239,6,46,13,10,16,0,91,38.245997800209665,-109.4122414
47240,6,44,12,11,16,0,89,38.245997800209665,-109.4119719
47241,7,38,11,8,16,2,82,38.245997800209665,-109.4117024
47242,5,30,10,6,11,8,70,38.245997800209665,-109.4114329
47243,3,31,10,3,10,10,67,38.245997800209665,-109.4111634
47244,3,39,10,6,14,3,75,38.245997800209665,-109.4108939
47245,6,37,10,8,14,2,77,38.245997800209665,-109.4106244
47246,10,34,12,12,14,1,83,38.245997800209665,-109.4103549
47247,14,33,14,14,13,1,89,38.245997800209665,-109.4100855
47248,13,33,15,16,13,1,91,38.245997800209665,-109.409816
47249,12,35,15,14,13,1,90,38.245997800209665,-109.4095465
47250,15,34,14,14,13,0,90,38.245997800209665,-109.409277
47251,17,33,14,13,13,0,90,38.245997800209665,-109.4090075
47252,15,35,15,14,13,0,92,38.245997800209665,-109.408738
47253,14,35,15,14,13,0,91,38.245997800209665,-109.4084685
47254,14,36,15,14,13,0,92,38.245997800209665,-109.408199
47255,13,36,14,14,14,0,91,38.245997800209665,-109.4079295
47256,13,35,14,14,14,0,90,38.245997800209665,-109.40766
47257,14,34,14,14,15,0,91,38.245997800209665,-109.4073905
47258,16,34,14,14,14,0,92,38.245997800209665,-109.407121
47259,17,33,14,14,13,0,91,38.245997800209665,-109.4068515
47260,19,31,14,14,13,0,91,38.245997800209665,-109.406582
47261,19,30,14,14,13,0,90,38.245997800209665,-109.4063125
47262,20,30,14,14,12,0,90,38.245997800209665,-109.406043
47263,19,30,14,14,12,0,89,38.245997800209665,-109.4057735
47264,18,32,14,13,13,0,90,38.245997800209665,-109.405504
47265,17,33,14,13,13,0,90,38.245997800209665,-109.4052345
47266,16,33,14,14,14,0,91,38.245997800209665,-109.4049651
47267,16,33,14,13,14,0,90,38.245997800209665,-109.4046956
47268,17,32,14,13,14,0,90,38.245997800209665,-109.4044261
47269,17,31,13,13,14,0,88,38.245997800209665,-109.4041566
47270,18,32,13,13,14,0,90,38.245997800209665,-109.4038871
47271,21,32,14,12,13,0,92,38.245997800209665,-109.4036176
47272,23,31,14,12,12,0,92,38.245997800209665,-109.4033481
47273,20,32,14,12,13,0,91,38.245997800209665,-109.4030786
47274,18,33,14,13,13,0,91,38.245997800209665,-109.4028091
47275,17,34,14,13,14,0,92,38.245997800209665,-109.4025396
47276,15,34,14,13,14,0,90,38.245997800209665,-109.4022701
47277,16,34,14,13,13,0,90,38.245997800209665,-109.4020006
47278,15,35,15,14,14,0,93,38.245997800209665,-109.4017311
47279,13,37,15,14,14,0,93,38.245997800209665,-109.4014616
47280,10,40,14,14,14,1,93,38.245997800209665,-109.4011921
47281,10,40,14,14,14,1,93,38.245997800209665,-109.4009226
47282,13,36,14,16,14,0,93,38.245997800209665,-109.4006531
47283,14,36,14,15,13,0,92,38.245997800209665,-109.4003836
47284,14,36,15,14,14,0,93,38.245997800209665,-109.4001142
47285,15,35,14,13,13,0,90,38.245997800209665,-109.3998447
47286,11,36,14,13,15,0,89,38.245997800209665,-109.3995752
47287,11,39,14,13,15,1,93,38.245997800209665,-109.3993057
47288,11,40,14,12,15,1,93,38.245997800209665,-109.3990362
47289,12,39,14,13,15,0,93,38.245997800209665,-109.3987667
47290,15,37,14,11,15,1,93,38.245997800209665,-109.3984972
47291,9,42,14,12,16,1,94,38.245997800209665,-109.3982277
47292,8,43,14,11,14,2,92,38.245997800209665,-109.3979582
47293,7,45,14,10,14,1,91,38.245997800209665,-109.3976887
47294,8,46,14,11,14,1,94,38.245997800209665,-109.3974192
47295,7,44,14,12,15,1,93,38.245997800209665,-109.3971497
47296,8,43,14,12,14,1,92,38.245997800209665,-109.3968802
47297,7,42,14,11,13,2,89,38.245997800209665,-109.3966107
47298,7,42,14,10,12,2,87,38.245997800209665,-109.3963412
47299,7,43,14,10,13,1,88,38.245997800209665,-109.3960717
47300,7,43,14,12,13,1,90,38.245997800209665,-109.3958022
47301,6,45,14,10,13,1,89,38.245997800209665,-109.3955327
47302,6,46,14,10,15,1,92,38.245997800209665,-109.3952632
47303,6,45,14,10,16,1,92,38.245997800209665,-109.3949938
47304,5,45,14,10,17,0,91,38.245997800209665,-109.3947243
47305,4,43,14,9,17,1,88,38.245997800209665,-109.3944548
47306,4,44,14,8,16,2,88,38.245997800209665,-109.3941853
47307,4,45,14,8,16,2,89,38.245997800209665,-109.3939158
47308,4,44,14,9,16,1,88,38.245997800209665,-109.3936463
47309,4,43,14,9,16,1,87,38.245997800209665,-109.3933768
47310,4,43,15,9,16,2,89,38.245997800209665,-109.3931073
47311,4,45,15,9,17,2,92,38.245997800209665,-109.3928378
47312,4,45,14,9,17,2,91,38.245997800209665,-109.3925683
47313,4,44,15,9,17,1,90,38.245997800209665,-109.3922988
47314,4,46,15,9,18,1,93,38.245997800209665,-109.3920293
47315,4,48,14,8,17,1,92,38.245997800209665,-109.3917598
47316,4,46,14,10,17,1,92,38.245997800209665,-109.3914903
47317,5,45,15,12,17,1,95,38.245997800209665,-109.3912208
47318,6,44,14,11,16,1,92,38.245997800209665,-109.3909513
47319,5,44,14,11,16,2,92,38.245997800209665,-109.3906818
47320,5,44,14,12,17,1,93,38.245997800209665,-109.3904123
47321,4,46,14,11,17,1,93,38.245997800209665,-109.3901429
47322,5,48,13,9,17,1,93,38.245997800209665,-109.3898734
47323,5,49,13,9,16,1,93,38.245997800209665,-109.3896039
47324,6,49,14,11,15,0,95,38.245997800209665,-109.3893344
47325,7,47,13,12,14,1,94,38.245997800209665,-109.3890649
47326,7,45,13,12,13,1,91,38.245997800209665,-109.3887954
47327,8,41,13,14,13,2,91,38.245997800209665,-109.3885259
47328,7,38,13,17,13,1,89,38.245997800209665,-109.3882564
47329,9,40,14,16,13,0,92,38.245997800209665,-109.3879869
47330,8,42,14,15,14,0,93,38.245997800209665,-109.3877174
47331,8,43,15,14,14,1,95,38.245997800209665,-109.3874479
47332,8,43,15,15,12,1,94,38.245997800209665,-109.3871784
47333,7,41,14,14,12,2,90,38.245997800209665,-109.3869089
47334,8,41,14,14,13,2,92,38.245997800209665,-109.3866394
47335,9,41,15,15,13,1,94,38.245997800209665,-109.3863699
47336,9,40,15,17,13,1,95,38.245997800209665,-109.3861004
47337,10,37,16,17,13,1,94,38.245997800209665,-109.3858309
47338,11,37,15,17,13,0,93,38.245997800209665,-109.3855614
47339,12,37,14,15,14,0,92,38.245997800209665,-109.3852919
47340,12,37,13,13,14,1,90,38.245997800209665,-109.3850225
47341,12,38,13,12,14,1,90,38.245997800209665,-109.384753
47342,12,40,13,13,14,1,93,38.245997800209665,-109.3844835
47343,12,38,14,14,13,0,91,38.245997800209665,-109.384214
47344,12,40,14,13,13,0,92,38.245997800209665,-109.3839445
47345,10,42,13,12,14,0,91,38.245997800209665,-109.383675
47346,9,43,14,13,13,0,92,38.245997800209665,-109.3834055
47347,11,39,14,14,12,1,91,38.245997800209665,-109.383136
47348,12,38,13,13,13,1,90,38.245997800209665,-109.3828665
47349,14,34,12,11,13,2,86,38.245997800209665,-109.382597
47350,17,24,12,14,10,2,79,38.245997800209665,-109.3823275
47351,14,20,10,17,12,0,73,38.245997800209665,-109.382058
47352,18,30,12,12,9,2,83,38.245997800209665,-109.3817885
47353,14,36,13,11,11,3,88,38.245997800209665,-109.381519
47354,10,39,14,12,12,3,90,38.245997800209665,-109.3812495
47355,9,39,14,14,11,3,90,38.245997800209665,-109.38098
47356,13,38,14,15,10,1,91,38.245997800209665,-109.3807105
47357,15,38,13,12,10,1,89,38.245997800209665,-109.380441
47358,13,39,13,12,10,2,89,38.245997800209665,-109.3801716
47359,12,37,13,12,10,2,86,38.245997800209665,-109.3799021
47360,15,34,13,12,9,3,86,38.245997800209665,-109.3796326
47361,19,31,14,16,9,1,90,38.245997800209665,-109.3793631
47362,19,29,14,18,8,1,89,38.245997800209665,-109.3790936
47363,22,26,14,18,8,1,89,38.245997800209665,-109.3788241
47364,25,23,15,18,7,2,90,38.245997800209665,-109.3785546
47365,29,22,15,14,6,1,87,38.245997800209665,-109.3782851
47366,27,22,15,14,6,3,87,38.245997800209665,-109.3780156
47367,22,24,16,15,6,3,86,38.245997800209665,-109.3777461
47368,22,25,16,15,6,3,87,38.245997800209665,-109.3774766
47369,28,24,15,13,7,2,89,38.245997800209665,-109.3772071
47370,25,29,13,10,8,1,86,38.245997800209665,-109.3769376
47371,17,28,11,9,7,3,75,38.245997800209665,-109.3766681
47372,10,28,9,6,7,5,65,38.245997800209665,-109.3763986
47373,4,33,8,5,9,7,66,38.245997800209665,-109.3761291
47374,2,43,6,4,9,4,68,38.245997800209665,-109.3758596
47375,2,48,6,4,9,3,72,38.245997800209665,-109.3755901
47376,1,45,6,3,9,5,69,38.245997800209665,-109.3753206
47377,1,46,6,3,9,4,69,38.245997800209665,-109.3750512
47378,0,48,6,3,9,4,70,38.245997800209665,-109.3747817
47379,1,53,7,4,9,5,79,38.245997800209665,-109.3745122
47380,1,46,8,3,11,6,75,38.245997800209665,-109.3742427
47381,2,38,10,4,11,8,73,38.245997800209665,-109.3739732
47382,2,33,12,5,10,11,73,38.245997800209665,-109.3737037
47383,2,29,12,6,8,14,71,38.245997800209665,-109.3734342
47384,2,29,12,6,9,12,70,38.245997800209665,-109.3731647
47385,6,30,13,11,9,10,79,38.245997800209665,-109.3728952
47386,7,31,10,15,11,5,79,38.245997800209665,-109.3726257
47387,8,31,11,14,13,2,79,38.245997800209665,-109.3723562
47388,11,29,11,14,13,2,80,38.245997800209665,-109.3720867
47389,10,30,11,16,12,2,81,38.245997800209665,-109.3718172
47390,5,33,13,14,10,5,80,38.245997800209665,-109.3715477
47391,3,29,14,7,18,7,78,38.245997800209665,-109.3712782
47392,1,21,12,8,18,9,69,38.245997800209665,-109.3710087
47393,0,15,13,9,16,10,63,38.245997800209665,-109.3707392
47394,0,18,10,9,17,5,59,38.245997800209665,-109.3704697
47395,1,21,12,9,8,13,64,38.245997800209665,-109.3702003
47396,2,24,15,3,6,21,71,38.245997800209665,-109.3699308
47397,2,23,16,0,2,28,71,38.245997800209665,-109.3696613
47398,2,25,15,0,3,25,70,38.245997800209665,-109.3693918
47399,2,25,14,0,3,26,70,38.245997800209665,-109.3691223
47400,1,24,15,0,3,27,70,38.245997800209665,-109.3688528
47401,1,24,15,0,3,29,72,38.245997800209665,-109.3685833
47402,1,26,16,0,3,29,75,38.245997800209665,-109.3683138
47403,2,26,14,0,3,26,71,38.245997800209665,-109.3680443
47404,2,25,14,0,2,26,69,38.245997800209665,-109.3677748
47405,2,25,14,0,2,25,68,38.245997800209665,-109.3675053
47406,2,25,14,1,3,25,70,38.245997800209665,-109.3672358
47407,2,25,13,0,3,22,65,38.245997800209665,-109.3669663
47408,2,27,12,1,4,20,66,38.245997800209665,-109.3666968
47409,2,26,12,0,4,19,63,38.245997800209665,-109.3664273
47410,2,24,12,0,4,20,62,38.245997800209665,-109.3661578
47411,2,24,12,0,3,20,61,38.245997800209665,-109.3658883
47412,2,24,11,0,3,18,58,38.245997800209665,-109.3656188
47413,2,27,12,0,4,19,64,38.245997800209665,-109.3653493
47414,3,30,13,1,6,20,73,38.245997800209665,-109.3650799
47415,3,31,14,2,5,22,77,38.245997800209665,-109.3648104
47416,2,28,16,2,6,25,79,38.245997800209665,-109.3645409
47417,2,27,16,1,5,28,79,38.245997800209665,-109.3642714
47418,2,26,14,0,2,25,69,38.245997800209665,-109.3640019
47419,2,28,12,1,4,20,67,38.245997800209665,-109.3637324
47420,1,30,11,1,5,17,65,38.245997800209665,-109.3634629
47421,2,26,11,2,5,16,62,38.245997800209665,-109.3631934
47422,1,26,11,1,5,16,60,38.245997800209665,-109.3629239
47423,1,26,12,0,5,18,62,38.245997800209665,-109.3626544
47424,1,27,12,0,5,19,64,38.245997800209665,-109.3623849
47425,1,26,13,0,2,22,64,38.245997800209665,-109.3621154
47426,2,24,14,0,1,26,67,38.245997800209665,-109.3618459
47427,1,23,16,1,2,29,72,38.245997800209665,-109.3615764
47428,1,23,16,1,3,28,72,38.245997800209665,-109.3613069
47429,2,22,15,2,2,26,69,38.245997800209665,-109.3610374
47430,2,26,14,3,4,22,71,38.245997800209665,-109.3607679
47431,3,33,13,3,7,18,77,38.245997800209665,-109.3604984
47432,1,21,12,2,2,20,58,38.245997800209665,-109.360229
47433,2,17,12,3,3,18,55,38.245997800209665,-109.3599595
47434,2,14,13,4,3,18,54,38.245997800209665,-109.35969
47435,2,18,14,2,2,20,58,38.245997800209665,-109.3594205
47436,5,24,11,4,5,13,62,38.245997800209665,-109.359151
47437,2,25,9,3,9,7,55,38.245997800209665,-109.3588815
47438,2,30,7,2,8,5,54,38.245997800209665,-109.358612
47439,3,39,6,3,8,3,62,38.245997800209665,-109.3583425
47440,3,32,6,4,9,6,60,38.245997800209665,-109.358073
47441,3,29,8,3,8,10,61,38.245997800209665,-109.3578035
47442,2,34,9,2,8,11,66,38.245997800209665,-109.357534
47443,2,36,9,0,8,12,67,38.245997800209665,-109.3572645
47444,1,36,9,0,8,13,67,38.245997800209665,-109.356995
47445,1,41,10,0,10,10,72,38.245997800209665,-109.3567255
47446,1,31,9,2,7,9,59,38.245997800209665,-109.356456
47447,2,29,9,4,7,7,58,38.245997800209665,-109.3561865
47448,2,29,9,5,7,6,58,38.245997800209665,-109.355917
47449,3,31,7,5,8,4,58,38.245997800209665,-109.3556475
47450,3,32,7,4,7,4,57,38.245997800209665,-109.355378
47451,3,32,7,5,7,4,58,38.245997800209665,-109.3551086
47452,2,32,7,4,6,6,57,38.245997800209665,-109.3548391
47453,2,31,8,4,7,6,58,38.245997800209665,-109.3545696
47454,4,24,10,8,9,6,61,38.245997800209665,-109.3543001
47455,2,17,12,6,6,17,60,38.245997800209665,-109.3540306
47456,2,16,11,4,8,14,55,38.245997800209665,-109.3537611
47457,3,28,8,7,7,5,58,38.245997800209665,-109.3534916
47458,3,37,6,5,8,2,61,38.245997800209665,-109.3532221
47459,1,36,5,5,8,2,57,38.245997800209665,-109.3529526
47460,0,36,4,3,8,2,53,38.245997800209665,-109.3526831
47461,0,31,6,4,9,3,53,38.245997800209665,-109.3524136
47462,1,23,10,8,12,5,59,38.245997800209665,-109.3521441
47463,16,20,18,8,16,9,87,38.245997800209665,-109.3518746
47464,19,14,15,12,17,8,85,38.245997800209665,-109.3516051
47465,4,19,13,16,13,11,76,38.245997800209665,-109.3513356
47466,1,21,9,13,13,5,62,38.245997800209665,-109.3510661
47467,1,24,8,13,10,4,60,38.245997800209665,-109.3507966
47468,2,25,11,5,11,10,64,38.245997800209665,-109.3505271
47469,1,25,11,1,4,17,59,38.245997800209665,-109.3502577
47470,1,32,11,0,6,12,62,38.245997800209665,-109.3499882
47471,2,33,9,3,6,7,60,38.245997800209665,-109.3497187
47472,2,32,7,4,7,4,56,38.245997800209665,-109.3494492
47473,3,33,8,4,8,3,59,38.245997800209665,-109.3491797
47474,1,27,9,3,7,7,54,38.245997800209665,-109.3489102
47475,1,20,10,4,7,10,52,38.245997800209665,-109.3486407
47476,3,19,12,8,6,10,58,38.245997800209665,-109.3483712
47477,8,21,13,12,8,10,72,38.245997800209665,-109.3481017
47478,2,19,14,6,7,22,70,38.245997800209665,-109.3478322
47479,2,25,13,5,11,17,73,38.245997800209665,-109.3475627
47480,3,25,14,8,12,9,71,38.245997800209665,-109.3472932
47481,5,22,14,12,8,8,69,38.245997800209665,-109.3470237
47482,5,20,13,15,9,9,71,38.245997800209665,-109.3467542
47483,14,17,13,12,13,9,78,38.245997800209665,-109.3464847
47484,7,18,12,11,11,11,70,38.245997800209665,-109.3462152
47485,2,24,12,6,9,11,64,38.245997800209665,-109.3459457
47486,1,26,11,5,8,10,61,38.245997800209665,-109.3456762
47487,1,22,12,5,9,12,61,38.245997800209665,-109.3454068
47488,1,21,12,5,11,13,63,38.245997800209665,-109.3451373
47489,1,20,13,8,10,14,66,38.245997800209665,-109.3448678
47490,2,16,12,10,9,13,62,38.245997800209665,-109.3445983
47491,4,11,11,10,13,9,58,38.245997800209665,-109.3443288
47492,3,23,9,8,9,7,59,38.245997800209665,-109.3440593
47493,4,30,8,5,12,4,63,38.245997800209665,-109.3437898
47494,3,30,8,7,8,5,61,38.245997800209665,-109.3435203
47495,3,32,7,6,10,5,63,38.245997800209665,-109.3432508
47496,4,33,7,8,10,3,65,38.245997800209665,-109.3429813
47497,2,36,7,6,9,4,64,38.245997800209665,-109.3427118
47498,3,43,8,7,11,2,74,38.245997800209665,-109.3424423
47499,4,34,10,9,12,3,72,38.245997800209665,-109.3421728
47500,9,22,12,9,11,5,68,38.245997800209665,-109.3419033
47501,2,24,12,6,11,10,65,38.245997800209665,-109.3416338
47502,2,29,13,7,11,7,69,38.245997800209665,-109.3413643
47503,0,32,10,2,12,9,65,38.245997800209665,-109.3410948
47504,0,28,10,4,11,9,62,38.245997800209665,-109.3408253
47505,0,20,11,7,11,12,61,38.245997800209665,-109.3405558
47506,0,20,10,9,10,9,58,38.245997800209665,-109.3402864
47507,1,17,11,6,10,10,55,38.245997800209665,-109.3400169
47508,1,18,11,4,8,13,55,38.245997800209665,-109.3397474
47509,0,24,12,4,11,13,64,38.245997800209665,-109.3394779
47510,1,29,13,3,13,13,72,38.245997800209665,-109.3392084
47511,0,24,13,0,4,23,64,38.245997800209665,-109.3389389
47512,2,21,13,1,4,20,61,38.245997800209665,-109.3386694
47513,1,14,11,3,6,15,50,38.245997800209665,-109.3383999
47514,1,16,10,4,7,14,52,38.245997800209665,-109.3381304
47515,1,22,10,4,5,16,58,38.245997800209665,-109.3378609
47516,8,18,12,6,5,15,64,38.245997800209665,-109.3375914
47517,9,22,12,8,6,11,68,38.245997800209665,-109.3373219
47518,3,31,10,7,11,7,69,38.245997800209665,-109.3370524
47519,2,44,9,4,16,3,78,38.245997800209665,-109.3367829
47520,1,32,9,2,9,10,63,38.245997800209665,-109.3365134
47521,1,26,9,0,7,12,55,38.245997800209665,-109.3362439
47522,0,35,8,0,10,6,59,38.245997800209665,-109.3359744
47523,1,46,8,2,11,3,71,38.245997800209665,-109.3357049
47524,1,42,9,3,12,6,73,38.245997800209665,-109.3354355
47525,2,35,11,1,9,14,72,38.245997800209665,-109.335166
47526,1,26,12,0,3,21,63,38.245997800209665,-109.3348965
47527,0,25,9,1,4,16,55,38.245997800209665,-109.334627
47528,3,32,7,3,9,4,58,38.245997800209665,-109.3343575
47529,1,36,5,3,6,4,55,38.245997800209665,-109.334088
47530,3,43,5,4,7,3,65,38.245997800209665,-109.3338185
47531,4,43,6,5,7,2,67,38.245997800209665,-109.333549
47532,5,39,8,6,8,2,68,38.245997800209665,-109.3332795
47533,3,39,7,5,7,3,64,38.245997800209665,-109.33301
47534,8,33,9,8,10,2,70,38.245997800209665,-109.3327405
47535,2,24,10,8,9,7,60,38.245997800209665,-109.332471
47536,0,22,10,6,8,11,57,38.245997800209665,-109.3322015
47537,0,24,10,6,8,11,59,38.245997800209665,-109.331932
47538,0,24,10,7,7,9,57,38.245997800209665,-109.3316625
47539,0,23,9,8,6,9,55,38.245997800209665,-109.331393
47540,3,30,10,6,10,7,66,38.24572830562443,-109.4402688
47541,3,34,9,6,11,5,68,38.24572830562443,-109.4399993
47542,2,36,9,4,11,6,68,38.24572830562443,-109.4397299
47543,1,36,9,3,10,8,67,38.24572830562443,-109.4394604
47544,1,35,9,2,9,9,65,38.24572830562443,-109.4391909
47545,1,32,9,3,8,10,63,38.24572830562443,-109.4389214
47546,1,29,10,4,12,9,65,38.24572830562443,-109.4386519
47547,1,35,10,2,12,9,69,38.24572830562443,-109.4383824
47548,2,47,10,2,15,6,82,38.24572830562443,-109.4381129
47549,2,50,10,5,13,5,85,38.24572830562443,-109.4378434
47550,3,47,11,7,13,4,85,38.24572830562443,-109.4375739
47551,4,47,12,4,13,7,87,38.24572830562443,-109.4373044
47552,4,46,12,3,14,6,85,38.24572830562443,-109.4370349
47553,5,44,12,4,15,4,84,38.24572830562443,-109.4367654
47554,7,42,12,9,16,1,87,38.24572830562443,-109.4364959
47555,10,39,12,14,14,1,90,38.24572830562443,-109.4362264
47556,8,42,13,14,14,1,92,38.24572830562443,-109.4359569
47557,6,43,13,13,14,1,90,38.24572830562443,-109.4356874
47558,6,42,13,13,13,1,88,38.24572830562443,-109.4354179
47559,5,41,13,14,13,1,87,38.24572830562443,-109.4351484
47560,6,40,14,16,13,1,90,38.24572830562443,-109.434879
47561,6,41,13,16,13,1,90,38.24572830562443,-109.4346095
47562,5,42,12,12,13,2,86,38.24572830562443,-109.43434
47563,5,43,12,11,14,1,86,38.24572830562443,-109.4340705
47564,6,43,13,14,14,1,91,38.24572830562443,-109.433801
47565,6,44,14,14,14,0,92,38.24572830562443,-109.4335315
47566,5,43,12,9,15,2,86,38.24572830562443,-109.433262
47567,3,39,11,5,14,5,77,38.24572830562443,-109.4329925
47568,2,34,11,3,12,8,70,38.24572830562443,-109.432723
47569,1,33,11,3,11,9,68,38.24572830562443,-109.4324535
47570,3,41,10,4,13,7,78,38.24572830562443,-109.432184
47571,9,43,12,9,15,1,89,38.24572830562443,-109.4319145
47572,12,43,13,10,14,0,92,38.24572830562443,-109.431645
47573,9,46,13,9,15,0,92,38.24572830562443,-109.4313755
47574,7,47,13,9,15,1,92,38.24572830562443,-109.431106
47575,8,45,13,10,15,0,91,38.24572830562443,-109.4308365
47576,7,44,13,12,15,0,91,38.24572830562443,-109.430567
47577,7,42,13,13,15,0,90,38.24572830562443,-109.4302975
47578,8,42,14,14,15,0,93,38.24572830562443,-109.430028
47579,8,43,13,12,16,0,92,38.24572830562443,-109.4297586
47580,11,38,14,12,15,0,90,38.24572830562443,-109.4294891
47581,12,37,14,13,15,0,91,38.24572830562443,-109.4292196
47582,11,38,14,13,15,0,91,38.24572830562443,-109.4289501
47583,12,39,14,13,15,0,93,38.24572830562443,-109.4286806
47584,12,37,13,10,15,1,88,38.24572830562443,-109.4284111
47585,8,36,11,9,15,1,80,38.24572830562443,-109.4281416
47586,5,40,11,7,16,2,81,38.24572830562443,-109.4278721
47587,5,44,11,7,16,1,84,38.24572830562443,-109.4276026
47588,5,46,11,6,16,1,85,38.24572830562443,-109.4273331
47589,6,44,11,8,16,1,86,38.24572830562443,-109.4270636
47590,9,45,12,9,16,0,91,38.24572830562443,-109.4267941
47591,10,45,12,8,15,0,90,38.24572830562443,-109.4265246
47592,9,47,11,7,15,0,89,38.24572830562443,-109.4262551
47593,9,46,11,8,15,0,89,38.24572830562443,-109.4259856
47594,9,45,11,7,15,1,88,38.24572830562443,-109.4257161
47595,8,46,10,6,15,1,86,38.24572830562443,-109.4254466
47596,7,46,10,5,16,1,85,38.24572830562443,-109.4251771
47597,9,41,11,9,15,1,86,38.24572830562443,-109.4249077
47598,19,37,12,11,13,0,92,38.24572830562443,-109.4246382
47599,21,35,12,11,13,0,92,38.24572830562443,-109.4243687
47600,23,35,12,10,12,0,92,38.24572830562443,-109.4240992
47601,23,35,12,10,11,0,91,38.24572830562443,-109.4238297
47602,20,36,12,11,13,0,92,38.24572830562443,-109.4235602
47603,16,37,12,11,14,0,90,38.24572830562443,-109.4232907
47604,11,39,13,12,15,0,90,38.24572830562443,-109.4230212
47605,9,41,13,12,15,0,90,38.24572830562443,-109.4227517
47606,9,44,13,9,15,0,90,38.24572830562443,-109.4224822
47607,7,43,14,12,14,1,91,38.24572830562443,-109.4222127
47608,7,42,14,13,15,0,91,38.24572830562443,-109.4219432
47609,6,45,13,11,14,1,90,38.24572830562443,-109.4216737
47610,5,47,11,8,15,1,87,38.24572830562443,-109.4214042
47611,6,49,9,7,13,1,85,38.24572830562443,-109.4211347
47612,3,48,8,3,14,2,78,38.24572830562443,-109.4208652
47613,1,45,8,2,11,4,71,38.24572830562443,-109.4205957
47614,2,43,8,3,9,4,69,38.24572830562443,-109.4203262
47615,1,38,9,2,10,6,66,38.24572830562443,-109.4200568
47616,1,35,10,2,11,10,69,38.24572830562443,-109.4197873
47617,1,39,10,0,12,11,73,38.24572830562443,-109.4195178
47618,1,41,11,2,14,10,79,38.24572830562443,-109.4192483
47619,1,43,11,3,14,7,79,38.24572830562443,-109.4189788
47620,1,43,9,3,11,5,72,38.24572830562443,-109.4187093
47621,2,42,9,3,10,4,70,38.24572830562443,-109.4184398
47622,3,39,9,4,10,5,70,38.24572830562443,-109.4181703
47623,1,41,10,1,12,8,73,38.24572830562443,-109.4179008
47624,1,46,10,0,13,10,80,38.24572830562443,-109.4176313
47625,2,47,10,4,11,5,79,38.24572830562443,-109.4173618
47626,1,48,9,2,12,5,77,38.24572830562443,-109.4170923
47627,1,50,9,1,12,5,78,38.24572830562443,-109.4168228
47628,1,46,9,1,12,6,75,38.24572830562443,-109.4165533
47629,2,40,10,2,11,9,74,38.24572830562443,-109.4162838
47630,5,33,13,10,11,8,80,38.24572830562443,-109.4160143
47631,16,31,14,13,13,3,90,38.24572830562443,-109.4157448
47632,13,35,13,14,14,2,91,38.24572830562443,-109.4154753
47633,6,35,12,12,14,6,85,38.24572830562443,-109.4152058
47634,3,34,13,7,12,14,83,38.24572830562443,-109.4149364
47635,1,30,11,2,11,11,66,38.24572830562443,-109.4146669
47636,2,30,9,3,10,8,62,38.24572830562443,-109.4143974
47637,2,32,9,6,8,6,63,38.24572830562443,-109.4141279
47638,2,29,9,6,10,6,62,38.24572830562443,-109.4138584
47639,2,38,10,2,12,8,72,38.24572830562443,-109.4135889
47640,8,43,11,7,15,2,86,38.24572830562443,-109.4133194
47641,10,43,12,10,14,1,90,38.24572830562443,-109.4130499
47642,9,43,13,11,13,1,90,38.24572830562443,-109.4127804
47643,7,46,13,11,14,0,91,38.24572830562443,-109.4125109
47644,6,48,13,10,15,0,92,38.24572830562443,-109.4122414
47645,7,45,13,11,16,0,92,38.24572830562443,-109.4119719
47646,9,39,12,11,16,1,88,38.24572830562443,-109.4117024
47647,8,34,12,8,15,4,81,38.24572830562443,-109.4114329
47648,6,31,12,6,11,9,75,38.24572830562443,-109.4111634
47649,6,38,10,5,13,5,77,38.24572830562443,-109.4108939
47650,7,38,11,8,15,2,81,38.24572830562443,-109.4106244
47651,10,36,12,11,15,1,85,38.24572830562443,-109.4103549
47652,13,35,14,12,13,1,88,38.24572830562443,-109.4100855
47653,12,36,14,13,13,1,89,38.24572830562443,-109.409816
47654,10,39,13,11,13,1,87,38.24572830562443,-109.4095465
47655,13,36,13,13,14,0,89,38.24572830562443,-109.409277
47656,16,34,14,13,13,0,90,38.24572830562443,-109.4090075
47657,13,35,15,13,13,0,89,38.24572830562443,-109.408738
47658,12,36,15,14,14,0,91,38.24572830562443,-109.4084685
47659,12,37,14,14,14,0,91,38.24572830562443,-109.408199
47660,10,39,14,13,15,0,91,38.24572830562443,-109.4079295
47661,10,38,13,13,15,0,89,38.24572830562443,-109.40766
47662,11,35,13,13,15,1,88,38.24572830562443,-109.4073905
47663,11,35,13,13,15,1,88,38.24572830562443,-109.407121
47664,12,35,13,13,15,0,88,38.24572830562443,-109.4068515
47665,12,35,13,13,15,0,88,38.24572830562443,-109.406582
47666,12,34,13,13,15,0,87,38.24572830562443,-109.4063125
47667,15,34,13,13,14,0,89,38.24572830562443,-109.406043
47668,17,33,14,14,13,0,91,38.24572830562443,-109.4057735
47669,15,34,13,13,14,0,89,38.24572830562443,-109.405504
47670,16,34,13,13,14,0,90,38.24572830562443,-109.4052345
47671,17,33,14,12,15,0,91,38.24572830562443,-109.4049651
47672,14,34,14,13,15,0,90,38.24572830562443,-109.4046956
47673,17,32,13,13,14,0,89,38.24572830562443,-109.4044261
47674,18,32,14,13,14,0,91,38.24572830562443,-109.4041566
47675,19,32,14,13,14,0,92,38.24572830562443,-109.4038871
47676,19,32,14,12,13,0,90,38.24572830562443,-109.4036176
47677,21,30,14,13,12,0,90,38.24572830562443,-109.4033481
47678,18,32,14,13,13,0,90,38.24572830562443,-109.4030786
47679,16,33,14,13,14,0,90,38.24572830562443,-109.4028091
47680,14,34,14,13,15,1,91,38.24572830562443,-109.4025396
47681,11,35,14,13,15,1,89,38.24572830562443,-109.4022701
47682,13,36,15,14,15,1,94,38.24572830562443,-109.4020006
47683,12,37,15,14,15,0,93,38.24572830562443,-109.4017311
47684,11,39,14,14,15,0,93,38.24572830562443,-109.4014616
47685,10,41,14,14,14,0,93,38.24572830562443,-109.4011921
47686,8,41,14,15,14,1,93,38.24572830562443,-109.4009226
47687,11,38,15,16,14,0,94,38.24572830562443,-109.4006531
47688,12,36,15,15,14,0,92,38.24572830562443,-109.4003836
47689,15,34,15,14,15,0,93,38.24572830562443,-109.4001142
47690,17,33,15,13,14,0,92,38.24572830562443,-109.3998447
47691,11,38,15,14,15,0,93,38.24572830562443,-109.3995752
47692,9,40,14,13,15,1,92,38.24572830562443,-109.3993057
47693,11,39,14,13,15,1,93,38.24572830562443,-109.3990362
47694,13,38,14,13,15,0,93,38.24572830562443,-109.3987667
47695,14,38,14,12,15,0,93,38.24572830562443,-109.3984972
47696,8,42,14,11,15,2,92,38.24572830562443,-109.3982277
47697,7,43,14,11,16,1,92,38.24572830562443,-109.3979582
47698,7,43,14,11,15,1,91,38.24572830562443,-109.3976887
47699,7,44,14,10,14,2,91,38.24572830562443,-109.3974192
47700,7,44,14,10,14,1,90,38.24572830562443,-109.3971497
47701,7,42,14,10,14,2,89,38.24572830562443,-109.3968802
47702,7,42,14,11,13,2,89,38.24572830562443,-109.3966107
47703,7,41,14,11,14,1,88,38.24572830562443,-109.3963412
47704,8,42,14,11,15,1,91,38.24572830562443,-109.3960717
47705,8,44,14,10,15,1,92,38.24572830562443,-109.3958022
47706,6,46,14,11,16,1,94,38.24572830562443,-109.3955327
47707,5,46,14,11,16,0,92,38.24572830562443,-109.3952632
47708,4,45,14,10,17,1,91,38.24572830562443,-109.3949938
47709,4,45,14,10,18,1,92,38.24572830562443,-109.3947243
47710,5,44,14,9,17,1,90,38.24572830562443,-109.3944548
47711,5,45,14,10,17,1,92,38.24572830562443,-109.3941853
47712,5,44,14,10,17,1,91,38.24572830562443,-109.3939158
47713,5,43,14,9,17,1,89,38.24572830562443,-109.3936463
47714,6,43,14,10,17,1,91,38.24572830562443,-109.3933768
47715,5,44,15,10,18,0,92,38.24572830562443,-109.3931073
47716,4,44,15,10,18,1,92,38.24572830562443,-109.3928378
47717,4,43,15,9,18,1,90,38.24572830562443,-109.3925683
47718,5,43,15,10,18,1,92,38.24572830562443,-109.3922988
47719,6,42,15,11,18,0,92,38.24572830562443,-109.3920293
47720,5,42,15,11,18,0,91,38.24572830562443,-109.3917598
47721,5,42,15,12,18,0,92,38.24572830562443,-109.3914903
47722,6,43,15,12,17,0,93,38.24572830562443,-109.3912208
47723,6,43,14,12,17,0,92,38.24572830562443,-109.3909513
47724,6,44,14,12,18,0,94,38.24572830562443,-109.3906818
47725,5,45,14,11,18,0,93,38.24572830562443,-109.3904123
47726,4,46,14,10,18,1,93,38.24572830562443,-109.3901429
47727,4,47,14,10,18,1,94,38.24572830562443,-109.3898734
47728,5,48,14,10,17,0,94,38.24572830562443,-109.3896039
47729,5,51,13,9,15,0,93,38.24572830562443,-109.3893344
47730,6,50,13,11,14,1,95,38.24572830562443,-109.3890649
47731,7,46,13,12,13,1,92,38.24572830562443,-109.3887954
47732,8,40,13,13,13,1,88,38.24572830562443,-109.3885259
47733,9,40,13,14,14,1,91,38.24572830562443,-109.3882564
47734,10,41,14,14,13,0,92,38.24572830562443,-109.3879869
47735,8,43,15,14,14,0,94,38.24572830562443,-109.3877174
47736,7,44,14,14,14,0,93,38.24572830562443,-109.3874479
47737,7,43,15,15,13,1,94,38.24572830562443,-109.3871784
47738,7,44,14,13,12,1,91,38.24572830562443,-109.3869089
47739,8,43,14,13,12,2,92,38.24572830562443,-109.3866394
47740,8,42,15,14,13,1,93,38.24572830562443,-109.3863699
47741,9,40,15,15,14,1,94,38.24572830562443,-109.3861004
47742,12,36,15,17,13,0,93,38.24572830562443,-109.3858309
47743,12,36,14,17,14,0,93,38.24572830562443,-109.3855614
47744,12,36,14,15,14,0,91,38.24572830562443,-109.3852919
47745,11,37,14,13,14,1,90,38.24572830562443,-109.3850225
47746,10,39,13,11,14,2,89,38.24572830562443,-109.384753
47747,11,40,13,11,13,1,89,38.24572830562443,-109.3844835
47748,13,37,14,14,13,0,91,38.24572830562443,-109.384214
47749,12,38,14,14,13,0,91,38.24572830562443,-109.3839445
47750,11,41,14,13,13,1,93,38.24572830562443,-109.383675
47751,11,41,14,13,12,0,91,38.24572830562443,-109.3834055
47752,11,39,13,14,12,1,90,38.24572830562443,-109.383136
47753,12,39,12,12,13,1,89,38.24572830562443,-109.3828665
47754,12,35,12,11,13,1,84,38.24572830562443,-109.382597
47755,15,26,11,10,12,2,76,38.24572830562443,-109.3823275
47756,10,23,10,18,12,0,73,38.24572830562443,-109.382058
47757,13,28,10,16,10,1,78,38.24572830562443,-109.3817885
47758,17,35,12,10,11,2,87,38.24572830562443,-109.381519
47759,14,37,13,11,12,2,89,38.24572830562443,-109.3812495
47760,14,37,13,12,12,2,90,38.24572830562443,-109.38098
47761,15,37,14,14,11,1,92,38.24572830562443,-109.3807105
47762,15,38,13,13,10,1,90,38.24572830562443,-109.380441
47763,15,37,14,15,10,1,92,38.24572830562443,-109.3801716
47764,14,36,14,16,10,1,91,38.24572830562443,-109.3799021
47765,15,35,14,16,9,2,91,38.24572830562443,-109.3796326
47766,14,35,14,17,9,2,91,38.24572830562443,-109.3793631
47767,13,34,14,15,9,3,88,38.24572830562443,-109.3790936
47768,13,32,14,14,8,4,85,38.24572830562443,-109.3788241
47769,15,31,14,13,7,5,85,38.24572830562443,-109.3785546
47770,17,34,14,14,8,2,89,38.24572830562443,-109.3782851
47771,18,34,14,14,9,1,90,38.24572830562443,-109.3780156
47772,20,32,14,13,8,2,89,38.24572830562443,-109.3777461
47773,22,30,15,14,7,2,90,38.24572830562443,-109.3774766
47774,23,29,15,14,7,1,89,38.24572830562443,-109.3772071
47775,21,33,14,13,8,1,90,38.24572830562443,-109.3769376
47776,16,33,13,10,8,2,82,38.24572830562443,-109.3766681
47777,9,33,11,6,7,5,71,38.24572830562443,-109.3763986
47778,3,33,9,3,8,8,64,38.24572830562443,-109.3761291
47779,1,41,7,2,8,7,66,38.24572830562443,-109.3758596
47780,1,48,6,3,9,5,72,38.24572830562443,-109.3755901
47781,1,51,6,2,10,3,73,38.24572830562443,-109.3753206
47782,0,47,7,0,10,4,68,38.24572830562443,-109.3750512
47783,0,53,7,2,9,6,77,38.24572830562443,-109.3747817
47784,1,44,9,3,14,4,75,38.24572830562443,-109.3745122
47785,3,29,12,8,7,12,71,38.24572830562443,-109.3742427
47786,3,26,13,8,7,14,71,38.24572830562443,-109.3739732
47787,2,29,12,8,9,14,74,38.24572830562443,-109.3737037
47788,3,28,12,4,10,15,72,38.24572830562443,-109.3734342
47789,2,27,11,3,10,14,67,38.24572830562443,-109.3731647
47790,7,30,12,12,9,9,79,38.24572830562443,-109.3728952
47791,12,29,10,16,10,3,80,38.24572830562443,-109.3726257
47792,5,27,10,8,11,5,66,38.24572830562443,-109.3723562
47793,6,29,13,6,14,7,75,38.24572830562443,-109.3720867
47794,4,32,16,7,18,6,83,38.24572830562443,-109.3718172
47795,7,21,14,14,15,7,78,38.24572830562443,-109.3715477
47796,2,17,12,13,19,5,68,38.24572830562443,-109.3712782
47797,0,15,12,10,17,12,66,38.24572830562443,-109.3710087
47798,1,17,12,15,15,10,70,38.24572830562443,-109.3707392
47799,0,19,11,9,12,10,61,38.24572830562443,-109.3704697
47800,2,24,15,3,6,20,70,38.24572830562443,-109.3702003
47801,1,23,16,0,3,28,71,38.24572830562443,-109.3699308
47802,2,21,15,0,1,28,67,38.24572830562443,-109.3696613
47803,3,26,14,0,2,23,68,38.24572830562443,-109.3693918
47804,3,26,14,0,3,23,69,38.24572830562443,-109.3691223
47805,3,24,15,0,2,24,68,38.24572830562443,-109.3688528
47806,2,22,14,0,1,25,64,38.24572830562443,-109.3685833
47807,1,22,12,0,1,22,58,38.24572830562443,-109.3683138
47808,1,28,10,0,4,16,59,38.24572830562443,-109.3680443
47809,1,31,10,0,6,16,64,38.24572830562443,-109.3677748
47810,1,30,11,0,6,16,64,38.24572830562443,-109.3675053
47811,2,27,11,0,6,17,63,38.24572830562443,-109.3672358
47812,2,29,11,0,5,15,62,38.24572830562443,-109.3669663
47813,2,30,11,0,6,14,63,38.24572830562443,-109.3666968
47814,2,29,11,0,7,14,63,38.24572830562443,-109.3664273
47815,2,29,10,0,8,12,61,38.24572830562443,-109.3661578
47816,2,30,10,0,8,11,61,38.24572830562443,-109.3658883
47817,2,29,9,0,5,14,59,38.24572830562443,-109.3656188
47818,2,31,11,0,5,15,64,38.24572830562443,-109.3653493
47819,3,29,12,0,5,18,67,38.24572830562443,-109.3650799
47820,3,27,14,2,4,22,72,38.24572830562443,-109.3648104
47821,3,26,15,2,3,25,74,38.24572830562443,-109.3645409
47822,2,24,16,2,2,28,74,38.24572830562443,-109.3642714
47823,2,23,14,1,1,26,67,38.24572830562443,-109.3640019
47824,2,26,13,1,3,21,66,38.24572830562443,-109.3637324
47825,1,30,11,1,5,18,66,38.24572830562443,-109.3634629
47826,2,30,12,2,5,16,67,38.24572830562443,-109.3631934
47827,2,27,12,1,5,17,64,38.24572830562443,-109.3629239
47828,2,27,12,0,4,20,65,38.24572830562443,-109.3626544
47829,1,24,13,0,3,23,64,38.24572830562443,-109.3623849
47830,1,23,14,0,2,25,65,38.24572830562443,-109.3621154
47831,2,24,15,1,2,26,70,38.24572830562443,-109.3618459
47832,2,21,17,1,1,31,73,38.24572830562443,-109.3615764
47833,2,23,16,2,1,28,72,38.24572830562443,-109.3613069
47834,3,30,14,2,4,22,75,38.24572830562443,-109.3610374
47835,2,36,11,1,8,14,72,38.24572830562443,-109.3607679
47836,3,28,11,2,5,15,64,38.24572830562443,-109.3604984
47837,5,24,9,3,7,8,56,38.24572830562443,-109.360229
47838,3,20,8,4,7,8,50,38.24572830562443,-109.3599595
47839,2,19,8,3,6,10,48,38.24572830562443,-109.35969
47840,8,20,11,2,7,10,58,38.24572830562443,-109.3594205
47841,4,26,9,2,6,10,57,38.24572830562443,-109.359151
47842,1,28,8,3,8,7,55,38.24572830562443,-109.3588815
47843,2,32,7,2,7,5,55,38.24572830562443,-109.358612
47844,2,30,7,1,7,5,52,38.24572830562443,-109.3583425
47845,2,26,8,4,9,6,55,38.24572830562443,-109.358073
47846,2,32,9,3,10,6,62,38.24572830562443,-109.3578035
47847,2,30,9,3,8,9,61,38.24572830562443,-109.357534
47848,1,30,10,2,7,13,63,38.24572830562443,-109.3572645
47849,1,33,10,0,6,15,65,38.24572830562443,-109.356995
47850,1,39,10,0,8,12,70,38.24572830562443,-109.3567255
47851,1,33,9,3,8,7,61,38.24572830562443,-109.356456
47852,2,28,9,4,7,7,57,38.24572830562443,-109.3561865
47853,2,26,9,5,6,8,56,38.24572830562443,-109.355917
47854,2,30,8,4,7,6,57,38.24572830562443,-109.3556475
47855,3,32,8,6,7,4,60,38.24572830562443,-109.355378
47856,4,34,8,7,7,3,63,38.24572830562443,-109.3551086
47857,3,32,8,6,7,5,61,38.24572830562443,-109.3548391
47858,2,30,8,4,7,6,57,38.24572830562443,-109.3545696
47859,4,31,10,5,7,6,63,38.24572830562443,-109.3543001
47860,2,26,11,2,8,13,62,38.24572830562443,-109.3540306
47861,2,26,10,3,7,11,59,38.24572830562443,-109.3537611
47862,4,31,9,5,7,6,62,38.24572830562443,-109.3534916
47863,4,34,8,5,8,4,63,38.24572830562443,-109.3532221
47864,2,35,5,5,8,2,57,38.24572830562443,-109.3529526
47865,1,37,4,3,8,2,55,38.24572830562443,-109.3526831
47866,1,30,6,5,10,3,55,38.24572830562443,-109.3524136
47867,3,27,11,11,13,3,68,38.24572830562443,-109.3521441
47868,11,22,17,9,17,9,85,38.24572830562443,-109.3518746
47869,8,18,15,10,18,11,80,38.24572830562443,-109.3516051
47870,3,21,12,13,13,9,71,38.24572830562443,-109.3513356
47871,0,24,8,13,13,4,62,38.24572830562443,-109.3510661
47872,1,25,8,11,12,5,62,38.24572830562443,-109.3507966
47873,2,29,11,6,13,11,72,38.24572830562443,-109.3505271
47874,3,30,12,1,7,16,69,38.24572830562443,-109.3502577
47875,2,32,11,2,6,10,63,38.24572830562443,-109.3499882
47876,3,30,8,4,6,6,57,38.24572830562443,-109.3497187
47877,2,33,6,4,7,3,55,38.24572830562443,-109.3494492
47878,2,31,7,4,8,3,55,38.24572830562443,-109.3491797
47879,2,23,10,4,8,8,55,38.24572830562443,-109.3489102
47880,3,23,12,7,6,10,61,38.24572830562443,-109.3486407
47881,8,23,13,11,8,9,72,38.24572830562443,-109.3483712
47882,7,22,13,14,10,11,77,38.24572830562443,-109.3481017
47883,2,24,13,9,10,17,75,38.24572830562443,-109.3478322
47884,1,23,11,4,10,14,63,38.24572830562443,-109.3475627
47885,3,23,13,13,10,8,70,38.24572830562443,-109.3472932
47886,5,21,13,15,10,7,71,38.24572830562443,-109.3470237
47887,11,23,14,16,11,5,80,38.24572830562443,-109.3467542
47888,21,18,13,20,12,4,88,38.24572830562443,-109.3464847
47889,14,19,11,19,10,7,80,38.24572830562443,-109.3462152
47890,2,20,11,11,7,13,64,38.24572830562443,-109.3459457
47891,0,24,9,7,7,9,56,38.24572830562443,-109.3456762
47892,0,26,11,9,17,7,70,38.24572830562443,-109.3454068
47893,1,26,13,9,13,12,74,38.24572830562443,-109.3451373
47894,0,23,15,3,7,23,71,38.24572830562443,-109.3448678
47895,0,24,15,1,6,24,70,38.24572830562443,-109.3445983
47896,2,20,14,7,8,17,68,38.24572830562443,-109.3443288
47897,8,16,13,15,15,4,71,38.24572830562443,-109.3440593
47898,5,27,9,7,14,4,66,38.24572830562443,-109.3437898
47899,3,31,7,6,12,4,63,38.24572830562443,-109.3435203
47900,3,27,9,5,13,6,63,38.24572830562443,-109.3432508
47901,2,27,10,11,11,2,63,38.24572830562443,-109.3429813
47902,0,25,9,13,15,1,63,38.24572830562443,-109.3427118
47903,2,24,10,7,14,7,64,38.24572830562443,-109.3424423
47904,3,26,16,3,10,16,74,38.24572830562443,-109.3421728
47905,1,28,15,2,10,18,74,38.24572830562443,-109.3419033
47906,0,22,13,1,5,20,61,38.24572830562443,-109.3416338
47907,2,25,11,7,13,6,64,38.24572830562443,-109.3413643
47908,1,38,9,7,11,3,69,38.24572830562443,-109.3410948
47909,1,37,8,7,9,3,65,38.24572830562443,-109.3408253
47910,0,27,9,6,11,5,58,38.24572830562443,-109.3405558
47911,0,25,12,4,15,10,66,38.24572830562443,-109.3402864
47912,0,26,13,0,10,18,67,38.24572830562443,-109.3400169
47913,0,28,13,0,9,20,70,38.24572830562443,-109.3397474
47914,0,28,12,0,8,19,67,38.24572830562443,-109.3394779
47915,0,26,11,0,7,18,62,38.24572830562443,-109.3392084
47916,1,23,11,0,5,17,57,38.24572830562443,-109.3389389
47917,0,17,11,3,6,15,52,38.24572830562443,-109.3386694
47918,0,17,9,3,7,12,48,38.24572830562443,-109.3383999
47919,1,25,8,5,9,7,55,38.24572830562443,-109.3381304
47920,2,26,8,4,9,7,56,38.24572830562443,-109.3378609
47921,9,17,11,7,7,10,61,38.24572830562443,-109.3375914
47922,11,19,12,7,7,10,66,38.24572830562443,-109.3373219
47923,4,25,11,8,8,9,65,38.24572830562443,-109.3370524
47924,2,38,9,6,15,4,74,38.24572830562443,-109.3367829
47925,1,35,9,2,11,8,66,38.24572830562443,-109.3365134
47926,1,29,8,1,10,8,57,38.24572830562443,-109.3362439
47927,1,39,8,1,12,4,65,38.24572830562443,-109.3359744
47928,1,48,8,1,12,3,73,38.24572830562443,-109.3357049
47929,4,45,11,3,12,6,81,38.24572830562443,-109.3354355
47930,2,30,12,2,6,17,69,38.24572830562443,-109.335166
47931,0,25,11,1,4,17,58,38.24572830562443,-109.3348965
47932,1,29,7,2,10,7,56,38.24572830562443,-109.334627
47933,2,39,6,2,8,3,60,38.24572830562443,-109.3343575
47934,2,37,6,2,7,3,57,38.24572830562443,-109.334088
47935,3,40,6,3,7,3,62,38.24572830562443,-109.3338185
47936,6,34,6,5,7,2,60,38.24572830562443,-109.333549
47937,5,30,7,7,8,3,60,38.24572830562443,-109.3332795
47938,4,30,9,9,8,3,63,38.24572830562443,-109.33301
47939,7,28,10,13,10,1,69,38.24572830562443,-109.3327405
47940,2,28,9,8,8,5,60,38.24572830562443,-109.332471
47941,0,25,9,7,7,8,56,38.24572830562443,-109.3322015
47942,1,25,11,7,9,9,62,38.24572830562443,-109.331932
47943,1,24,10,6,8,10,59,38.24572830562443,-109.3316625
47944,3,31,9,7,7,6,63,38.24572830562443,-109.331393
47945,10,25,12,15,17,3,82,38.24545881103919,-109.4402688
47946,6,29,12,10,19,4,80,38.24545881103919,-109.4399993
47947,3,28,11,13,17,5,77,38.24545881103919,-109.4397299
47948,2,25,10,7,11,9,64,38.24545881103919,-109.4394604
47949,2,35,9,4,9,8,67,38.24545881103919,-109.4391909
47950,1,34,9,5,9,8,66,38.24545881103919,-109.4389214
47951,1,38,9,0,10,10,68,38.24545881103919,-109.4386519
47952,1,45,9,0,14,8,77,38.24545881103919,-109.4383824
47953,1,50,9,1,13,7,81,38.24545881103919,-109.4381129
47954,2,48,10,2,12,7,81,38.24545881103919,-109.4378434
47955,3,41,11,2,13,9,79,38.24545881103919,-109.4375739
47956,2,37,12,0,10,13,74,38.24545881103919,-109.4373044
47957,2,38,11,0,11,12,74,38.24545881103919,-109.4370349
47958,4,40,11,2,13,9,79,38.24545881103919,-109.4367654
47959,9,44,12,9,15,2,91,38.24545881103919,-109.4364959
47960,9,40,13,13,13,1,89,38.24545881103919,-109.4362264
47961,8,40,13,13,14,1,89,38.24545881103919,-109.4359569
47962,7,41,12,10,15,2,87,38.24545881103919,-109.4356874
47963,4,40,12,7,15,3,81,38.24545881103919,-109.4354179
47964,4,40,12,7,14,4,81,38.24545881103919,-109.4351484
47965,4,44,12,11,12,1,84,38.24545881103919,-109.434879
47966,5,45,13,14,11,1,89,38.24545881103919,-109.4346095
47967,5,44,13,14,12,1,89,38.24545881103919,-109.43434
47968,4,43,12,12,13,2,86,38.24545881103919,-109.4340705
47969,4,43,12,11,12,2,84,38.24545881103919,-109.433801
47970,7,43,13,13,13,1,90,38.24545881103919,-109.4335315
47971,5,41,12,10,14,2,84,38.24545881103919,-109.433262
47972,4,39,12,7,15,4,81,38.24545881103919,-109.4329925
47973,3,39,11,4,15,5,77,38.24545881103919,-109.432723
47974,3,37,11,4,14,8,77,38.24545881103919,-109.4324535
47975,5,39,12,8,13,5,82,38.24545881103919,-109.432184
47976,10,41,13,12,14,1,91,38.24545881103919,-109.4319145
47977,10,42,13,12,13,0,90,38.24545881103919,-109.431645
47978,8,46,13,10,14,0,91,38.24545881103919,-109.4313755
47979,9,44,13,12,13,0,91,38.24545881103919,-109.431106
47980,10,40,14,14,14,0,92,38.24545881103919,-109.4308365
47981,8,41,14,15,14,0,92,38.24545881103919,-109.430567
47982,7,42,15,16,14,0,94,38.24545881103919,-109.4302975
47983,7,42,15,15,15,0,94,38.24545881103919,-109.430028
47984,7,43,14,13,16,0,93,38.24545881103919,-109.4297586
47985,11,40,14,13,16,0,94,38.24545881103919,-109.4294891
47986,11,38,13,12,15,0,89,38.24545881103919,-109.4292196
47987,9,35,12,11,15,2,84,38.24545881103919,-109.4289501
47988,8,38,12,9,15,2,84,38.24545881103919,-109.4286806
47989,9,38,12,9,16,1,85,38.24545881103919,-109.4284111
47990,7,38,12,9,16,1,83,38.24545881103919,-109.4281416
47991,6,38,11,9,16,1,81,38.24545881103919,-109.4278721
47992,6,41,11,7,16,2,83,38.24545881103919,-109.4276026
47993,5,45,10,5,16,2,83,38.24545881103919,-109.4273331
47994,4,46,10,5,15,2,82,38.24545881103919,-109.4270636
47995,5,48,10,6,15,1,85,38.24545881103919,-109.4267941
47996,7,47,11,7,15,1,88,38.24545881103919,-109.4265246
47997,9,46,11,7,14,1,88,38.24545881103919,-109.4262551
47998,11,40,11,8,13,1,84,38.24545881103919,-109.4259856
47999,13,37,11,8,12,2,83,38.24545881103919,-109.4257161
48000,13,37,12,8,13,2,85,38.24545881103919,-109.4254466
48001,13,38,12,10,15,1,89,38.24545881103919,-109.4251771
48002,15,37,12,11,14,1,90,38.24545881103919,-109.4249077
48003,24,33,12,11,12,0,92,38.24545881103919,-109.4246382
48004,25,32,13,11,12,0,93,38.24545881103919,-109.4243687
48005,25,32,13,10,12,0,92,38.24545881103919,-109.4240992
48006,25,33,12,10,12,0,92,38.24545881103919,-109.4238297
48007,19,35,13,11,13,0,91,38.24545881103919,-109.4235602
48008,16,37,13,12,14,0,92,38.24545881103919,-109.4232907
48009,13,38,13,13,14,0,91,38.24545881103919,-109.4230212
48010,11,39,13,12,14,0,89,38.24545881103919,-109.4227517
48011,8,42,13,11,15,1,90,38.24545881103919,-109.4224822
48012,6,42,13,11,14,1,87,38.24545881103919,-109.4222127
48013,6,42,13,10,14,1,86,38.24545881103919,-109.4219432
48014,6,44,12,10,13,1,86,38.24545881103919,-109.4216737
48015,6,46,11,9,13,1,86,38.24545881103919,-109.4214042
48016,4,48,9,7,13,1,82,38.24545881103919,-109.4211347
48017,3,50,10,5,15,2,85,38.24545881103919,-109.4208652
48018,3,48,9,6,14,2,82,38.24545881103919,-109.4205957
48019,2,46,9,5,10,3,75,38.24545881103919,-109.4203262
48020,2,42,8,3,9,4,68,38.24545881103919,-109.4200568
48021,2,40,8,2,9,7,68,38.24545881103919,-109.4197873
48022,3,40,9,4,9,5,70,38.24545881103919,-109.4195178
48023,3,42,9,5,10,4,73,38.24545881103919,-109.4192483
48024,2,43,9,5,11,4,74,38.24545881103919,-109.4189788
48025,1,41,9,3,10,5,69,38.24545881103919,-109.4187093
48026,1,41,8,2,9,4,65,38.24545881103919,-109.4184398
48027,3,41,8,3,9,3,67,38.24545881103919,-109.4181703
48028,3,40,9,3,10,4,69,38.24545881103919,-109.4179008
48029,1,41,9,2,11,6,70,38.24545881103919,-109.4176313
48030,1,46,9,1,11,5,73,38.24545881103919,-109.4173618
48031,1,46,9,2,10,5,73,38.24545881103919,-109.4170923
48032,2,47,10,2,13,5,79,38.24545881103919,-109.4168228
48033,2,44,11,3,13,6,79,38.24545881103919,-109.4165533
48034,2,37,11,5,12,9,76,38.24545881103919,-109.4162838
48035,8,28,14,14,12,7,83,38.24545881103919,-109.4160143
48036,18,26,14,16,15,2,91,38.24545881103919,-109.4157448
48037,17,34,13,15,12,1,92,38.24545881103919,-109.4154753
48038,8,36,12,12,12,6,86,38.24545881103919,-109.4152058
48039,5,32,12,5,11,14,79,38.24545881103919,-109.4149364
48040,1,30,10,2,8,14,65,38.24545881103919,-109.4146669
48041,1,31,9,5,10,7,63,38.24545881103919,-109.4143974
48042,1,31,9,6,10,6,63,38.24545881103919,-109.4141279
48043,1,31,9,5,10,7,63,38.24545881103919,-109.4138584
48044,2,39,10,1,12,8,72,38.24545881103919,-109.4135889
48045,5,46,11,6,16,3,87,38.24545881103919,-109.4133194
48046,6,46,12,10,16,1,91,38.24545881103919,-109.4130499
48047,7,47,12,11,14,1,92,38.24545881103919,-109.4127804
48048,7,46,12,10,14,1,90,38.24545881103919,-109.4125109
48049,6,46,12,10,14,1,89,38.24545881103919,-109.4122414
48050,8,45,12,9,15,0,89,38.24545881103919,-109.4119719
48051,7,45,13,10,16,0,91,38.24545881103919,-109.4117024
48052,6,43,13,9,16,1,88,38.24545881103919,-109.4114329
48053,6,40,12,7,15,4,84,38.24545881103919,-109.4111634
48054,8,41,11,8,17,1,86,38.24545881103919,-109.4108939
48055,7,42,12,9,16,1,87,38.24545881103919,-109.4106244
48056,8,40,12,11,15,1,87,38.24545881103919,-109.4103549
48057,9,37,13,12,14,1,86,38.24545881103919,-109.4100855
48058,11,38,14,12,13,1,89,38.24545881103919,-109.409816
48059,10,36,13,11,13,1,84,38.24545881103919,-109.4095465
48060,13,36,13,12,14,0,88,38.24545881103919,-109.409277
48061,16,33,14,13,13,0,89,38.24545881103919,-109.4090075
48062,16,32,15,14,13,1,91,38.24545881103919,-109.408738
48063,12,36,15,14,13,0,90,38.24545881103919,-109.4084685
48064,11,37,14,13,14,1,90,38.24545881103919,-109.408199
48065,10,39,13,13,15,0,90,38.24545881103919,-109.4079295
48066,9,40,12,12,15,1,89,38.24545881103919,-109.40766
48067,8,40,12,10,15,1,86,38.24545881103919,-109.4073905
48068,6,39,11,10,15,1,82,38.24545881103919,-109.407121
48069,7,42,11,9,15,1,85,38.24545881103919,-109.4068515
48070,8,44,11,10,14,0,87,38.24545881103919,-109.406582
48071,9,42,11,11,15,0,88,38.24545881103919,-109.4063125
48072,8,35,12,15,15,1,86,38.24545881103919,-109.406043
48073,11,32,13,15,14,1,86,38.24545881103919,-109.4057735
48074,13,34,13,14,14,0,88,38.24545881103919,-109.405504
48075,14,35,14,14,14,0,91,38.24545881103919,-109.4052345
48076,15,33,14,13,14,0,89,38.24545881103919,-109.4049651
48077,14,34,13,12,15,0,88,38.24545881103919,-109.4046956
48078,16,33,13,12,15,0,89,38.24545881103919,-109.4044261
48079,15,33,13,13,15,0,89,38.24545881103919,-109.4041566
48080,15,33,13,14,14,0,89,38.24545881103919,-109.4038871
48081,17,32,14,13,13,0,89,38.24545881103919,-109.4036176
48082,18,31,14,14,13,0,90,38.24545881103919,-109.4033481
48083,14,32,14,14,14,1,89,38.24545881103919,-109.4030786
48084,13,34,14,13,15,1,90,38.24545881103919,-109.4028091
48085,11,36,15,13,16,1,92,38.24545881103919,-109.4025396
48086,9,37,14,12,15,1,88,38.24545881103919,-109.4022701
48087,12,35,14,13,16,0,90,38.24545881103919,-109.4020006
48088,10,37,15,13,16,1,92,38.24545881103919,-109.4017311
48089,10,38,15,13,15,1,92,38.24545881103919,-109.4014616
48090,10,39,15,14,14,0,92,38.24545881103919,-109.4011921
48091,7,43,14,13,15,1,93,38.24545881103919,-109.4009226
48092,9,41,15,15,15,0,95,38.24545881103919,-109.4006531
48093,10,38,15,15,15,0,93,38.24545881103919,-109.4003836
48094,12,37,14,14,16,0,93,38.24545881103919,-109.4001142
48095,12,35,14,14,15,1,91,38.24545881103919,-109.3998447
48096,10,37,14,14,14,1,90,38.24545881103919,-109.3995752
48097,10,38,14,14,14,1,91,38.24545881103919,-109.3993057
48098,12,37,14,14,14,1,92,38.24545881103919,-109.3990362
48099,13,37,14,13,15,0,92,38.24545881103919,-109.3987667
48100,10,39,15,13,16,0,93,38.24545881103919,-109.3984972
48101,7,42,14,11,15,1,90,38.24545881103919,-109.3982277
48102,6,42,14,11,15,2,90,38.24545881103919,-109.3979582
48103,6,42,14,10,14,2,88,38.24545881103919,-109.3976887
48104,6,42,14,10,14,2,88,38.24545881103919,-109.3974192
48105,6,41,14,10,13,2,86,38.24545881103919,-109.3971497
48106,6,42,14,10,14,2,88,38.24545881103919,-109.3968802
48107,7,41,14,11,14,1,88,38.24545881103919,-109.3966107
48108,8,40,14,12,15,1,90,38.24545881103919,-109.3963412
48109,8,40,14,11,15,1,89,38.24545881103919,-109.3960717
48110,7,41,14,10,15,2,89,38.24545881103919,-109.3958022
48111,8,42,14,12,16,0,92,38.24545881103919,-109.3955327
48112,6,43,14,11,17,0,91,38.24545881103919,-109.3952632
48113,5,44,14,10,17,1,91,38.24545881103919,-109.3949938
48114,5,44,14,10,17,1,91,38.24545881103919,-109.3947243
48115,8,42,14,11,17,0,92,38.24545881103919,-109.3944548
48116,8,42,14,10,17,0,91,38.24545881103919,-109.3941853
48117,7,42,14,11,17,0,91,38.24545881103919,-109.3939158
48118,6,42,14,10,18,1,91,38.24545881103919,-109.3936463
48119,6,42,14,10,17,1,90,38.24545881103919,-109.3933768
48120,6,42,15,12,18,0,93,38.24545881103919,-109.3931073
48121,6,42,15,12,18,0,93,38.24545881103919,-109.3928378
48122,6,41,15,12,18,0,92,38.24545881103919,-109.3925683
48123,6,40,15,12,18,0,91,38.24545881103919,-109.3922988
48124,9,39,15,12,17,0,92,38.24545881103919,-109.3920293
48125,9,38,14,13,17,0,91,38.24545881103919,-109.3917598
48126,8,39,14,12,17,0,90,38.24545881103919,-109.3914903
48127,7,41,14,12,17,0,91,38.24545881103919,-109.3912208
48128,7,41,14,13,17,0,92,38.24545881103919,-109.3909513
48129,7,41,14,12,17,0,91,38.24545881103919,-109.3906818
48130,5,44,14,11,18,0,92,38.24545881103919,-109.3904123
48131,4,45,14,10,18,1,92,38.24545881103919,-109.3901429
48132,5,46,14,10,18,0,93,38.24545881103919,-109.3898734
48133,5,46,14,11,18,0,94,38.24545881103919,-109.3896039
48134,5,49,14,12,14,1,95,38.24545881103919,-109.3893344
48135,5,47,14,13,14,1,94,38.24545881103919,-109.3890649
48136,6,43,13,14,13,1,90,38.24545881103919,-109.3887954
48137,11,39,13,15,13,0,91,38.24545881103919,-109.3885259
48138,10,41,14,14,14,0,93,38.24545881103919,-109.3882564
48139,10,41,14,14,14,0,93,38.24545881103919,-109.3879869
48140,10,41,14,13,15,0,93,38.24545881103919,-109.3877174
48141,10,40,14,13,14,0,91,38.24545881103919,-109.3874479
48142,10,41,14,14,14,0,93,38.24545881103919,-109.3871784
48143,9,42,14,13,13,1,92,38.24545881103919,-109.3869089
48144,9,41,14,14,12,1,91,38.24545881103919,-109.3866394
48145,10,39,14,14,13,1,91,38.24545881103919,-109.3863699
48146,11,38,14,15,14,0,92,38.24545881103919,-109.3861004
48147,12,35,14,16,13,0,90,38.24545881103919,-109.3858309
48148,14,35,14,16,13,0,92,38.24545881103919,-109.3855614
48149,12,36,13,14,14,0,89,38.24545881103919,-109.3852919
48150,10,37,13,13,14,1,88,38.24545881103919,-109.3850225
48151,10,38,13,12,14,1,88,38.24545881103919,-109.384753
48152,10,38,14,15,13,1,91,38.24545881103919,-109.3844835
48153,9,38,14,15,13,1,90,38.24545881103919,-109.384214
48154,10,39,14,15,13,1,92,38.24545881103919,-109.3839445
48155,10,40,14,15,13,0,92,38.24545881103919,-109.383675
48156,11,40,14,16,12,0,93,38.24545881103919,-109.3834055
48157,13,37,14,17,12,0,93,38.24545881103919,-109.383136
48158,15,36,13,14,12,0,90,38.24545881103919,-109.3828665
48159,13,39,12,10,13,1,88,38.24545881103919,-109.382597
48160,12,37,10,8,11,3,81,38.24545881103919,-109.3823275
48161,11,25,10,13,9,2,70,38.24545881103919,-109.382058
48162,11,25,10,12,10,1,69,38.24545881103919,-109.3817885
48163,18,34,11,10,11,2,86,38.24545881103919,-109.381519
48164,16,37,13,10,12,1,89,38.24545881103919,-109.3812495
48165,15,38,13,10,12,2,90,38.24545881103919,-109.38098
48166,14,41,13,10,12,1,91,38.24545881103919,-109.3807105
48167,12,41,13,10,12,2,90,38.24545881103919,-109.380441
48168,12,40,13,13,11,2,91,38.24545881103919,-109.3801716
48169,13,39,14,16,10,1,93,38.24545881103919,-109.3799021
48170,12,39,14,15,10,1,91,38.24545881103919,-109.3796326
48171,10,40,14,14,10,2,90,38.24545881103919,-109.3793631
48172,12,38,14,13,10,2,89,38.24545881103919,-109.3790936
48173,13,35,14,14,9,3,88,38.24545881103919,-109.3788241
48174,13,35,14,14,9,2,87,38.24545881103919,-109.3785546
48175,13,38,14,14,9,1,89,38.24545881103919,-109.3782851
48176,13,38,14,14,9,1,89,38.24545881103919,-109.3780156
48177,15,35,15,14,8,2,89,38.24545881103919,-109.3777461
48178,17,33,16,14,7,3,90,38.24545881103919,-109.3774766
48179,19,31,16,13,7,3,89,38.24545881103919,-109.3772071
48180,19,32,15,12,8,2,88,38.24545881103919,-109.3769376
48181,12,34,13,8,8,4,79,38.24545881103919,-109.3766681
48182,7,31,11,5,7,8,69,38.24545881103919,-109.3763986
48183,3,31,9,3,7,9,62,38.24545881103919,-109.3761291
48184,1,42,7,0,9,5,64,38.24545881103919,-109.3758596
48185,0,54,6,0,8,3,71,38.24545881103919,-109.3755901
48186,0,49,6,1,9,2,67,38.24545881103919,-109.3753206
48187,1,45,8,3,10,3,70,38.24545881103919,-109.3750512
48188,2,44,9,5,9,5,74,38.24545881103919,-109.3747817
48189,5,39,12,10,6,9,81,38.24545881103919,-109.3745122
48190,7,31,13,15,4,11,81,38.24545881103919,-109.3742427
48191,3,31,11,9,15,7,76,38.24545881103919,-109.3739732
48192,9,35,13,12,7,8,84,38.24545881103919,-109.3737037
48193,8,31,12,13,6,10,80,38.24545881103919,-109.3734342
48194,6,28,12,15,8,8,77,38.24545881103919,-109.3731647
48195,5,30,12,12,13,7,79,38.24545881103919,-109.3728952
48196,7,31,12,15,14,5,84,38.24545881103919,-109.3726257
48197,3,32,14,13,19,5,86,38.24545881103919,-109.3723562
48198,4,23,13,13,24,3,80,38.24545881103919,-109.3720867
48199,3,21,15,13,20,5,77,38.24545881103919,-109.3718172
48200,2,17,15,20,16,7,77,38.24545881103919,-109.3715477
48201,0,11,12,15,13,10,61,38.24545881103919,-109.3712782
48202,1,19,11,20,12,11,74,38.24545881103919,-109.3710087
48203,3,20,14,8,11,13,69,38.24545881103919,-109.3707392
48204,0,26,15,0,7,22,70,38.24545881103919,-109.3704697
48205,0,24,17,0,5,28,74,38.24545881103919,-109.3702003
48206,1,23,17,0,3,30,74,38.24545881103919,-109.3699308
48207,1,22,16,0,2,29,70,38.24545881103919,-109.3696613
48208,1,23,13,0,1,25,63,38.24545881103919,-109.3693918
48209,1,24,14,0,1,25,65,38.24545881103919,-109.3691223
48210,1,21,14,0,0,26,62,38.24545881103919,-109.3688528
48211,1,21,12,0,1,22,57,38.24545881103919,-109.3685833
48212,1,27,10,0,4,16,58,38.24545881103919,-109.3683138
48213,1,30,9,0,6,13,59,38.24545881103919,-109.3680443
48214,1,34,9,0,7,12,63,38.24545881103919,-109.3677748
48215,1,34,9,0,8,12,64,38.24545881103919,-109.3675053
48216,1,31,9,0,7,12,60,38.24545881103919,-109.3672358
48217,1,28,10,0,6,14,59,38.24545881103919,-109.3669663
48218,2,28,12,0,6,15,63,38.24545881103919,-109.3666968
48219,2,32,11,0,8,13,66,38.24545881103919,-109.3664273
48220,2,34,10,0,10,11,67,38.24545881103919,-109.3661578
48221,1,32,10,0,9,12,64,38.24545881103919,-109.3658883
48222,2,31,9,0,6,13,61,38.24545881103919,-109.3656188
48223,1,29,9,0,5,14,58,38.24545881103919,-109.3653493
48224,1,29,10,0,5,15,60,38.24545881103919,-109.3650799
48225,2,31,11,0,6,15,65,38.24545881103919,-109.3648104
48226,2,28,12,1,4,19,66,38.24545881103919,-109.3645409
48227,2,25,15,3,1,26,72,38.24545881103919,-109.3642714
48228,2,24,15,2,2,26,71,38.24545881103919,-109.3640019
48229,1,26,13,2,3,23,68,38.24545881103919,-109.3637324
48230,2,29,12,1,4,21,69,38.24545881103919,-109.3634629
48231,2,26,12,1,3,21,65,38.24545881103919,-109.3631934
48232,2,25,12,1,3,18,61,38.24545881103919,-109.3629239
48233,3,24,12,1,3,19,62,38.24545881103919,-109.3626544
48234,2,23,13,0,2,22,62,38.24545881103919,-109.3623849
48235,2,24,14,0,1,25,66,38.24545881103919,-109.3621154
48236,2,22,15,0,2,25,66,38.24545881103919,-109.3618459
48237,2,22,15,0,1,27,67,38.24545881103919,-109.3615764
48238,1,24,14,0,1,25,65,38.24545881103919,-109.3613069
48239,1,24,11,2,3,20,61,38.24545881103919,-109.3610374
48240,0,24,9,2,5,14,54,38.24545881103919,-109.3607679
48241,1,21,8,3,8,8,49,38.24545881103919,-109.3604984
48242,2,28,7,4,9,5,55,38.24545881103919,-109.360229
48243,2,30,7,3,7,5,54,38.24545881103919,-109.3599595
48244,2,31,7,5,5,7,57,38.24545881103919,-109.35969
48245,2,27,8,4,6,8,55,38.24545881103919,-109.3594205
48246,1,27,8,3,7,7,53,38.24545881103919,-109.359151
48247,1,28,7,3,7,6,52,38.24545881103919,-109.3588815
48248,2,30,7,2,6,5,52,38.24545881103919,-109.358612
48249,2,27,7,2,8,5,51,38.24545881103919,-109.3583425
48250,5,27,10,5,9,5,61,38.24545881103919,-109.358073
48251,2,23,10,2,4,15,56,38.24545881103919,-109.3578035
48252,1,25,10,2,5,16,59,38.24545881103919,-109.357534
48253,1,29,10,3,7,13,63,38.24545881103919,-109.3572645
48254,1,32,10,1,6,14,64,38.24545881103919,-109.356995
48255,0,35,9,0,6,14,64,38.24545881103919,-109.3567255
48256,2,33,9,4,8,7,63,38.24545881103919,-109.356456
48257,2,30,9,3,6,7,57,38.24545881103919,-109.3561865
48258,2,27,9,4,6,7,55,38.24545881103919,-109.355917
48259,3,30,9,4,8,6,60,38.24545881103919,-109.3556475
48260,2,28,9,5,6,7,57,38.24545881103919,-109.355378
48261,3,33,9,6,7,5,63,38.24545881103919,-109.3551086
48262,2,32,8,6,6,5,59,38.24545881103919,-109.3548391
48263,2,30,8,6,7,5,58,38.24545881103919,-109.3545696
48264,5,36,8,5,8,4,66,38.24545881103919,-109.3543001
48265,2,28,10,3,9,10,62,38.24545881103919,-109.3540306
48266,2,31,10,2,7,13,65,38.24545881103919,-109.3537611
48267,3,32,10,0,9,11,65,38.24545881103919,-109.3534916
48268,4,34,10,2,8,8,66,38.24545881103919,-109.3532221
48269,3,35,7,4,7,4,60,38.24545881103919,-109.3529526
48270,1,31,6,5,9,3,55,38.24545881103919,-109.3526831
48271,3,29,6,8,11,5,62,38.24545881103919,-109.3524136
48272,9,19,10,13,11,6,68,38.24545881103919,-109.3521441
48273,12,16,17,10,19,10,84,38.24545881103919,-109.3518746
48274,4,19,14,13,14,12,76,38.24545881103919,-109.3516051
48275,0,26,9,11,14,5,65,38.24545881103919,-109.3513356
48276,2,28,9,12,10,3,64,38.24545881103919,-109.3510661
48277,1,26,9,10,8,6,60,38.24545881103919,-109.3507966
48278,4,23,11,5,10,10,63,38.24545881103919,-109.3505271
48279,6,27,11,4,8,7,63,38.24545881103919,-109.3502577
48280,5,29,8,5,8,4,59,38.24545881103919,-109.3499882
48281,3,31,7,4,7,4,56,38.24545881103919,-109.3497187
48282,3,33,6,4,7,3,56,38.24545881103919,-109.3494492
48283,2,29,8,5,7,4,55,38.24545881103919,-109.3491797
48284,3,23,11,6,8,8,59,38.24545881103919,-109.3489102
48285,5,22,13,9,7,11,67,38.24545881103919,-109.3486407
48286,13,20,13,12,9,11,78,38.24545881103919,-109.3483712
48287,11,20,12,19,8,10,80,38.24545881103919,-109.3481017
48288,3,15,13,10,8,16,65,38.24545881103919,-109.3478322
48289,2,20,11,6,8,11,58,38.24545881103919,-109.3475627
48290,2,22,12,9,10,8,63,38.24545881103919,-109.3472932
48291,4,22,12,15,12,6,71,38.24545881103919,-109.3470237
48292,13,25,14,16,13,3,84,38.24545881103919,-109.3467542
48293,20,17,12,21,15,3,88,38.24545881103919,-109.3464847
48294,28,15,11,22,14,2,92,38.24545881103919,-109.3462152
48295,10,19,11,23,15,5,83,38.24545881103919,-109.3459457
48296,2,23,11,9,11,12,68,38.24545881103919,-109.3456762
48297,3,25,11,10,15,7,71,38.24545881103919,-109.3454068
48298,2,25,12,7,10,13,69,38.24545881103919,-109.3451373
48299,1,25,14,4,8,20,72,38.24545881103919,-109.3448678
48300,0,26,16,0,6,25,73,38.24545881103919,-109.3445983
48301,2,25,17,8,8,19,79,38.24545881103919,-109.3443288
48302,3,25,17,8,10,16,79,38.24545881103919,-109.3440593
48303,0,24,16,11,9,18,78,38.24545881103919,-109.3437898
48304,0,23,16,13,10,16,78,38.24545881103919,-109.3435203
48305,1,23,13,14,14,10,75,38.24545881103919,-109.3432508
48306,2,27,14,6,14,12,75,38.24545881103919,-109.3429813
48307,0,25,14,0,10,20,69,38.24545881103919,-109.3427118
48308,0,23,13,0,4,22,62,38.24545881103919,-109.3424423
48309,0,24,13,0,4,23,64,38.24545881103919,-109.3421728
48310,0,23,14,0,4,25,66,38.24545881103919,-109.3419033
48311,0,23,14,0,6,23,66,38.24545881103919,-109.3416338
48312,1,27,11,5,12,12,68,38.24545881103919,-109.3413643
48313,0,23,10,10,11,6,60,38.24545881103919,-109.3410948
48314,1,33,9,6,11,4,64,38.24545881103919,-109.3408253
48315,1,38,7,4,10,3,63,38.24545881103919,-109.3405558
48316,3,28,10,5,11,6,63,38.24545881103919,-109.3402864
48317,0,20,12,4,8,14,58,38.24545881103919,-109.3400169
48318,1,24,12,1,6,18,62,38.24545881103919,-109.3397474
48319,2,29,12,0,8,15,66,38.24545881103919,-109.3394779
48320,1,31,12,0,9,13,66,38.24545881103919,-109.3392084
48321,1,33,10,1,10,12,67,38.24545881103919,-109.3389389
48322,0,32,9,2,9,9,61,38.24545881103919,-109.3386694
48323,0,32,8,4,8,6,58,38.24545881103919,-109.3383999
48324,2,33,7,7,10,3,62,38.24545881103919,-109.3381304
48325,4,32,8,8,10,3,65,38.24545881103919,-109.3378609
48326,4,24,9,6,10,7,60,38.24545881103919,-109.3375914
48327,2,26,10,6,10,9,63,38.24545881103919,-109.3373219
48328,2,31,10,4,10,9,66,38.24545881103919,-109.3370524
48329,2,37,10,3,13,7,72,38.24545881103919,-109.3367829
48330,1,30,10,2,9,12,64,38.24545881103919,-109.3365134
48331,1,27,9,2,10,9,58,38.24545881103919,-109.3362439
48332,1,36,8,1,10,7,63,38.24545881103919,-109.3359744
48333,2,40,8,2,11,6,69,38.24545881103919,-109.3357049
48334,6,41,11,4,12,6,80,38.24545881103919,-109.3354355
48335,0,26,9,1,7,14,57,38.24545881103919,-109.335166
48336,3,40,6,5,8,5,67,38.24545881103919,-109.3348965
48337,2,47,5,3,9,2,68,38.24545881103919,-109.334627
48338,2,49,5,3,7,2,68,38.24545881103919,-109.3343575
48339,2,35,5,2,6,4,54,38.24545881103919,-109.334088
48340,6,29,7,5,9,3,59,38.24545881103919,-109.3338185
48341,10,26,8,8,10,2,64,38.24545881103919,-109.333549
48342,7,24,10,12,11,3,67,38.24545881103919,-109.3332795
48343,2,21,9,15,12,2,61,38.24545881103919,-109.33301
48344,5,28,9,9,8,3,62,38.24545881103919,-109.3327405
48345,4,34,9,9,9,1,66,38.24545881103919,-109.332471
48346,3,31,8,9,9,3,63,38.24545881103919,-109.3322015
48347,1,25,9,7,7,7,56,38.24545881103919,-109.331932
48348,1,25,9,6,6,10,57,38.24545881103919,-109.3316625
48349,4,32,8,4,8,4,60,38.24545881103919,-109.331393
48350,16,28,11,9,14,2,80,38.24518931645396,-109.4402688
48351,2,17,0,0,12,0,31,38.24518931645396,-109.4399993
48352,23,24,10,9,20,5,91,38.24518931645396,-109.4397299
48353,14,21,11,21,14,3,84,38.24518931645396,-109.4394604
48354,10,22,12,19,13,3,79,38.24518931645396,-109.4391909
48355,11,20,12,13,12,5,73,38.24518931645396,-109.4389214
48356,6,27,10,9,10,6,68,38.24518931645396,-109.4386519
48357,1,40,9,2,13,7,72,38.24518931645396,-109.4383824
48358,1,47,9,1,13,6,77,38.24518931645396,-109.4381129
48359,1,48,9,0,11,8,77,38.24518931645396,-109.4378434
48360,1,35,10,1,13,8,68,38.24518931645396,-109.4375739
48361,1,32,10,2,11,8,64,38.24518931645396,-109.4373044
48362,2,37,11,3,13,7,73,38.24518931645396,-109.4370349
48363,4,46,11,4,14,5,84,38.24518931645396,-109.4367654
48364,5,49,11,7,13,3,88,38.24518931645396,-109.4364959
48365,7,44,11,11,12,1,86,38.24518931645396,-109.4362264
48366,9,39,12,12,13,1,86,38.24518931645396,-109.4359569
48367,9,38,12,10,13,2,84,38.24518931645396,-109.4356874
48368,6,35,11,8,12,4,76,38.24518931645396,-109.4354179
48369,4,35,10,6,10,6,71,38.24518931645396,-109.4351484
48370,3,36,11,6,11,5,72,38.24518931645396,-109.434879
48371,3,41,11,6,12,4,77,38.24518931645396,-109.4346095
48372,3,44,11,7,12,4,81,38.24518931645396,-109.43434
48373,4,44,10,8,12,3,81,38.24518931645396,-109.4340705
48374,4,43,11,9,12,2,81,38.24518931645396,-109.433801
48375,5,45,12,10,12,2,86,38.24518931645396,-109.4335315
48376,5,41,12,9,14,3,84,38.24518931645396,-109.433262
48377,5,38,11,6,14,4,78,38.24518931645396,-109.4329925
48378,3,40,10,5,14,4,76,38.24518931645396,-109.432723
48379,3,46,10,4,14,5,82,38.24518931645396,-109.4324535
48380,4,45,11,6,13,4,83,38.24518931645396,-109.432184
48381,6,44,12,9,14,2,87,38.24518931645396,-109.4319145
48382,8,41,13,12,13,1,88,38.24518931645396,-109.431645
48383,8,40,13,14,13,1,89,38.24518931645396,-109.4313755
48384,8,40,14,15,14,0,91,38.24518931645396,-109.431106
48385,10,39,14,16,13,0,92,38.24518931645396,-109.4308365
48386,9,40,15,16,14,0,94,38.24518931645396,-109.430567
48387,7,41,16,17,14,0,95,38.24518931645396,-109.4302975
48388,7,42,15,18,14,0,96,38.24518931645396,-109.430028
48389,7,42,15,15,15,0,94,38.24518931645396,-109.4297586
48390,9,41,14,14,16,0,94,38.24518931645396,-109.4294891
48391,9,39,13,11,16,1,89,38.24518931645396,-109.4292196
48392,6,38,12,7,15,3,81,38.24518931645396,-109.4289501
48393,3,39,11,3,15,6,77,38.24518931645396,-109.4286806
48394,3,43,10,2,15,5,78,38.24518931645396,-109.4284111
48395,4,45,10,4,16,3,82,38.24518931645396,-109.4281416
48396,5,44,11,6,16,2,84,38.24518931645396,-109.4278721
48397,6,41,11,8,16,2,84,38.24518931645396,-109.4276026
48398,6,44,10,6,15,2,83,38.24518931645396,-109.4273331
48399,5,44,10,5,15,2,81,38.24518931645396,-109.4270636
48400,6,43,10,7,15,2,83,38.24518931645396,-109.4267941
48401,7,42,10,7,15,2,83,38.24518931645396,-109.4265246
48402,7,43,10,7,16,1,84,38.24518931645396,-109.4262551
48403,6,42,11,7,16,2,84,38.24518931645396,-109.4259856
48404,12,38,12,10,14,1,87,38.24518931645396,-109.4257161
48405,18,36,12,10,14,0,90,38.24518931645396,-109.4254466
48406,19,35,12,10,14,0,90,38.24518931645396,-109.4251771
48407,16,36,13,12,14,0,91,38.24518931645396,-109.4249077
48408,20,34,13,12,13,0,92,38.24518931645396,-109.4246382
48409,20,35,13,11,13,0,92,38.24518931645396,-109.4243687
48410,19,35,13,11,13,0,91,38.24518931645396,-109.4240992
48411,18,35,13,12,14,0,92,38.24518931645396,-109.4238297
48412,15,37,14,13,14,0,93,38.24518931645396,-109.4235602
48413,15,37,14,13,13,0,92,38.24518931645396,-109.4232907
48414,14,37,14,14,14,0,93,38.24518931645396,-109.4230212
48415,12,38,13,14,14,0,91,38.24518931645396,-109.4227517
48416,8,41,14,12,14,1,90,38.24518931645396,-109.4224822
48417,9,41,14,11,14,1,90,38.24518931645396,-109.4222127
48418,8,40,13,10,14,1,86,38.24518931645396,-109.4219432
48419,7,43,12,8,14,1,85,38.24518931645396,-109.4216737
48420,7,46,10,7,13,1,84,38.24518931645396,-109.4214042
48421,7,45,10,8,14,1,85,38.24518931645396,-109.4211347
48422,4,48,11,6,15,1,85,38.24518931645396,-109.4208652
48423,2,48,9,3,14,4,80,38.24518931645396,-109.4205957
48424,1,47,9,3,12,4,76,38.24518931645396,-109.4203262
48425,2,45,8,5,9,3,72,38.24518931645396,-109.4200568
48426,5,42,8,6,8,2,71,38.24518931645396,-109.4197873
48427,3,36,8,4,10,3,64,38.24518931645396,-109.4195178
48428,2,38,8,3,10,4,65,38.24518931645396,-109.4192483
48429,1,42,8,2,10,4,67,38.24518931645396,-109.4189788
48430,1,44,8,2,10,4,69,38.24518931645396,-109.4187093
48431,3,46,7,4,9,2,71,38.24518931645396,-109.4184398
48432,2,40,7,3,9,3,64,38.24518931645396,-109.4181703
48433,2,37,8,3,10,4,64,38.24518931645396,-109.4179008
48434,2,40,8,4,10,4,68,38.24518931645396,-109.4176313
48435,2,42,8,3,10,5,70,38.24518931645396,-109.4173618
48436,2,40,9,3,10,6,70,38.24518931645396,-109.4170923
48437,3,41,10,4,12,6,76,38.24518931645396,-109.4168228
48438,4,38,12,7,12,7,80,38.24518931645396,-109.4165533
48439,6,34,13,12,11,6,82,38.24518931645396,-109.4162838
48440,12,25,14,19,14,4,88,38.24518931645396,-109.4160143
48441,18,24,14,17,14,3,90,38.24518931645396,-109.4157448
48442,15,35,13,14,13,2,92,38.24518931645396,-109.4154753
48443,6,38,11,11,12,6,84,38.24518931645396,-109.4152058
48444,2,32,10,5,10,10,69,38.24518931645396,-109.4149364
48445,2,31,9,2,10,9,63,38.24518931645396,-109.4146669
48446,2,31,9,5,10,6,63,38.24518931645396,-109.4143974
48447,2,32,9,6,9,5,63,38.24518931645396,-109.4141279
48448,2,31,9,5,11,7,65,38.24518931645396,-109.4138584
48449,2,36,10,3,13,7,71,38.24518931645396,-109.4135889
48450,3,46,10,5,16,2,82,38.24518931645396,-109.4133194
48451,5,48,11,10,15,1,90,38.24518931645396,-109.4130499
48452,6,49,12,10,15,1,93,38.24518931645396,-109.4127804
48453,6,49,12,8,16,1,92,38.24518931645396,-109.4125109
48454,6,48,12,7,16,1,90,38.24518931645396,-109.4122414
48455,8,46,12,9,16,0,91,38.24518931645396,-109.4119719
48456,8,45,13,10,16,0,92,38.24518931645396,-109.4117024
48457,8,44,13,10,16,0,91,38.24518931645396,-109.4114329
48458,8,42,13,11,16,0,90,38.24518931645396,-109.4111634
48459,9,42,13,11,16,0,91,38.24518931645396,-109.4108939
48460,8,45,12,10,16,0,91,38.24518931645396,-109.4106244
48461,7,43,12,10,15,0,87,38.24518931645396,-109.4103549
48462,8,40,13,11,15,1,88,38.24518931645396,-109.4100855
48463,10,38,13,12,13,1,87,38.24518931645396,-109.409816
48464,12,36,13,11,13,1,86,38.24518931645396,-109.4095465
48465,16,34,13,12,13,0,88,38.24518931645396,-109.409277
48466,19,32,14,13,12,0,90,38.24518931645396,-109.4090075
48467,18,31,15,14,12,1,91,38.24518931645396,-109.408738
48468,15,35,15,13,12,1,91,38.24518931645396,-109.4084685
48469,13,36,14,12,15,1,91,38.24518931645396,-109.408199
48470,11,38,13,11,15,1,89,38.24518931645396,-109.4079295
48471,9,39,12,10,15,1,86,38.24518931645396,-109.40766
48472,7,39,11,8,15,2,82,38.24518931645396,-109.4073905
48473,6,44,9,7,14,1,81,38.24518931645396,-109.407121
48474,5,50,8,8,11,1,83,38.24518931645396,-109.4068515
48475,4,52,8,9,9,1,83,38.24518931645396,-109.406582
48476,5,47,10,11,11,1,85,38.24518931645396,-109.4063125
48477,10,41,11,14,13,0,89,38.24518931645396,-109.406043
48478,11,32,12,13,14,1,83,38.24518931645396,-109.4057735
48479,12,33,13,12,14,1,85,38.24518931645396,-109.405504
48480,12,37,14,13,14,0,90,38.24518931645396,-109.4052345
48481,12,38,13,12,14,0,89,38.24518931645396,-109.4049651
48482,11,38,13,12,15,0,89,38.24518931645396,-109.4046956
48483,11,32,13,12,15,1,84,38.24518931645396,-109.4044261
48484,11,32,12,12,15,1,83,38.24518931645396,-109.4041566
48485,10,32,12,12,15,1,82,38.24518931645396,-109.4038871
48486,10,31,13,13,14,1,82,38.24518931645396,-109.4036176
48487,11,30,13,13,14,1,82,38.24518931645396,-109.4033481
48488,11,33,13,13,15,1,86,38.24518931645396,-109.4030786
48489,11,35,14,13,15,1,89,38.24518931645396,-109.4028091
48490,10,35,14,13,15,1,88,38.24518931645396,-109.4025396
48491,10,35,14,14,15,1,89,38.24518931645396,-109.4022701
48492,12,34,14,14,15,1,90,38.24518931645396,-109.4020006
48493,12,34,14,14,15,1,90,38.24518931645396,-109.4017311
48494,11,35,14,15,15,1,91,38.24518931645396,-109.4014616
48495,10,38,14,14,15,1,92,38.24518931645396,-109.4011921
48496,7,42,14,14,14,1,92,38.24518931645396,-109.4009226
48497,10,38,14,16,15,0,93,38.24518931645396,-109.4006531
48498,10,40,14,15,15,0,94,38.24518931645396,-109.4003836
48499,8,41,14,13,15,1,92,38.24518931645396,-109.4001142
48500,8,39,14,13,15,1,90,38.24518931645396,-109.3998447
48501,5,41,13,10,14,3,86,38.24518931645396,-109.3995752
48502,8,42,13,12,14,1,90,38.24518931645396,-109.3993057
48503,10,40,14,14,15,1,94,38.24518931645396,-109.3990362
48504,10,39,14,13,15,1,92,38.24518931645396,-109.3987667
48505,7,41,15,12,16,1,92,38.24518931645396,-109.3984972
48506,6,41,14,11,15,2,89,38.24518931645396,-109.3982277
48507,6,42,14,12,14,1,89,38.24518931645396,-109.3979582
48508,6,43,14,11,13,1,88,38.24518931645396,-109.3976887
48509,6,43,14,10,13,2,88,38.24518931645396,-109.3974192
48510,5,40,14,10,13,2,84,38.24518931645396,-109.3971497
48511,5,40,14,11,14,2,86,38.24518931645396,-109.3968802
48512,6,40,14,10,14,2,86,38.24518931645396,-109.3966107
48513,6,39,14,10,15,2,86,38.24518931645396,-109.3963412
48514,6,40,14,11,15,1,87,38.24518931645396,-109.3960717
48515,6,39,14,11,15,2,87,38.24518931645396,-109.3958022
48516,7,40,15,12,16,1,91,38.24518931645396,-109.3955327
48517,7,40,15,12,17,1,92,38.24518931645396,-109.3952632
48518,8,41,14,11,17,1,92,38.24518931645396,-109.3949938
48519,8,41,14,11,17,1,92,38.24518931645396,-109.3947243
48520,10,40,14,10,17,0,91,38.24518931645396,-109.3944548
48521,9,40,14,10,17,0,90,38.24518931645396,-109.3941853
48522,8,40,14,10,17,1,90,38.24518931645396,-109.3939158
48523,7,41,14,11,17,1,91,38.24518931645396,-109.3936463
48524,6,41,14,11,17,1,90,38.24518931645396,-109.3933768
48525,6,41,15,13,18,0,93,38.24518931645396,-109.3931073
48526,6,41,15,12,18,0,92,38.24518931645396,-109.3928378
48527,7,41,15,12,18,0,93,38.24518931645396,-109.3925683
48528,7,40,15,12,17,0,91,38.24518931645396,-109.3922988
48529,9,39,15,14,17,0,94,38.24518931645396,-109.3920293
48530,9,39,14,13,17,0,92,38.24518931645396,-109.3917598
48531,8,40,15,13,17,0,93,38.24518931645396,-109.3914903
48532,7,41,14,13,17,0,92,38.24518931645396,-109.3912208
48533,7,40,14,13,17,0,91,38.24518931645396,-109.3909513
48534,8,40,14,12,16,0,90,38.24518931645396,-109.3906818
48535,7,41,14,12,17,0,91,38.24518931645396,-109.3904123
48536,6,43,14,10,18,0,91,38.24518931645396,-109.3901429
48537,5,46,14,10,18,0,93,38.24518931645396,-109.3898734
48538,5,46,14,10,18,0,93,38.24518931645396,-109.3896039
48539,5,49,14,11,15,1,95,38.24518931645396,-109.3893344
48540,5,45,13,13,13,1,90,38.24518931645396,-109.3890649
48541,6,42,14,15,13,1,91,38.24518931645396,-109.3887954
48542,9,41,14,14,13,0,91,38.24518931645396,-109.3885259
48543,8,44,14,13,15,0,94,38.24518931645396,-109.3882564
48544,8,42,14,12,15,0,91,38.24518931645396,-109.3879869
48545,10,39,14,13,15,0,91,38.24518931645396,-109.3877174
48546,14,37,13,12,14,0,90,38.24518931645396,-109.3874479
48547,16,37,13,12,13,0,91,38.24518931645396,-109.3871784
48548,14,36,14,15,13,0,92,38.24518931645396,-109.3869089
48549,13,36,13,15,13,0,90,38.24518931645396,-109.3866394
48550,14,35,13,13,13,1,89,38.24518931645396,-109.3863699
48551,15,36,13,13,13,1,91,38.24518931645396,-109.3861004
48552,13,36,13,15,13,1,91,38.24518931645396,-109.3858309
48553,13,36,13,15,14,0,91,38.24518931645396,-109.3855614
48554,12,37,14,14,14,0,91,38.24518931645396,-109.3852919
48555,11,37,13,15,13,0,89,38.24518931645396,-109.3850225
48556,12,36,13,15,13,1,90,38.24518931645396,-109.384753
48557,9,37,13,13,13,2,87,38.24518931645396,-109.3844835
48558,9,40,13,13,13,2,90,38.24518931645396,-109.384214
48559,9,41,14,13,13,1,91,38.24518931645396,-109.3839445
48560,10,40,14,14,13,1,92,38.24518931645396,-109.383675
48561,11,40,13,14,13,1,92,38.24518931645396,-109.3834055
48562,11,39,14,15,13,0,92,38.24518931645396,-109.383136
48563,13,38,13,14,13,0,91,38.24518931645396,-109.3828665
48564,11,41,13,11,14,1,91,38.24518931645396,-109.382597
48565,11,41,11,9,13,2,87,38.24518931645396,-109.3823275
48566,14,26,11,10,9,3,73,38.24518931645396,-109.382058
48567,6,27,9,14,9,2,67,38.24518931645396,-109.3817885
48568,11,33,10,9,11,2,76,38.24518931645396,-109.381519
48569,11,41,12,10,13,1,88,38.24518931645396,-109.3812495
48570,9,43,13,10,14,1,90,38.24518931645396,-109.38098
48571,13,43,13,11,13,0,93,38.24518931645396,-109.3807105
48572,12,43,14,12,12,1,94,38.24518931645396,-109.380441
48573,11,42,13,12,11,2,91,38.24518931645396,-109.3801716
48574,10,43,13,11,10,2,89,38.24518931645396,-109.3799021
48575,9,43,13,12,10,3,90,38.24518931645396,-109.3796326
48576,9,42,13,11,9,3,87,38.24518931645396,-109.3793631
48577,9,41,13,12,9,3,87,38.24518931645396,-109.3790936
48578,8,40,13,11,9,4,85,38.24518931645396,-109.3788241
48579,8,40,13,11,9,4,85,38.24518931645396,-109.3785546
48580,9,40,14,12,10,3,88,38.24518931645396,-109.3782851
48581,12,38,14,12,10,3,89,38.24518931645396,-109.3780156
48582,16,35,15,14,9,2,91,38.24518931645396,-109.3777461
48583,17,33,15,14,8,2,89,38.24518931645396,-109.3774766
48584,17,32,15,13,8,3,88,38.24518931645396,-109.3772071
48585,19,30,15,13,9,2,88,38.24518931645396,-109.3769376
48586,9,34,12,8,8,6,77,38.24518931645396,-109.3766681
48587,5,32,11,5,7,9,69,38.24518931645396,-109.3763986
48588,3,33,9,4,8,8,65,38.24518931645396,-109.3761291
48589,1,43,8,1,10,5,68,38.24518931645396,-109.3758596
48590,0,52,6,0,8,3,69,38.24518931645396,-109.3755901
48591,1,43,8,4,9,2,67,38.24518931645396,-109.3753206
48592,2,39,9,9,10,3,72,38.24518931645396,-109.3750512
48593,3,35,13,4,9,12,76,38.24518931645396,-109.3747817
48594,3,31,14,3,9,16,76,38.24518931645396,-109.3745122
48595,4,32,14,7,9,8,74,38.24518931645396,-109.3742427
48596,0,31,11,6,11,10,69,38.24518931645396,-109.3739732
48597,10,34,11,13,8,7,83,38.24518931645396,-109.3737037
48598,12,33,10,11,8,7,81,38.24518931645396,-109.3734342
48599,9,31,10,17,9,6,82,38.24518931645396,-109.3731647
48600,6,31,11,19,10,7,84,38.24518931645396,-109.3728952
48601,2,27,13,16,23,1,82,38.24518931645396,-109.3726257
48602,3,18,13,18,24,1,77,38.24518931645396,-109.3723562
48603,3,19,13,22,18,3,78,38.24518931645396,-109.3720867
48604,3,14,11,22,18,2,70,38.24518931645396,-109.3718172
48605,3,21,13,15,14,8,74,38.24518931645396,-109.3715477
48606,1,21,11,10,11,10,64,38.24518931645396,-109.3712782
48607,3,26,13,7,10,17,76,38.24518931645396,-109.3710087
48608,2,28,16,3,5,24,78,38.24518931645396,-109.3707392
48609,0,24,18,0,4,31,77,38.24518931645396,-109.3704697
48610,0,21,17,0,2,33,73,38.24518931645396,-109.3702003
48611,0,21,17,0,2,33,73,38.24518931645396,-109.3699308
48612,1,22,16,0,2,31,72,38.24518931645396,-109.3696613
48613,2,22,14,0,2,26,66,38.24518931645396,-109.3693918
48614,1,21,14,0,0,25,61,38.24518931645396,-109.3691223
48615,1,20,13,0,0,25,59,38.24518931645396,-109.3688528
48616,1,24,12,0,2,21,60,38.24518931645396,-109.3685833
48617,1,27,10,0,5,17,60,38.24518931645396,-109.3683138
48618,1,27,10,0,6,15,59,38.24518931645396,-109.3680443
48619,1,27,10,0,7,15,60,38.24518931645396,-109.3677748
48620,1,26,10,0,7,13,57,38.24518931645396,-109.3675053
48621,1,27,10,0,7,12,57,38.24518931645396,-109.3672358
48622,1,27,10,0,7,12,57,38.24518931645396,-109.3669663
48623,1,28,10,0,6,16,61,38.24518931645396,-109.3666968
48624,1,29,10,0,5,17,62,38.24518931645396,-109.3664273
48625,1,30,10,0,6,16,63,38.24518931645396,-109.3661578
48626,1,31,10,0,6,15,63,38.24518931645396,-109.3658883
48627,2,32,9,0,6,13,62,38.24518931645396,-109.3656188
48628,1,33,9,0,5,13,61,38.24518931645396,-109.3653493
48629,1,30,9,0,4,15,59,38.24518931645396,-109.3650799
48630,1,28,10,0,4,16,59,38.24518931645396,-109.3648104
48631,1,28,11,0,5,17,62,38.24518931645396,-109.3645409
48632,3,28,13,2,4,20,70,38.24518931645396,-109.3642714
48633,3,29,14,3,5,20,74,38.24518931645396,-109.3640019
48634,3,29,13,3,4,21,73,38.24518931645396,-109.3637324
48635,2,29,12,2,3,20,68,38.24518931645396,-109.3634629
48636,2,27,12,1,2,21,65,38.24518931645396,-109.3631934
48637,3,29,12,1,5,15,65,38.24518931645396,-109.3629239
48638,3,24,12,1,3,16,59,38.24518931645396,-109.3626544
48639,3,22,13,1,2,18,59,38.24518931645396,-109.3623849
48640,4,22,14,1,2,19,62,38.24518931645396,-109.3621154
48641,3,22,13,0,3,20,61,38.24518931645396,-109.3618459
48642,2,24,12,0,3,21,62,38.24518931645396,-109.3615764
48643,1,20,12,1,3,20,57,38.24518931645396,-109.3613069
48644,2,21,9,3,5,13,53,38.24518931645396,-109.3610374
48645,1,25,7,3,8,6,50,38.24518931645396,-109.3607679
48646,1,28,6,1,7,5,48,38.24518931645396,-109.3604984
48647,1,24,5,0,8,6,44,38.24518931645396,-109.360229
48648,1,29,5,1,7,6,49,38.24518931645396,-109.3599595
48649,1,36,6,2,7,6,58,38.24518931645396,-109.35969
48650,2,35,6,3,6,6,58,38.24518931645396,-109.3594205
48651,2,39,6,4,7,5,63,38.24518931645396,-109.359151
48652,2,29,6,3,8,6,54,38.24518931645396,-109.3588815
48653,2,26,7,2,8,6,51,38.24518931645396,-109.358612
48654,2,25,7,2,8,6,50,38.24518931645396,-109.3583425
48655,2,28,8,2,9,6,55,38.24518931645396,-109.358073
48656,1,22,11,2,4,17,57,38.24518931645396,-109.3578035
48657,1,25,11,1,3,20,61,38.24518931645396,-109.357534
48658,1,30,10,1,4,17,63,38.24518931645396,-109.3572645
48659,1,33,10,0,6,15,65,38.24518931645396,-109.356995
48660,1,38,10,0,9,12,70,38.24518931645396,-109.3567255
48661,1,36,9,2,9,7,64,38.24518931645396,-109.356456
48662,2,29,9,4,7,7,58,38.24518931645396,-109.3561865
48663,3,25,9,5,7,7,56,38.24518931645396,-109.355917
48664,4,29,11,5,7,7,63,38.24518931645396,-109.3556475
48665,3,27,11,5,7,8,61,38.24518931645396,-109.355378
48666,3,29,11,3,6,9,61,38.24518931645396,-109.3551086
48667,3,26,10,3,8,10,60,38.24518931645396,-109.3548391
48668,3,23,11,5,9,9,60,38.24518931645396,-109.3545696
48669,6,20,12,5,8,10,61,38.24518931645396,-109.3543001
48670,3,24,11,4,9,10,61,38.24518931645396,-109.3540306
48671,3,29,11,3,9,10,65,38.24518931645396,-109.3537611
48672,2,34,10,0,8,12,66,38.24518931645396,-109.3534916
48673,3,35,11,2,8,9,68,38.24518931645396,-109.3532221
48674,2,31,8,5,6,6,58,38.24518931645396,-109.3529526
48675,2,29,9,12,13,3,68,38.24518931645396,-109.3526831
48676,9,21,10,14,13,5,72,38.24518931645396,-109.3524136
48677,14,14,16,15,10,10,79,38.24518931645396,-109.3521441
48678,5,17,15,9,17,20,83,38.24518931645396,-109.3518746
48679,1,21,10,11,17,6,66,38.24518931645396,-109.3516051
48680,6,26,7,11,9,2,61,38.24518931645396,-109.3513356
48681,4,32,7,8,8,1,60,38.24518931645396,-109.3510661
48682,4,30,7,6,7,4,58,38.24518931645396,-109.3507966
48683,8,31,7,7,6,3,62,38.24518931645396,-109.3505271
48684,6,35,6,5,7,2,61,38.24518931645396,-109.3502577
48685,3,42,4,3,6,2,60,38.24518931645396,-109.3499882
48686,3,44,4,2,6,2,61,38.24518931645396,-109.3497187
48687,3,31,6,4,7,4,55,38.24518931645396,-109.3494492
48688,4,28,9,6,8,4,59,38.24518931645396,-109.3491797
48689,3,19,12,7,8,10,59,38.24518931645396,-109.3489102
48690,10,20,14,12,8,9,73,38.24518931645396,-109.3486407
48691,20,20,15,19,9,6,89,38.24518931645396,-109.3483712
48692,25,16,12,28,7,3,91,38.24518931645396,-109.3481017
48693,14,14,12,30,6,7,83,38.24518931645396,-109.3478322
48694,3,19,11,12,10,8,63,38.24518931645396,-109.3475627
48695,3,21,11,11,12,6,64,38.24518931645396,-109.3472932
48696,7,21,12,16,13,4,73,38.24518931645396,-109.3470237
48697,17,23,14,17,12,3,86,38.24518931645396,-109.3467542
48698,23,15,11,22,13,2,86,38.24518931645396,-109.3464847
48699,32,12,10,22,16,2,94,38.24518931645396,-109.3462152
48700,15,19,10,22,16,4,86,38.24518931645396,-109.3459457
48701,2,23,11,9,11,14,70,38.24518931645396,-109.3456762
48702,3,31,11,9,20,5,79,38.24518931645396,-109.3454068
48703,4,27,12,10,14,8,75,38.24518931645396,-109.3451373
48704,4,26,13,10,11,12,76,38.24518931645396,-109.3448678
48705,4,27,14,9,11,14,79,38.24518931645396,-109.3445983
48706,3,27,15,8,11,15,79,38.24518931645396,-109.3443288
48707,1,32,16,2,11,19,81,38.24518931645396,-109.3440593
48708,0,28,17,1,9,22,77,38.24518931645396,-109.3437898
48709,0,28,16,1,12,20,77,38.24518931645396,-109.3435203
48710,2,27,14,3,13,15,74,38.24518931645396,-109.3432508
48711,1,26,15,0,6,23,71,38.24518931645396,-109.3429813
48712,3,26,14,0,4,21,68,38.24518931645396,-109.3427118
48713,3,27,13,0,4,20,67,38.24518931645396,-109.3424423
48714,2,26,12,0,6,17,63,38.24518931645396,-109.3421728
48715,1,25,12,0,6,18,62,38.24518931645396,-109.3419033
48716,1,26,13,0,5,22,67,38.24518931645396,-109.3416338
48717,0,26,15,0,5,25,71,38.24518931645396,-109.3413643
48718,0,27,14,0,7,21,69,38.24518931645396,-109.3410948
48719,2,24,13,6,10,11,66,38.24518931645396,-109.3408253
48720,3,27,11,11,12,4,68,38.24518931645396,-109.3405558
48721,2,23,11,6,11,7,60,38.24518931645396,-109.3402864
48722,0,13,12,4,4,16,49,38.24518931645396,-109.3400169
48723,1,16,12,2,4,17,52,38.24518931645396,-109.3397474
48724,1,23,10,3,7,12,56,38.24518931645396,-109.3394779
48725,1,26,11,4,7,13,62,38.24518931645396,-109.3392084
48726,1,34,9,3,11,8,66,38.24518931645396,-109.3389389
48727,1,38,9,5,11,4,68,38.24518931645396,-109.3386694
48728,2,39,9,9,11,2,72,38.24518931645396,-109.3383999
48729,3,34,10,10,11,2,70,38.24518931645396,-109.3381304
48730,1,22,9,6,9,7,54,38.24518931645396,-109.3378609
48731,2,22,9,5,8,8,54,38.24518931645396,-109.3375914
48732,1,29,10,3,10,10,63,38.24518931645396,-109.3373219
48733,1,36,10,0,11,10,68,38.24518931645396,-109.3370524
48734,1,38,10,0,11,11,71,38.24518931645396,-109.3367829
48735,0,21,12,1,3,21,58,38.24518931645396,-109.3365134
48736,0,24,10,2,8,12,56,38.24518931645396,-109.3362439
48737,1,33,9,3,10,8,64,38.24518931645396,-109.3359744
48738,1,33,8,2,10,7,61,38.24518931645396,-109.3357049
48739,1,37,7,2,9,9,65,38.24518931645396,-109.3354355
48740,2,47,6,5,9,2,71,38.24518931645396,-109.335166
48741,2,53,4,3,8,1,71,38.24518931645396,-109.3348965
48742,3,48,5,2,7,2,67,38.24518931645396,-109.334627
48743,3,39,5,1,5,4,57,38.24518931645396,-109.3343575
48744,14,24,9,9,7,4,67,38.24518931645396,-109.334088
48745,9,20,10,9,10,6,64,38.24518931645396,-109.3338185
48746,4,23,12,8,12,10,69,38.24518931645396,-109.333549
48747,1,22,11,13,12,8,67,38.24518931645396,-109.3332795
48748,1,23,9,13,12,3,61,38.24518931645396,-109.33301
48749,6,26,9,9,9,3,62,38.24518931645396,-109.3327405
48750,5,32,9,9,10,2,67,38.24518931645396,-109.332471
48751,4,31,9,10,10,2,66,38.24518931645396,-109.3322015
48752,3,27,8,9,8,5,60,38.24518931645396,-109.331932
48753,2,36,8,5,7,5,63,38.24518931645396,-109.3316625
48754,3,34,6,5,8,3,59,38.24518931645396,-109.331393
48755,9,33,11,11,10,1,75,38.24491982186872,-109.4402688
48756,16,21,6,0,16,11,70,38.24491982186872,-109.4399993
48757,18,23,11,16,19,3,90,38.24491982186872,-109.4397299
48758,13,25,12,23,13,3,89,38.24491982186872,-109.4394604
48759,14,23,13,21,14,3,88,38.24491982186872,-109.4391909
48760,18,18,12,19,17,3,87,38.24491982186872,-109.4389214
48761,25,16,14,14,12,2,83,38.24491982186872,-109.4386519
48762,5,28,10,8,13,5,69,38.24491982186872,-109.4383824
48763,2,36,9,4,11,7,69,38.24491982186872,-109.4381129
48764,1,37,9,1,11,9,68,38.24491982186872,-109.4378434
48765,2,31,10,4,12,7,66,38.24491982186872,-109.4375739
48766,0,34,9,5,10,6,64,38.24491982186872,-109.4373044
48767,1,38,9,7,10,5,70,38.24491982186872,-109.4370349
48768,3,41,9,6,12,4,75,38.24491982186872,-109.4367654
48769,3,43,9,5,11,4,75,38.24491982186872,-109.4364959
48770,2,40,9,6,11,3,71,38.24491982186872,-109.4362264
48771,3,36,8,5,11,3,66,38.24491982186872,-109.4359569
48772,4,34,8,5,12,3,66,38.24491982186872,-109.4356874
48773,3,33,9,5,11,4,65,38.24491982186872,-109.4354179
48774,2,34,9,3,9,5,62,38.24491982186872,-109.4351484
48775,2,33,10,4,9,7,65,38.24491982186872,-109.434879
48776,2,38,9,2,9,7,67,38.24491982186872,-109.4346095
48777,2,45,9,3,11,5,75,38.24491982186872,-109.43434
48778,2,50,10,5,13,3,83,38.24491982186872,-109.4340705
48779,3,50,10,7,13,3,86,38.24491982186872,-109.433801
48780,4,44,12,7,14,3,84,38.24491982186872,-109.4335315
48781,5,42,12,6,14,4,83,38.24491982186872,-109.433262
48782,4,39,10,5,13,6,77,38.24491982186872,-109.4329925
48783,2,38,9,4,12,6,71,38.24491982186872,-109.432723
48784,3,43,10,4,13,5,78,38.24491982186872,-109.4324535
48785,4,44,11,6,13,4,82,38.24491982186872,-109.432184
48786,7,42,12,10,13,2,86,38.24491982186872,-109.4319145
48787,9,40,13,13,13,1,89,38.24491982186872,-109.431645
48788,8,40,13,14,13,1,89,38.24491982186872,-109.4313755
48789,7,39,13,14,13,1,87,38.24491982186872,-109.431106
48790,8,38,14,14,13,1,88,38.24491982186872,-109.4308365
48791,8,38,14,14,14,1,89,38.24491982186872,-109.430567
48792,7,38,13,15,14,1,88,38.24491982186872,-109.4302975
48793,6,40,14,18,14,0,92,38.24491982186872,-109.430028
48794,8,40,14,16,14,0,92,38.24491982186872,-109.4297586
48795,9,40,13,12,16,0,90,38.24491982186872,-109.4294891
48796,7,42,11,6,14,3,83,38.24491982186872,-109.4292196
48797,5,43,10,2,14,6,80,38.24491982186872,-109.4289501
48798,2,42,10,0,13,9,76,38.24491982186872,-109.4286806
48799,2,46,10,0,14,7,79,38.24491982186872,-109.4284111
48800,3,46,10,2,17,3,81,38.24491982186872,-109.4281416
48801,6,42,11,6,16,2,83,38.24491982186872,-109.4278721
48802,8,40,11,7,15,2,83,38.24491982186872,-109.4276026
48803,5,42,10,5,14,3,79,38.24491982186872,-109.4273331
48804,7,42,11,8,16,1,85,38.24491982186872,-109.4270636
48805,9,40,11,10,15,1,86,38.24491982186872,-109.4267941
48806,10,39,11,10,14,1,85,38.24491982186872,-109.4265246
48807,8,41,12,10,15,1,87,38.24491982186872,-109.4262551
48808,9,43,12,10,15,0,89,38.24491982186872,-109.4259856
48809,15,38,13,11,15,0,92,38.24491982186872,-109.4257161
48810,17,36,13,12,14,0,92,38.24491982186872,-109.4254466
48811,14,36,13,13,14,0,90,38.24491982186872,-109.4251771
48812,10,39,13,15,14,0,91,38.24491982186872,-109.4249077
48813,11,39,14,14,14,0,92,38.24491982186872,-109.4246382
48814,13,38,14,14,14,0,93,38.24491982186872,-109.4243687
48815,13,38,14,14,14,0,93,38.24491982186872,-109.4240992
48816,11,38,13,14,15,0,91,38.24491982186872,-109.4238297
48817,10,38,13,14,14,0,89,38.24491982186872,-109.4235602
48818,11,40,14,14,14,0,93,38.24491982186872,-109.4232907
48819,10,39,14,14,14,0,91,38.24491982186872,-109.4230212
48820,9,39,14,14,14,0,90,38.24491982186872,-109.4227517
48821,8,39,14,14,14,1,90,38.24491982186872,-109.4224822
48822,10,38,14,14,14,1,91,38.24491982186872,-109.4222127
48823,9,38,13,12,14,1,87,38.24491982186872,-109.4219432
48824,8,41,12,10,15,1,87,38.24491982186872,-109.4216737
48825,7,42,11,9,15,1,85,38.24491982186872,-109.4214042
48826,6,40,11,9,15,1,82,38.24491982186872,-109.4211347
48827,7,42,12,9,16,1,87,38.24491982186872,-109.4208652
48828,3,45,10,5,15,3,81,38.24491982186872,-109.4205957
48829,2,48,9,3,14,3,79,38.24491982186872,-109.4203262
48830,2,49,8,4,10,2,75,38.24491982186872,-109.4200568
48831,2,45,7,3,7,3,67,38.24491982186872,-109.4197873
48832,3,40,8,4,9,4,68,38.24491982186872,-109.4195178
48833,1,39,8,3,9,6,66,38.24491982186872,-109.4192483
48834,1,39,8,3,10,5,66,38.24491982186872,-109.4189788
48835,3,41,8,4,10,3,69,38.24491982186872,-109.4187093
48836,3,41,8,3,9,3,67,38.24491982186872,-109.4184398
48837,2,40,8,3,9,4,66,38.24491982186872,-109.4181703
48838,2,40,8,3,10,5,68,38.24491982186872,-109.4179008
48839,2,43,8,2,10,4,69,38.24491982186872,-109.4176313
48840,2,47,8,2,9,4,72,38.24491982186872,-109.4173618
48841,3,37,10,6,10,6,72,38.24491982186872,-109.4170923
48842,7,37,13,13,11,4,85,38.24491982186872,-109.4168228
48843,15,32,15,14,13,3,92,38.24491982186872,-109.4165533
48844,17,27,15,18,13,2,92,38.24491982186872,-109.4162838
48845,22,24,13,17,12,3,91,38.24491982186872,-109.4160143
48846,21,26,14,15,13,1,90,38.24491982186872,-109.4157448
48847,11,39,12,11,13,2,88,38.24491982186872,-109.4154753
48848,4,41,10,8,11,6,80,38.24491982186872,-109.4152058
48849,2,35,10,4,12,7,70,38.24491982186872,-109.4149364
48850,1,34,10,5,12,6,68,38.24491982186872,-109.4146669
48851,1,31,9,4,11,7,63,38.24491982186872,-109.4143974
48852,1,28,9,4,11,9,62,38.24491982186872,-109.4141279
48853,1,27,10,3,11,10,62,38.24491982186872,-109.4138584
48854,1,30,10,1,11,9,62,38.24491982186872,-109.4135889
48855,1,41,9,1,14,6,72,38.24491982186872,-109.4133194
48856,4,46,10,6,16,2,84,38.24491982186872,-109.4130499
48857,6,48,11,9,16,1,91,38.24491982186872,-109.4127804
48858,8,47,11,8,16,1,91,38.24491982186872,-109.4125109
48859,5,47,11,6,16,3,88,38.24491982186872,-109.4122414
48860,6,48,12,7,17,1,91,38.24491982186872,-109.4119719
48861,7,45,13,10,16,0,91,38.24491982186872,-109.4117024
48862,10,42,13,11,15,0,91,38.24491982186872,-109.4114329
48863,12,40,14,12,14,0,92,38.24491982186872,-109.4111634
48864,13,39,13,12,13,0,90,38.24491982186872,-109.4108939
48865,13,41,13,11,13,0,91,38.24491982186872,-109.4106244
48866,12,41,13,11,14,0,91,38.24491982186872,-109.4103549
48867,10,42,13,11,14,0,90,38.24491982186872,-109.4100855
48868,9,43,13,10,14,0,89,38.24491982186872,-109.409816
48869,11,42,13,10,13,0,89,38.24491982186872,-109.4095465
48870,16,33,14,14,12,1,90,38.24491982186872,-109.409277
48871,19,31,15,14,11,1,91,38.24491982186872,-109.4090075
48872,20,32,15,13,12,1,93,38.24491982186872,-109.408738
48873,17,34,15,12,12,1,91,38.24491982186872,-109.4084685
48874,14,36,14,12,14,1,91,38.24491982186872,-109.408199
48875,10,39,12,11,15,1,88,38.24491982186872,-109.4079295
48876,7,42,11,9,14,1,84,38.24491982186872,-109.40766
48877,5,47,9,7,13,2,83,38.24491982186872,-109.4073905
48878,2,56,7,6,10,1,82,38.24491982186872,-109.407121
48879,2,66,6,7,6,0,87,38.24491982186872,-109.4068515
48880,1,66,6,8,5,0,86,38.24491982186872,-109.406582
48881,2,57,7,13,5,0,84,38.24491982186872,-109.4063125
48882,8,48,10,13,11,0,90,38.24491982186872,-109.406043
48883,9,34,12,13,15,1,84,38.24491982186872,-109.4057735
48884,9,34,12,13,14,1,83,38.24491982186872,-109.405504
48885,10,34,13,12,15,1,85,38.24491982186872,-109.4052345
48886,11,36,13,13,15,0,88,38.24491982186872,-109.4049651
48887,14,35,14,13,14,0,90,38.24491982186872,-109.4046956
48888,14,34,13,13,14,0,88,38.24491982186872,-109.4044261
48889,14,34,14,13,14,0,89,38.24491982186872,-109.4041566
48890,10,33,13,13,15,1,85,38.24491982186872,-109.4038871
48891,8,32,13,12,15,2,82,38.24491982186872,-109.4036176
48892,6,33,13,11,15,3,81,38.24491982186872,-109.4033481
48893,9,32,13,12,15,2,83,38.24491982186872,-109.4030786
48894,10,32,13,12,15,2,84,38.24491982186872,-109.4028091
48895,10,33,13,13,15,1,85,38.24491982186872,-109.4025396
48896,10,35,14,13,15,1,88,38.24491982186872,-109.4022701
48897,8,35,14,12,16,1,86,38.24491982186872,-109.4020006
48898,10,34,14,13,15,1,87,38.24491982186872,-109.4017311
48899,8,38,14,14,15,1,90,38.24491982186872,-109.4014616
48900,6,41,13,11,14,2,87,38.24491982186872,-109.4011921
48901,7,42,14,13,14,1,91,38.24491982186872,-109.4009226
48902,8,41,14,14,14,0,91,38.24491982186872,-109.4006531
48903,9,40,14,15,15,0,93,38.24491982186872,-109.4003836
48904,7,40,14,13,14,1,89,38.24491982186872,-109.4001142
48905,6,40,13,11,14,2,86,38.24491982186872,-109.3998447
48906,6,41,14,11,15,1,88,38.24491982186872,-109.3995752
48907,7,42,14,12,15,1,91,38.24491982186872,-109.3993057
48908,9,42,14,12,15,1,93,38.24491982186872,-109.3990362
48909,9,42,14,12,15,1,93,38.24491982186872,-109.3987667
48910,6,42,14,11,15,2,90,38.24491982186872,-109.3984972
48911,6,43,14,11,15,2,91,38.24491982186872,-109.3982277
48912,6,42,14,11,14,2,89,38.24491982186872,-109.3979582
48913,6,41,14,10,13,2,86,38.24491982186872,-109.3976887
48914,5,40,14,9,13,3,84,38.24491982186872,-109.3974192
48915,5,39,14,10,14,2,84,38.24491982186872,-109.3971497
48916,5,40,13,10,14,3,85,38.24491982186872,-109.3968802
48917,5,40,13,9,15,3,85,38.24491982186872,-109.3966107
48918,5,41,14,9,15,2,86,38.24491982186872,-109.3963412
48919,6,41,14,11,16,1,89,38.24491982186872,-109.3960717
48920,7,40,15,12,16,1,91,38.24491982186872,-109.3958022
48921,8,38,15,13,16,1,91,38.24491982186872,-109.3955327
48922,10,37,15,13,16,0,91,38.24491982186872,-109.3952632
48923,12,37,14,12,15,0,90,38.24491982186872,-109.3949938
48924,13,38,14,11,15,0,91,38.24491982186872,-109.3947243
48925,11,39,14,11,16,0,91,38.24491982186872,-109.3944548
48926,9,39,14,11,17,0,90,38.24491982186872,-109.3941853
48927,9,40,14,11,17,0,91,38.24491982186872,-109.3939158
48928,8,41,14,11,17,1,92,38.24491982186872,-109.3936463
48929,7,40,14,11,17,1,90,38.24491982186872,-109.3933768
48930,5,40,14,11,17,1,88,38.24491982186872,-109.3931073
48931,5,41,15,11,17,1,90,38.24491982186872,-109.3928378
48932,6,41,15,10,17,1,90,38.24491982186872,-109.3925683
48933,6,41,14,11,17,1,90,38.24491982186872,-109.3922988
48934,7,41,14,11,17,0,90,38.24491982186872,-109.3920293
48935,6,41,14,11,17,0,89,38.24491982186872,-109.3917598
48936,5,42,14,12,17,0,90,38.24491982186872,-109.3914903
48937,5,42,14,12,17,0,90,38.24491982186872,-109.3912208
48938,6,42,14,12,17,0,91,38.24491982186872,-109.3909513
48939,8,41,14,11,16,0,90,38.24491982186872,-109.3906818
48940,8,41,14,12,17,0,92,38.24491982186872,-109.3904123
48941,7,43,14,11,17,0,92,38.24491982186872,-109.3901429
48942,6,46,14,9,18,0,93,38.24491982186872,-109.3898734
48943,6,48,14,9,18,0,95,38.24491982186872,-109.3896039
48944,5,47,14,10,16,1,93,38.24491982186872,-109.3893344
48945,5,43,13,12,13,1,87,38.24491982186872,-109.3890649
48946,7,42,13,13,13,1,89,38.24491982186872,-109.3887954
48947,8,44,14,13,13,1,93,38.24491982186872,-109.3885259
48948,7,45,14,12,15,0,93,38.24491982186872,-109.3882564
48949,8,43,13,12,14,0,90,38.24491982186872,-109.3879869
48950,11,38,13,12,15,0,89,38.24491982186872,-109.3877174
48951,15,36,13,12,14,0,90,38.24491982186872,-109.3874479
48952,18,35,13,12,13,0,91,38.24491982186872,-109.3871784
48953,18,34,13,13,13,0,91,38.24491982186872,-109.3869089
48954,15,35,13,15,13,0,91,38.24491982186872,-109.3866394
48955,15,35,13,14,13,0,90,38.24491982186872,-109.3863699
48956,16,35,12,14,12,0,89,38.24491982186872,-109.3861004
48957,16,35,13,14,13,0,91,38.24491982186872,-109.3858309
48958,15,36,13,13,13,0,90,38.24491982186872,-109.3855614
48959,14,36,13,14,13,0,90,38.24491982186872,-109.3852919
48960,13,37,13,14,12,0,89,38.24491982186872,-109.3850225
48961,13,38,13,14,12,0,90,38.24491982186872,-109.384753
48962,11,40,13,12,12,1,89,38.24491982186872,-109.3844835
48963,12,39,13,13,12,1,90,38.24491982186872,-109.384214
48964,12,39,13,13,13,1,91,38.24491982186872,-109.3839445
48965,13,39,13,13,12,1,91,38.24491982186872,-109.383675
48966,13,40,13,13,12,1,92,38.24491982186872,-109.3834055
48967,14,39,13,13,12,0,91,38.24491982186872,-109.383136
48968,16,37,12,12,12,0,89,38.24491982186872,-109.3828665
48969,16,37,12,12,12,0,89,38.24491982186872,-109.382597
48970,15,37,12,11,12,1,88,38.24491982186872,-109.3823275
48971,12,29,11,11,10,4,77,38.24491982186872,-109.382058
48972,10,26,10,15,11,1,73,38.24491982186872,-109.3817885
48973,11,32,10,10,11,2,76,38.24491982186872,-109.381519
48974,10,42,11,9,12,2,86,38.24491982186872,-109.3812495
48975,8,45,13,8,14,2,90,38.24491982186872,-109.38098
48976,7,46,13,10,12,3,91,38.24491982186872,-109.3807105
48977,7,44,13,10,12,3,89,38.24491982186872,-109.380441
48978,7,44,13,10,11,4,89,38.24491982186872,-109.3801716
48979,7,44,13,9,10,4,87,38.24491982186872,-109.3799021
48980,6,43,12,8,9,5,83,38.24491982186872,-109.3796326
48981,7,42,12,9,9,5,84,38.24491982186872,-109.3793631
48982,7,40,12,9,9,5,82,38.24491982186872,-109.3790936
48983,8,40,13,10,9,4,84,38.24491982186872,-109.3788241
48984,10,40,13,12,10,2,87,38.24491982186872,-109.3785546
48985,12,39,14,13,11,1,90,38.24491982186872,-109.3782851
48986,16,36,14,15,11,1,93,38.24491982186872,-109.3780156
48987,18,35,15,14,10,1,93,38.24491982186872,-109.3777461
48988,17,35,15,13,10,2,92,38.24491982186872,-109.3774766
48989,14,35,14,13,10,2,88,38.24491982186872,-109.3772071
48990,14,37,14,11,11,3,90,38.24491982186872,-109.3769376
48991,8,36,13,7,10,7,81,38.24491982186872,-109.3766681
48992,4,36,11,4,10,9,74,38.24491982186872,-109.3763986
48993,1,38,9,2,10,8,68,38.24491982186872,-109.3761291
48994,0,42,7,1,11,5,66,38.24491982186872,-109.3758596
48995,0,43,6,0,8,5,62,38.24491982186872,-109.3755901
48996,2,34,9,7,12,4,68,38.24491982186872,-109.3753206
48997,5,25,12,14,12,5,73,38.24491982186872,-109.3750512
48998,1,29,14,5,10,16,75,38.24491982186872,-109.3747817
48999,1,33,13,4,13,13,77,38.24491982186872,-109.3745122
49000,0,35,11,3,11,10,70,38.24491982186872,-109.3742427
49001,7,29,10,15,9,7,77,38.24491982186872,-109.3739732
49002,9,28,11,15,8,8,79,38.24491982186872,-109.3737037
49003,12,35,10,13,10,5,85,38.24491982186872,-109.3734342
49004,2,33,12,16,15,3,81,38.24491982186872,-109.3731647
49005,3,20,13,15,23,1,75,38.24491982186872,-109.3728952
49006,7,12,11,25,19,1,75,38.24491982186872,-109.3726257
49007,5,14,12,22,20,1,74,38.24491982186872,-109.3723562
49008,3,19,12,18,16,3,71,38.24491982186872,-109.3720867
49009,0,25,14,11,17,8,75,38.24491982186872,-109.3718172
49010,0,20,12,7,13,12,64,38.24491982186872,-109.3715477
49011,0,20,12,3,7,16,58,38.24491982186872,-109.3712782
49012,0,20,13,0,5,20,58,38.24491982186872,-109.3710087
49013,0,19,14,0,2,27,62,38.24491982186872,-109.3707392
49014,1,20,16,0,1,29,67,38.24491982186872,-109.3704697
49015,1,20,16,0,1,29,67,38.24491982186872,-109.3702003
49016,2,21,16,0,1,29,69,38.24491982186872,-109.3699308
49017,2,21,15,0,0,27,65,38.24491982186872,-109.3696613
49018,1,21,13,0,1,24,60,38.24491982186872,-109.3693918
49019,2,21,13,0,2,21,59,38.24491982186872,-109.3691223
49020,2,22,13,0,2,21,60,38.24491982186872,-109.3688528
49021,2,23,12,0,2,21,60,38.24491982186872,-109.3685833
49022,1,23,11,0,2,20,57,38.24491982186872,-109.3683138
49023,1,25,11,0,4,19,60,38.24491982186872,-109.3680443
49024,1,25,11,0,5,18,60,38.24491982186872,-109.3677748
49025,1,24,11,1,6,16,59,38.24491982186872,-109.3675053
49026,1,24,11,1,7,14,58,38.24491982186872,-109.3672358
49027,1,27,11,1,7,14,61,38.24491982186872,-109.3669663
49028,2,31,10,0,8,13,64,38.24491982186872,-109.3666968
49029,2,27,11,0,5,15,60,38.24491982186872,-109.3664273
49030,1,25,11,1,4,17,59,38.24491982186872,-109.3661578
49031,1,28,10,0,5,15,59,38.24491982186872,-109.3658883
49032,1,33,9,0,7,12,62,38.24491982186872,-109.3656188
49033,1,31,10,0,6,14,62,38.24491982186872,-109.3653493
49034,1,28,10,0,5,15,59,38.24491982186872,-109.3650799
49035,1,25,10,0,5,15,56,38.24491982186872,-109.3648104
49036,0,24,10,0,4,17,55,38.24491982186872,-109.3645409
49037,1,28,12,1,5,19,66,38.24491982186872,-109.3642714
49038,1,29,12,2,4,20,68,38.24491982186872,-109.3640019
49039,1,29,12,2,5,20,69,38.24491982186872,-109.3637324
49040,1,29,12,1,4,21,68,38.24491982186872,-109.3634629
49041,2,29,12,1,3,20,67,38.24491982186872,-109.3631934
49042,3,30,11,1,5,15,65,38.24491982186872,-109.3629239
49043,3,25,12,1,4,15,60,38.24491982186872,-109.3626544
49044,3,22,13,0,2,17,57,38.24491982186872,-109.3623849
49045,4,22,14,0,2,19,61,38.24491982186872,-109.3621154
49046,3,23,13,0,2,21,62,38.24491982186872,-109.3618459
49047,5,25,14,2,4,16,66,38.24491982186872,-109.3615764
49048,1,22,11,4,5,15,58,38.24491982186872,-109.3613069
49049,1,22,8,4,8,8,51,38.24491982186872,-109.3610374
49050,2,27,6,2,8,5,50,38.24491982186872,-109.3607679
49051,3,23,6,0,7,6,45,38.24491982186872,-109.3604984
49052,2,24,7,3,6,8,50,38.24491982186872,-109.360229
49053,2,31,7,4,9,7,60,38.24491982186872,-109.3599595
49054,2,48,7,4,10,5,76,38.24491982186872,-109.35969
49055,1,57,7,3,9,5,82,38.24491982186872,-109.3594205
49056,2,55,7,4,9,5,82,38.24491982186872,-109.359151
49057,2,45,8,5,8,5,73,38.24491982186872,-109.3588815
49058,2,37,7,3,7,6,62,38.24491982186872,-109.358612
49059,2,31,6,1,7,6,53,38.24491982186872,-109.3583425
49060,1,30,6,0,8,6,51,38.24491982186872,-109.358073
49061,2,30,10,4,9,8,63,38.24491982186872,-109.3578035
49062,2,30,10,3,7,15,67,38.24491982186872,-109.357534
49063,2,29,11,1,4,18,65,38.24491982186872,-109.3572645
49064,1,31,11,1,5,18,67,38.24491982186872,-109.356995
49065,1,37,10,0,9,14,71,38.24491982186872,-109.3567255
49066,1,35,10,0,8,12,66,38.24491982186872,-109.356456
49067,2,28,9,4,6,7,56,38.24491982186872,-109.3561865
49068,2,27,9,5,5,7,55,38.24491982186872,-109.355917
49069,2,29,9,4,7,7,58,38.24491982186872,-109.3556475
49070,3,26,11,5,7,8,60,38.24491982186872,-109.355378
49071,2,27,11,4,6,11,61,38.24491982186872,-109.3551086
49072,2,28,11,4,7,13,65,38.24491982186872,-109.3548391
49073,3,22,13,6,7,14,65,38.24491982186872,-109.3545696
49074,3,14,15,7,6,19,64,38.24491982186872,-109.3543001
49075,6,20,11,9,9,9,64,38.24491982186872,-109.3540306
49076,2,23,10,7,7,9,58,38.24491982186872,-109.3537611
49077,1,29,10,3,7,10,60,38.24491982186872,-109.3534916
49078,3,36,11,2,8,9,69,38.24491982186872,-109.3532221
49079,2,30,10,4,8,8,62,38.24491982186872,-109.3529526
49080,5,26,13,14,12,5,75,38.24491982186872,-109.3526831
49081,13,17,16,18,17,5,86,38.24491982186872,-109.3524136
49082,18,12,14,17,16,11,88,38.24491982186872,-109.3521441
49083,4,18,13,17,11,17,80,38.24491982186872,-109.3518746
49084,4,23,9,10,11,4,61,38.24491982186872,-109.3516051
49085,5,32,8,8,8,2,63,38.24491982186872,-109.3513356
49086,4,36,7,5,8,2,62,38.24491982186872,-109.3510661
49087,3,31,6,5,8,3,56,38.24491982186872,-109.3507966
49088,5,36,6,5,7,3,62,38.24491982186872,-109.3505271
49089,3,42,5,3,6,3,62,38.24491982186872,-109.3502577
49090,2,47,4,2,6,2,63,38.24491982186872,-109.3499882
49091,2,42,5,3,6,3,61,38.24491982186872,-109.3497187
49092,2,27,7,5,7,4,52,38.24491982186872,-109.3494492
49093,6,27,9,7,10,3,62,38.24491982186872,-109.3491797
49094,4,22,12,10,10,5,63,38.24491982186872,-109.3489102
49095,14,21,15,22,7,3,82,38.24491982186872,-109.3486407
49096,26,17,13,21,10,3,90,38.24491982186872,-109.3483712
49097,24,14,11,27,11,3,90,38.24491982186872,-109.3481017
49098,26,16,12,27,10,1,92,38.24491982186872,-109.3478322
49099,8,26,12,19,14,2,81,38.24491982186872,-109.3475627
49100,10,25,12,19,14,2,82,38.24491982186872,-109.3472932
49101,20,17,13,21,14,0,85,38.24491982186872,-109.3470237
49102,21,14,12,25,12,1,85,38.24491982186872,-109.3467542
49103,33,11,11,23,11,3,92,38.24491982186872,-109.3464847
49104,18,15,9,27,18,3,90,38.24491982186872,-109.3462152
49105,4,23,10,16,16,7,76,38.24491982186872,-109.3459457
49106,2,26,11,9,12,9,69,38.24491982186872,-109.3456762
49107,3,30,12,7,17,7,76,38.24491982186872,-109.3454068
49108,5,28,13,9,14,9,78,38.24491982186872,-109.3451373
49109,5,24,12,10,13,10,74,38.24491982186872,-109.3448678
49110,4,25,12,8,12,12,73,38.24491982186872,-109.3445983
49111,1,25,15,2,7,21,71,38.24491982186872,-109.3443288
49112,2,31,14,0,6,22,75,38.24491982186872,-109.3440593
49113,0,27,15,0,6,24,72,38.24491982186872,-109.3437898
49114,1,29,16,0,8,22,76,38.24491982186872,-109.3435203
49115,3,32,16,1,8,20,80,38.24491982186872,-109.3432508
49116,0,28,16,0,4,27,75,38.24491982186872,-109.3429813
49117,1,26,16,0,4,27,74,38.24491982186872,-109.3427118
49118,2,26,16,0,3,27,74,38.24491982186872,-109.3424423
49119,1,24,15,0,2,27,69,38.24491982186872,-109.3421728
49120,0,22,14,0,1,28,65,38.24491982186872,-109.3419033
49121,1,20,14,0,1,27,63,38.24491982186872,-109.3416338
49122,1,23,14,0,2,26,66,38.24491982186872,-109.3413643
49123,0,25,15,0,2,30,72,38.24491982186872,-109.3410948
49124,0,27,16,0,4,29,76,38.24491982186872,-109.3408253
49125,0,32,16,0,8,22,78,38.24491982186872,-109.3405558
49126,0,29,14,0,8,20,71,38.24491982186872,-109.3402864
49127,0,23,13,1,6,20,63,38.24491982186872,-109.3400169
49128,0,19,12,2,5,19,57,38.24491982186872,-109.3397474
49129,1,19,11,3,6,15,55,38.24491982186872,-109.3394779
49130,1,22,10,5,8,12,58,38.24491982186872,-109.3392084
49131,0,26,10,2,7,14,59,38.24491982186872,-109.3389389
49132,0,34,9,1,11,10,65,38.24491982186872,-109.3386694
49133,1,33,10,2,12,9,67,38.24491982186872,-109.3383999
49134,1,23,11,5,10,10,60,38.24491982186872,-109.3381304
49135,0,18,10,5,8,11,52,38.24491982186872,-109.3378609
49136,2,27,10,5,11,7,62,38.24491982186872,-109.3375914
49137,1,24,9,5,9,8,56,38.24491982186872,-109.3373219
49138,0,26,10,4,8,11,59,38.24491982186872,-109.3370524
49139,1,35,10,0,9,13,68,38.24491982186872,-109.3367829
49140,0,26,11,1,4,19,61,38.24491982186872,-109.3365134
49141,0,30,10,2,8,12,62,38.24491982186872,-109.3362439
49142,0,32,8,1,8,10,59,38.24491982186872,-109.3359744
49143,1,32,7,1,10,7,58,38.24491982186872,-109.3357049
49144,1,44,5,4,9,3,66,38.24491982186872,-109.3354355
49145,1,48,5,3,8,2,67,38.24491982186872,-109.335166
49146,2,46,5,3,7,3,66,38.24491982186872,-109.3348965
49147,4,37,6,1,7,3,58,38.24491982186872,-109.334627
49148,6,25,7,5,8,4,55,38.24491982186872,-109.3343575
49149,39,23,15,8,7,0,92,38.24491982186872,-109.334088
49150,14,28,15,8,13,6,84,38.24491982186872,-109.3338185
49151,1,21,14,6,9,20,71,38.24491982186872,-109.333549
49152,1,22,11,10,9,12,65,38.24491982186872,-109.3332795
49153,3,32,10,10,15,1,71,38.24491982186872,-109.33301
49154,10,31,11,8,10,1,71,38.24491982186872,-109.3327405
49155,4,32,9,10,9,3,67,38.24491982186872,-109.332471
49156,3,30,9,9,9,4,64,38.24491982186872,-109.3322015
49157,1,28,9,7,6,8,59,38.24491982186872,-109.331932
49158,2,44,7,4,7,4,68,38.24491982186872,-109.3316625
49159,4,39,6,4,7,2,62,38.24491982186872,-109.331393
49160,21,27,9,6,15,8,86,38.24465032728349,-109.4402688
49161,17,26,11,15,16,4,89,38.24465032728349,-109.4399993
49162,15,27,12,24,12,2,92,38.24465032728349,-109.4397299
49163,15,30,12,20,13,1,91,38.24465032728349,-109.4394604
49164,19,28,12,19,13,1,92,38.24465032728349,-109.4391909
49165,23,20,11,25,13,1,93,38.24465032728349,-109.4389214
49166,26,11,10,29,16,2,94,38.24465032728349,-109.4386519
49167,18,16,12,22,16,3,87,38.24465032728349,-109.4383824
49168,9,21,12,12,12,6,72,38.24465032728349,-109.4381129
49169,1,35,9,4,10,8,67,38.24465032728349,-109.4378434
49170,1,36,8,3,9,7,64,38.24465032728349,-109.4375739
49171,1,35,7,6,8,5,62,38.24465032728349,-109.4373044
49172,2,36,7,5,8,5,63,38.24465032728349,-109.4370349
49173,2,39,8,3,9,4,65,38.24465032728349,-109.4367654
49174,1,39,7,3,10,4,64,38.24465032728349,-109.4364959
49175,1,38,8,2,10,5,64,38.24465032728349,-109.4362264
49176,1,36,8,2,9,5,61,38.24465032728349,-109.4359569
49177,2,35,8,2,9,6,62,38.24465032728349,-109.4356874
49178,2,36,9,3,10,6,66,38.24465032728349,-109.4354179
49179,2,37,9,3,11,5,67,38.24465032728349,-109.4351484
49180,1,41,10,2,11,7,72,38.24465032728349,-109.434879
49181,2,42,10,2,14,6,76,38.24465032728349,-109.4346095
49182,2,45,11,3,15,5,81,38.24465032728349,-109.43434
49183,2,46,11,4,16,4,83,38.24465032728349,-109.4340705
49184,3,46,11,8,16,2,86,38.24465032728349,-109.433801
49185,4,43,12,9,14,2,84,38.24465032728349,-109.4335315
49186,4,39,11,6,14,5,79,38.24465032728349,-109.433262
49187,4,39,11,5,14,5,78,38.24465032728349,-109.4329925
49188,4,41,10,6,13,4,78,38.24465032728349,-109.432723
49189,4,43,11,7,14,3,82,38.24465032728349,-109.4324535
49190,6,41,12,10,15,2,86,38.24465032728349,-109.432184
49191,10,39,13,13,13,1,89,38.24465032728349,-109.4319145
49192,9,40,14,14,13,1,91,38.24465032728349,-109.431645
49193,7,42,13,12,14,1,89,38.24465032728349,-109.4313755
49194,8,39,13,12,13,2,87,38.24465032728349,-109.431106
49195,5,40,12,9,14,2,82,38.24465032728349,-109.4308365
49196,5,41,11,8,13,3,81,38.24465032728349,-109.430567
49197,6,42,11,8,12,2,81,38.24465032728349,-109.4302975
49198,6,42,12,10,14,2,86,38.24465032728349,-109.430028
49199,9,39,13,15,14,1,91,38.24465032728349,-109.4297586
49200,10,40,13,11,15,1,90,38.24465032728349,-109.4294891
49201,7,42,11,6,14,5,85,38.24465032728349,-109.4292196
49202,4,42,10,2,13,8,79,38.24465032728349,-109.4289501
49203,2,41,10,0,12,11,76,38.24465032728349,-109.4286806
49204,2,40,10,0,13,10,75,38.24465032728349,-109.4284111
49205,3,39,11,3,14,6,76,38.24465032728349,-109.4281416
49206,6,39,12,5,15,4,81,38.24465032728349,-109.4278721
49207,8,40,12,9,15,2,86,38.24465032728349,-109.4276026
49208,6,42,12,9,16,1,86,38.24465032728349,-109.4273331
49209,5,42,12,10,16,1,86,38.24465032728349,-109.4270636
49210,6,42,12,10,16,1,87,38.24465032728349,-109.4267941
49211,6,42,12,11,15,1,87,38.24465032728349,-109.4265246
49212,6,42,12,13,13,1,87,38.24465032728349,-109.4262551
49213,10,41,13,13,14,0,91,38.24465032728349,-109.4259856
49214,12,38,13,13,14,0,90,38.24465032728349,-109.4257161
49215,10,38,14,14,14,0,90,38.24465032728349,-109.4254466
49216,7,39,14,15,13,1,89,38.24465032728349,-109.4251771
49217,7,39,14,16,13,1,90,38.24465032728349,-109.4249077
49218,8,39,13,14,14,1,89,38.24465032728349,-109.4246382
49219,10,39,14,14,14,1,92,38.24465032728349,-109.4243687
49220,11,38,14,15,14,0,92,38.24465032728349,-109.4240992
49221,9,38,14,15,14,1,91,38.24465032728349,-109.4238297
49222,7,39,13,15,13,1,88,38.24465032728349,-109.4235602
49223,7,41,14,13,14,1,90,38.24465032728349,-109.4232907
49224,8,41,14,13,14,1,91,38.24465032728349,-109.4230212
49225,7,41,14,13,14,1,90,38.24465032728349,-109.4227517
49226,7,41,14,14,13,1,90,38.24465032728349,-109.4224822
49227,8,41,15,14,14,1,93,38.24465032728349,-109.4222127
49228,7,42,13,12,14,1,89,38.24465032728349,-109.4219432
49229,6,44,11,10,14,1,86,38.24465032728349,-109.4216737
49230,6,44,11,9,14,1,85,38.24465032728349,-109.4214042
49231,9,40,12,12,16,0,89,38.24465032728349,-109.4211347
49232,8,42,13,11,15,0,89,38.24465032728349,-109.4208652
49233,4,46,11,7,15,1,84,38.24465032728349,-109.4205957
49234,1,50,9,2,14,3,79,38.24465032728349,-109.4203262
49235,0,49,8,1,12,4,74,38.24465032728349,-109.4200568
49236,2,42,8,3,8,3,66,38.24465032728349,-109.4197873
49237,2,38,8,2,8,6,64,38.24465032728349,-109.4195178
49238,2,35,8,3,8,5,61,38.24465032728349,-109.4192483
49239,2,37,7,3,8,4,61,38.24465032728349,-109.4189788
49240,4,42,7,3,7,3,66,38.24465032728349,-109.4187093
49241,3,37,7,4,8,3,62,38.24465032728349,-109.4184398
49242,3,40,7,3,8,3,64,38.24465032728349,-109.4181703
49243,3,39,8,3,10,4,67,38.24465032728349,-109.4179008
49244,2,37,8,3,11,5,66,38.24465032728349,-109.4176313
49245,1,39,7,2,9,6,64,38.24465032728349,-109.4173618
49246,6,38,11,10,11,2,78,38.24465032728349,-109.4170923
49247,15,35,14,13,13,2,92,38.24465032728349,-109.4168228
49248,24,27,13,14,12,2,92,38.24465032728349,-109.4165533
49249,26,23,12,18,11,2,92,38.24465032728349,-109.4162838
49250,23,25,13,16,13,2,92,38.24465032728349,-109.4160143
49251,17,34,12,14,13,1,91,38.24465032728349,-109.4157448
49252,7,39,11,13,14,3,87,38.24465032728349,-109.4154753
49253,3,37,10,7,12,7,76,38.24465032728349,-109.4152058
49254,1,34,11,1,12,12,71,38.24465032728349,-109.4149364
49255,1,32,10,3,11,10,67,38.24465032728349,-109.4146669
49256,1,29,10,1,9,13,63,38.24465032728349,-109.4143974
49257,1,29,10,1,10,11,62,38.24465032728349,-109.4141279
49258,1,30,10,1,12,9,63,38.24465032728349,-109.4138584
49259,1,33,10,2,13,6,65,38.24465032728349,-109.4135889
49260,1,40,9,0,14,7,71,38.24465032728349,-109.4133194
49261,3,47,10,3,16,4,83,38.24465032728349,-109.4130499
49262,5,49,11,6,16,2,89,38.24465032728349,-109.4127804
49263,9,47,11,9,15,1,92,38.24465032728349,-109.4125109
49264,8,46,12,7,15,2,90,38.24465032728349,-109.4122414
49265,7,46,12,8,16,0,89,38.24465032728349,-109.4119719
49266,8,43,13,11,16,0,91,38.24465032728349,-109.4117024
49267,9,42,14,12,15,0,92,38.24465032728349,-109.4114329
49268,10,42,14,12,14,0,92,38.24465032728349,-109.4111634
49269,13,39,14,13,13,0,92,38.24465032728349,-109.4108939
49270,16,37,13,13,13,0,92,38.24465032728349,-109.4106244
49271,16,37,14,13,13,0,93,38.24465032728349,-109.4103549
49272,13,40,13,12,13,0,91,38.24465032728349,-109.4100855
49273,9,43,13,11,14,0,90,38.24465032728349,-109.409816
49274,11,41,13,10,14,0,89,38.24465032728349,-109.4095465
49275,17,33,14,13,12,0,89,38.24465032728349,-109.409277
49276,20,32,15,13,12,0,92,38.24465032728349,-109.4090075
49277,20,34,14,12,11,0,91,38.24465032728349,-109.408738
49278,17,35,14,12,12,0,90,38.24465032728349,-109.4084685
49279,14,36,13,12,14,0,89,38.24465032728349,-109.408199
49280,9,41,11,9,14,1,85,38.24465032728349,-109.4079295
49281,6,44,10,9,13,2,84,38.24465032728349,-109.40766
49282,3,49,9,7,12,2,82,38.24465032728349,-109.4073905
49283,2,58,7,6,10,0,83,38.24465032728349,-109.407121
49284,3,66,7,8,7,0,91,38.24465032728349,-109.4068515
49285,2,64,6,10,5,0,87,38.24465032728349,-109.406582
49286,2,57,7,12,5,0,83,38.24465032728349,-109.4063125
49287,5,50,9,11,10,1,86,38.24465032728349,-109.406043
49288,9,36,12,12,15,1,85,38.24465032728349,-109.4057735
49289,12,32,12,12,14,1,83,38.24465032728349,-109.405504
49290,15,33,13,11,14,1,87,38.24465032728349,-109.4052345
49291,16,33,13,11,14,0,87,38.24465032728349,-109.4049651
49292,18,31,13,12,14,0,88,38.24465032728349,-109.4046956
49293,16,32,14,12,14,0,88,38.24465032728349,-109.4044261
49294,15,31,14,13,14,1,88,38.24465032728349,-109.4041566
49295,12,31,13,12,15,1,84,38.24465032728349,-109.4038871
49296,9,33,13,12,15,2,84,38.24465032728349,-109.4036176
49297,8,33,13,11,15,2,82,38.24465032728349,-109.4033481
49298,9,32,12,11,15,2,81,38.24465032728349,-109.4030786
49299,9,32,13,11,15,2,82,38.24465032728349,-109.4028091
49300,9,34,13,11,15,2,84,38.24465032728349,-109.4025396
49301,8,37,14,11,15,1,86,38.24465032728349,-109.4022701
49302,9,39,13,10,15,1,87,38.24465032728349,-109.4020006
49303,8,39,13,11,15,1,87,38.24465032728349,-109.4017311
49304,7,41,13,11,15,1,88,38.24465032728349,-109.4014616
49305,6,43,13,10,14,2,88,38.24465032728349,-109.4011921
49306,7,43,14,12,14,1,91,38.24465032728349,-109.4009226
49307,8,42,14,13,14,1,92,38.24465032728349,-109.4006531
49308,7,40,14,13,14,1,89,38.24465032728349,-109.4003836
49309,6,41,13,12,14,2,88,38.24465032728349,-109.4001142
49310,6,43,13,10,13,2,87,38.24465032728349,-109.3998447
49311,7,46,13,9,14,2,91,38.24465032728349,-109.3995752
49312,7,40,13,13,14,1,88,38.24465032728349,-109.3993057
49313,7,42,13,12,14,1,89,38.24465032728349,-109.3990362
49314,5,44,14,10,15,2,90,38.24465032728349,-109.3987667
49315,5,46,14,8,15,2,90,38.24465032728349,-109.3984972
49316,5,45,14,11,14,1,90,38.24465032728349,-109.3982277
49317,5,43,14,11,14,2,89,38.24465032728349,-109.3979582
49318,5,40,14,10,13,3,85,38.24465032728349,-109.3976887
49319,5,39,14,9,14,3,84,38.24465032728349,-109.3974192
49320,5,40,14,10,15,3,87,38.24465032728349,-109.3971497
49321,5,41,14,11,15,2,88,38.24465032728349,-109.3968802
49322,5,42,14,11,16,2,90,38.24465032728349,-109.3966107
49323,5,41,14,10,16,2,88,38.24465032728349,-109.3963412
49324,7,39,15,11,16,1,89,38.24465032728349,-109.3960717
49325,11,38,15,13,16,0,93,38.24465032728349,-109.3958022
49326,13,36,14,14,14,0,91,38.24465032728349,-109.3955327
49327,15,34,14,13,14,0,90,38.24465032728349,-109.3952632
49328,15,34,14,13,14,0,90,38.24465032728349,-109.3949938
49329,16,34,14,13,14,0,91,38.24465032728349,-109.3947243
49330,13,36,14,13,15,0,91,38.24465032728349,-109.3944548
49331,10,38,14,13,15,0,90,38.24465032728349,-109.3941853
49332,9,39,14,13,16,0,91,38.24465032728349,-109.3939158
49333,8,40,14,13,16,0,91,38.24465032728349,-109.3936463
49334,7,39,14,12,16,1,89,38.24465032728349,-109.3933768
49335,6,41,14,12,16,1,90,38.24465032728349,-109.3931073
49336,5,41,14,11,16,1,88,38.24465032728349,-109.3928378
49337,5,42,14,10,16,1,88,38.24465032728349,-109.3925683
49338,5,43,14,9,17,1,89,38.24465032728349,-109.3922988
49339,5,43,14,10,17,1,90,38.24465032728349,-109.3920293
49340,5,43,14,11,17,1,91,38.24465032728349,-109.3917598
49341,5,43,14,11,17,1,91,38.24465032728349,-109.3914903
49342,5,42,14,11,17,1,90,38.24465032728349,-109.3912208
49343,6,43,14,11,17,0,91,38.24465032728349,-109.3909513
49344,7,43,14,11,17,0,92,38.24465032728349,-109.3906818
49345,7,43,14,11,17,0,92,38.24465032728349,-109.3904123
49346,6,43,14,11,17,0,91,38.24465032728349,-109.3901429
49347,6,45,14,10,17,0,92,38.24465032728349,-109.3898734
49348,7,45,15,11,17,0,95,38.24465032728349,-109.3896039
49349,6,41,14,14,16,0,91,38.24465032728349,-109.3893344
49350,6,38,13,14,15,1,87,38.24465032728349,-109.3890649
49351,6,41,13,13,15,1,89,38.24465032728349,-109.3887954
49352,6,44,15,12,15,0,92,38.24465032728349,-109.3885259
49353,7,45,14,11,15,0,92,38.24465032728349,-109.3882564
49354,8,42,14,12,15,0,91,38.24465032728349,-109.3879869
49355,10,38,13,13,15,0,89,38.24465032728349,-109.3877174
49356,14,36,13,12,15,0,90,38.24465032728349,-109.3874479
49357,17,34,13,12,14,0,90,38.24465032728349,-109.3871784
49358,17,33,13,13,14,0,90,38.24465032728349,-109.3869089
49359,14,34,13,14,14,0,89,38.24465032728349,-109.3866394
49360,15,34,13,14,13,0,89,38.24465032728349,-109.3863699
49361,18,34,12,14,12,0,90,38.24465032728349,-109.3861004
49362,20,33,12,13,12,0,90,38.24465032728349,-109.3858309
49363,18,33,13,15,12,0,91,38.24465032728349,-109.3855614
49364,14,35,13,15,12,1,90,38.24465032728349,-109.3852919
49365,13,36,13,15,12,0,89,38.24465032728349,-109.3850225
49366,14,37,13,15,12,0,91,38.24465032728349,-109.384753
49367,13,37,13,15,12,0,90,38.24465032728349,-109.3844835
49368,14,37,13,15,12,0,91,38.24465032728349,-109.384214
49369,13,37,13,14,12,1,90,38.24465032728349,-109.3839445
49370,13,38,13,13,13,1,91,38.24465032728349,-109.383675
49371,14,38,13,12,12,1,90,38.24465032728349,-109.3834055
49372,15,36,13,12,13,1,90,38.24465032728349,-109.383136
49373,17,36,12,10,12,1,88,38.24465032728349,-109.3828665
49374,16,37,12,10,12,1,88,38.24465032728349,-109.382597
49375,16,36,12,10,12,1,87,38.24465032728349,-109.3823275
49376,17,31,11,10,11,2,82,38.24465032728349,-109.382058
49377,14,21,11,14,10,2,72,38.24465032728349,-109.3817885
49378,16,29,11,9,9,4,78,38.24465032728349,-109.381519
49379,12,39,11,7,10,4,83,38.24465032728349,-109.3812495
49380,8,46,12,6,13,3,88,38.24465032728349,-109.38098
49381,7,48,13,9,13,2,92,38.24465032728349,-109.3807105
49382,8,46,13,11,11,2,91,38.24465032728349,-109.380441
49383,8,46,13,9,12,2,90,38.24465032728349,-109.3801716
49384,6,48,13,7,12,4,90,38.24465032728349,-109.3799021
49385,4,45,12,5,11,7,84,38.24465032728349,-109.3796326
49386,5,43,13,8,11,4,84,38.24465032728349,-109.3793631
49387,7,40,13,10,10,4,84,38.24465032728349,-109.3790936
49388,9,39,13,11,10,3,85,38.24465032728349,-109.3788241
49389,11,39,13,12,11,2,88,38.24465032728349,-109.3785546
49390,11,40,14,13,12,1,91,38.24465032728349,-109.3782851
49391,12,39,14,13,13,1,92,38.24465032728349,-109.3780156
49392,11,39,14,12,12,2,90,38.24465032728349,-109.3777461
49393,8,40,13,10,11,4,86,38.24465032728349,-109.3774766
49394,6,41,12,7,10,6,82,38.24465032728349,-109.3772071
49395,4,46,11,5,11,6,83,38.24465032728349,-109.3769376
49396,4,43,11,3,12,7,80,38.24465032728349,-109.3766681
49397,2,41,9,2,11,7,72,38.24465032728349,-109.3763986
49398,1,41,8,1,11,6,68,38.24465032728349,-109.3761291
49399,0,43,7,1,11,4,66,38.24465032728349,-109.3758596
49400,1,40,7,2,10,5,65,38.24465032728349,-109.3755901
49401,2,31,12,9,11,8,73,38.24465032728349,-109.3753206
49402,1,25,13,9,9,13,70,38.24465032728349,-109.3750512
49403,1,29,14,2,11,18,75,38.24465032728349,-109.3747817
49404,1,31,12,0,10,17,71,38.24465032728349,-109.3745122
49405,0,34,10,0,12,12,68,38.24465032728349,-109.3742427
49406,10,25,11,16,9,6,77,38.24465032728349,-109.3739732
49407,10,30,11,15,9,6,81,38.24465032728349,-109.3737037
49408,2,32,13,11,20,2,80,38.24465032728349,-109.3734342
49409,4,25,12,21,19,3,84,38.24465032728349,-109.3731647
49410,2,17,11,27,18,3,78,38.24465032728349,-109.3728952
49411,2,22,11,22,14,3,74,38.24465032728349,-109.3726257
49412,0,26,13,6,16,8,69,38.24465032728349,-109.3723562
49413,0,19,11,5,9,12,56,38.24465032728349,-109.3720867
49414,1,22,11,9,9,8,60,38.24465032728349,-109.3718172
49415,4,16,9,5,10,8,52,38.24465032728349,-109.3715477
49416,4,14,8,5,8,8,47,38.24465032728349,-109.3712782
49417,5,13,10,4,6,10,48,38.24465032728349,-109.3710087
49418,2,15,12,3,5,17,54,38.24465032728349,-109.3707392
49419,1,17,14,0,1,25,58,38.24465032728349,-109.3704697
49420,3,20,15,0,1,26,65,38.24465032728349,-109.3702003
49421,3,21,15,0,1,25,65,38.24465032728349,-109.3699308
49422,2,22,14,0,1,24,63,38.24465032728349,-109.3696613
49423,2,24,12,0,3,19,60,38.24465032728349,-109.3693918
49424,2,24,12,0,4,18,60,38.24465032728349,-109.3691223
49425,2,24,12,0,4,18,60,38.24465032728349,-109.3688528
49426,2,23,12,0,3,19,59,38.24465032728349,-109.3685833
49427,2,23,12,0,2,21,60,38.24465032728349,-109.3683138
49428,1,21,13,0,1,24,60,38.24465032728349,-109.3680443
49429,1,23,12,0,3,20,59,38.24465032728349,-109.3677748
49430,1,24,11,0,4,19,59,38.24465032728349,-109.3675053
49431,1,24,11,0,4,18,58,38.24465032728349,-109.3672358
49432,1,26,12,0,4,19,62,38.24465032728349,-109.3669663
49433,1,25,12,1,5,19,63,38.24465032728349,-109.3666968
49434,1,24,12,1,4,18,60,38.24465032728349,-109.3664273
49435,1,25,11,0,4,18,59,38.24465032728349,-109.3661578
49436,1,26,11,0,4,17,59,38.24465032728349,-109.3658883
49437,1,30,10,0,5,15,61,38.24465032728349,-109.3656188
49438,0,25,10,0,3,18,56,38.24465032728349,-109.3653493
49439,1,24,10,0,4,17,56,38.24465032728349,-109.3650799
49440,1,25,10,0,5,15,56,38.24465032728349,-109.3648104
49441,1,24,11,1,5,16,58,38.24465032728349,-109.3645409
49442,1,27,11,1,4,20,64,38.24465032728349,-109.3642714
49443,2,31,12,2,6,18,71,38.24465032728349,-109.3640019
49444,2,33,11,2,7,17,72,38.24465032728349,-109.3637324
49445,2,33,11,1,6,16,69,38.24465032728349,-109.3634629
49446,2,30,11,1,4,18,66,38.24465032728349,-109.3631934
49447,2,26,12,1,3,19,63,38.24465032728349,-109.3629239
49448,2,24,13,0,4,18,61,38.24465032728349,-109.3626544
49449,2,21,13,0,3,19,58,38.24465032728349,-109.3623849
49450,2,18,12,0,2,20,54,38.24465032728349,-109.3621154
49451,2,19,13,2,3,19,58,38.24465032728349,-109.3618459
49452,2,20,12,1,2,18,55,38.24465032728349,-109.3615764
49453,2,24,9,4,6,10,55,38.24465032728349,-109.3613069
49454,2,22,8,2,8,7,49,38.24465032728349,-109.3610374
49455,4,25,6,3,7,5,50,38.24465032728349,-109.3607679
49456,2,22,7,3,6,9,49,38.24465032728349,-109.3604984
49457,3,24,8,4,7,9,55,38.24465032728349,-109.360229
49458,3,31,11,3,7,10,65,38.24465032728349,-109.3599595
49459,1,30,8,3,7,9,58,38.24465032728349,-109.35969
49460,1,34,7,2,8,7,59,38.24465032728349,-109.3594205
49461,2,50,7,4,10,5,78,38.24465032728349,-109.359151
49462,1,50,7,4,10,5,77,38.24465032728349,-109.3588815
49463,1,46,7,4,9,5,72,38.24465032728349,-109.358612
49464,2,43,7,3,8,5,68,38.24465032728349,-109.3583425
49465,1,41,6,0,9,5,62,38.24465032728349,-109.358073
49466,3,38,10,3,10,6,70,38.24465032728349,-109.3578035
49467,1,30,10,2,7,15,65,38.24465032728349,-109.357534
49468,1,30,11,2,5,16,65,38.24465032728349,-109.3572645
49469,2,35,11,1,6,14,69,38.24465032728349,-109.356995
49470,1,37,10,0,7,14,69,38.24465032728349,-109.3567255
49471,0,37,10,0,9,12,68,38.24465032728349,-109.356456
49472,1,31,9,3,7,7,58,38.24465032728349,-109.3561865
49473,2,31,8,4,6,5,56,38.24465032728349,-109.355917
49474,1,31,7,5,7,4,55,38.24465032728349,-109.3556475
49475,4,27,11,7,8,5,62,38.24465032728349,-109.355378
49476,2,20,12,7,7,13,61,38.24465032728349,-109.3551086
49477,2,23,12,6,6,15,64,38.24465032728349,-109.3548391
49478,4,28,12,7,9,12,72,38.24465032728349,-109.3545696
49479,6,18,14,12,9,14,73,38.24465032728349,-109.3543001
49480,3,16,13,8,8,15,63,38.24465032728349,-109.3540306
49481,1,20,10,6,6,11,54,38.24465032728349,-109.3537611
49482,1,27,10,3,6,11,58,38.24465032728349,-109.3534916
49483,2,36,11,2,8,10,69,38.24465032728349,-109.3532221
49484,2,34,10,4,7,8,65,38.24465032728349,-109.3529526
49485,4,22,13,9,6,12,66,38.24465032728349,-109.3526831
49486,13,18,17,12,12,11,83,38.24465032728349,-109.3524136
49487,19,14,15,10,13,14,85,38.24465032728349,-109.3521441
49488,5,19,12,14,14,18,82,38.24465032728349,-109.3518746
49489,1,22,10,9,12,6,60,38.24465032728349,-109.3516051
49490,4,30,8,9,7,3,61,38.24465032728349,-109.3513356
49491,3,37,8,5,7,4,64,38.24465032728349,-109.3510661
49492,2,32,8,3,7,6,58,38.24465032728349,-109.3507966
49493,2,28,8,4,7,6,55,38.24465032728349,-109.3505271
49494,1,28,6,4,8,4,51,38.24465032728349,-109.3502577
49495,1,27,6,3,8,4,49,38.24465032728349,-109.3499882
49496,1,24,7,4,9,4,49,38.24465032728349,-109.3497187
49497,2,24,8,6,10,5,55,38.24465032728349,-109.3494492
49498,6,25,8,8,12,3,62,38.24465032728349,-109.3491797
49499,10,24,11,14,12,2,73,38.24465032728349,-109.3489102
49500,18,22,14,24,8,2,88,38.24465032728349,-109.3486407
49501,28,18,13,18,11,3,91,38.24465032728349,-109.3483712
49502,27,15,12,23,10,2,89,38.24465032728349,-109.3481017
49503,25,14,12,24,9,2,86,38.24465032728349,-109.3478322
49504,28,14,11,23,10,2,88,38.24465032728349,-109.3475627
49505,31,13,11,22,12,2,91,38.24465032728349,-109.3472932
49506,31,12,11,24,12,1,91,38.24465032728349,-109.3470237
49507,27,11,10,27,15,2,92,38.24465032728349,-109.3467542
49508,15,14,10,31,19,3,92,38.24465032728349,-109.3464847
49509,6,21,10,26,16,5,84,38.24465032728349,-109.3462152
49510,3,28,10,15,19,4,79,38.24465032728349,-109.3459457
49511,2,26,10,9,14,7,68,38.24465032728349,-109.3456762
49512,2,29,11,5,13,8,68,38.24465032728349,-109.3454068
49513,2,27,11,4,11,12,67,38.24465032728349,-109.3451373
49514,2,22,11,5,10,12,62,38.24465032728349,-109.3448678
49515,2,22,11,5,9,14,63,38.24465032728349,-109.3445983
49516,2,25,12,1,5,18,63,38.24465032728349,-109.3443288
49517,3,30,12,0,6,16,67,38.24465032728349,-109.3440593
49518,2,28,12,0,3,19,64,38.24465032728349,-109.3437898
49519,1,27,13,0,3,21,65,38.24465032728349,-109.3435203
49520,2,27,13,0,3,23,68,38.24465032728349,-109.3432508
49521,1,26,14,0,3,24,68,38.24465032728349,-109.3429813
49522,1,25,15,0,3,26,70,38.24465032728349,-109.3427118
49523,1,24,17,0,3,29,74,38.24465032728349,-109.3424423
49524,2,25,16,1,3,28,75,38.24465032728349,-109.3421728
49525,3,31,15,2,4,22,77,38.24465032728349,-109.3419033
49526,1,30,12,0,5,20,68,38.24465032728349,-109.3416338
49527,2,27,14,0,6,24,73,38.24465032728349,-109.3413643
49528,0,30,15,1,8,22,76,38.24465032728349,-109.3410948
49529,0,27,15,2,8,21,73,38.24465032728349,-109.3408253
49530,3,31,19,5,8,20,86,38.24465032728349,-109.3405558
49531,1,29,18,0,8,24,80,38.24465032728349,-109.3402864
49532,1,28,17,0,7,22,75,38.24465032728349,-109.3400169
49533,1,29,16,0,7,22,75,38.24465032728349,-109.3397474
49534,0,28,15,0,7,22,72,38.24465032728349,-109.3394779
49535,0,27,12,0,6,21,66,38.24465032728349,-109.3392084
49536,0,31,11,0,8,18,68,38.24465032728349,-109.3389389
49537,1,30,11,0,8,16,66,38.24465032728349,-109.3386694
49538,0,28,12,0,7,18,65,38.24465032728349,-109.3383999
49539,0,26,11,0,5,19,61,38.24465032728349,-109.3381304
49540,0,22,11,1,4,17,55,38.24465032728349,-109.3378609
49541,2,26,10,2,6,13,59,38.24465032728349,-109.3375914
49542,2,26,10,3,8,10,59,38.24465032728349,-109.3373219
49543,1,24,10,5,9,11,60,38.24465032728349,-109.3370524
49544,1,32,10,2,10,12,67,38.24465032728349,-109.3367829
49545,0,40,9,0,10,12,71,38.24465032728349,-109.3365134
49546,0,32,8,1,10,9,60,38.24465032728349,-109.3362439
49547,1,43,5,2,9,4,64,38.24465032728349,-109.3359744
49548,1,48,5,3,9,3,69,38.24465032728349,-109.3357049
49549,1,50,5,2,8,2,68,38.24465032728349,-109.3354355
49550,1,36,5,3,7,4,56,38.24465032728349,-109.335166
49551,3,22,6,4,7,5,47,38.24465032728349,-109.3348965
49552,5,19,7,7,8,6,52,38.24465032728349,-109.334627
49553,7,17,11,8,7,8,58,38.24465032728349,-109.3343575
49554,15,29,14,9,15,3,85,38.24465032728349,-109.334088
49555,2,25,11,9,12,12,71,38.24465032728349,-109.3338185
49556,2,23,11,8,13,9,66,38.24465032728349,-109.333549
49557,2,23,9,11,13,4,62,38.24465032728349,-109.3332795
49558,4,32,9,8,10,2,65,38.24465032728349,-109.33301
49559,9,38,12,12,9,1,81,38.24465032728349,-109.3327405
49560,3,34,10,8,10,4,69,38.24465032728349,-109.332471
49561,1,36,8,8,7,4,64,38.24465032728349,-109.3322015
49562,1,40,8,6,6,5,66,38.24465032728349,-109.331932
49563,2,36,7,5,7,5,62,38.24465032728349,-109.3316625
49564,18,24,10,14,20,3,89,38.244380832698255,-109.4402688
49565,9,30,10,20,14,3,86,38.244380832698255,-109.4399993
49566,14,29,11,23,14,1,92,38.244380832698255,-109.4397299
49567,14,31,11,18,15,1,90,38.244380832698255,-109.4394604
49568,20,30,11,18,14,0,93,38.244380832698255,-109.4391909
49569,29,18,11,24,12,0,94,38.244380832698255,-109.4389214
49570,26,9,10,24,17,7,93,38.244380832698255,-109.4386519
49571,19,11,11,27,21,4,93,38.244380832698255,-109.4383824
49572,11,17,11,21,16,4,80,38.244380832698255,-109.4381129
49573,5,25,10,10,12,5,67,38.244380832698255,-109.4378434
49574,1,35,8,3,9,8,64,38.244380832698255,-109.4375739
49575,1,35,9,2,8,10,65,38.244380832698255,-109.4373044
49576,1,32,9,2,8,11,63,38.244380832698255,-109.4370349
49577,2,33,9,4,9,7,64,38.244380832698255,-109.4367654
49578,2,36,8,4,9,4,63,38.244380832698255,-109.4364959
49579,1,36,8,1,8,5,59,38.244380832698255,-109.4362264
49580,2,37,9,2,9,6,65,38.244380832698255,-109.4359569
49581,2,39,10,5,10,7,73,38.244380832698255,-109.4356874
49582,2,38,12,4,14,8,78,38.244380832698255,-109.4354179
49583,2,35,11,2,13,11,74,38.244380832698255,-109.4351484
49584,2,36,11,1,10,14,74,38.244380832698255,-109.434879
49585,3,41,12,4,14,7,81,38.244380832698255,-109.4346095
49586,4,44,12,5,17,3,85,38.244380832698255,-109.43434
49587,5,44,12,8,16,2,87,38.244380832698255,-109.4340705
49588,6,42,12,12,14,1,87,38.244380832698255,-109.433801
49589,7,39,13,16,13,1,89,38.244380832698255,-109.4335315
49590,6,39,12,11,14,2,84,38.244380832698255,-109.433262
49591,5,39,11,10,14,2,81,38.244380832698255,-109.4329925
49592,5,40,11,11,13,2,82,38.244380832698255,-109.432723
49593,5,43,12,11,14,1,86,38.244380832698255,-109.4324535
49594,7,40,13,13,13,1,87,38.244380832698255,-109.432184
49595,7,40,13,14,13,1,88,38.244380832698255,-109.4319145
49596,6,42,12,11,14,1,86,38.244380832698255,-109.431645
49597,5,44,12,10,15,1,87,38.244380832698255,-109.4313755
49598,7,39,13,13,13,1,86,38.244380832698255,-109.431106
49599,4,40,11,7,14,3,79,38.244380832698255,-109.4308365
49600,5,43,10,6,14,3,81,38.244380832698255,-109.430567
49601,6,44,10,6,13,3,82,38.244380832698255,-109.4302975
49602,5,45,10,5,13,4,82,38.244380832698255,-109.430028
49603,6,45,12,7,16,2,88,38.244380832698255,-109.4297586
49604,6,44,11,5,15,3,84,38.244380832698255,-109.4294891
49605,5,42,11,4,14,6,82,38.244380832698255,-109.4292196
49606,4,39,12,4,14,8,81,38.244380832698255,-109.4289501
49607,3,38,11,2,11,11,76,38.244380832698255,-109.4286806
49608,3,37,11,2,13,9,75,38.244380832698255,-109.4284111
49609,4,38,11,4,14,7,78,38.244380832698255,-109.4281416
49610,5,39,11,6,15,4,80,38.244380832698255,-109.4278721
49611,6,41,12,9,16,2,86,38.244380832698255,-109.4276026
49612,6,42,12,11,15,1,87,38.244380832698255,-109.4273331
49613,6,42,13,12,15,1,89,38.244380832698255,-109.4270636
49614,6,42,13,13,14,1,89,38.244380832698255,-109.4267941
49615,6,42,13,14,14,1,90,38.244380832698255,-109.4265246
49616,6,42,13,15,14,1,91,38.244380832698255,-109.4262551
49617,10,39,13,15,14,0,91,38.244380832698255,-109.4259856
49618,11,37,14,15,14,0,91,38.244380832698255,-109.4257161
49619,11,38,14,15,14,0,92,38.244380832698255,-109.4254466
49620,9,39,14,15,13,1,91,38.244380832698255,-109.4251771
49621,8,38,14,15,13,1,89,38.244380832698255,-109.4249077
49622,8,38,14,14,13,1,88,38.244380832698255,-109.4246382
49623,7,38,13,14,12,2,86,38.244380832698255,-109.4243687
49624,7,39,13,14,12,2,87,38.244380832698255,-109.4240992
49625,7,40,13,14,12,1,87,38.244380832698255,-109.4238297
49626,7,42,13,13,13,1,89,38.244380832698255,-109.4235602
49627,10,41,14,13,14,1,93,38.244380832698255,-109.4232907
49628,9,42,14,12,14,1,92,38.244380832698255,-109.4230212
49629,7,42,13,10,14,1,87,38.244380832698255,-109.4227517
49630,6,41,13,11,14,2,87,38.244380832698255,-109.4224822
49631,5,45,13,10,13,2,88,38.244380832698255,-109.4222127
49632,4,49,12,9,12,2,88,38.244380832698255,-109.4219432
49633,4,49,10,8,13,1,85,38.244380832698255,-109.4216737
49634,6,46,11,9,14,1,87,38.244380832698255,-109.4214042
49635,10,42,13,12,14,0,91,38.244380832698255,-109.4211347
49636,7,45,12,11,14,0,89,38.244380832698255,-109.4208652
49637,4,49,10,7,14,1,85,38.244380832698255,-109.4205957
49638,1,53,9,2,14,3,82,38.244380832698255,-109.4203262
49639,0,52,8,1,13,4,78,38.244380832698255,-109.4200568
49640,1,49,7,3,9,2,71,38.244380832698255,-109.4197873
49641,1,36,7,2,7,5,58,38.244380832698255,-109.4195178
49642,2,39,7,3,7,4,62,38.244380832698255,-109.4192483
49643,2,39,7,3,7,3,61,38.244380832698255,-109.4189788
49644,2,34,8,3,8,5,60,38.244380832698255,-109.4187093
49645,4,37,7,4,8,3,63,38.244380832698255,-109.4184398
49646,3,41,7,3,8,3,65,38.244380832698255,-109.4181703
49647,1,39,7,2,9,5,63,38.244380832698255,-109.4179008
49648,2,35,8,3,10,7,65,38.244380832698255,-109.4176313
49649,2,34,9,4,9,8,66,38.244380832698255,-109.4173618
49650,11,34,14,14,15,1,89,38.244380832698255,-109.4170923
49651,20,29,13,14,13,2,91,38.244380832698255,-109.4168228
49652,24,23,12,17,13,2,91,38.244380832698255,-109.4165533
49653,23,21,12,20,13,2,91,38.244380832698255,-109.4162838
49654,25,24,11,19,12,2,93,38.244380832698255,-109.4160143
49655,15,35,12,13,14,2,91,38.244380832698255,-109.4157448
49656,6,34,11,8,11,9,79,38.244380832698255,-109.4154753
49657,1,32,11,2,11,14,71,38.244380832698255,-109.4152058
49658,1,33,11,0,11,13,69,38.244380832698255,-109.4149364
49659,1,34,10,2,9,12,68,38.244380832698255,-109.4146669
49660,1,31,10,1,9,12,64,38.244380832698255,-109.4143974
49661,1,34,10,1,10,11,67,38.244380832698255,-109.4141279
49662,1,36,9,0,11,9,66,38.244380832698255,-109.4138584
49663,1,37,9,0,13,7,67,38.244380832698255,-109.4135889
49664,1,42,9,0,14,7,73,38.244380832698255,-109.4133194
49665,2,46,9,0,15,6,78,38.244380832698255,-109.4130499
49666,4,50,10,4,16,3,87,38.244380832698255,-109.4127804
49667,7,50,11,7,15,2,92,38.244380832698255,-109.4125109
49668,8,47,12,9,15,1,92,38.244380832698255,-109.4122414
49669,8,45,13,10,16,0,92,38.244380832698255,-109.4119719
49670,8,44,14,11,15,0,92,38.244380832698255,-109.4117024
49671,7,44,14,11,15,1,92,38.244380832698255,-109.4114329
49672,8,44,14,10,15,1,92,38.244380832698255,-109.4111634
49673,12,43,14,11,14,0,94,38.244380832698255,-109.4108939
49674,18,37,14,12,12,0,93,38.244380832698255,-109.4106244
49675,19,35,14,12,12,0,92,38.244380832698255,-109.4103549
49676,17,37,14,12,12,0,92,38.244380832698255,-109.4100855
49677,15,39,13,11,13,0,91,38.244380832698255,-109.409816
49678,13,38,14,12,13,0,90,38.244380832698255,-109.4095465
49679,17,35,15,13,12,0,92,38.244380832698255,-109.409277
49680,18,34,15,13,12,0,92,38.244380832698255,-109.4090075
49681,19,34,14,12,12,0,91,38.244380832698255,-109.408738
49682,19,35,14,11,12,0,91,38.244380832698255,-109.4084685
49683,15,37,14,12,13,0,91,38.244380832698255,-109.408199
49684,10,38,12,11,15,1,87,38.244380832698255,-109.4079295
49685,6,41,11,11,13,2,84,38.244380832698255,-109.40766
49686,5,46,10,9,12,2,84,38.244380832698255,-109.4073905
49687,4,50,9,8,12,1,84,38.244380832698255,-109.407121
49688,4,51,8,9,10,1,83,38.244380832698255,-109.4068515
49689,3,48,8,9,10,1,79,38.244380832698255,-109.406582
49690,4,46,8,9,11,1,79,38.244380832698255,-109.4063125
49691,10,43,10,11,12,1,87,38.244380832698255,-109.406043
49692,16,33,13,11,14,0,87,38.244380832698255,-109.4057735
49693,15,35,13,12,14,0,89,38.244380832698255,-109.405504
49694,16,34,13,11,14,0,88,38.244380832698255,-109.4052345
49695,18,32,13,11,14,0,88,38.244380832698255,-109.4049651
49696,20,29,13,12,13,0,87,38.244380832698255,-109.4046956
49697,17,30,13,14,13,1,88,38.244380832698255,-109.4044261
49698,16,30,14,14,13,1,88,38.244380832698255,-109.4041566
49699,15,31,14,13,13,1,87,38.244380832698255,-109.4038871
49700,13,33,14,12,14,1,87,38.244380832698255,-109.4036176
49701,11,32,13,12,14,1,83,38.244380832698255,-109.4033481
49702,11,33,13,12,15,1,85,38.244380832698255,-109.4030786
49703,10,35,13,11,15,1,85,38.244380832698255,-109.4028091
49704,8,37,13,11,15,1,85,38.244380832698255,-109.4025396
49705,7,38,13,11,15,1,85,38.244380832698255,-109.4022701
49706,10,37,14,12,15,1,89,38.244380832698255,-109.4020006
49707,8,39,13,11,15,1,87,38.244380832698255,-109.4017311
49708,6,40,13,11,15,2,87,38.244380832698255,-109.4014616
49709,6,40,13,11,15,2,87,38.244380832698255,-109.4011921
49710,8,42,13,12,14,1,90,38.244380832698255,-109.4009226
49711,8,42,14,12,14,1,91,38.244380832698255,-109.4006531
49712,7,41,13,12,14,2,89,38.244380832698255,-109.4003836
49713,6,41,13,11,13,2,86,38.244380832698255,-109.4001142
49714,6,42,13,10,13,3,87,38.244380832698255,-109.3998447
49715,6,44,13,9,13,3,88,38.244380832698255,-109.3995752
49716,5,44,13,10,13,3,88,38.244380832698255,-109.3993057
49717,5,44,13,8,13,3,86,38.244380832698255,-109.3990362
49718,5,45,13,10,14,2,89,38.244380832698255,-109.3987667
49719,7,42,13,12,13,2,89,38.244380832698255,-109.3984972
49720,5,44,13,11,13,2,88,38.244380832698255,-109.3982277
49721,5,43,13,10,13,2,86,38.244380832698255,-109.3979582
49722,4,41,14,9,14,3,85,38.244380832698255,-109.3976887
49723,4,41,14,9,14,3,85,38.244380832698255,-109.3974192
49724,5,42,13,8,16,2,86,38.244380832698255,-109.3971497
49725,5,43,14,10,16,2,90,38.244380832698255,-109.3968802
49726,5,43,14,10,16,1,89,38.244380832698255,-109.3966107
49727,6,42,14,10,16,1,89,38.244380832698255,-109.3963412
49728,8,40,14,11,16,1,90,38.244380832698255,-109.3960717
49729,13,38,14,13,15,0,93,38.244380832698255,-109.3958022
49730,15,35,15,14,14,0,93,38.244380832698255,-109.3955327
49731,14,36,14,12,14,1,91,38.244380832698255,-109.3952632
49732,12,37,14,12,14,1,90,38.244380832698255,-109.3949938
49733,12,37,14,13,14,0,90,38.244380832698255,-109.3947243
49734,10,39,14,13,15,0,91,38.244380832698255,-109.3944548
49735,9,38,14,14,14,0,89,38.244380832698255,-109.3941853
49736,9,40,14,13,15,0,91,38.244380832698255,-109.3939158
49737,9,41,14,13,15,0,92,38.244380832698255,-109.3936463
49738,7,41,13,11,15,1,88,38.244380832698255,-109.3933768
49739,8,43,13,11,15,1,91,38.244380832698255,-109.3931073
49740,7,42,13,10,15,1,88,38.244380832698255,-109.3928378
49741,5,43,14,10,17,1,90,38.244380832698255,-109.3925683
49742,5,44,14,10,17,0,90,38.244380832698255,-109.3922988
49743,5,45,14,10,17,1,92,38.244380832698255,-109.3920293
49744,5,43,14,11,17,1,91,38.244380832698255,-109.3917598
49745,5,42,14,11,17,1,90,38.244380832698255,-109.3914903
49746,6,42,14,11,17,1,91,38.244380832698255,-109.3912208
49747,5,43,14,11,17,0,90,38.244380832698255,-109.3909513
49748,6,45,14,11,17,0,93,38.244380832698255,-109.3906818
49749,5,45,14,11,17,0,92,38.244380832698255,-109.3904123
49750,5,45,14,11,17,0,92,38.244380832698255,-109.3901429
49751,6,44,14,12,16,0,92,38.244380832698255,-109.3898734
49752,7,42,14,12,15,1,91,38.244380832698255,-109.3896039
49753,8,38,13,15,15,1,90,38.244380832698255,-109.3893344
49754,7,39,13,15,15,1,90,38.244380832698255,-109.3890649
49755,7,42,14,13,16,1,93,38.244380832698255,-109.3887954
49756,6,45,15,12,16,1,95,38.244380832698255,-109.3885259
49757,5,44,14,12,16,1,92,38.244380832698255,-109.3882564
49758,7,41,14,14,15,1,92,38.244380832698255,-109.3879869
49759,9,38,14,14,15,0,90,38.244380832698255,-109.3877174
49760,13,36,13,14,15,0,91,38.244380832698255,-109.3874479
49761,14,35,13,14,14,0,90,38.244380832698255,-109.3871784
49762,14,34,13,14,15,0,90,38.244380832698255,-109.3869089
49763,12,34,13,15,15,1,90,38.244380832698255,-109.3866394
49764,15,33,13,14,14,0,89,38.244380832698255,-109.3863699
49765,19,32,13,13,12,0,89,38.244380832698255,-109.3861004
49766,20,32,13,13,12,0,90,38.244380832698255,-109.3858309
49767,18,34,13,14,12,0,91,38.244380832698255,-109.3855614
49768,15,36,13,14,11,1,90,38.244380832698255,-109.3852919
49769,14,37,13,14,12,1,91,38.244380832698255,-109.3850225
49770,14,37,13,15,12,0,91,38.244380832698255,-109.384753
49771,12,37,14,17,12,0,92,38.244380832698255,-109.3844835
49772,11,37,13,15,12,1,89,38.244380832698255,-109.384214
49773,11,38,13,14,13,1,90,38.244380832698255,-109.3839445
49774,13,37,13,14,13,0,90,38.244380832698255,-109.383675
49775,15,36,13,14,12,0,90,38.244380832698255,-109.3834055
49776,15,35,13,12,12,1,88,38.244380832698255,-109.383136
49777,16,36,12,11,12,1,88,38.244380832698255,-109.3828665
49778,15,37,12,10,13,1,88,38.244380832698255,-109.382597
49779,15,37,12,11,13,1,89,38.244380832698255,-109.3823275
49780,16,33,12,11,13,1,86,38.244380832698255,-109.382058
49781,15,23,11,15,9,2,75,38.244380832698255,-109.3817885
49782,15,24,11,14,10,3,77,38.244380832698255,-109.381519
49783,14,34,11,10,10,3,82,38.244380832698255,-109.3812495
49784,7,46,12,8,13,3,89,38.244380832698255,-109.38098
49785,7,49,12,8,13,2,91,38.244380832698255,-109.3807105
49786,8,47,13,9,11,2,90,38.244380832698255,-109.380441
49787,7,46,13,9,12,3,90,38.244380832698255,-109.3801716
49788,6,47,12,7,13,3,88,38.244380832698255,-109.3799021
49789,6,47,13,6,13,3,88,38.244380832698255,-109.3796326
49790,7,45,13,8,12,3,88,38.244380832698255,-109.3793631
49791,8,43,13,8,11,4,87,38.244380832698255,-109.3790936
49792,9,43,14,8,10,4,88,38.244380832698255,-109.3788241
49793,10,42,14,10,11,3,90,38.244380832698255,-109.3785546
49794,9,45,14,10,12,1,91,38.244380832698255,-109.3782851
49795,8,46,14,11,13,0,92,38.244380832698255,-109.3780156
49796,4,48,11,6,13,3,85,38.244380832698255,-109.3777461
49797,2,48,10,4,13,5,82,38.244380832698255,-109.3774766
49798,2,48,10,3,13,6,82,38.244380832698255,-109.3772071
49799,2,41,9,3,11,8,74,38.244380832698255,-109.3769376
49800,2,43,9,4,12,4,74,38.244380832698255,-109.3766681
49801,0,43,7,0,10,6,66,38.244380832698255,-109.3763986
49802,0,43,7,0,10,5,65,38.244380832698255,-109.3761291
49803,2,43,8,3,10,4,70,38.244380832698255,-109.3758596
49804,1,35,10,6,12,7,71,38.244380832698255,-109.3755901
49805,1,23,11,5,9,13,62,38.244380832698255,-109.3753206
49806,1,26,12,3,13,15,70,38.244380832698255,-109.3750512
49807,2,33,14,8,5,18,80,38.244380832698255,-109.3747817
49808,5,32,11,9,8,12,77,38.244380832698255,-109.3745122
49809,0,33,9,8,8,11,69,38.244380832698255,-109.3742427
49810,0,28,11,4,17,8,68,38.244380832698255,-109.3739732
49811,0,26,13,11,17,6,73,38.244380832698255,-109.3737037
49812,0,20,12,13,23,3,71,38.244380832698255,-109.3734342
49813,7,21,11,16,21,3,79,38.244380832698255,-109.3731647
49814,0,21,10,9,18,3,61,38.244380832698255,-109.3728952
49815,1,27,12,0,8,17,65,38.244380832698255,-109.3726257
49816,1,24,9,5,8,9,56,38.244380832698255,-109.3723562
49817,3,27,7,2,6,8,53,38.244380832698255,-109.3720867
49818,4,27,6,5,9,6,57,38.244380832698255,-109.3718172
49819,4,25,7,6,8,7,57,38.244380832698255,-109.3715477
49820,3,27,8,4,5,10,57,38.244380832698255,-109.3712782
49821,3,18,9,3,7,9,49,38.244380832698255,-109.3710087
49822,3,18,11,3,6,13,54,38.244380832698255,-109.3707392
49823,0,15,13,0,2,24,54,38.244380832698255,-109.3704697
49824,2,19,13,0,2,22,58,38.244380832698255,-109.3702003
49825,3,22,13,0,3,20,61,38.244380832698255,-109.3699308
49826,2,22,13,0,3,20,60,38.244380832698255,-109.3696613
49827,2,23,13,0,3,20,61,38.244380832698255,-109.3693918
49828,1,23,12,0,3,20,59,38.244380832698255,-109.3691223
49829,1,24,12,0,3,19,59,38.244380832698255,-109.3688528
49830,2,24,12,0,3,19,60,38.244380832698255,-109.3685833
49831,2,25,12,0,3,19,61,38.244380832698255,-109.3683138
49832,1,22,11,0,2,19,55,38.244380832698255,-109.3680443
49833,1,26,10,0,4,17,58,38.244380832698255,-109.3677748
49834,1,27,11,0,4,17,60,38.244380832698255,-109.3675053
49835,2,27,12,1,4,18,64,38.244380832698255,-109.3672358
49836,1,26,12,0,4,19,62,38.244380832698255,-109.3669663
49837,1,24,12,1,3,21,62,38.244380832698255,-109.3666968
49838,1,23,12,1,2,21,60,38.244380832698255,-109.3664273
49839,1,23,12,0,2,21,59,38.244380832698255,-109.3661578
49840,1,23,11,0,3,19,57,38.244380832698255,-109.3658883
49841,1,26,11,0,4,17,59,38.244380832698255,-109.3656188
49842,1,23,11,0,3,18,56,38.244380832698255,-109.3653493
49843,1,24,11,0,4,16,56,38.244380832698255,-109.3650799
49844,1,26,10,0,6,15,58,38.244380832698255,-109.3648104
49845,1,25,11,0,5,16,58,38.244380832698255,-109.3645409
49846,2,26,12,1,4,20,65,38.244380832698255,-109.3642714
49847,3,34,12,3,6,18,76,38.244380832698255,-109.3640019
49848,3,35,12,3,7,18,78,38.244380832698255,-109.3637324
49849,2,31,12,3,5,18,71,38.244380832698255,-109.3634629
49850,2,26,12,2,3,20,65,38.244380832698255,-109.3631934
49851,1,22,12,2,4,18,59,38.244380832698255,-109.3629239
49852,3,25,12,2,6,14,62,38.244380832698255,-109.3626544
49853,2,29,10,2,8,11,62,38.244380832698255,-109.3623849
49854,2,32,9,3,9,9,64,38.244380832698255,-109.3621154
49855,6,22,11,6,7,9,61,38.244380832698255,-109.3618459
49856,1,17,12,1,4,18,53,38.244380832698255,-109.3615764
49857,2,20,10,4,5,13,54,38.244380832698255,-109.3613069
49858,1,21,8,4,7,7,48,38.244380832698255,-109.3610374
49859,3,22,6,3,7,5,46,38.244380832698255,-109.3607679
49860,4,28,8,4,8,6,58,38.244380832698255,-109.3604984
49861,4,29,8,3,7,9,60,38.244380832698255,-109.360229
49862,3,32,12,2,4,16,69,38.244380832698255,-109.3599595
49863,2,34,11,2,6,14,69,38.244380832698255,-109.35969
49864,2,36,10,2,8,10,68,38.244380832698255,-109.3594205
49865,1,34,9,3,8,9,64,38.244380832698255,-109.359151
49866,1,36,9,2,10,7,65,38.244380832698255,-109.3588815
49867,1,37,8,2,10,7,65,38.244380832698255,-109.358612
49868,1,41,7,2,9,5,65,38.244380832698255,-109.3583425
49869,3,51,8,4,10,2,78,38.244380832698255,-109.358073
49870,1,32,9,1,7,11,61,38.244380832698255,-109.3578035
49871,1,34,9,0,7,14,65,38.244380832698255,-109.357534
49872,1,37,11,1,9,13,72,38.244380832698255,-109.3572645
49873,1,42,9,0,11,10,73,38.244380832698255,-109.356995
49874,1,41,9,0,12,9,72,38.244380832698255,-109.3567255
49875,1,41,10,1,13,7,73,38.244380832698255,-109.356456
49876,1,32,8,4,8,6,59,38.244380832698255,-109.3561865
49877,2,32,8,4,6,5,57,38.244380832698255,-109.355917
49878,2,29,8,5,7,5,56,38.244380832698255,-109.3556475
49879,3,27,10,7,10,5,62,38.244380832698255,-109.355378
49880,2,18,13,9,7,13,62,38.244380832698255,-109.3551086
49881,3,20,13,10,7,13,66,38.244380832698255,-109.3548391
49882,7,30,13,10,8,9,77,38.244380832698255,-109.3545696
49883,8,23,13,15,10,9,78,38.244380832698255,-109.3543001
49884,3,24,12,4,6,18,67,38.244380832698255,-109.3540306
49885,2,22,10,2,6,14,56,38.244380832698255,-109.3537611
49886,2,28,10,1,7,12,60,38.244380832698255,-109.3534916
49887,2,36,10,2,7,9,66,38.244380832698255,-109.3532221
49888,1,33,9,4,6,7,60,38.244380832698255,-109.3529526
49889,3,23,11,7,6,10,60,38.244380832698255,-109.3526831
49890,8,18,15,9,9,15,74,38.244380832698255,-109.3524136
49891,14,15,15,10,13,17,84,38.244380832698255,-109.3521441
49892,3,16,12,9,13,22,75,38.244380832698255,-109.3518746
49893,2,23,10,7,12,7,61,38.244380832698255,-109.3516051
49894,3,29,9,8,7,5,61,38.244380832698255,-109.3513356
49895,4,38,9,5,7,5,68,38.244380832698255,-109.3510661
49896,2,29,8,4,7,6,56,38.244380832698255,-109.3507966
49897,2,24,8,4,9,5,52,38.244380832698255,-109.3505271
49898,1,21,7,4,11,5,49,38.244380832698255,-109.3502577
49899,2,17,8,7,12,5,51,38.244380832698255,-109.3499882
49900,6,19,10,12,12,4,63,38.244380832698255,-109.3497187
49901,8,23,11,13,13,4,72,38.244380832698255,-109.3494492
49902,11,26,11,15,12,3,78,38.244380832698255,-109.3491797
49903,20,22,14,20,9,1,86,38.244380832698255,-109.3489102
49904,27,19,14,19,9,1,89,38.244380832698255,-109.3486407
49905,27,16,12,18,10,1,84,38.244380832698255,-109.3483712
49906,30,16,12,19,9,2,88,38.244380832698255,-109.3481017
49907,32,12,12,24,7,2,89,38.244380832698255,-109.3478322
49908,34,12,10,27,9,1,93,38.244380832698255,-109.3475627
49909,42,12,10,24,7,1,96,38.244380832698255,-109.3472932
49910,41,11,8,22,12,0,94,38.244380832698255,-109.3470237
49911,23,11,8,29,19,2,92,38.244380832698255,-109.3467542
49912,10,16,10,29,13,6,84,38.244380832698255,-109.3464847
49913,2,25,12,14,16,9,78,38.244380832698255,-109.3462152
49914,1,28,12,8,14,11,74,38.244380832698255,-109.3459457
49915,1,31,11,6,14,9,72,38.244380832698255,-109.3456762
49916,1,30,11,4,11,10,67,38.244380832698255,-109.3454068
49917,2,24,11,6,10,10,63,38.244380832698255,-109.3451373
49918,1,19,10,9,10,7,56,38.244380832698255,-109.3448678
49919,2,20,10,8,10,7,57,38.244380832698255,-109.3445983
49920,3,24,11,4,8,11,61,38.244380832698255,-109.3443288
49921,3,29,11,2,7,13,65,38.244380832698255,-109.3440593
49922,2,29,11,1,5,14,62,38.244380832698255,-109.3437898
49923,2,30,11,1,7,13,64,38.244380832698255,-109.3435203
49924,2,29,11,1,7,15,65,38.244380832698255,-109.3432508
49925,2,28,14,0,4,22,70,38.244380832698255,-109.3429813
49926,2,29,15,0,3,25,74,38.244380832698255,-109.3427118
49927,2,26,16,0,2,28,74,38.244380832698255,-109.3424423
49928,1,25,17,0,3,30,76,38.244380832698255,-109.3421728
49929,1,26,17,0,4,30,78,38.244380832698255,-109.3419033
49930,2,31,14,0,6,23,76,38.244380832698255,-109.3416338
49931,3,27,14,4,10,17,75,38.244380832698255,-109.3413643
49932,1,26,12,3,11,16,69,38.244380832698255,-109.3410948
49933,0,26,12,1,9,18,66,38.244380832698255,-109.3408253
49934,1,31,12,0,7,19,70,38.244380832698255,-109.3405558
49935,0,28,14,0,6,23,71,38.244380832698255,-109.3402864
49936,0,30,14,0,8,21,73,38.244380832698255,-109.3400169
49937,0,29,15,0,9,21,74,38.244380832698255,-109.3397474
49938,0,28,15,0,8,22,73,38.244380832698255,-109.3394779
49939,0,26,13,0,7,22,68,38.244380832698255,-109.3392084
49940,2,33,13,0,10,16,74,38.244380832698255,-109.3389389
49941,0,29,11,0,8,18,66,38.244380832698255,-109.3386694
49942,0,29,11,0,8,18,66,38.244380832698255,-109.3383999
49943,2,32,12,0,8,18,72,38.244380832698255,-109.3381304
49944,0,26,11,0,4,21,62,38.244380832698255,-109.3378609
49945,1,27,11,0,5,18,62,38.244380832698255,-109.3375914
49946,2,27,11,0,5,15,60,38.244380832698255,-109.3373219
49947,2,24,10,2,5,15,58,38.244380832698255,-109.3370524
49948,0,28,9,2,5,14,58,38.244380832698255,-109.3367829
49949,0,38,7,0,8,10,63,38.244380832698255,-109.3365134
49950,1,34,6,2,9,7,59,38.244380832698255,-109.3362439
49951,1,45,5,3,8,4,66,38.244380832698255,-109.3359744
49952,2,51,5,3,8,3,72,38.244380832698255,-109.3357049
49953,4,40,5,3,9,3,64,38.244380832698255,-109.3354355
49954,2,24,7,4,7,8,52,38.244380832698255,-109.335166
49955,5,15,8,4,6,11,49,38.244380832698255,-109.3348965
49956,9,10,12,4,5,14,54,38.244380832698255,-109.334627
49957,0,15,10,2,5,16,48,38.244380832698255,-109.3343575
49958,6,29,14,13,17,4,83,38.244380832698255,-109.334088
49959,2,21,11,8,11,9,62,38.244380832698255,-109.3338185
49960,2,22,9,10,12,6,61,38.244380832698255,-109.333549
49961,2,23,9,10,12,5,61,38.244380832698255,-109.3332795
49962,1,21,10,11,11,8,62,38.244380832698255,-109.33301
49963,12,28,13,16,13,2,84,38.244380832698255,-109.3327405
49964,1,24,10,9,11,7,62,38.244380832698255,-109.332471
49965,1,36,8,7,9,4,65,38.244380832698255,-109.3322015
49966,2,38,8,5,10,4,67,38.244380832698255,-109.331932
49967,3,41,7,5,9,3,68,38.244380832698255,-109.3316625
49968,9,29,10,18,18,2,86,38.244111338113015,-109.4402688
49969,7,29,10,21,15,1,83,38.244111338113015,-109.4399993
49970,7,30,10,15,15,3,80,38.244111338113015,-109.4397299
49971,16,32,11,13,16,2,90,38.244111338113015,-109.4394604
49972,27,27,11,16,15,0,96,38.244111338113015,-109.4391909
49973,27,22,11,22,16,0,98,38.244111338113015,-109.4389214
49974,27,19,11,20,19,0,96,38.244111338113015,-109.4386519
49975,20,19,11,21,21,3,95,38.244111338113015,-109.4383824
49976,11,20,11,23,19,5,89,38.244111338113015,-109.4381129
49977,3,22,13,11,12,10,71,38.244111338113015,-109.4378434
49978,1,40,9,0,9,12,71,38.244111338113015,-109.4375739
49979,1,47,9,0,12,8,77,38.244111338113015,-109.4373044
49980,1,40,9,0,11,11,72,38.244111338113015,-109.4370349
49981,1,39,10,1,12,9,72,38.244111338113015,-109.4367654
49982,2,40,10,5,11,5,73,38.244111338113015,-109.4364959
49983,2,38,9,3,9,6,67,38.244111338113015,-109.4362264
49984,2,40,11,1,11,10,75,38.244111338113015,-109.4359569
49985,2,36,12,2,12,11,75,38.244111338113015,-109.4356874
49986,2,36,12,3,13,11,77,38.244111338113015,-109.4354179
49987,3,37,12,4,14,10,80,38.244111338113015,-109.4351484
49988,3,39,11,2,12,11,78,38.244111338113015,-109.434879
49989,3,41,12,4,15,6,81,38.244111338113015,-109.4346095
49990,5,44,12,8,17,2,88,38.244111338113015,-109.43434
49991,5,44,12,9,16,1,87,38.244111338113015,-109.4340705
49992,4,42,12,8,15,3,84,38.244111338113015,-109.433801
49993,5,40,12,14,14,1,86,38.244111338113015,-109.4335315
49994,6,38,12,15,13,1,85,38.244111338113015,-109.433262
49995,6,38,13,16,13,1,87,38.244111338113015,-109.4329925
49996,7,39,13,16,12,1,88,38.244111338113015,-109.432723
49997,8,40,14,15,12,1,90,38.244111338113015,-109.4324535
49998,6,40,13,14,12,1,86,38.244111338113015,-109.432184
49999,6,41,12,13,13,1,86,38.244111338113015,-109.4319145
50000,5,42,12,9,14,2,84,38.244111338113015,-109.431645
50001,5,43,12,7,14,4,85,38.244111338113015,-109.4313755
50002,5,39,12,9,13,3,81,38.244111338113015,-109.431106
50003,4,39,11,6,14,4,78,38.244111338113015,-109.4308365
50004,6,41,11,7,14,3,82,38.244111338113015,-109.430567
50005,7,45,11,8,15,1,87,38.244111338113015,-109.4302975
50006,6,48,11,7,17,1,90,38.244111338113015,-109.430028
50007,3,47,10,3,17,3,83,38.244111338113015,-109.4297586
50008,3,44,10,2,15,5,79,38.244111338113015,-109.4294891
50009,3,41,11,3,15,6,79,38.244111338113015,-109.4292196
50010,3,41,12,4,15,6,81,38.244111338113015,-109.4289501
50011,3,42,12,4,14,7,82,38.244111338113015,-109.4286806
50012,5,44,12,7,17,2,87,38.244111338113015,-109.4284111
50013,7,42,12,10,16,1,88,38.244111338113015,-109.4281416
50014,7,42,13,12,15,1,90,38.244111338113015,-109.4278721
50015,7,41,13,13,14,1,89,38.244111338113015,-109.4276026
50016,6,42,13,13,15,1,90,38.244111338113015,-109.4273331
50017,7,43,13,14,14,1,92,38.244111338113015,-109.4270636
50018,7,42,14,15,14,0,92,38.244111338113015,-109.4267941
50019,8,41,14,16,14,0,93,38.244111338113015,-109.4265246
50020,10,39,15,16,14,0,94,38.244111338113015,-109.4262551
50021,10,38,14,16,14,0,92,38.244111338113015,-109.4259856
50022,10,38,14,15,14,0,91,38.244111338113015,-109.4257161
50023,11,38,14,14,14,0,91,38.244111338113015,-109.4254466
50024,9,38,14,13,14,1,89,38.244111338113015,-109.4251771
50025,7,39,13,11,14,2,86,38.244111338113015,-109.4249077
50026,6,43,13,10,13,2,87,38.244111338113015,-109.4246382
50027,6,43,13,9,13,3,87,38.244111338113015,-109.4243687
50028,6,42,13,9,13,3,86,38.244111338113015,-109.4240992
50029,6,42,13,10,12,2,85,38.244111338113015,-109.4238297
50030,7,41,13,11,13,2,87,38.244111338113015,-109.4235602
50031,11,38,14,12,13,1,89,38.244111338113015,-109.4232907
50032,9,39,13,11,14,1,87,38.244111338113015,-109.4230212
50033,7,41,13,10,13,2,86,38.244111338113015,-109.4227517
50034,7,43,13,9,13,1,86,38.244111338113015,-109.4224822
50035,5,46,11,7,12,2,83,38.244111338113015,-109.4222127
50036,3,53,9,5,12,2,84,38.244111338113015,-109.4219432
50037,4,51,9,6,12,1,83,38.244111338113015,-109.4216737
50038,6,47,11,9,13,1,87,38.244111338113015,-109.4214042
50039,7,46,12,10,12,1,88,38.244111338113015,-109.4211347
50040,5,50,10,7,12,2,86,38.244111338113015,-109.4208652
50041,3,53,9,5,14,2,86,38.244111338113015,-109.4205957
50042,1,56,8,2,13,3,83,38.244111338113015,-109.4203262
50043,0,56,6,1,11,4,78,38.244111338113015,-109.4200568
50044,0,45,7,1,9,4,66,38.244111338113015,-109.4197873
50045,1,40,7,2,8,4,62,38.244111338113015,-109.4195178
50046,2,42,6,3,7,3,63,38.244111338113015,-109.4192483
50047,2,41,6,2,8,3,62,38.244111338113015,-109.4189788
50048,1,36,7,2,8,5,59,38.244111338113015,-109.4187093
50049,4,41,7,3,9,3,67,38.244111338113015,-109.4184398
50050,1,37,7,3,9,4,61,38.244111338113015,-109.4181703
50051,1,34,8,2,9,6,60,38.244111338113015,-109.4179008
50052,3,32,9,5,9,6,64,38.244111338113015,-109.4176313
50053,7,35,13,13,13,4,85,38.244111338113015,-109.4173618
50054,25,26,12,16,10,1,90,38.244111338113015,-109.4170923
50055,29,22,11,17,10,1,90,38.244111338113015,-109.4168228
50056,23,23,12,21,13,1,93,38.244111338113015,-109.4165533
50057,17,25,12,23,14,1,92,38.244111338113015,-109.4162838
50058,20,28,13,19,12,1,93,38.244111338113015,-109.4160143
50059,16,32,12,15,13,2,90,38.244111338113015,-109.4157448
50060,8,27,12,11,11,8,77,38.244111338113015,-109.4154753
50061,2,29,12,4,12,11,70,38.244111338113015,-109.4152058
50062,2,36,10,0,11,10,69,38.244111338113015,-109.4149364
50063,0,33,10,0,9,12,64,38.244111338113015,-109.4146669
50064,1,32,10,1,10,11,65,38.244111338113015,-109.4143974
50065,1,35,10,1,10,8,65,38.244111338113015,-109.4141279
50066,1,40,9,1,11,6,68,38.244111338113015,-109.4138584
50067,1,43,8,1,12,5,70,38.244111338113015,-109.4135889
50068,1,48,8,0,13,5,75,38.244111338113015,-109.4133194
50069,1,47,9,0,15,5,77,38.244111338113015,-109.4130499
50070,3,49,10,2,16,5,85,38.244111338113015,-109.4127804
50071,5,52,11,5,15,3,91,38.244111338113015,-109.4125109
50072,6,51,11,8,14,1,91,38.244111338113015,-109.4122414
50073,6,48,13,10,15,1,93,38.244111338113015,-109.4119719
50074,7,46,14,11,15,1,94,38.244111338113015,-109.4117024
50075,7,45,14,10,14,1,91,38.244111338113015,-109.4114329
50076,8,46,14,9,14,1,92,38.244111338113015,-109.4111634
50077,9,46,14,10,14,1,94,38.244111338113015,-109.4108939
50078,14,38,14,13,13,0,92,38.244111338113015,-109.4106244
50079,17,36,14,13,12,0,92,38.244111338113015,-109.4103549
50080,17,36,14,12,12,0,91,38.244111338113015,-109.4100855
50081,17,37,14,12,12,0,92,38.244111338113015,-109.409816
50082,15,36,14,13,13,0,91,38.244111338113015,-109.4095465
50083,17,35,14,13,12,0,91,38.244111338113015,-109.409277
50084,19,35,14,12,12,0,92,38.244111338113015,-109.4090075
50085,19,35,14,12,12,0,92,38.244111338113015,-109.408738
50086,20,34,14,11,12,0,91,38.244111338113015,-109.4084685
50087,17,36,14,12,13,0,92,38.244111338113015,-109.408199
50088,14,36,14,13,14,0,91,38.244111338113015,-109.4079295
50089,12,38,13,12,15,0,90,38.244111338113015,-109.40766
50090,10,40,13,12,15,1,91,38.244111338113015,-109.4073905
50091,11,40,13,11,15,0,90,38.244111338113015,-109.407121
50092,11,38,12,11,14,1,87,38.244111338113015,-109.4068515
50093,12,37,12,11,14,0,86,38.244111338113015,-109.406582
50094,13,36,12,11,14,0,86,38.244111338113015,-109.4063125
50095,14,36,13,11,14,0,88,38.244111338113015,-109.406043
50096,15,37,13,12,13,0,90,38.244111338113015,-109.4057735
50097,15,36,13,13,13,0,90,38.244111338113015,-109.405504
50098,16,34,13,12,13,0,88,38.244111338113015,-109.4052345
50099,17,31,13,12,13,0,86,38.244111338113015,-109.4049651
50100,17,30,13,13,13,1,87,38.244111338113015,-109.4046956
50101,16,31,13,15,13,0,88,38.244111338113015,-109.4044261
50102,15,31,14,14,13,1,88,38.244111338113015,-109.4041566
50103,15,32,14,14,14,1,90,38.244111338113015,-109.4038871
50104,16,32,13,12,14,1,88,38.244111338113015,-109.4036176
50105,15,33,13,12,14,1,88,38.244111338113015,-109.4033481
50106,15,33,13,11,14,1,87,38.244111338113015,-109.4030786
50107,13,35,12,10,14,1,85,38.244111338113015,-109.4028091
50108,11,38,12,10,15,1,87,38.244111338113015,-109.4025396
50109,9,39,13,10,15,2,88,38.244111338113015,-109.4022701
50110,11,37,13,11,15,1,88,38.244111338113015,-109.4020006
50111,12,38,13,12,14,1,90,38.244111338113015,-109.4017311
50112,11,37,14,13,14,1,90,38.244111338113015,-109.4014616
50113,11,37,14,13,14,1,90,38.244111338113015,-109.4011921
50114,11,40,13,12,14,1,91,38.244111338113015,-109.4009226
50115,10,39,13,12,14,1,89,38.244111338113015,-109.4006531
50116,7,42,13,11,15,1,89,38.244111338113015,-109.4003836
50117,6,41,13,10,14,3,87,38.244111338113015,-109.4001142
50118,6,40,13,10,14,3,86,38.244111338113015,-109.3998447
50119,6,42,13,10,14,2,87,38.244111338113015,-109.3995752
50120,6,45,13,9,14,2,89,38.244111338113015,-109.3993057
50121,5,45,14,9,14,2,89,38.244111338113015,-109.3990362
50122,5,43,14,10,14,2,88,38.244111338113015,-109.3987667
50123,5,41,14,12,13,2,87,38.244111338113015,-109.3984972
50124,5,42,13,10,13,3,86,38.244111338113015,-109.3982277
50125,5,42,14,10,13,2,86,38.244111338113015,-109.3979582
50126,4,42,13,9,14,3,85,38.244111338113015,-109.3976887
50127,4,44,13,8,14,3,86,38.244111338113015,-109.3974192
50128,5,45,13,9,15,2,89,38.244111338113015,-109.3971497
50129,5,44,13,8,15,2,87,38.244111338113015,-109.3968802
50130,6,43,13,9,16,2,89,38.244111338113015,-109.3966107
50131,6,43,13,9,16,1,88,38.244111338113015,-109.3963412
50132,7,41,14,10,16,1,89,38.244111338113015,-109.3960717
50133,8,42,14,11,16,1,92,38.244111338113015,-109.3958022
50134,11,40,14,12,15,0,92,38.244111338113015,-109.3955327
50135,12,40,14,11,14,1,92,38.244111338113015,-109.3952632
50136,12,41,14,11,14,1,93,38.244111338113015,-109.3949938
50137,10,40,14,13,14,1,92,38.244111338113015,-109.3947243
50138,11,41,14,11,14,1,92,38.244111338113015,-109.3944548
50139,9,39,14,13,14,1,90,38.244111338113015,-109.3941853
50140,9,41,14,13,14,1,92,38.244111338113015,-109.3939158
50141,9,42,14,12,15,0,92,38.244111338113015,-109.3936463
50142,6,43,14,13,15,0,91,38.244111338113015,-109.3933768
50143,7,45,13,11,15,0,91,38.244111338113015,-109.3931073
50144,6,44,13,11,16,0,90,38.244111338113015,-109.3928378
50145,5,45,13,11,17,0,91,38.244111338113015,-109.3925683
50146,5,46,14,11,17,0,93,38.244111338113015,-109.3922988
50147,4,46,14,9,17,1,91,38.244111338113015,-109.3920293
50148,4,45,14,9,17,1,90,38.244111338113015,-109.3917598
50149,5,44,14,11,17,0,91,38.244111338113015,-109.3914903
50150,5,44,14,12,17,0,92,38.244111338113015,-109.3912208
50151,5,44,14,12,16,0,91,38.244111338113015,-109.3909513
50152,5,45,14,11,17,1,93,38.244111338113015,-109.3906818
50153,5,46,14,10,16,1,92,38.244111338113015,-109.3904123
50154,5,44,14,11,16,1,91,38.244111338113015,-109.3901429
50155,6,43,14,13,15,1,92,38.244111338113015,-109.3898734
50156,7,39,13,13,14,1,87,38.244111338113015,-109.3896039
50157,8,38,13,15,15,1,90,38.244111338113015,-109.3893344
50158,7,41,14,15,15,1,93,38.244111338113015,-109.3890649
50159,7,42,15,14,15,1,94,38.244111338113015,-109.3887954
50160,6,43,15,13,16,1,94,38.244111338113015,-109.3885259
50161,6,42,15,14,16,1,94,38.244111338113015,-109.3882564
50162,7,40,15,15,15,1,93,38.244111338113015,-109.3879869
50163,10,38,15,15,15,1,94,38.244111338113015,-109.3877174
50164,11,37,14,15,14,0,91,38.244111338113015,-109.3874479
50165,11,36,13,15,14,1,90,38.244111338113015,-109.3871784
50166,12,35,13,13,14,1,88,38.244111338113015,-109.3869089
50167,12,35,13,13,14,0,87,38.244111338113015,-109.3866394
50168,15,34,13,14,13,0,89,38.244111338113015,-109.3863699
50169,18,33,13,14,13,0,91,38.244111338113015,-109.3861004
50170,17,34,13,14,12,0,90,38.244111338113015,-109.3858309
50171,17,34,13,14,12,0,90,38.244111338113015,-109.3855614
50172,17,35,13,14,12,0,91,38.244111338113015,-109.3852919
50173,15,36,13,14,12,0,90,38.244111338113015,-109.3850225
50174,12,38,13,14,13,1,91,38.244111338113015,-109.384753
50175,9,41,14,12,13,1,90,38.244111338113015,-109.3844835
50176,10,38,13,12,13,1,87,38.244111338113015,-109.384214
50177,13,36,13,14,13,1,90,38.244111338113015,-109.3839445
50178,16,34,13,15,12,0,90,38.244111338113015,-109.383675
50179,16,35,13,14,12,0,90,38.244111338113015,-109.3834055
50180,17,35,13,13,11,0,89,38.244111338113015,-109.383136
50181,16,36,12,11,12,1,88,38.244111338113015,-109.3828665
50182,11,37,13,11,14,1,87,38.244111338113015,-109.382597
50183,8,36,12,10,15,2,83,38.244111338113015,-109.3823275
50184,11,36,12,10,13,3,85,38.244111338113015,-109.382058
50185,14,28,12,12,10,3,79,38.244111338113015,-109.3817885
50186,12,23,11,18,11,2,77,38.244111338113015,-109.381519
50187,13,29,11,14,10,2,79,38.244111338113015,-109.3812495
50188,10,43,12,11,13,1,90,38.244111338113015,-109.38098
50189,7,46,13,9,12,2,89,38.244111338113015,-109.3807105
50190,8,44,12,9,11,3,87,38.244111338113015,-109.380441
50191,8,45,12,9,12,3,89,38.244111338113015,-109.3801716
50192,8,46,13,8,14,2,91,38.244111338113015,-109.3799021
50193,7,47,14,10,14,1,93,38.244111338113015,-109.3796326
50194,6,46,13,8,13,2,88,38.244111338113015,-109.3793631
50195,6,46,13,6,12,4,87,38.244111338113015,-109.3790936
50196,10,46,13,9,12,1,91,38.244111338113015,-109.3788241
50197,13,44,14,10,11,1,93,38.244111338113015,-109.3785546
50198,11,45,14,11,11,1,93,38.244111338113015,-109.3782851
50199,7,49,13,9,13,2,93,38.244111338113015,-109.3780156
50200,3,51,11,3,13,5,86,38.244111338113015,-109.3777461
50201,2,46,10,3,12,7,80,38.244111338113015,-109.3774766
50202,2,36,9,3,10,10,70,38.244111338113015,-109.3772071
50203,0,40,7,2,10,7,66,38.244111338113015,-109.3769376
50204,1,49,6,3,10,3,72,38.244111338113015,-109.3766681
50205,0,53,6,2,9,4,74,38.244111338113015,-109.3763986
50206,1,51,7,3,9,4,75,38.244111338113015,-109.3761291
50207,1,43,8,4,12,4,72,38.244111338113015,-109.3758596
50208,1,27,11,8,14,8,69,38.244111338113015,-109.3755901
50209,0,26,10,0,10,15,61,38.244111338113015,-109.3753206
50210,0,29,11,0,10,17,67,38.244111338113015,-109.3750512
50211,0,33,11,5,9,14,72,38.244111338113015,-109.3747817
50212,4,40,9,14,8,5,80,38.244111338113015,-109.3745122
50213,0,29,10,5,15,7,66,38.244111338113015,-109.3742427
50214,0,30,10,2,11,14,67,38.244111338113015,-109.3739732
50215,2,27,12,5,13,11,70,38.244111338113015,-109.3737037
50216,2,19,10,13,14,6,64,38.244111338113015,-109.3734342
50217,5,25,12,12,13,5,72,38.244111338113015,-109.3731647
50218,3,24,10,8,6,8,59,38.244111338113015,-109.3728952
50219,5,31,9,4,9,3,61,38.244111338113015,-109.3726257
50220,1,38,6,4,8,3,60,38.244111338113015,-109.3723562
50221,2,38,6,3,7,5,61,38.244111338113015,-109.3720867
50222,3,39,6,4,8,4,64,38.244111338113015,-109.3718172
50223,3,30,7,6,8,6,60,38.244111338113015,-109.3715477
50224,3,26,10,5,5,10,59,38.244111338113015,-109.3712782
50225,2,14,10,6,8,11,51,38.244111338113015,-109.3710087
50226,2,20,12,1,4,18,57,38.244111338113015,-109.3707392
50227,0,17,13,0,1,25,56,38.244111338113015,-109.3704697
50228,1,21,12,1,4,19,58,38.244111338113015,-109.3702003
50229,2,22,12,2,4,17,59,38.244111338113015,-109.3699308
50230,2,20,12,0,3,20,57,38.244111338113015,-109.3696613
50231,2,18,14,0,1,24,59,38.244111338113015,-109.3693918
50232,1,20,13,2,2,22,60,38.244111338113015,-109.3691223
50233,1,23,12,1,3,20,60,38.244111338113015,-109.3688528
50234,1,26,12,1,3,18,61,38.244111338113015,-109.3685833
50235,2,28,11,1,5,15,62,38.244111338113015,-109.3683138
50236,2,35,9,1,9,10,66,38.244111338113015,-109.3680443
50237,1,27,11,0,4,17,60,38.244111338113015,-109.3677748
50238,1,23,12,0,2,20,58,38.244111338113015,-109.3675053
50239,1,23,12,0,2,21,59,38.244111338113015,-109.3672358
50240,2,24,12,0,3,19,60,38.244111338113015,-109.3669663
50241,1,23,12,1,3,19,59,38.244111338113015,-109.3666968
50242,1,22,12,1,2,20,58,38.244111338113015,-109.3664273
50243,1,21,13,1,2,22,60,38.244111338113015,-109.3661578
50244,1,21,13,1,1,22,59,38.244111338113015,-109.3658883
50245,1,24,12,0,2,20,59,38.244111338113015,-109.3656188
50246,1,23,11,0,2,19,56,38.244111338113015,-109.3653493
50247,1,22,11,0,2,19,55,38.244111338113015,-109.3650799
50248,0,22,11,0,2,19,54,38.244111338113015,-109.3648104
50249,0,23,11,0,3,20,57,38.244111338113015,-109.3645409
50250,1,25,13,1,3,21,64,38.244111338113015,-109.3642714
50251,2,31,13,2,5,20,73,38.244111338113015,-109.3640019
50252,3,37,12,2,8,17,79,38.244111338113015,-109.3637324
50253,2,37,12,1,9,15,76,38.244111338113015,-109.3634629
50254,2,30,11,2,5,18,68,38.244111338113015,-109.3631934
50255,1,22,12,2,3,19,59,38.244111338113015,-109.3629239
50256,1,19,12,4,3,17,56,38.244111338113015,-109.3626544
50257,3,20,8,3,6,11,51,38.244111338113015,-109.3623849
50258,4,30,7,3,8,4,56,38.244111338113015,-109.3621154
50259,4,27,8,2,6,7,54,38.244111338113015,-109.3618459
50260,12,22,13,6,5,8,66,38.244111338113015,-109.3615764
50261,2,20,9,4,6,11,52,38.244111338113015,-109.3613069
50262,3,30,6,5,7,5,56,38.244111338113015,-109.3610374
50263,4,31,6,5,8,3,57,38.244111338113015,-109.3607679
50264,5,25,7,3,7,7,54,38.244111338113015,-109.3604984
50265,4,29,8,5,8,7,61,38.244111338113015,-109.360229
50266,2,32,13,2,6,15,70,38.244111338113015,-109.3599595
50267,2,33,12,1,6,17,71,38.244111338113015,-109.35969
50268,2,34,12,3,8,14,73,38.244111338113015,-109.3594205
50269,2,29,11,3,5,16,66,38.244111338113015,-109.359151
50270,1,30,10,2,7,15,65,38.244111338113015,-109.3588815
50271,0,39,8,1,8,9,65,38.244111338113015,-109.358612
50272,1,44,8,2,10,6,71,38.244111338113015,-109.3583425
50273,4,47,8,7,10,3,79,38.244111338113015,-109.358073
50274,2,40,8,5,10,6,71,38.244111338113015,-109.3578035
50275,1,40,9,2,10,7,69,38.244111338113015,-109.357534
50276,1,45,9,0,12,7,74,38.244111338113015,-109.3572645
50277,0,48,8,0,13,5,74,38.244111338113015,-109.356995
50278,1,53,8,0,16,2,80,38.244111338113015,-109.3567255
50279,0,50,9,1,14,3,77,38.244111338113015,-109.356456
50280,1,34,8,3,9,5,60,38.244111338113015,-109.3561865
50281,1,30,8,4,5,7,55,38.244111338113015,-109.355917
50282,3,30,9,5,6,5,58,38.244111338113015,-109.3556475
50283,2,28,9,6,10,4,59,38.244111338113015,-109.355378
50284,3,20,13,8,6,14,64,38.244111338113015,-109.3551086
50285,6,20,15,10,7,14,72,38.244111338113015,-109.3548391
50286,12,26,15,11,8,10,82,38.244111338113015,-109.3545696
50287,6,27,13,9,9,11,75,38.244111338113015,-109.3543001
50288,3,30,12,0,6,17,68,38.244111338113015,-109.3540306
50289,2,26,10,2,7,12,59,38.244111338113015,-109.3537611
50290,2,31,10,2,7,10,62,38.244111338113015,-109.3534916
50291,4,36,9,3,6,6,64,38.244111338113015,-109.3532221
50292,2,30,9,5,7,6,59,38.244111338113015,-109.3529526
50293,4,21,11,8,7,9,60,38.244111338113015,-109.3526831
50294,14,17,15,11,8,12,77,38.244111338113015,-109.3524136
50295,17,15,15,12,12,15,86,38.244111338113015,-109.3521441
50296,2,19,13,10,10,21,75,38.244111338113015,-109.3518746
50297,3,26,10,6,10,8,63,38.244111338113015,-109.3516051
50298,4,34,10,4,8,6,66,38.244111338113015,-109.3513356
50299,3,31,9,5,7,6,61,38.244111338113015,-109.3510661
50300,2,23,7,4,9,5,50,38.244111338113015,-109.3507966
50301,1,23,7,4,10,5,50,38.244111338113015,-109.3505271
50302,3,17,9,9,10,6,54,38.244111338113015,-109.3502577
50303,9,19,13,16,11,5,73,38.244111338113015,-109.3499882
50304,16,20,15,18,11,1,81,38.244111338113015,-109.3497187
50305,23,21,16,15,9,2,86,38.244111338113015,-109.3494492
50306,28,21,14,13,10,1,87,38.244111338113015,-109.3491797
50307,30,20,13,13,10,0,86,38.244111338113015,-109.3489102
50308,31,18,13,20,10,1,93,38.244111338113015,-109.3486407
50309,30,16,13,27,8,1,95,38.244111338113015,-109.3483712
50310,31,12,13,24,9,3,92,38.244111338113015,-109.3481017
50311,30,11,11,27,12,1,92,38.244111338113015,-109.3478322
50312,35,13,9,23,13,1,94,38.244111338113015,-109.3475627
50313,30,16,9,19,14,3,91,38.244111338113015,-109.3472932
50314,12,18,11,22,16,4,83,38.244111338113015,-109.3470237
50315,4,23,12,18,16,7,80,38.244111338113015,-109.3467542
50316,2,25,13,11,13,12,76,38.244111338113015,-109.3464847
50317,1,28,12,9,14,10,74,38.244111338113015,-109.3462152
50318,1,31,12,7,16,8,75,38.244111338113015,-109.3459457
50319,2,32,12,5,16,9,76,38.244111338113015,-109.3456762
50320,1,29,12,2,8,17,69,38.244111338113015,-109.3454068
50321,1,29,11,2,9,15,67,38.244111338113015,-109.3451373
50322,1,24,10,5,9,11,60,38.244111338113015,-109.3448678
50323,1,24,10,4,7,10,56,38.244111338113015,-109.3445983
50324,1,26,10,1,7,12,57,38.244111338113015,-109.3443288
50325,2,29,10,1,8,11,61,38.244111338113015,-109.3440593
50326,2,28,10,2,7,12,61,38.244111338113015,-109.3437898
50327,2,29,11,1,8,13,64,38.244111338113015,-109.3435203
50328,2,32,12,0,9,15,70,38.244111338113015,-109.3432508
50329,3,32,13,0,8,17,73,38.244111338113015,-109.3429813
50330,1,30,15,0,5,23,74,38.244111338113015,-109.3427118
50331,0,29,13,0,5,23,70,38.244111338113015,-109.3424423
50332,0,30,13,0,7,21,71,38.244111338113015,-109.3421728
50333,1,31,14,0,7,20,73,38.244111338113015,-109.3419033
50334,0,28,13,0,7,21,69,38.244111338113015,-109.3416338
50335,1,30,13,0,8,18,70,38.244111338113015,-109.3413643
50336,1,29,12,0,7,18,67,38.244111338113015,-109.3410948
50337,3,33,12,0,8,16,72,38.244111338113015,-109.3408253
50338,4,36,12,0,8,15,75,38.244111338113015,-109.3405558
50339,3,34,12,0,8,17,74,38.244111338113015,-109.3402864
50340,2,33,12,0,8,18,73,38.244111338113015,-109.3400169
50341,1,31,12,0,7,20,71,38.244111338113015,-109.3397474
50342,0,29,13,0,6,22,70,38.244111338113015,-109.3394779
50343,1,29,13,0,7,22,72,38.244111338113015,-109.3392084
50344,2,32,14,0,7,21,76,38.244111338113015,-109.3389389
50345,2,31,13,0,8,19,73,38.244111338113015,-109.3386694
50346,2,30,13,0,7,19,71,38.244111338113015,-109.3383999
50347,2,31,13,0,6,21,73,38.244111338113015,-109.3381304
50348,1,28,13,0,4,22,68,38.244111338113015,-109.3378609
50349,2,29,13,0,5,21,70,38.244111338113015,-109.3375914
50350,0,27,12,0,5,22,66,38.244111338113015,-109.3373219
50351,1,29,11,0,7,17,65,38.244111338113015,-109.3370524
50352,1,34,9,1,7,9,61,38.244111338113015,-109.3367829
50353,0,47,5,1,9,4,66,38.244111338113015,-109.3365134
50354,1,42,5,3,8,4,63,38.244111338113015,-109.3362439
50355,2,46,6,3,8,4,69,38.244111338113015,-109.3359744
50356,1,42,6,3,8,4,64,38.244111338113015,-109.3357049
50357,7,34,7,4,9,4,65,38.244111338113015,-109.3354355
50358,4,23,8,5,6,10,56,38.244111338113015,-109.335166
50359,6,16,9,4,3,15,53,38.244111338113015,-109.3348965
50360,4,17,13,6,7,17,64,38.244111338113015,-109.334627
50361,0,21,13,3,7,21,65,38.244111338113015,-109.3343575
50362,9,31,13,10,14,5,82,38.244111338113015,-109.334088
50363,2,22,12,5,10,11,62,38.244111338113015,-109.3338185
50364,1,23,11,6,10,10,61,38.244111338113015,-109.333549
50365,0,22,11,4,8,16,61,38.244111338113015,-109.3332795
50366,0,20,12,1,4,20,57,38.244111338113015,-109.33301
50367,1,23,11,4,10,12,61,38.244111338113015,-109.3327405
50368,0,25,10,5,9,10,59,38.244111338113015,-109.332471
50369,1,36,8,4,10,5,64,38.244111338113015,-109.3322015
50370,3,43,6,5,10,3,70,38.244111338113015,-109.331932
50371,2,40,6,5,9,4,66,38.244111338113015,-109.3316625
50372,22,25,11,17,17,1,93,38.243841843527775,-109.4402688
50373,22,27,11,15,15,1,91,38.243841843527775,-109.4399993
50374,15,30,12,14,14,3,88,38.243841843527775,-109.4397299
50375,17,29,11,14,14,4,89,38.243841843527775,-109.4394604
50376,22,28,11,13,15,2,91,38.243841843527775,-109.4391909
50377,23,27,12,14,17,2,95,38.243841843527775,-109.4389214
50378,16,24,12,22,18,2,94,38.243841843527775,-109.4386519
50379,12,22,12,22,20,4,92,38.243841843527775,-109.4383824
50380,8,20,11,26,22,4,91,38.243841843527775,-109.4381129
50381,6,28,11,17,19,4,85,38.243841843527775,-109.4378434
50382,1,34,10,0,9,13,67,38.243841843527775,-109.4375739
50383,1,38,10,0,10,12,71,38.243841843527775,-109.4373044
50384,1,37,10,0,9,15,72,38.243841843527775,-109.4370349
50385,1,36,10,0,10,15,72,38.243841843527775,-109.4367654
50386,2,38,11,1,12,12,76,38.243841843527775,-109.4364959
50387,2,40,11,0,12,12,77,38.243841843527775,-109.4362264
50388,2,39,12,3,13,8,77,38.243841843527775,-109.4359569
50389,3,40,12,7,15,4,81,38.243841843527775,-109.4356874
50390,4,41,12,10,14,2,83,38.243841843527775,-109.4354179
50391,6,42,13,11,14,2,88,38.243841843527775,-109.4351484
50392,4,43,13,8,16,2,86,38.243841843527775,-109.434879
50393,5,43,13,8,15,2,86,38.243841843527775,-109.4346095
50394,5,42,12,9,16,1,85,38.243841843527775,-109.43434
50395,4,39,12,7,16,3,81,38.243841843527775,-109.4340705
50396,4,39,12,7,14,4,80,38.243841843527775,-109.433801
50397,6,41,12,11,14,1,85,38.243841843527775,-109.4335315
50398,7,39,13,15,12,1,87,38.243841843527775,-109.433262
50399,9,38,14,17,12,1,91,38.243841843527775,-109.4329925
50400,10,38,14,17,12,1,92,38.243841843527775,-109.432723
50401,9,38,13,17,12,1,90,38.243841843527775,-109.4324535
50402,5,41,12,13,13,1,85,38.243841843527775,-109.432184
50403,5,42,12,12,14,1,86,38.243841843527775,-109.4319145
50404,6,42,12,9,15,2,86,38.243841843527775,-109.431645
50405,4,38,12,6,14,5,79,38.243841843527775,-109.4313755
50406,3,34,11,8,13,6,75,38.243841843527775,-109.431106
50407,3,35,11,5,14,7,75,38.243841843527775,-109.4308365
50408,5,41,11,6,16,3,82,38.243841843527775,-109.430567
50409,9,44,12,10,16,0,91,38.243841843527775,-109.4302975
50410,8,46,12,8,16,0,90,38.243841843527775,-109.430028
50411,4,44,11,3,15,4,81,38.243841843527775,-109.4297586
50412,3,41,10,2,14,7,77,38.243841843527775,-109.4294891
50413,3,41,11,4,15,5,79,38.243841843527775,-109.4292196
50414,3,42,12,6,16,4,83,38.243841843527775,-109.4289501
50415,3,43,12,7,15,3,83,38.243841843527775,-109.4286806
50416,4,44,12,10,15,1,86,38.243841843527775,-109.4284111
50417,6,42,13,13,14,1,89,38.243841843527775,-109.4281416
50418,7,41,14,15,14,1,92,38.243841843527775,-109.4278721
50419,8,40,14,17,14,0,93,38.243841843527775,-109.4276026
50420,6,40,14,16,14,1,91,38.243841843527775,-109.4273331
50421,7,40,14,15,14,0,90,38.243841843527775,-109.4270636
50422,7,39,14,15,14,1,90,38.243841843527775,-109.4267941
50423,8,38,14,16,14,1,91,38.243841843527775,-109.4265246
50424,10,38,14,16,14,0,92,38.243841843527775,-109.4262551
50425,10,38,14,14,14,1,91,38.243841843527775,-109.4259856
50426,11,40,14,14,14,0,93,38.243841843527775,-109.4257161
50427,12,38,14,14,14,0,92,38.243841843527775,-109.4254466
50428,11,38,14,12,14,1,90,38.243841843527775,-109.4251771
50429,8,43,13,10,14,3,91,38.243841843527775,-109.4249077
50430,6,45,13,9,12,3,88,38.243841843527775,-109.4246382
50431,6,43,12,8,12,3,84,38.243841843527775,-109.4243687
50432,7,43,12,8,13,3,86,38.243841843527775,-109.4240992
50433,9,43,13,10,13,2,90,38.243841843527775,-109.4238297
50434,9,41,13,10,12,2,87,38.243841843527775,-109.4235602
50435,9,39,13,11,12,2,86,38.243841843527775,-109.4232907
50436,8,40,12,10,11,2,83,38.243841843527775,-109.4230212
50437,7,42,12,9,11,2,83,38.243841843527775,-109.4227517
50438,6,45,11,8,11,1,82,38.243841843527775,-109.4224822
50439,4,51,10,6,12,1,84,38.243841843527775,-109.4222127
50440,4,53,8,5,11,1,82,38.243841843527775,-109.4219432
50441,5,49,10,7,12,1,84,38.243841843527775,-109.4216737
50442,5,48,11,8,13,2,87,38.243841843527775,-109.4214042
50443,4,52,10,4,12,4,86,38.243841843527775,-109.4211347
50444,2,53,8,2,11,5,81,38.243841843527775,-109.4208652
50445,1,54,8,2,12,4,81,38.243841843527775,-109.4205957
50446,0,51,7,1,11,4,74,38.243841843527775,-109.4203262
50447,0,44,6,1,8,4,63,38.243841843527775,-109.4200568
50448,1,40,6,3,7,3,60,38.243841843527775,-109.4197873
50449,1,41,6,3,7,3,61,38.243841843527775,-109.4195178
50450,1,40,6,3,7,4,61,38.243841843527775,-109.4192483
50451,1,42,6,2,7,3,61,38.243841843527775,-109.4189788
50452,2,45,7,3,8,2,67,38.243841843527775,-109.4187093
50453,2,42,7,1,8,4,64,38.243841843527775,-109.4184398
50454,2,35,8,3,10,5,63,38.243841843527775,-109.4181703
50455,3,30,10,6,9,7,65,38.243841843527775,-109.4179008
50456,6,32,13,13,13,4,81,38.243841843527775,-109.4176313
50457,19,30,14,18,14,1,96,38.243841843527775,-109.4173618
50458,31,21,12,20,8,1,93,38.243841843527775,-109.4170923
50459,24,19,11,25,12,1,92,38.243841843527775,-109.4168228
50460,16,23,12,23,15,2,91,38.243841843527775,-109.4165533
50461,14,30,13,19,14,1,91,38.243841843527775,-109.4162838
50462,11,35,12,17,13,2,90,38.243841843527775,-109.4160143
50463,11,30,11,19,14,2,87,38.243841843527775,-109.4157448
50464,6,27,12,14,14,6,79,38.243841843527775,-109.4154753
50465,2,26,12,6,13,8,67,38.243841843527775,-109.4152058
50466,1,32,10,2,12,8,65,38.243841843527775,-109.4149364
50467,0,34,9,1,9,8,61,38.243841843527775,-109.4146669
50468,1,37,9,2,8,8,65,38.243841843527775,-109.4143974
50469,1,39,9,4,9,6,68,38.243841843527775,-109.4141279
50470,1,43,8,4,10,4,70,38.243841843527775,-109.4138584
50471,1,47,8,2,11,4,73,38.243841843527775,-109.4135889
50472,1,53,8,2,12,2,78,38.243841843527775,-109.4133194
50473,1,52,9,1,16,3,82,38.243841843527775,-109.4130499
50474,2,47,10,1,18,3,81,38.243841843527775,-109.4127804
50475,6,48,11,4,17,2,88,38.243841843527775,-109.4125109
50476,7,51,12,8,15,1,94,38.243841843527775,-109.4122414
50477,5,47,13,10,16,1,92,38.243841843527775,-109.4119719
50478,6,45,14,11,14,1,91,38.243841843527775,-109.4117024
50479,6,45,14,10,13,2,90,38.243841843527775,-109.4114329
50480,6,46,13,9,13,2,89,38.243841843527775,-109.4111634
50481,7,43,13,9,12,2,86,38.243841843527775,-109.4108939
50482,9,41,14,11,13,1,89,38.243841843527775,-109.4106244
50483,11,39,14,12,13,1,90,38.243841843527775,-109.4103549
50484,13,39,13,11,14,1,91,38.243841843527775,-109.4100855
50485,14,38,13,12,13,1,91,38.243841843527775,-109.409816
50486,14,37,14,12,13,0,90,38.243841843527775,-109.4095465
50487,16,36,14,12,13,0,91,38.243841843527775,-109.409277
50488,17,35,14,13,13,0,92,38.243841843527775,-109.4090075
50489,18,34,14,13,13,0,92,38.243841843527775,-109.408738
50490,20,33,14,11,13,0,91,38.243841843527775,-109.4084685
50491,19,34,14,13,12,0,92,38.243841843527775,-109.408199
50492,18,35,13,12,13,0,91,38.243841843527775,-109.4079295
50493,16,36,13,12,14,0,91,38.243841843527775,-109.40766
50494,14,37,14,13,14,0,92,38.243841843527775,-109.4073905
50495,13,38,14,12,14,0,91,38.243841843527775,-109.407121
50496,14,39,13,11,13,0,90,38.243841843527775,-109.4068515
50497,16,38,14,12,13,0,93,38.243841843527775,-109.406582
50498,17,37,13,11,12,0,90,38.243841843527775,-109.4063125
50499,17,38,13,11,12,0,91,38.243841843527775,-109.406043
50500,15,37,13,12,13,0,90,38.243841843527775,-109.4057735
50501,15,37,13,12,13,0,90,38.243841843527775,-109.405504
50502,18,32,13,13,13,0,89,38.243841843527775,-109.4052345
50503,20,30,14,14,12,0,90,38.243841843527775,-109.4049651
50504,19,30,13,14,12,0,88,38.243841843527775,-109.4046956
50505,18,31,14,14,12,0,89,38.243841843527775,-109.4044261
50506,16,31,14,14,13,0,88,38.243841843527775,-109.4041566
50507,17,31,14,13,13,1,89,38.243841843527775,-109.4038871
50508,18,32,13,12,13,1,89,38.243841843527775,-109.4036176
50509,16,32,13,12,14,1,88,38.243841843527775,-109.4033481
50510,16,32,13,11,14,1,87,38.243841843527775,-109.4030786
50511,16,33,13,10,14,1,87,38.243841843527775,-109.4028091
50512,13,37,13,10,15,1,89,38.243841843527775,-109.4025396
50513,10,40,13,11,15,1,90,38.243841843527775,-109.4022701
50514,11,37,13,11,14,2,88,38.243841843527775,-109.4020006
50515,13,35,13,13,13,1,88,38.243841843527775,-109.4017311
50516,13,35,13,13,13,1,88,38.243841843527775,-109.4014616
50517,12,38,13,13,14,1,91,38.243841843527775,-109.4011921
50518,12,40,13,12,14,0,91,38.243841843527775,-109.4009226
50519,11,39,13,12,14,1,90,38.243841843527775,-109.4006531
50520,8,42,13,11,14,1,89,38.243841843527775,-109.4003836
50521,6,43,13,10,13,2,87,38.243841843527775,-109.4001142
50522,5,43,13,9,13,3,86,38.243841843527775,-109.3998447
50523,5,45,13,8,13,3,87,38.243841843527775,-109.3995752
50524,4,44,13,8,13,3,85,38.243841843527775,-109.3993057
50525,4,42,13,8,13,3,83,38.243841843527775,-109.3990362
50526,4,42,13,8,14,3,84,38.243841843527775,-109.3987667
50527,4,42,13,8,14,4,85,38.243841843527775,-109.3984972
50528,4,40,13,9,13,3,82,38.243841843527775,-109.3982277
50529,5,40,14,10,13,3,85,38.243841843527775,-109.3979582
50530,5,41,14,10,13,3,86,38.243841843527775,-109.3976887
50531,5,44,13,8,14,2,86,38.243841843527775,-109.3974192
50532,5,45,13,7,15,2,87,38.243841843527775,-109.3971497
50533,5,44,13,7,15,2,86,38.243841843527775,-109.3968802
50534,6,44,13,8,15,2,88,38.243841843527775,-109.3966107
50535,6,44,13,8,15,1,87,38.243841843527775,-109.3963412
50536,7,44,13,8,15,1,88,38.243841843527775,-109.3960717
50537,6,44,14,8,16,1,89,38.243841843527775,-109.3958022
50538,10,44,14,9,15,0,92,38.243841843527775,-109.3955327
50539,12,43,14,10,14,0,93,38.243841843527775,-109.3952632
50540,13,42,14,10,14,0,93,38.243841843527775,-109.3949938
50541,13,41,14,11,14,0,93,38.243841843527775,-109.3947243
50542,12,41,14,11,14,1,93,38.243841843527775,-109.3944548
50543,9,42,14,11,14,1,91,38.243841843527775,-109.3941853
50544,9,42,14,12,15,1,93,38.243841843527775,-109.3939158
50545,8,43,14,11,15,0,91,38.243841843527775,-109.3936463
50546,7,45,14,12,16,0,94,38.243841843527775,-109.3933768
50547,6,47,13,11,16,0,93,38.243841843527775,-109.3931073
50548,5,47,13,10,17,0,92,38.243841843527775,-109.3928378
50549,5,47,14,10,17,0,93,38.243841843527775,-109.3925683
50550,5,47,14,9,17,1,93,38.243841843527775,-109.3922988
50551,5,46,14,11,17,0,93,38.243841843527775,-109.3920293
50552,4,46,15,11,16,0,92,38.243841843527775,-109.3917598
50553,5,45,14,11,17,1,93,38.243841843527775,-109.3914903
50554,5,45,14,11,16,1,92,38.243841843527775,-109.3912208
50555,6,45,14,12,16,0,93,38.243841843527775,-109.3909513
50556,5,45,15,11,16,1,93,38.243841843527775,-109.3906818
50557,5,45,15,11,16,1,93,38.243841843527775,-109.3904123
50558,6,43,15,12,15,2,93,38.243841843527775,-109.3901429
50559,6,40,14,13,14,2,89,38.243841843527775,-109.3898734
50560,6,37,13,15,14,2,87,38.243841843527775,-109.3896039
50561,8,38,14,16,15,1,92,38.243841843527775,-109.3893344
50562,7,41,15,15,15,1,94,38.243841843527775,-109.3890649
50563,7,42,15,15,15,1,95,38.243841843527775,-109.3887954
50564,7,41,15,15,15,1,94,38.243841843527775,-109.3885259
50565,7,40,15,15,15,1,93,38.243841843527775,-109.3882564
50566,8,40,15,15,14,1,93,38.243841843527775,-109.3879869
50567,9,39,15,14,14,1,92,38.243841843527775,-109.3877174
50568,9,38,15,14,14,1,91,38.243841843527775,-109.3874479
50569,10,37,14,14,13,1,89,38.243841843527775,-109.3871784
50570,11,36,14,15,13,1,90,38.243841843527775,-109.3869089
50571,11,35,14,14,14,1,89,38.243841843527775,-109.3866394
50572,12,35,14,14,14,1,90,38.243841843527775,-109.3863699
50573,13,35,14,14,13,1,90,38.243841843527775,-109.3861004
50574,14,36,13,13,13,1,90,38.243841843527775,-109.3858309
50575,17,35,13,13,12,0,90,38.243841843527775,-109.3855614
50576,17,34,13,12,12,1,89,38.243841843527775,-109.3852919
50577,15,36,14,13,12,1,91,38.243841843527775,-109.3850225
50578,11,39,14,13,13,1,91,38.243841843527775,-109.384753
50579,10,41,14,12,13,1,91,38.243841843527775,-109.3844835
50580,13,37,13,12,13,1,89,38.243841843527775,-109.384214
50581,15,35,13,12,13,1,89,38.243841843527775,-109.3839445
50582,17,34,13,13,12,1,90,38.243841843527775,-109.383675
50583,17,35,13,14,11,0,90,38.243841843527775,-109.3834055
50584,17,36,13,14,11,0,91,38.243841843527775,-109.383136
50585,15,36,13,12,12,1,89,38.243841843527775,-109.3828665
50586,11,37,13,11,13,1,86,38.243841843527775,-109.382597
50587,9,37,12,10,14,2,84,38.243841843527775,-109.3823275
50588,9,37,13,11,13,2,85,38.243841843527775,-109.382058
50589,14,30,12,10,11,4,81,38.243841843527775,-109.3817885
50590,14,22,11,17,11,1,76,38.243841843527775,-109.381519
50591,12,26,11,19,10,1,79,38.243841843527775,-109.3812495
50592,12,34,12,12,10,3,83,38.243841843527775,-109.38098
50593,9,42,14,10,12,3,90,38.243841843527775,-109.3807105
50594,8,42,13,9,11,4,87,38.243841843527775,-109.380441
50595,7,42,13,9,12,4,87,38.243841843527775,-109.3801716
50596,6,43,13,8,13,4,87,38.243841843527775,-109.3799021
50597,6,46,13,6,14,3,88,38.243841843527775,-109.3796326
50598,7,47,13,8,14,2,91,38.243841843527775,-109.3793631
50599,10,45,13,10,13,1,92,38.243841843527775,-109.3790936
50600,11,43,13,10,12,1,90,38.243841843527775,-109.3788241
50601,10,43,13,11,12,2,91,38.243841843527775,-109.3785546
50602,10,43,13,12,11,1,90,38.243841843527775,-109.3782851
50603,10,47,13,11,11,1,93,38.243841843527775,-109.3780156
50604,3,51,10,1,13,6,84,38.243841843527775,-109.3777461
50605,1,43,9,2,11,7,73,38.243841843527775,-109.3774766
50606,1,41,8,2,12,6,70,38.243841843527775,-109.3772071
50607,0,50,6,3,10,4,73,38.243841843527775,-109.3769376
50608,1,55,6,4,10,2,78,38.243841843527775,-109.3766681
50609,2,47,7,5,9,4,74,38.243841843527775,-109.3763986
50610,2,42,8,5,10,6,73,38.243841843527775,-109.3761291
50611,1,26,9,4,6,11,57,38.243841843527775,-109.3758596
50612,0,34,11,2,14,11,72,38.243841843527775,-109.3755901
50613,1,34,10,12,12,4,73,38.243841843527775,-109.3753206
50614,1,38,9,13,10,2,73,38.243841843527775,-109.3750512
50615,0,37,9,10,11,4,71,38.243841843527775,-109.3747817
50616,0,34,9,10,13,3,69,38.243841843527775,-109.3745122
50617,0,34,10,5,18,7,74,38.243841843527775,-109.3742427
50618,1,31,11,3,16,10,72,38.243841843527775,-109.3739732
50619,0,25,10,2,10,15,62,38.243841843527775,-109.3737037
50620,2,19,11,6,6,11,55,38.243841843527775,-109.3734342
50621,7,34,8,5,4,6,64,38.243841843527775,-109.3731647
50622,4,34,6,5,8,3,60,38.243841843527775,-109.3728952
50623,1,44,5,3,9,2,64,38.243841843527775,-109.3726257
50624,1,41,5,2,9,2,60,38.243841843527775,-109.3723562
50625,2,38,6,3,8,6,63,38.243841843527775,-109.3720867
50626,4,36,8,8,10,5,71,38.243841843527775,-109.3718172
50627,2,31,7,5,9,6,60,38.243841843527775,-109.3715477
50628,1,23,8,6,6,7,51,38.243841843527775,-109.3712782
50629,2,14,10,6,7,9,48,38.243841843527775,-109.3710087
50630,2,15,11,5,7,13,53,38.243841843527775,-109.3707392
50631,1,19,13,0,3,21,57,38.243841843527775,-109.3704697
50632,1,19,13,2,4,20,59,38.243841843527775,-109.3702003
50633,1,18,13,1,3,20,56,38.243841843527775,-109.3699308
50634,1,20,13,0,2,22,58,38.243841843527775,-109.3696613
50635,3,21,14,0,0,24,62,38.243841843527775,-109.3693918
50636,1,22,12,0,3,19,57,38.243841843527775,-109.3691223
50637,1,23,11,1,3,17,56,38.243841843527775,-109.3688528
50638,1,25,10,0,4,16,56,38.243841843527775,-109.3685833
50639,2,27,10,2,7,12,60,38.243841843527775,-109.3683138
50640,4,32,10,3,9,7,65,38.243841843527775,-109.3680443
50641,1,24,11,0,4,17,57,38.243841843527775,-109.3677748
50642,1,23,12,0,3,19,58,38.243841843527775,-109.3675053
50643,1,22,12,0,3,19,57,38.243841843527775,-109.3672358
50644,2,23,12,1,4,17,59,38.243841843527775,-109.3669663
50645,2,22,12,2,4,18,60,38.243841843527775,-109.3666968
50646,1,21,12,1,3,20,58,38.243841843527775,-109.3664273
50647,1,21,12,1,2,21,58,38.243841843527775,-109.3661578
50648,1,21,12,1,2,22,59,38.243841843527775,-109.3658883
50649,0,23,11,0,2,20,56,38.243841843527775,-109.3656188
50650,0,23,11,0,3,18,55,38.243841843527775,-109.3653493
50651,0,23,11,0,3,18,55,38.243841843527775,-109.3650799
50652,1,24,11,0,4,18,58,38.243841843527775,-109.3648104
50653,1,25,11,0,4,18,59,38.243841843527775,-109.3645409
50654,2,28,12,0,5,17,64,38.243841843527775,-109.3642714
50655,2,32,12,2,6,18,72,38.243841843527775,-109.3640019
50656,3,31,13,2,5,19,73,38.243841843527775,-109.3637324
50657,2,29,12,2,4,21,70,38.243841843527775,-109.3634629
50658,1,26,11,2,3,20,63,38.243841843527775,-109.3631934
50659,1,28,10,3,6,13,61,38.243841843527775,-109.3629239
50660,2,25,8,3,6,10,54,38.243841843527775,-109.3626544
50661,2,26,7,4,8,5,52,38.243841843527775,-109.3623849
50662,6,35,7,4,8,3,63,38.243841843527775,-109.3621154
50663,5,26,10,6,8,5,60,38.243841843527775,-109.3618459
50664,9,28,11,5,7,6,66,38.243841843527775,-109.3615764
50665,4,28,7,3,6,7,55,38.243841843527775,-109.3613069
50666,2,33,5,4,9,3,56,38.243841843527775,-109.3610374
50667,4,28,6,4,9,4,55,38.243841843527775,-109.3607679
50668,5,29,7,6,8,5,60,38.243841843527775,-109.3604984
50669,3,29,9,4,9,7,61,38.243841843527775,-109.360229
50670,3,34,10,4,9,8,68,38.243841843527775,-109.3599595
50671,3,36,10,4,10,9,72,38.243841843527775,-109.35969
50672,2,37,11,2,10,12,74,38.243841843527775,-109.3594205
50673,3,35,11,1,8,14,72,38.243841843527775,-109.359151
50674,2,27,12,4,5,17,67,38.243841843527775,-109.3588815
50675,0,35,9,2,7,12,65,38.243841843527775,-109.358612
50676,0,40,8,2,9,9,68,38.243841843527775,-109.3583425
50677,2,41,8,5,9,7,72,38.243841843527775,-109.358073
50678,2,46,8,6,10,5,77,38.243841843527775,-109.3578035
50679,1,47,9,4,12,3,76,38.243841843527775,-109.357534
50680,1,45,9,2,14,5,76,38.243841843527775,-109.3572645
50681,1,39,9,1,14,7,71,38.243841843527775,-109.356995
50682,1,55,8,0,14,3,81,38.243841843527775,-109.3567255
50683,0,52,7,1,12,4,76,38.243841843527775,-109.356456
50684,1,32,8,3,8,5,57,38.243841843527775,-109.3561865
50685,1,27,9,4,5,7,53,38.243841843527775,-109.355917
50686,2,29,8,5,7,5,56,38.243841843527775,-109.3556475
50687,1,26,8,5,7,5,52,38.243841843527775,-109.355378
50688,2,19,11,6,8,10,56,38.243841843527775,-109.3551086
50689,5,16,14,9,6,15,65,38.243841843527775,-109.3548391
50690,14,22,15,13,9,9,82,38.243841843527775,-109.3545696
50691,6,26,13,8,7,13,73,38.243841843527775,-109.3543001
50692,2,28,11,0,4,19,64,38.243841843527775,-109.3540306
50693,2,29,10,1,7,12,61,38.243841843527775,-109.3537611
50694,2,33,9,3,6,8,61,38.243841843527775,-109.3534916
50695,3,33,8,6,9,3,62,38.243841843527775,-109.3532221
50696,3,23,8,7,10,5,56,38.243841843527775,-109.3529526
50697,12,19,13,13,6,7,70,38.243841843527775,-109.3526831
50698,26,17,14,20,9,5,91,38.243841843527775,-109.3524136
50699,22,16,12,18,14,8,90,38.243841843527775,-109.3521441
50700,2,23,12,14,11,13,75,38.243841843527775,-109.3518746
50701,3,30,10,5,9,7,64,38.243841843527775,-109.3516051
50702,5,36,10,4,7,5,67,38.243841843527775,-109.3513356
50703,2,21,9,5,9,7,53,38.243841843527775,-109.3510661
50704,3,19,9,8,11,6,56,38.243841843527775,-109.3507966
50705,7,18,10,12,11,5,63,38.243841843527775,-109.3505271
50706,9,18,14,15,9,7,72,38.243841843527775,-109.3502577
50707,24,19,15,17,13,2,90,38.243841843527775,-109.3499882
50708,28,17,14,19,10,1,89,38.243841843527775,-109.3497187
50709,28,19,13,20,8,2,90,38.243841843527775,-109.3494492
50710,30,17,14,22,8,1,92,38.243841843527775,-109.3491797
50711,27,15,13,26,10,1,92,38.243841843527775,-109.3489102
50712,19,14,13,29,15,1,91,38.243841843527775,-109.3486407
50713,13,14,12,32,18,2,91,38.243841843527775,-109.3483712
50714,11,15,11,29,19,4,89,38.243841843527775,-109.3481017
50715,8,19,11,27,16,5,86,38.243841843527775,-109.3478322
50716,4,22,13,16,15,9,79,38.243841843527775,-109.3475627
50717,3,25,13,11,13,10,75,38.243841843527775,-109.3472932
50718,1,28,12,5,11,11,68,38.243841843527775,-109.3470237
50719,1,28,11,4,9,12,65,38.243841843527775,-109.3467542
50720,2,28,11,6,13,7,67,38.243841843527775,-109.3464847
50721,2,26,11,7,12,7,65,38.243841843527775,-109.3462152
50722,1,27,11,6,13,8,66,38.243841843527775,-109.3459457
50723,1,29,11,5,13,9,68,38.243841843527775,-109.3456762
50724,0,27,11,2,8,16,64,38.243841843527775,-109.3454068
50725,1,31,11,0,9,16,68,38.243841843527775,-109.3451373
50726,2,32,11,1,12,10,68,38.243841843527775,-109.3448678
50727,2,30,11,2,11,10,66,38.243841843527775,-109.3445983
50728,1,28,11,1,8,14,63,38.243841843527775,-109.3443288
50729,1,27,11,0,6,16,61,38.243841843527775,-109.3440593
50730,1,26,11,0,6,17,61,38.243841843527775,-109.3437898
50731,1,28,12,0,6,19,66,38.243841843527775,-109.3435203
50732,1,30,12,0,8,17,68,38.243841843527775,-109.3432508
50733,2,30,11,2,11,11,67,38.243841843527775,-109.3429813
50734,1,30,12,0,8,16,67,38.243841843527775,-109.3427118
50735,1,31,12,0,8,18,70,38.243841843527775,-109.3424423
50736,1,33,12,0,8,18,72,38.243841843527775,-109.3421728
50737,1,33,13,0,7,18,72,38.243841843527775,-109.3419033
50738,1,31,12,0,8,18,70,38.243841843527775,-109.3416338
50739,0,32,12,0,10,16,70,38.243841843527775,-109.3413643
50740,1,30,13,0,9,17,70,38.243841843527775,-109.3410948
50741,2,29,13,0,6,20,70,38.243841843527775,-109.3408253
50742,2,28,14,0,4,22,70,38.243841843527775,-109.3405558
50743,2,28,14,0,3,23,70,38.243841843527775,-109.3402864
50744,2,30,13,0,5,21,71,38.243841843527775,-109.3400169
50745,3,30,13,0,5,20,71,38.243841843527775,-109.3397474
50746,3,29,14,0,5,21,72,38.243841843527775,-109.3394779
50747,3,30,14,0,6,21,74,38.243841843527775,-109.3392084
50748,3,34,13,1,7,18,76,38.243841843527775,-109.3389389
50749,2,33,13,0,7,19,74,38.243841843527775,-109.3386694
50750,2,30,13,0,5,21,71,38.243841843527775,-109.3383999
50751,1,27,14,0,3,24,69,38.243841843527775,-109.3381304
50752,2,29,14,0,3,24,72,38.243841843527775,-109.3378609
50753,1,30,13,0,5,22,71,38.243841843527775,-109.3375914
50754,0,30,13,0,6,21,70,38.243841843527775,-109.3373219
50755,0,28,9,0,11,12,60,38.243841843527775,-109.3370524
50756,3,45,8,8,9,2,75,38.243841843527775,-109.3367829
50757,0,47,5,1,9,3,65,38.243841843527775,-109.3365134
50758,2,50,6,4,8,3,73,38.243841843527775,-109.3362439
50759,2,43,6,4,8,4,67,38.243841843527775,-109.3359744
50760,2,31,6,3,8,6,56,38.243841843527775,-109.3357049
50761,8,28,8,4,9,5,62,38.243841843527775,-109.3354355
50762,4,16,8,2,3,13,46,38.243841843527775,-109.335166
50763,5,17,13,8,8,13,64,38.243841843527775,-109.3348965
50764,2,23,14,5,7,21,72,38.243841843527775,-109.334627
50765,1,27,15,3,8,22,76,38.243841843527775,-109.3343575
50766,8,33,13,8,8,13,83,38.243841843527775,-109.334088
50767,1,25,11,6,10,11,64,38.243841843527775,-109.3338185
50768,1,20,10,5,10,10,56,38.243841843527775,-109.333549
50769,1,23,10,5,9,9,57,38.243841843527775,-109.3332795
50770,1,32,9,4,10,8,64,38.243841843527775,-109.33301
50771,1,35,8,3,11,6,64,38.243841843527775,-109.3327405
50772,1,34,8,3,8,7,61,38.243841843527775,-109.332471
50773,2,36,7,4,9,4,62,38.243841843527775,-109.3322015
50774,3,42,6,5,10,3,69,38.243841843527775,-109.331932
50775,2,40,6,4,8,4,64,38.243841843527775,-109.3316625
50776,17,17,10,22,23,1,90,38.24357234894254,-109.4402688
50777,18,24,12,18,16,1,89,38.24357234894254,-109.4399993
50778,10,28,13,15,15,4,85,38.24357234894254,-109.4397299
50779,10,28,12,14,16,5,85,38.24357234894254,-109.4394604
50780,14,30,12,14,16,3,89,38.24357234894254,-109.4391909
50781,20,31,11,15,15,1,93,38.24357234894254,-109.4389214
50782,20,27,12,16,16,1,92,38.24357234894254,-109.4386519
50783,12,18,10,27,24,2,93,38.24357234894254,-109.4383824
50784,8,15,9,35,25,3,95,38.24357234894254,-109.4381129
50785,2,24,13,15,18,10,82,38.24357234894254,-109.4378434
50786,0,33,13,1,8,20,75,38.24357234894254,-109.4375739
50787,0,32,12,0,9,19,72,38.24357234894254,-109.4373044
50788,0,31,12,0,8,19,70,38.24357234894254,-109.4370349
50789,1,34,11,0,10,17,73,38.24357234894254,-109.4367654
50790,1,37,11,0,13,13,75,38.24357234894254,-109.4364959
50791,2,42,11,1,14,10,80,38.24357234894254,-109.4362264
50792,3,41,12,4,14,5,79,38.24357234894254,-109.4359569
50793,2,45,12,5,15,3,82,38.24357234894254,-109.4356874
50794,3,46,12,9,15,1,86,38.24357234894254,-109.4354179
50795,5,44,12,12,14,1,88,38.24357234894254,-109.4351484
50796,4,44,13,12,15,1,89,38.24357234894254,-109.434879
50797,5,45,13,10,15,1,89,38.24357234894254,-109.4346095
50798,5,45,12,10,15,1,88,38.24357234894254,-109.43434
50799,7,44,13,12,15,0,91,38.24357234894254,-109.4340705
50800,6,42,12,11,14,1,86,38.24357234894254,-109.433801
50801,7,43,12,10,15,1,88,38.24357234894254,-109.4335315
50802,7,42,12,12,14,1,88,38.24357234894254,-109.433262
50803,6,40,12,14,13,1,86,38.24357234894254,-109.4329925
50804,6,39,12,13,13,1,84,38.24357234894254,-109.432723
50805,5,40,12,11,14,2,84,38.24357234894254,-109.4324535
50806,4,40,11,7,13,4,79,38.24357234894254,-109.432184
50807,3,42,11,5,15,4,80,38.24357234894254,-109.4319145
50808,3,39,11,4,15,6,78,38.24357234894254,-109.431645
50809,2,34,11,4,13,9,73,38.24357234894254,-109.4313755
50810,2,32,11,5,12,9,71,38.24357234894254,-109.431106
50811,2,36,11,5,15,6,75,38.24357234894254,-109.4308365
50812,4,43,11,5,17,3,83,38.24357234894254,-109.430567
50813,7,44,12,7,18,1,89,38.24357234894254,-109.4302975
50814,8,42,12,6,17,1,86,38.24357234894254,-109.430028
50815,5,41,11,5,15,4,81,38.24357234894254,-109.4297586
50816,5,41,12,6,16,3,83,38.24357234894254,-109.4294891
50817,5,44,12,8,17,2,88,38.24357234894254,-109.4292196
50818,4,45,12,10,16,1,88,38.24357234894254,-109.4289501
50819,4,43,13,11,14,2,87,38.24357234894254,-109.4286806
50820,5,42,13,13,14,1,88,38.24357234894254,-109.4284111
50821,6,41,13,14,14,1,89,38.24357234894254,-109.4281416
50822,7,40,14,16,14,1,92,38.24357234894254,-109.4278721
50823,6,39,14,17,13,1,90,38.24357234894254,-109.4276026
50824,6,39,14,16,13,1,89,38.24357234894254,-109.4273331
50825,7,38,14,16,14,1,90,38.24357234894254,-109.4270636
50826,8,36,13,14,14,2,87,38.24357234894254,-109.4267941
50827,10,36,13,14,14,1,88,38.24357234894254,-109.4265246
50828,11,35,13,12,14,2,87,38.24357234894254,-109.4262551
50829,13,38,14,12,14,1,92,38.24357234894254,-109.4259856
50830,13,39,14,13,14,1,94,38.24357234894254,-109.4257161
50831,14,36,14,13,14,1,92,38.24357234894254,-109.4254466
50832,13,34,13,12,13,1,86,38.24357234894254,-109.4251771
50833,10,36,13,10,12,4,85,38.24357234894254,-109.4249077
50834,8,39,13,8,12,6,86,38.24357234894254,-109.4246382
50835,11,35,13,11,12,3,85,38.24357234894254,-109.4243687
50836,11,37,12,11,12,2,85,38.24357234894254,-109.4240992
50837,10,40,12,11,12,2,87,38.24357234894254,-109.4238297
50838,8,41,11,10,12,2,84,38.24357234894254,-109.4235602
50839,10,40,13,10,11,2,86,38.24357234894254,-109.4232907
50840,9,40,12,10,11,1,83,38.24357234894254,-109.4230212
50841,7,43,12,9,10,1,82,38.24357234894254,-109.4227517
50842,6,48,11,8,11,1,85,38.24357234894254,-109.4224822
50843,3,52,9,5,12,2,83,38.24357234894254,-109.4222127
50844,4,48,9,7,12,1,81,38.24357234894254,-109.4219432
50845,6,46,11,9,12,1,85,38.24357234894254,-109.4216737
50846,7,47,12,10,12,1,89,38.24357234894254,-109.4214042
50847,4,52,10,5,12,3,86,38.24357234894254,-109.4211347
50848,1,52,9,3,12,4,81,38.24357234894254,-109.4208652
50849,0,51,7,1,12,5,76,38.24357234894254,-109.4205957
50850,0,43,7,1,10,4,65,38.24357234894254,-109.4203262
50851,1,40,6,3,7,4,61,38.24357234894254,-109.4200568
50852,2,44,5,3,7,2,63,38.24357234894254,-109.4197873
50853,2,44,5,3,6,3,63,38.24357234894254,-109.4195178
50854,1,46,5,2,6,3,63,38.24357234894254,-109.4192483
50855,1,45,6,2,6,3,63,38.24357234894254,-109.4189788
50856,2,42,7,3,9,3,66,38.24357234894254,-109.4187093
50857,1,31,9,4,10,5,60,38.24357234894254,-109.4184398
50858,5,24,12,13,11,6,71,38.24357234894254,-109.4181703
50859,11,23,14,13,12,7,80,38.24357234894254,-109.4179008
50860,16,27,13,15,16,3,90,38.24357234894254,-109.4176313
50861,21,24,13,20,15,1,94,38.24357234894254,-109.4173618
50862,22,22,12,23,13,1,93,38.24357234894254,-109.4170923
50863,16,22,12,26,15,2,93,38.24357234894254,-109.4168228
50864,15,25,12,22,15,2,91,38.24357234894254,-109.4165533
50865,13,32,12,19,14,1,91,38.24357234894254,-109.4162838
50866,9,38,11,17,12,1,88,38.24357234894254,-109.4160143
50867,8,27,11,21,14,3,84,38.24357234894254,-109.4157448
50868,3,28,14,9,16,13,83,38.24357234894254,-109.4154753
50869,2,31,12,4,13,11,73,38.24357234894254,-109.4152058
50870,2,35,11,3,13,7,71,38.24357234894254,-109.4149364
50871,1,39,9,4,11,4,68,38.24357234894254,-109.4146669
50872,1,39,8,4,8,5,65,38.24357234894254,-109.4143974
50873,0,40,8,2,9,6,65,38.24357234894254,-109.4141279
50874,0,41,9,2,10,6,68,38.24357234894254,-109.4138584
50875,1,48,8,1,10,4,72,38.24357234894254,-109.4135889
50876,2,56,8,5,12,1,84,38.24357234894254,-109.4133194
50877,1,55,10,4,16,1,87,38.24357234894254,-109.4130499
50878,2,49,10,2,19,2,84,38.24357234894254,-109.4127804
50879,5,47,11,4,18,1,86,38.24357234894254,-109.4125109
50880,7,50,12,8,17,1,95,38.24357234894254,-109.4122414
50881,7,45,14,10,17,0,93,38.24357234894254,-109.4119719
50882,6,44,14,11,14,1,90,38.24357234894254,-109.4117024
50883,5,44,14,10,13,2,88,38.24357234894254,-109.4114329
50884,5,43,13,9,12,3,85,38.24357234894254,-109.4111634
50885,6,43,14,9,11,2,85,38.24357234894254,-109.4108939
50886,7,42,13,10,12,2,86,38.24357234894254,-109.4106244
50887,10,43,13,10,13,1,90,38.24357234894254,-109.4103549
50888,11,43,13,10,14,0,91,38.24357234894254,-109.4100855
50889,11,41,13,12,14,0,91,38.24357234894254,-109.409816
50890,12,39,14,13,13,0,91,38.24357234894254,-109.4095465
50891,14,37,14,13,13,0,91,38.24357234894254,-109.409277
50892,15,36,14,13,13,0,91,38.24357234894254,-109.4090075
50893,16,35,14,13,13,0,91,38.24357234894254,-109.408738
50894,17,34,14,13,13,0,91,38.24357234894254,-109.4084685
50895,18,33,14,14,12,0,91,38.24357234894254,-109.408199
50896,17,35,13,12,13,0,90,38.24357234894254,-109.4079295
50897,15,36,13,12,14,0,90,38.24357234894254,-109.40766
50898,15,37,13,12,14,0,91,38.24357234894254,-109.4073905
50899,15,38,14,12,13,0,92,38.24357234894254,-109.407121
50900,16,39,14,11,13,0,93,38.24357234894254,-109.4068515
50901,17,35,13,12,13,0,90,38.24357234894254,-109.406582
50902,18,35,13,12,13,0,91,38.24357234894254,-109.4063125
50903,18,37,13,11,12,0,91,38.24357234894254,-109.406043
50904,21,34,13,11,13,0,92,38.24357234894254,-109.4057735
50905,19,35,13,12,13,0,92,38.24357234894254,-109.405504
50906,20,32,13,12,13,0,90,38.24357234894254,-109.4052345
50907,20,31,13,12,13,0,89,38.24357234894254,-109.4049651
50908,17,32,13,14,13,0,89,38.24357234894254,-109.4046956
50909,15,32,14,15,13,0,89,38.24357234894254,-109.4044261
50910,15,32,14,14,14,1,90,38.24357234894254,-109.4041566
50911,15,32,13,13,14,1,88,38.24357234894254,-109.4038871
50912,17,32,13,12,13,1,88,38.24357234894254,-109.4036176
50913,17,33,13,12,14,0,89,38.24357234894254,-109.4033481
50914,17,31,13,12,14,0,87,38.24357234894254,-109.4030786
50915,15,33,13,12,14,1,88,38.24357234894254,-109.4028091
50916,14,36,13,12,14,1,90,38.24357234894254,-109.4025396
50917,14,37,13,12,14,0,90,38.24357234894254,-109.4022701
50918,12,36,13,13,15,0,89,38.24357234894254,-109.4020006
50919,11,36,13,11,15,1,87,38.24357234894254,-109.4017311
50920,10,37,13,11,15,1,87,38.24357234894254,-109.4014616
50921,9,38,13,11,15,1,87,38.24357234894254,-109.4011921
50922,10,40,13,12,15,1,91,38.24357234894254,-109.4009226
50923,7,41,13,11,14,2,88,38.24357234894254,-109.4006531
50924,5,44,13,8,13,3,86,38.24357234894254,-109.4003836
50925,4,46,12,7,14,3,86,38.24357234894254,-109.4001142
50926,4,47,13,7,14,2,87,38.24357234894254,-109.3998447
50927,5,47,12,8,14,2,88,38.24357234894254,-109.3995752
50928,4,48,12,6,14,3,87,38.24357234894254,-109.3993057
50929,4,46,13,5,14,4,86,38.24357234894254,-109.3990362
50930,3,45,12,6,14,4,84,38.24357234894254,-109.3987667
50931,3,43,12,6,13,5,82,38.24357234894254,-109.3984972
50932,4,41,13,6,12,5,81,38.24357234894254,-109.3982277
50933,4,40,13,8,12,3,80,38.24357234894254,-109.3979582
50934,5,41,13,8,13,3,83,38.24357234894254,-109.3976887
50935,6,43,14,8,14,2,87,38.24357234894254,-109.3974192
50936,5,44,13,7,14,2,85,38.24357234894254,-109.3971497
50937,5,45,13,6,14,3,86,38.24357234894254,-109.3968802
50938,5,44,13,7,15,2,86,38.24357234894254,-109.3966107
50939,5,43,13,8,15,2,86,38.24357234894254,-109.3963412
50940,6,44,14,8,15,2,89,38.24357234894254,-109.3960717
50941,6,45,14,8,15,2,90,38.24357234894254,-109.3958022
50942,8,44,14,8,15,1,90,38.24357234894254,-109.3955327
50943,10,45,13,8,15,0,91,38.24357234894254,-109.3952632
50944,10,45,13,8,15,0,91,38.24357234894254,-109.3949938
50945,9,44,13,10,15,0,91,38.24357234894254,-109.3947243
50946,10,43,14,10,15,0,92,38.24357234894254,-109.3944548
50947,9,43,14,11,15,0,92,38.24357234894254,-109.3941853
50948,8,43,14,11,16,0,92,38.24357234894254,-109.3939158
50949,8,44,14,10,16,0,92,38.24357234894254,-109.3936463
50950,6,45,14,10,17,0,92,38.24357234894254,-109.3933768
50951,5,47,14,9,17,1,93,38.24357234894254,-109.3931073
50952,4,47,14,8,18,1,92,38.24357234894254,-109.3928378
50953,4,46,14,8,18,1,91,38.24357234894254,-109.3925683
50954,4,46,14,8,17,1,90,38.24357234894254,-109.3922988
50955,4,45,14,10,17,1,91,38.24357234894254,-109.3920293
50956,5,45,14,11,16,1,92,38.24357234894254,-109.3917598
50957,5,45,15,11,16,1,93,38.24357234894254,-109.3914903
50958,6,44,15,11,16,1,93,38.24357234894254,-109.3912208
50959,6,43,15,13,16,1,94,38.24357234894254,-109.3909513
50960,6,44,15,12,16,1,94,38.24357234894254,-109.3906818
50961,6,43,15,13,16,1,94,38.24357234894254,-109.3904123
50962,6,40,14,12,15,2,89,38.24357234894254,-109.3901429
50963,5,37,13,13,13,4,85,38.24357234894254,-109.3898734
50964,5,37,12,15,13,2,84,38.24357234894254,-109.3896039
50965,7,38,14,16,14,1,90,38.24357234894254,-109.3893344
50966,7,41,15,14,15,2,94,38.24357234894254,-109.3890649
50967,7,41,15,13,14,2,92,38.24357234894254,-109.3887954
50968,8,40,15,14,14,2,93,38.24357234894254,-109.3885259
50969,8,39,15,13,14,2,91,38.24357234894254,-109.3882564
50970,8,39,15,14,14,2,92,38.24357234894254,-109.3879869
50971,8,40,15,14,15,1,93,38.24357234894254,-109.3877174
50972,8,39,15,15,14,1,92,38.24357234894254,-109.3874479
50973,9,37,14,15,13,1,89,38.24357234894254,-109.3871784
50974,9,36,14,14,13,2,88,38.24357234894254,-109.3869089
50975,9,35,14,12,13,3,86,38.24357234894254,-109.3866394
50976,10,36,14,12,13,3,88,38.24357234894254,-109.3863699
50977,10,36,14,12,13,3,88,38.24357234894254,-109.3861004
50978,11,36,14,12,13,3,89,38.24357234894254,-109.3858309
50979,14,35,13,12,12,2,88,38.24357234894254,-109.3855614
50980,16,35,13,11,12,1,88,38.24357234894254,-109.3852919
50981,15,36,13,11,12,1,88,38.24357234894254,-109.3850225
50982,12,37,14,13,13,1,90,38.24357234894254,-109.384753
50983,10,37,14,13,14,2,90,38.24357234894254,-109.3844835
50984,12,38,14,12,14,1,91,38.24357234894254,-109.384214
50985,11,38,14,11,13,2,89,38.24357234894254,-109.3839445
50986,13,38,14,11,13,2,91,38.24357234894254,-109.383675
50987,13,37,14,13,12,1,90,38.24357234894254,-109.3834055
50988,12,38,14,13,12,1,90,38.24357234894254,-109.383136
50989,12,37,14,13,12,2,90,38.24357234894254,-109.3828665
50990,10,36,13,13,12,2,86,38.24357234894254,-109.382597
50991,8,36,13,12,13,2,84,38.24357234894254,-109.3823275
50992,7,36,13,11,12,3,82,38.24357234894254,-109.382058
50993,10,35,12,11,12,4,84,38.24357234894254,-109.3817885
50994,9,26,10,16,12,2,75,38.24357234894254,-109.381519
50995,10,26,10,17,12,1,76,38.24357234894254,-109.3812495
50996,16,29,12,14,11,1,83,38.24357234894254,-109.38098
50997,13,37,12,10,12,3,87,38.24357234894254,-109.3807105
50998,10,40,13,9,12,4,88,38.24357234894254,-109.380441
50999,8,40,13,9,12,5,87,38.24357234894254,-109.3801716
51000,7,41,13,9,13,4,87,38.24357234894254,-109.3799021
51001,8,44,13,8,14,3,90,38.24357234894254,-109.3796326
51002,7,47,12,7,15,1,89,38.24357234894254,-109.3793631
51003,8,45,13,8,14,2,90,38.24357234894254,-109.3790936
51004,8,44,13,8,13,3,89,38.24357234894254,-109.3788241
51005,9,44,13,9,12,3,90,38.24357234894254,-109.3785546
51006,9,47,13,10,11,2,92,38.24357234894254,-109.3782851
51007,4,51,11,5,13,4,88,38.24357234894254,-109.3780156
51008,2,49,10,1,12,7,81,38.24357234894254,-109.3777461
51009,1,46,9,1,12,6,75,38.24357234894254,-109.3774766
51010,1,45,8,2,12,5,73,38.24357234894254,-109.3772071
51011,0,43,8,3,10,6,70,38.24357234894254,-109.3769376
51012,2,44,8,5,11,3,73,38.24357234894254,-109.3766681
51013,1,37,8,3,10,8,67,38.24357234894254,-109.3763986
51014,1,34,9,2,10,10,66,38.24357234894254,-109.3761291
51015,1,31,10,1,10,10,63,38.24357234894254,-109.3758596
51016,0,43,8,1,12,6,70,38.24357234894254,-109.3755901
51017,1,48,8,5,11,2,75,38.24357234894254,-109.3753206
51018,1,50,8,5,10,2,76,38.24357234894254,-109.3750512
51019,0,41,8,7,10,3,69,38.24357234894254,-109.3747817
51020,2,36,9,9,7,8,71,38.24357234894254,-109.3745122
51021,1,36,12,6,9,12,76,38.24357234894254,-109.3742427
51022,2,32,14,10,4,17,79,38.24357234894254,-109.3739732
51023,2,21,11,3,6,18,61,38.24357234894254,-109.3737037
51024,2,24,8,4,3,12,53,38.24357234894254,-109.3734342
51025,5,34,5,5,7,3,59,38.24357234894254,-109.3731647
51026,1,45,5,1,9,2,63,38.24357234894254,-109.3728952
51027,1,47,5,2,10,1,66,38.24357234894254,-109.3726257
51028,1,38,6,3,10,3,61,38.24357234894254,-109.3723562
51029,4,36,8,6,10,6,70,38.24357234894254,-109.3720867
51030,3,25,9,5,7,8,57,38.24357234894254,-109.3718172
51031,1,23,9,3,9,9,54,38.24357234894254,-109.3715477
51032,2,28,9,3,9,5,56,38.24357234894254,-109.3712782
51033,4,26,11,5,6,7,59,38.24357234894254,-109.3710087
51034,3,14,10,5,9,8,49,38.24357234894254,-109.3707392
51035,2,19,11,5,7,12,56,38.24357234894254,-109.3704697
51036,1,15,12,2,4,18,52,38.24357234894254,-109.3702003
51037,1,16,13,0,3,22,55,38.24357234894254,-109.3699308
51038,1,21,13,0,2,23,60,38.24357234894254,-109.3696613
51039,2,23,11,0,4,18,58,38.24357234894254,-109.3693918
51040,3,25,10,0,7,12,57,38.24357234894254,-109.3691223
51041,2,23,10,1,6,13,55,38.24357234894254,-109.3688528
51042,2,22,11,1,5,14,55,38.24357234894254,-109.3685833
51043,2,22,11,2,5,15,57,38.24357234894254,-109.3683138
51044,3,23,12,3,7,13,61,38.24357234894254,-109.3680443
51045,1,24,11,2,6,13,57,38.24357234894254,-109.3677748
51046,1,27,11,4,9,11,63,38.24357234894254,-109.3675053
51047,1,28,11,4,8,11,63,38.24357234894254,-109.3672358
51048,2,23,11,3,6,14,59,38.24357234894254,-109.3669663
51049,2,20,12,2,4,16,56,38.24357234894254,-109.3666968
51050,2,19,13,0,3,20,57,38.24357234894254,-109.3664273
51051,2,21,12,0,2,21,58,38.24357234894254,-109.3661578
51052,1,22,12,0,3,20,58,38.24357234894254,-109.3658883
51053,0,23,11,0,3,19,56,38.24357234894254,-109.3656188
51054,0,22,11,0,2,20,55,38.24357234894254,-109.3653493
51055,0,23,11,0,3,19,56,38.24357234894254,-109.3650799
51056,1,24,11,0,3,19,58,38.24357234894254,-109.3648104
51057,1,25,11,0,3,20,60,38.24357234894254,-109.3645409
51058,1,31,11,1,6,17,67,38.24357234894254,-109.3642714
51059,2,33,11,2,7,16,71,38.24357234894254,-109.3640019
51060,2,26,13,2,3,21,67,38.24357234894254,-109.3637324
51061,1,22,13,0,1,23,60,38.24357234894254,-109.3634629
51062,2,24,11,2,3,19,61,38.24357234894254,-109.3631934
51063,1,26,9,3,7,10,56,38.24357234894254,-109.3629239
51064,2,40,5,4,8,3,62,38.24357234894254,-109.3626544
51065,2,39,5,5,7,2,60,38.24357234894254,-109.3623849
51066,9,36,6,7,5,2,65,38.24357234894254,-109.3621154
51067,5,32,10,4,3,8,62,38.24357234894254,-109.3618459
51068,5,30,8,3,4,7,57,38.24357234894254,-109.3615764
51069,2,34,6,4,7,6,59,38.24357234894254,-109.3613069
51070,2,32,5,4,8,5,56,38.24357234894254,-109.3610374
51071,4,23,6,5,7,6,51,38.24357234894254,-109.3607679
51072,5,28,8,4,8,7,60,38.24357234894254,-109.3604984
51073,3,27,11,3,7,12,63,38.24357234894254,-109.360229
51074,3,32,11,3,7,12,68,38.24357234894254,-109.3599595
51075,2,38,10,2,10,11,73,38.24357234894254,-109.35969
51076,2,41,10,2,11,9,75,38.24357234894254,-109.3594205
51077,2,42,10,2,11,9,76,38.24357234894254,-109.359151
51078,3,39,10,2,10,9,73,38.24357234894254,-109.3588815
51079,3,37,10,3,10,10,73,38.24357234894254,-109.358612
51080,2,36,10,4,11,9,72,38.24357234894254,-109.3583425
51081,1,39,10,3,13,7,73,38.24357234894254,-109.358073
51082,0,46,8,1,11,6,72,38.24357234894254,-109.3578035
51083,1,47,9,2,14,4,77,38.24357234894254,-109.357534
51084,2,35,11,4,12,8,72,38.24357234894254,-109.3572645
51085,1,28,10,1,8,14,62,38.24357234894254,-109.356995
51086,1,50,9,0,15,5,80,38.24357234894254,-109.3567255
51087,1,45,7,3,10,4,70,38.24357234894254,-109.356456
51088,2,32,7,3,7,4,55,38.24357234894254,-109.3561865
51089,2,26,8,4,7,5,52,38.24357234894254,-109.355917
51090,1,23,8,4,9,6,51,38.24357234894254,-109.3556475
51091,2,33,9,4,6,6,60,38.24357234894254,-109.355378
51092,1,19,9,7,10,7,53,38.24357234894254,-109.3551086
51093,6,18,12,14,8,8,66,38.24357234894254,-109.3548391
51094,15,20,15,14,10,7,81,38.24357234894254,-109.3545696
51095,9,18,14,10,7,13,71,38.24357234894254,-109.3543001
51096,3,23,12,3,5,18,64,38.24357234894254,-109.3540306
51097,4,29,11,1,6,12,63,38.24357234894254,-109.3537611
51098,4,29,10,3,7,8,61,38.24357234894254,-109.3534916
51099,3,26,9,6,10,5,59,38.24357234894254,-109.3532221
51100,8,20,11,14,9,5,67,38.24357234894254,-109.3529526
51101,22,21,15,23,6,3,90,38.24357234894254,-109.3526831
51102,28,14,11,26,9,3,91,38.24357234894254,-109.3524136
51103,21,19,11,23,12,4,90,38.24357234894254,-109.3521441
51104,6,22,10,14,12,5,69,38.24357234894254,-109.3518746
51105,7,38,10,5,8,3,71,38.24357234894254,-109.3516051
51106,4,29,8,6,8,4,59,38.24357234894254,-109.3513356
51107,4,20,10,9,10,6,59,38.24357234894254,-109.3510661
51108,11,21,12,17,11,4,76,38.24357234894254,-109.3507966
51109,24,20,14,17,11,3,89,38.24357234894254,-109.3505271
51110,26,17,13,20,13,3,92,38.24357234894254,-109.3502577
51111,27,15,12,23,13,2,92,38.24357234894254,-109.3499882
51112,33,15,12,20,11,1,92,38.24357234894254,-109.3497187
51113,37,14,11,21,9,1,93,38.24357234894254,-109.3494492
51114,31,13,10,28,13,1,96,38.24357234894254,-109.3491797
51115,19,15,10,29,16,3,92,38.24357234894254,-109.3489102
51116,9,18,12,24,16,8,87,38.24357234894254,-109.3486407
51117,4,20,14,12,13,15,78,38.24357234894254,-109.3483712
51118,2,24,14,8,11,16,75,38.24357234894254,-109.3481017
51119,2,25,15,8,11,16,77,38.24357234894254,-109.3478322
51120,2,24,14,7,9,16,72,38.24357234894254,-109.3475627
51121,1,26,13,7,11,13,71,38.24357234894254,-109.3472932
51122,1,26,12,6,10,11,66,38.24357234894254,-109.3470237
51123,1,32,11,2,11,12,69,38.24357234894254,-109.3467542
51124,1,28,12,3,10,12,66,38.24357234894254,-109.3464847
51125,1,27,11,5,12,10,66,38.24357234894254,-109.3462152
51126,1,28,12,6,13,11,71,38.24357234894254,-109.3459457
51127,1,32,12,5,14,12,76,38.24357234894254,-109.3456762
51128,1,36,12,3,16,10,78,38.24357234894254,-109.3454068
51129,1,32,12,0,9,17,71,38.24357234894254,-109.3451373
51130,0,30,11,0,9,17,67,38.24357234894254,-109.3448678
51131,0,31,12,0,10,16,69,38.24357234894254,-109.3445983
51132,1,31,12,1,11,14,70,38.24357234894254,-109.3443288
51133,0,29,13,0,11,18,71,38.24357234894254,-109.3440593
51134,2,29,12,3,12,13,71,38.24357234894254,-109.3437898
51135,1,30,11,2,12,13,69,38.24357234894254,-109.3435203
51136,1,31,11,0,10,13,66,38.24357234894254,-109.3432508
51137,1,33,11,0,10,15,70,38.24357234894254,-109.3429813
51138,1,32,12,0,8,19,72,38.24357234894254,-109.3427118
51139,2,32,13,0,7,19,73,38.24357234894254,-109.3424423
51140,1,31,13,0,7,20,72,38.24357234894254,-109.3421728
51141,2,31,12,0,7,18,70,38.24357234894254,-109.3419033
51142,2,34,11,1,10,11,69,38.24357234894254,-109.3416338
51143,1,33,10,0,10,13,67,38.24357234894254,-109.3413643
51144,0,30,11,0,7,17,65,38.24357234894254,-109.3410948
51145,1,29,12,0,5,19,66,38.24357234894254,-109.3408253
51146,2,34,13,1,8,16,74,38.24357234894254,-109.3405558
51147,3,41,12,1,12,11,80,38.24357234894254,-109.3402864
51148,4,39,12,1,11,11,78,38.24357234894254,-109.3400169
51149,4,36,13,1,9,14,77,38.24357234894254,-109.3397474
51150,4,33,14,1,8,17,77,38.24357234894254,-109.3394779
51151,4,36,13,2,10,15,80,38.24357234894254,-109.3392084
51152,3,41,13,1,12,12,82,38.24357234894254,-109.3389389
51153,3,42,12,2,12,12,83,38.24357234894254,-109.3386694
51154,3,35,13,2,9,16,78,38.24357234894254,-109.3383999
51155,2,28,14,2,5,22,73,38.24357234894254,-109.3381304
51156,2,26,16,1,2,27,74,38.24357234894254,-109.3378609
51157,1,27,15,0,3,25,71,38.24357234894254,-109.3375914
51158,1,26,12,0,5,20,64,38.24357234894254,-109.3373219
51159,2,30,8,2,8,9,59,38.24357234894254,-109.3370524
51160,2,51,7,5,11,1,77,38.24357234894254,-109.3367829
51161,1,49,5,0,8,3,66,38.24357234894254,-109.3365134
51162,2,42,5,1,8,4,62,38.24357234894254,-109.3362439
51163,2,39,6,3,9,4,63,38.24357234894254,-109.3359744
51164,3,29,6,3,9,6,56,38.24357234894254,-109.3357049
51165,8,23,8,4,7,8,58,38.24357234894254,-109.3354355
51166,6,15,10,3,2,17,53,38.24357234894254,-109.335166
51167,3,16,13,6,6,18,62,38.24357234894254,-109.3348965
51168,1,22,13,4,7,21,68,38.24357234894254,-109.334627
51169,2,25,13,3,5,21,69,38.24357234894254,-109.3343575
51170,6,33,12,8,9,11,79,38.24357234894254,-109.334088
51171,1,20,9,6,8,10,54,38.24357234894254,-109.3338185
51172,4,24,9,7,9,6,59,38.24357234894254,-109.333549
51173,6,33,9,5,10,4,67,38.24357234894254,-109.3332795
51174,2,32,8,4,10,7,63,38.24357234894254,-109.33301
51175,1,27,8,4,10,8,58,38.24357234894254,-109.3327405
51176,1,31,9,3,8,9,61,38.24357234894254,-109.332471
51177,2,33,8,4,11,6,64,38.24357234894254,-109.3322015
51178,3,33,7,6,11,4,64,38.24357234894254,-109.331932
51179,2,30,7,5,8,6,58,38.24357234894254,-109.3316625
51180,12,16,10,17,23,11,89,38.24330285435731,-109.4402688
51181,12,24,10,21,19,1,87,38.24330285435731,-109.4399993
51182,9,30,13,14,15,2,83,38.24330285435731,-109.4397299
51183,8,28,13,16,15,4,84,38.24330285435731,-109.4394604
51184,11,28,12,17,18,3,89,38.24330285435731,-109.4391909
51185,20,26,11,14,18,3,92,38.24330285435731,-109.4389214
51186,26,21,10,18,18,1,94,38.24330285435731,-109.4386519
51187,9,16,10,33,23,1,92,38.24330285435731,-109.4383824
51188,2,16,11,30,24,4,87,38.24330285435731,-109.4381129
51189,2,23,11,21,19,4,80,38.24330285435731,-109.4378434
51190,1,30,13,7,15,10,76,38.24330285435731,-109.4375739
51191,0,32,11,0,16,10,69,38.24330285435731,-109.4373044
51192,0,34,12,2,13,14,75,38.24330285435731,-109.4370349
51193,1,33,12,2,13,13,74,38.24330285435731,-109.4367654
51194,4,38,12,6,17,5,82,38.24330285435731,-109.4364959
51195,9,43,13,8,16,1,90,38.24330285435731,-109.4362264
51196,6,45,13,6,16,3,89,38.24330285435731,-109.4359569
51197,4,43,13,5,17,4,86,38.24330285435731,-109.4356874
51198,5,42,12,8,16,1,84,38.24330285435731,-109.4354179
51199,7,43,12,9,15,1,87,38.24330285435731,-109.4351484
51200,7,47,13,10,15,0,92,38.24330285435731,-109.434879
51201,6,48,12,10,15,0,91,38.24330285435731,-109.4346095
51202,6,48,12,10,15,0,91,38.24330285435731,-109.43434
51203,8,44,13,13,14,0,92,38.24330285435731,-109.4340705
51204,8,44,13,14,14,0,93,38.24330285435731,-109.433801
51205,8,42,13,13,14,1,91,38.24330285435731,-109.4335315
51206,8,41,13,13,14,1,90,38.24330285435731,-109.433262
51207,7,40,12,10,15,2,86,38.24330285435731,-109.4329925
51208,4,40,12,6,14,6,82,38.24330285435731,-109.432723
51209,2,41,11,3,13,9,79,38.24330285435731,-109.4324535
51210,1,39,10,1,11,11,73,38.24330285435731,-109.432184
51211,1,36,9,1,10,11,68,38.24330285435731,-109.4319145
51212,0,35,9,1,10,10,65,38.24330285435731,-109.431645
51213,1,35,9,2,11,9,67,38.24330285435731,-109.4313755
51214,2,38,10,3,13,7,73,38.24330285435731,-109.431106
51215,3,43,11,6,17,3,83,38.24330285435731,-109.4308365
51216,3,43,11,4,16,4,81,38.24330285435731,-109.430567
51217,5,40,12,5,17,4,83,38.24330285435731,-109.4302975
51218,6,40,12,5,17,4,84,38.24330285435731,-109.430028
51219,5,42,12,8,17,2,86,38.24330285435731,-109.4297586
51220,5,44,12,10,16,1,88,38.24330285435731,-109.4294891
51221,5,45,13,12,15,1,91,38.24330285435731,-109.4292196
51222,5,44,13,14,14,1,91,38.24330285435731,-109.4289501
51223,5,42,13,15,13,1,89,38.24330285435731,-109.4286806
51224,5,41,14,15,13,1,89,38.24330285435731,-109.4284111
51225,6,41,14,15,13,1,90,38.24330285435731,-109.4281416
51226,7,41,13,15,14,1,91,38.24330285435731,-109.4278721
51227,7,39,14,16,14,1,91,38.24330285435731,-109.4276026
51228,8,39,14,17,14,1,93,38.24330285435731,-109.4273331
51229,8,37,13,14,14,1,87,38.24330285435731,-109.4270636
51230,9,36,13,12,14,2,86,38.24330285435731,-109.4267941
51231,9,32,13,10,12,5,81,38.24330285435731,-109.4265246
51232,10,31,12,9,11,6,79,38.24330285435731,-109.4262551
51233,13,32,13,13,12,2,85,38.24330285435731,-109.4259856
51234,13,32,12,12,12,2,83,38.24330285435731,-109.4257161
51235,13,32,12,12,12,1,82,38.24330285435731,-109.4254466
51236,11,31,12,11,12,2,79,38.24330285435731,-109.4251771
51237,10,30,12,12,12,3,79,38.24330285435731,-109.4249077
51238,12,31,12,11,11,3,80,38.24330285435731,-109.4246382
51239,11,32,11,10,10,4,78,38.24330285435731,-109.4243687
51240,11,37,11,10,11,2,82,38.24330285435731,-109.4240992
51241,8,41,11,9,11,2,82,38.24330285435731,-109.4238297
51242,5,43,10,7,11,3,79,38.24330285435731,-109.4235602
51243,5,41,11,8,10,3,78,38.24330285435731,-109.4232907
51244,6,42,11,9,10,2,80,38.24330285435731,-109.4230212
51245,6,46,11,9,11,1,84,38.24330285435731,-109.4227517
51246,6,49,11,9,11,1,87,38.24330285435731,-109.4224822
51247,3,51,9,6,12,1,82,38.24330285435731,-109.4222127
51248,5,45,11,10,13,1,85,38.24330285435731,-109.4219432
51249,6,44,13,11,13,1,88,38.24330285435731,-109.4216737
51250,6,46,13,10,12,2,89,38.24330285435731,-109.4214042
51251,4,49,11,8,12,2,86,38.24330285435731,-109.4211347
51252,2,53,9,2,13,4,83,38.24330285435731,-109.4208652
51253,0,51,8,0,11,4,74,38.24330285435731,-109.4205957
51254,1,40,7,2,9,4,63,38.24330285435731,-109.4203262
51255,2,37,6,3,8,4,60,38.24330285435731,-109.4200568
51256,1,38,6,3,7,4,59,38.24330285435731,-109.4197873
51257,1,42,6,3,7,3,62,38.24330285435731,-109.4195178
51258,1,42,6,2,7,4,62,38.24330285435731,-109.4192483
51259,1,41,7,1,8,4,62,38.24330285435731,-109.4189788
51260,2,35,9,5,11,4,66,38.24330285435731,-109.4187093
51261,4,32,12,10,14,6,78,38.24330285435731,-109.4184398
51262,12,22,15,13,21,5,88,38.24330285435731,-109.4181703
51263,15,23,14,20,17,4,93,38.24330285435731,-109.4179008
51264,16,26,13,19,15,3,92,38.24330285435731,-109.4176313
51265,21,28,13,18,13,1,94,38.24330285435731,-109.4173618
51266,23,24,12,23,11,1,94,38.24330285435731,-109.4170923
51267,21,23,11,25,12,2,94,38.24330285435731,-109.4168228
51268,19,29,12,16,13,2,91,38.24330285435731,-109.4165533
51269,12,37,11,17,13,1,91,38.24330285435731,-109.4162838
51270,8,40,10,18,11,1,88,38.24330285435731,-109.4160143
51271,6,28,13,12,14,12,85,38.24330285435731,-109.4157448
51272,3,29,14,6,13,17,82,38.24330285435731,-109.4154753
51273,2,30,13,4,11,15,75,38.24330285435731,-109.4152058
51274,2,33,11,3,12,9,70,38.24330285435731,-109.4149364
51275,1,39,8,0,11,7,66,38.24330285435731,-109.4146669
51276,1,41,8,3,10,5,68,38.24330285435731,-109.4143974
51277,0,42,8,1,10,6,67,38.24330285435731,-109.4141279
51278,0,43,8,1,10,6,68,38.24330285435731,-109.4138584
51279,1,48,7,3,9,4,72,38.24330285435731,-109.4135889
51280,1,56,8,8,10,0,83,38.24330285435731,-109.4133194
51281,1,57,9,3,14,1,85,38.24330285435731,-109.4130499
51282,2,51,10,2,17,2,84,38.24330285435731,-109.4127804
51283,4,47,11,3,18,2,85,38.24330285435731,-109.4125109
51284,6,47,12,7,17,1,90,38.24330285435731,-109.4122414
51285,7,42,14,11,16,1,91,38.24330285435731,-109.4119719
51286,6,41,14,11,13,3,88,38.24330285435731,-109.4117024
51287,6,40,13,11,12,3,85,38.24330285435731,-109.4114329
51288,6,39,13,10,11,3,82,38.24330285435731,-109.4111634
51289,6,41,14,10,11,2,84,38.24330285435731,-109.4108939
51290,6,43,13,9,12,2,85,38.24330285435731,-109.4106244
51291,9,45,13,9,13,1,90,38.24330285435731,-109.4103549
51292,11,44,13,10,13,0,91,38.24330285435731,-109.4100855
51293,11,42,14,12,13,0,92,38.24330285435731,-109.409816
51294,11,40,14,13,13,0,91,38.24330285435731,-109.4095465
51295,13,39,14,13,12,0,91,38.24330285435731,-109.409277
51296,14,38,14,14,12,0,92,38.24330285435731,-109.4090075
51297,15,37,15,13,12,0,92,38.24330285435731,-109.408738
51298,16,36,15,14,12,0,93,38.24330285435731,-109.4084685
51299,17,34,14,14,13,0,92,38.24330285435731,-109.408199
51300,14,35,14,13,14,0,90,38.24330285435731,-109.4079295
51301,14,36,14,13,15,0,92,38.24330285435731,-109.40766
51302,16,36,14,12,14,0,92,38.24330285435731,-109.4073905
51303,17,37,14,11,12,0,91,38.24330285435731,-109.407121
51304,15,38,14,12,13,0,92,38.24330285435731,-109.4068515
51305,16,35,13,12,13,0,89,38.24330285435731,-109.406582
51306,17,35,13,12,13,0,90,38.24330285435731,-109.4063125
51307,18,35,13,11,13,0,90,38.24330285435731,-109.406043
51308,19,32,13,12,13,0,89,38.24330285435731,-109.4057735
51309,18,33,13,12,13,0,89,38.24330285435731,-109.405504
51310,18,33,13,12,13,0,89,38.24330285435731,-109.4052345
51311,18,33,13,13,13,0,90,38.24330285435731,-109.4049651
51312,17,33,13,13,14,0,90,38.24330285435731,-109.4046956
51313,19,32,14,14,13,0,92,38.24330285435731,-109.4044261
51314,19,32,14,13,13,0,91,38.24330285435731,-109.4041566
51315,19,32,13,13,13,0,90,38.24330285435731,-109.4038871
51316,18,34,13,13,13,0,91,38.24330285435731,-109.4036176
51317,17,34,13,13,13,0,90,38.24330285435731,-109.4033481
51318,19,33,13,12,13,0,90,38.24330285435731,-109.4030786
51319,15,35,13,13,13,0,89,38.24330285435731,-109.4028091
51320,14,35,13,14,13,0,89,38.24330285435731,-109.4025396
51321,15,33,14,14,14,0,90,38.24330285435731,-109.4022701
51322,13,35,14,14,14,1,91,38.24330285435731,-109.4020006
51323,10,38,13,12,15,1,89,38.24330285435731,-109.4017311
51324,7,40,13,11,15,1,87,38.24330285435731,-109.4014616
51325,7,41,13,10,15,2,88,38.24330285435731,-109.4011921
51326,7,43,14,12,15,1,92,38.24330285435731,-109.4009226
51327,5,47,13,8,14,2,89,38.24330285435731,-109.4006531
51328,3,47,12,6,14,4,86,38.24330285435731,-109.4003836
51329,4,46,12,7,13,3,85,38.24330285435731,-109.4001142
51330,5,45,13,9,13,2,87,38.24330285435731,-109.3998447
51331,5,43,13,10,13,2,86,38.24330285435731,-109.3995752
51332,5,49,13,8,15,1,91,38.24330285435731,-109.3993057
51333,4,46,13,6,15,2,86,38.24330285435731,-109.3990362
51334,4,44,13,6,14,3,84,38.24330285435731,-109.3987667
51335,4,43,13,6,14,3,83,38.24330285435731,-109.3984972
51336,5,41,13,6,13,4,82,38.24330285435731,-109.3982277
51337,5,42,13,6,13,3,82,38.24330285435731,-109.3979582
51338,6,42,14,7,14,3,86,38.24330285435731,-109.3976887
51339,7,42,14,8,14,2,87,38.24330285435731,-109.3974192
51340,7,42,14,8,15,2,88,38.24330285435731,-109.3971497
51341,7,43,13,7,15,2,87,38.24330285435731,-109.3968802
51342,6,42,13,8,15,2,86,38.24330285435731,-109.3966107
51343,5,43,13,7,14,3,85,38.24330285435731,-109.3963412
51344,5,44,13,7,14,3,86,38.24330285435731,-109.3960717
51345,5,43,14,8,14,2,86,38.24330285435731,-109.3958022
51346,6,43,14,8,14,2,87,38.24330285435731,-109.3955327
51347,6,46,13,8,15,1,89,38.24330285435731,-109.3952632
51348,6,48,13,7,16,1,91,38.24330285435731,-109.3949938
51349,7,48,13,7,16,1,92,38.24330285435731,-109.3947243
51350,7,47,14,8,16,0,92,38.24330285435731,-109.3944548
51351,7,45,14,10,16,1,93,38.24330285435731,-109.3941853
51352,7,44,14,10,16,0,91,38.24330285435731,-109.3939158
51353,6,44,14,9,17,1,91,38.24330285435731,-109.3936463
51354,5,45,13,8,17,1,89,38.24330285435731,-109.3933768
51355,5,46,14,7,18,1,91,38.24330285435731,-109.3931073
51356,4,46,14,8,18,2,92,38.24330285435731,-109.3928378
51357,4,45,14,8,17,2,90,38.24330285435731,-109.3925683
51358,4,44,14,8,17,2,89,38.24330285435731,-109.3922988
51359,5,45,14,9,17,1,91,38.24330285435731,-109.3920293
51360,5,44,14,10,16,1,90,38.24330285435731,-109.3917598
51361,6,44,15,11,15,1,92,38.24330285435731,-109.3914903
51362,7,42,15,13,15,1,93,38.24330285435731,-109.3912208
51363,7,41,15,13,14,1,91,38.24330285435731,-109.3909513
51364,6,42,15,13,15,2,93,38.24330285435731,-109.3906818
51365,6,42,14,13,15,1,91,38.24330285435731,-109.3904123
51366,6,39,13,12,14,3,87,38.24330285435731,-109.3901429
51367,6,36,12,13,12,4,83,38.24330285435731,-109.3898734
51368,6,38,13,14,13,3,87,38.24330285435731,-109.3896039
51369,6,40,15,13,15,2,91,38.24330285435731,-109.3893344
51370,6,40,15,12,15,3,91,38.24330285435731,-109.3890649
51371,7,41,15,12,14,3,92,38.24330285435731,-109.3887954
51372,9,40,15,13,14,2,93,38.24330285435731,-109.3885259
51373,9,39,15,13,14,2,92,38.24330285435731,-109.3882564
51374,9,38,15,14,15,2,93,38.24330285435731,-109.3879869
51375,9,38,15,15,15,1,93,38.24330285435731,-109.3877174
51376,10,37,15,15,15,1,93,38.24330285435731,-109.3874479
51377,10,36,15,15,14,2,92,38.24330285435731,-109.3871784
51378,9,36,15,13,14,2,89,38.24330285435731,-109.3869089
51379,9,37,15,13,13,3,90,38.24330285435731,-109.3866394
51380,10,37,14,12,12,3,88,38.24330285435731,-109.3863699
51381,10,36,14,12,12,3,87,38.24330285435731,-109.3861004
51382,11,35,14,13,12,3,88,38.24330285435731,-109.3858309
51383,13,35,14,12,12,2,88,38.24330285435731,-109.3855614
51384,15,35,14,11,11,2,88,38.24330285435731,-109.3852919
51385,15,36,14,11,12,2,90,38.24330285435731,-109.3850225
51386,13,37,14,13,12,2,91,38.24330285435731,-109.384753
51387,12,37,14,14,12,1,90,38.24330285435731,-109.3844835
51388,11,37,15,14,12,1,90,38.24330285435731,-109.384214
51389,10,38,14,13,13,2,90,38.24330285435731,-109.3839445
51390,10,38,14,13,13,2,90,38.24330285435731,-109.383675
51391,10,39,14,12,13,2,90,38.24330285435731,-109.3834055
51392,11,38,14,14,12,1,90,38.24330285435731,-109.383136
51393,9,38,14,14,12,2,89,38.24330285435731,-109.3828665
51394,8,38,13,13,13,2,87,38.24330285435731,-109.382597
51395,7,38,13,11,14,2,85,38.24330285435731,-109.3823275
51396,6,37,13,10,14,3,83,38.24330285435731,-109.382058
51397,8,37,13,10,13,4,85,38.24330285435731,-109.3817885
51398,9,30,10,11,10,3,73,38.24330285435731,-109.381519
51399,8,25,10,14,13,1,71,38.24330285435731,-109.3812495
51400,13,29,11,14,13,1,81,38.24330285435731,-109.38098
51401,12,36,12,10,12,3,85,38.24330285435731,-109.3807105
51402,10,39,13,9,13,2,86,38.24330285435731,-109.380441
51403,12,38,13,10,14,1,88,38.24330285435731,-109.3801716
51404,12,39,13,10,14,1,89,38.24330285435731,-109.3799021
51405,11,41,13,9,14,2,90,38.24330285435731,-109.3796326
51406,10,44,13,8,14,2,91,38.24330285435731,-109.3793631
51407,9,45,13,8,12,3,90,38.24330285435731,-109.3790936
51408,8,45,12,6,11,5,87,38.24330285435731,-109.3788241
51409,6,47,12,6,13,4,88,38.24330285435731,-109.3785546
51410,4,50,11,5,14,3,87,38.24330285435731,-109.3782851
51411,1,49,9,2,13,5,79,38.24330285435731,-109.3780156
51412,0,49,8,1,12,4,74,38.24330285435731,-109.3777461
51413,1,51,8,3,12,2,77,38.24330285435731,-109.3774766
51414,1,51,8,3,11,2,76,38.24330285435731,-109.3772071
51415,0,48,8,2,11,5,74,38.24330285435731,-109.3769376
51416,3,44,8,3,12,3,73,38.24330285435731,-109.3766681
51417,1,37,9,3,10,8,68,38.24330285435731,-109.3763986
51418,1,37,10,2,12,8,70,38.24330285435731,-109.3761291
51419,1,32,9,0,12,9,63,38.24330285435731,-109.3758596
51420,0,43,8,0,12,7,70,38.24330285435731,-109.3755901
51421,2,43,11,5,11,5,77,38.24330285435731,-109.3753206
51422,0,44,8,2,10,6,70,38.24330285435731,-109.3750512
51423,1,43,8,4,11,3,70,38.24330285435731,-109.3747817
51424,0,37,8,10,10,5,70,38.24330285435731,-109.3745122
51425,2,29,13,4,4,20,72,38.24330285435731,-109.3742427
51426,1,24,11,4,8,15,63,38.24330285435731,-109.3739732
51427,2,28,10,3,3,16,62,38.24330285435731,-109.3737037
51428,2,31,7,3,5,8,56,38.24330285435731,-109.3734342
51429,1,38,5,2,8,4,58,38.24330285435731,-109.3731647
51430,1,45,5,2,9,2,64,38.24330285435731,-109.3728952
51431,2,41,6,4,10,2,65,38.24330285435731,-109.3726257
51432,1,42,7,5,11,4,70,38.24330285435731,-109.3723562
51433,2,40,9,6,10,6,73,38.24330285435731,-109.3720867
51434,4,26,13,4,6,13,66,38.24330285435731,-109.3718172
51435,3,33,10,4,10,4,64,38.24330285435731,-109.3715477
51436,2,31,7,3,9,5,57,38.24330285435731,-109.3712782
51437,2,31,8,4,8,5,58,38.24330285435731,-109.3710087
51438,0,23,9,4,9,7,52,38.24330285435731,-109.3707392
51439,3,30,9,6,10,4,62,38.24330285435731,-109.3704697
51440,2,15,11,4,5,13,50,38.24330285435731,-109.3702003
51441,1,17,12,0,3,19,52,38.24330285435731,-109.3699308
51442,2,25,13,0,5,16,61,38.24330285435731,-109.3696613
51443,2,27,11,2,8,11,61,38.24330285435731,-109.3693918
51444,3,25,10,3,7,10,58,38.24330285435731,-109.3691223
51445,2,20,11,2,5,14,54,38.24330285435731,-109.3688528
51446,1,18,12,1,4,18,54,38.24330285435731,-109.3685833
51447,2,19,12,2,4,16,55,38.24330285435731,-109.3683138
51448,5,26,12,7,9,8,67,38.24330285435731,-109.3680443
51449,2,32,10,5,11,7,67,38.24330285435731,-109.3677748
51450,3,31,10,6,11,6,67,38.24330285435731,-109.3675053
51451,3,28,11,7,10,7,66,38.24330285435731,-109.3672358
51452,2,21,11,4,6,13,57,38.24330285435731,-109.3669663
51453,2,23,12,0,3,17,57,38.24330285435731,-109.3666968
51454,1,22,12,0,3,21,59,38.24330285435731,-109.3664273
51455,1,24,11,0,4,18,58,38.24330285435731,-109.3661578
51456,2,26,11,0,5,17,61,38.24330285435731,-109.3658883
51457,2,25,12,0,3,19,61,38.24330285435731,-109.3656188
51458,1,23,12,0,2,23,61,38.24330285435731,-109.3653493
51459,1,24,11,0,3,20,59,38.24330285435731,-109.3650799
51460,0,24,11,0,4,20,59,38.24330285435731,-109.3648104
51461,0,27,11,0,4,19,61,38.24330285435731,-109.3645409
51462,1,33,11,0,6,17,68,38.24330285435731,-109.3642714
51463,2,30,11,1,4,19,67,38.24330285435731,-109.3640019
51464,1,25,12,0,2,21,61,38.24330285435731,-109.3637324
51465,1,23,12,1,3,20,60,38.24330285435731,-109.3634629
51466,5,24,11,1,2,15,58,38.24330285435731,-109.3631934
51467,4,35,7,5,7,5,63,38.24330285435731,-109.3629239
51468,1,38,4,2,8,4,57,38.24330285435731,-109.3626544
51469,1,35,4,2,8,4,54,38.24330285435731,-109.3623849
51470,2,36,5,5,7,3,58,38.24330285435731,-109.3621154
51471,2,39,4,7,7,3,62,38.24330285435731,-109.3618459
51472,3,43,5,6,8,3,68,38.24330285435731,-109.3615764
51473,3,40,5,6,8,3,65,38.24330285435731,-109.3613069
51474,2,31,5,4,8,4,54,38.24330285435731,-109.3610374
51475,5,21,6,3,6,7,48,38.24330285435731,-109.3607679
51476,3,24,7,3,6,8,51,38.24330285435731,-109.3604984
51477,3,28,11,3,7,13,65,38.24330285435731,-109.360229
51478,2,28,12,3,4,17,66,38.24330285435731,-109.3599595
51479,2,28,11,2,4,16,63,38.24330285435731,-109.35969
51480,2,33,10,3,10,10,68,38.24330285435731,-109.3594205
51481,3,39,10,2,11,9,74,38.24330285435731,-109.359151
51482,2,35,10,1,8,13,69,38.24330285435731,-109.3588815
51483,2,36,10,2,11,11,72,38.24330285435731,-109.358612
51484,3,38,11,5,13,7,77,38.24330285435731,-109.3583425
51485,3,40,10,5,12,6,76,38.24330285435731,-109.358073
51486,2,40,10,3,11,8,74,38.24330285435731,-109.3578035
51487,2,38,10,2,11,9,72,38.24330285435731,-109.357534
51488,2,31,11,1,8,13,66,38.24330285435731,-109.3572645
51489,1,28,11,0,5,18,63,38.24330285435731,-109.356995
51490,0,39,9,0,10,12,70,38.24330285435731,-109.3567255
51491,2,41,8,3,10,4,68,38.24330285435731,-109.356456
51492,2,30,8,4,8,4,56,38.24330285435731,-109.3561865
51493,2,21,9,6,9,6,53,38.24330285435731,-109.355917
51494,3,21,11,6,8,10,59,38.24330285435731,-109.3556475
51495,3,36,10,4,7,6,66,38.24330285435731,-109.355378
51496,1,22,10,7,8,6,54,38.24330285435731,-109.3551086
51497,4,20,12,12,7,8,63,38.24330285435731,-109.3548391
51498,10,19,14,12,9,11,75,38.24330285435731,-109.3545696
51499,15,20,14,13,10,9,81,38.24330285435731,-109.3543001
51500,10,20,13,11,8,12,74,38.24330285435731,-109.3540306
51501,6,24,11,5,6,14,66,38.24330285435731,-109.3537611
51502,5,26,11,3,7,10,62,38.24330285435731,-109.3534916
51503,7,24,11,7,9,8,66,38.24330285435731,-109.3532221
51504,20,19,13,21,10,3,86,38.24330285435731,-109.3529526
51505,27,14,13,26,9,3,92,38.24330285435731,-109.3526831
51506,25,14,12,26,11,4,92,38.24330285435731,-109.3524136
51507,13,18,11,16,12,6,76,38.24330285435731,-109.3521441
51508,7,24,10,5,10,6,62,38.24330285435731,-109.3518746
51509,5,25,9,7,9,5,60,38.24330285435731,-109.3516051
51510,5,21,9,8,11,4,58,38.24330285435731,-109.3513356
51511,8,21,11,13,12,4,69,38.24330285435731,-109.3510661
51512,16,22,13,20,11,2,84,38.24330285435731,-109.3507966
51513,26,18,13,18,13,2,90,38.24330285435731,-109.3505271
51514,29,15,12,21,12,2,91,38.24330285435731,-109.3502577
51515,32,13,11,21,12,2,91,38.24330285435731,-109.3499882
51516,36,13,10,24,10,1,94,38.24330285435731,-109.3497187
51517,33,14,9,27,12,1,96,38.24330285435731,-109.3494492
51518,19,17,10,26,16,3,91,38.24330285435731,-109.3491797
51519,4,21,14,21,13,10,83,38.24330285435731,-109.3489102
51520,4,24,13,13,12,11,77,38.24330285435731,-109.3486407
51521,3,27,13,10,13,11,77,38.24330285435731,-109.3483712
51522,2,30,14,8,15,10,79,38.24330285435731,-109.3481017
51523,2,32,15,6,16,10,81,38.24330285435731,-109.3478322
51524,2,30,16,5,11,18,82,38.24330285435731,-109.3475627
51525,1,25,15,5,9,19,74,38.24330285435731,-109.3472932
51526,0,26,14,5,11,16,72,38.24330285435731,-109.3470237
51527,1,30,13,1,13,14,72,38.24330285435731,-109.3467542
51528,1,29,14,4,11,16,75,38.24330285435731,-109.3464847
51529,1,29,13,5,16,10,74,38.24330285435731,-109.3462152
51530,1,30,11,3,13,11,69,38.24330285435731,-109.3459457
51531,1,32,12,0,9,16,70,38.24330285435731,-109.3456762
51532,1,29,12,0,9,17,68,38.24330285435731,-109.3454068
51533,1,30,13,0,9,19,72,38.24330285435731,-109.3451373
51534,2,31,13,0,11,17,74,38.24330285435731,-109.3448678
51535,1,32,13,2,13,13,74,38.24330285435731,-109.3445983
51536,2,29,12,8,12,10,73,38.24330285435731,-109.3443288
51537,2,27,11,7,11,10,68,38.24330285435731,-109.3440593
51538,1,30,11,1,12,13,68,38.24330285435731,-109.3437898
51539,1,30,12,0,11,15,69,38.24330285435731,-109.3435203
51540,2,30,12,0,10,17,71,38.24330285435731,-109.3432508
51541,1,30,13,0,8,19,71,38.24330285435731,-109.3429813
51542,1,30,12,0,7,20,70,38.24330285435731,-109.3427118
51543,1,29,12,0,7,19,68,38.24330285435731,-109.3424423
51544,1,29,11,0,7,18,66,38.24330285435731,-109.3421728
51545,1,30,11,0,6,17,65,38.24330285435731,-109.3419033
51546,1,32,10,0,8,14,65,38.24330285435731,-109.3416338
51547,0,34,10,0,9,13,66,38.24330285435731,-109.3413643
51548,2,33,11,0,7,14,67,38.24330285435731,-109.3410948
51549,2,35,12,0,8,14,71,38.24330285435731,-109.3408253
51550,2,42,12,0,11,12,79,38.24330285435731,-109.3405558
51551,2,51,11,0,14,8,86,38.24330285435731,-109.3402864
51552,2,48,11,0,13,10,84,38.24330285435731,-109.3400169
51553,2,37,11,0,10,13,73,38.24330285435731,-109.3397474
51554,2,30,13,1,6,18,70,38.24330285435731,-109.3394779
51555,4,30,14,2,4,19,73,38.24330285435731,-109.3392084
51556,3,36,13,1,9,15,77,38.24330285435731,-109.3389389
51557,3,37,13,2,11,14,80,38.24330285435731,-109.3386694
51558,4,36,14,2,9,16,81,38.24330285435731,-109.3383999
51559,3,34,14,2,8,20,81,38.24330285435731,-109.3381304
51560,3,31,14,2,6,21,77,38.24330285435731,-109.3378609
51561,1,25,15,0,2,26,69,38.24330285435731,-109.3375914
51562,2,24,15,0,1,27,69,38.24330285435731,-109.3373219
51563,1,30,10,1,6,13,61,38.24330285435731,-109.3370524
51564,1,47,6,3,9,4,70,38.24330285435731,-109.3367829
51565,2,49,6,2,8,2,69,38.24330285435731,-109.3365134
51566,1,34,6,2,8,5,56,38.24330285435731,-109.3362439
51567,2,32,6,1,8,5,54,38.24330285435731,-109.3359744
51568,4,29,8,2,9,5,57,38.24330285435731,-109.3357049
51569,4,20,11,8,8,10,61,38.24330285435731,-109.3354355
51570,3,15,15,6,5,20,64,38.24330285435731,-109.335166
51571,4,19,13,7,7,15,65,38.24330285435731,-109.3348965
51572,2,20,11,5,6,16,60,38.24330285435731,-109.334627
51573,1,24,12,3,6,17,63,38.24330285435731,-109.3343575
51574,3,32,11,5,10,9,70,38.24330285435731,-109.334088
51575,1,23,9,5,7,10,55,38.24330285435731,-109.3338185
51576,4,26,10,7,10,5,62,38.24330285435731,-109.333549
51577,10,25,10,8,12,3,68,38.24330285435731,-109.3332795
51578,5,23,11,6,11,8,64,38.24330285435731,-109.33301
51579,2,19,12,6,8,12,59,38.24330285435731,-109.3327405
51580,0,22,11,2,5,17,57,38.24330285435731,-109.332471
51581,1,31,10,2,9,12,65,38.24330285435731,-109.3322015
51582,2,33,10,2,7,13,67,38.24330285435731,-109.331932
51583,2,28,11,1,5,14,61,38.24330285435731,-109.3316625
51584,0,3,1,11,7,13,35,38.24303335977207,-109.4402688
51585,10,18,9,10,22,13,82,38.24303335977207,-109.4399993
51586,11,25,13,18,20,2,89,38.24303335977207,-109.4397299
51587,8,26,12,19,17,3,85,38.24303335977207,-109.4394604
51588,9,26,12,22,16,3,88,38.24303335977207,-109.4391909
51589,11,23,12,22,20,4,92,38.24303335977207,-109.4389214
51590,8,20,10,27,25,3,93,38.24303335977207,-109.4386519
51591,2,18,12,30,21,4,87,38.24303335977207,-109.4383824
51592,2,23,11,21,18,3,78,38.24303335977207,-109.4381129
51593,0,26,10,12,18,4,70,38.24303335977207,-109.4378434
51594,0,30,10,9,13,6,68,38.24303335977207,-109.4375739
51595,1,36,10,3,14,8,72,38.24303335977207,-109.4373044
51596,2,36,10,3,14,7,72,38.24303335977207,-109.4370349
51597,4,40,11,9,15,3,82,38.24303335977207,-109.4367654
51598,8,42,13,12,14,1,90,38.24303335977207,-109.4364959
51599,9,43,13,12,14,0,91,38.24303335977207,-109.4362264
51600,7,41,12,9,16,2,87,38.24303335977207,-109.4359569
51601,7,40,13,7,16,4,87,38.24303335977207,-109.4356874
51602,9,40,14,8,15,2,88,38.24303335977207,-109.4354179
51603,11,41,13,10,15,0,90,38.24303335977207,-109.4351484
51604,12,42,13,12,14,0,93,38.24303335977207,-109.434879
51605,8,46,13,11,15,0,93,38.24303335977207,-109.4346095
51606,6,45,12,11,15,0,89,38.24303335977207,-109.43434
51607,6,44,13,12,15,0,90,38.24303335977207,-109.4340705
51608,7,44,13,13,14,0,91,38.24303335977207,-109.433801
51609,7,42,14,14,14,0,91,38.24303335977207,-109.4335315
51610,7,41,13,14,14,1,90,38.24303335977207,-109.433262
51611,6,41,12,10,15,1,85,38.24303335977207,-109.4329925
51612,4,41,11,5,14,5,80,38.24303335977207,-109.432723
51613,3,41,11,2,13,9,79,38.24303335977207,-109.4324535
51614,1,39,10,0,10,11,71,38.24303335977207,-109.432184
51615,0,37,9,0,10,11,67,38.24303335977207,-109.4319145
51616,0,39,8,2,9,8,66,38.24303335977207,-109.431645
51617,1,43,8,3,9,6,70,38.24303335977207,-109.4313755
51618,1,48,9,4,12,3,77,38.24303335977207,-109.431106
51619,3,48,11,6,17,1,86,38.24303335977207,-109.4308365
51620,4,41,11,5,17,4,82,38.24303335977207,-109.430567
51621,3,37,11,4,14,8,77,38.24303335977207,-109.4302975
51622,3,39,11,3,14,7,77,38.24303335977207,-109.430028
51623,4,44,11,6,15,3,83,38.24303335977207,-109.4297586
51624,4,45,12,11,15,1,88,38.24303335977207,-109.4294891
51625,5,44,13,14,14,1,91,38.24303335977207,-109.4292196
51626,5,44,13,15,14,1,92,38.24303335977207,-109.4289501
51627,6,42,14,15,14,1,92,38.24303335977207,-109.4286806
51628,7,40,14,16,13,1,91,38.24303335977207,-109.4284111
51629,6,40,14,16,13,1,90,38.24303335977207,-109.4281416
51630,8,38,14,16,13,1,90,38.24303335977207,-109.4278721
51631,9,37,14,16,13,1,90,38.24303335977207,-109.4276026
51632,9,39,14,14,14,1,91,38.24303335977207,-109.4273331
51633,8,39,13,10,14,3,87,38.24303335977207,-109.4270636
51634,7,39,12,9,14,3,84,38.24303335977207,-109.4267941
51635,6,35,12,11,13,4,81,38.24303335977207,-109.4265246
51636,9,31,11,11,12,3,77,38.24303335977207,-109.4262551
51637,11,31,10,9,12,2,75,38.24303335977207,-109.4259856
51638,7,28,10,8,11,5,69,38.24303335977207,-109.4257161
51639,7,30,10,8,12,3,70,38.24303335977207,-109.4254466
51640,7,33,10,7,12,3,72,38.24303335977207,-109.4251771
51641,9,36,10,8,12,2,77,38.24303335977207,-109.4249077
51642,9,36,10,8,13,2,78,38.24303335977207,-109.4246382
51643,6,34,10,8,12,4,74,38.24303335977207,-109.4243687
51644,5,40,10,8,12,3,78,38.24303335977207,-109.4240992
51645,5,44,10,8,12,2,81,38.24303335977207,-109.4238297
51646,4,43,10,8,11,2,78,38.24303335977207,-109.4235602
51647,4,44,11,8,11,2,80,38.24303335977207,-109.4232907
51648,4,48,10,8,11,2,83,38.24303335977207,-109.4230212
51649,4,49,9,8,12,1,83,38.24303335977207,-109.4227517
51650,5,49,10,8,12,1,85,38.24303335977207,-109.4224822
51651,5,49,11,9,11,1,86,38.24303335977207,-109.4222127
51652,7,46,13,12,12,1,91,38.24303335977207,-109.4219432
51653,7,45,13,12,12,1,90,38.24303335977207,-109.4216737
51654,6,48,12,10,12,1,89,38.24303335977207,-109.4214042
51655,4,53,10,8,12,2,89,38.24303335977207,-109.4211347
51656,2,53,9,5,12,3,84,38.24303335977207,-109.4208652
51657,2,48,7,3,11,2,73,38.24303335977207,-109.4205957
51658,2,40,7,3,9,3,64,38.24303335977207,-109.4203262
51659,2,39,7,2,8,4,62,38.24303335977207,-109.4200568
51660,2,42,7,1,8,3,63,38.24303335977207,-109.4197873
51661,2,45,7,1,8,3,66,38.24303335977207,-109.4195178
51662,2,40,7,2,9,4,64,38.24303335977207,-109.4192483
51663,2,36,8,3,10,6,65,38.24303335977207,-109.4189788
51664,4,35,10,7,9,8,73,38.24303335977207,-109.4187093
51665,7,29,14,12,12,8,82,38.24303335977207,-109.4184398
51666,13,22,14,19,22,3,93,38.24303335977207,-109.4181703
51667,12,20,12,24,20,4,92,38.24303335977207,-109.4179008
51668,15,21,12,24,14,4,90,38.24303335977207,-109.4176313
51669,21,25,13,20,12,1,92,38.24303335977207,-109.4173618
51670,23,24,12,22,12,1,94,38.24303335977207,-109.4170923
51671,24,27,12,20,10,1,94,38.24303335977207,-109.4168228
51672,11,40,11,18,10,1,91,38.24303335977207,-109.4165533
51673,7,46,10,18,10,0,91,38.24303335977207,-109.4162838
51674,7,43,10,16,10,2,88,38.24303335977207,-109.4160143
51675,3,28,13,5,13,14,76,38.24303335977207,-109.4157448
51676,2,32,13,5,15,11,78,38.24303335977207,-109.4154753
51677,2,30,13,4,13,14,76,38.24303335977207,-109.4152058
51678,2,26,13,5,10,14,70,38.24303335977207,-109.4149364
51679,1,28,10,3,10,10,62,38.24303335977207,-109.4146669
51680,1,34,9,0,11,9,64,38.24303335977207,-109.4143974
51681,1,38,8,0,9,8,64,38.24303335977207,-109.4141279
51682,1,43,7,3,7,6,67,38.24303335977207,-109.4138584
51683,2,49,6,5,6,2,70,38.24303335977207,-109.4135889
51684,2,57,7,7,7,1,81,38.24303335977207,-109.4133194
51685,1,58,8,3,13,1,84,38.24303335977207,-109.4130499
51686,1,54,9,1,17,1,83,38.24303335977207,-109.4127804
51687,3,46,10,3,17,3,82,38.24303335977207,-109.4125109
51688,6,45,11,8,17,1,88,38.24303335977207,-109.4122414
51689,9,41,13,11,16,1,91,38.24303335977207,-109.4119719
51690,7,37,13,11,13,3,84,38.24303335977207,-109.4117024
51691,7,35,13,11,12,3,81,38.24303335977207,-109.4114329
51692,7,38,13,10,11,2,81,38.24303335977207,-109.4111634
51693,5,40,13,9,10,3,80,38.24303335977207,-109.4108939
51694,6,42,13,9,11,2,83,38.24303335977207,-109.4106244
51695,8,45,13,9,13,1,89,38.24303335977207,-109.4103549
51696,11,44,14,10,13,0,92,38.24303335977207,-109.4100855
51697,11,41,14,12,13,0,91,38.24303335977207,-109.409816
51698,11,40,14,13,13,0,91,38.24303335977207,-109.4095465
51699,13,38,14,13,13,0,91,38.24303335977207,-109.409277
51700,15,38,15,14,12,0,94,38.24303335977207,-109.4090075
51701,16,37,15,13,12,0,93,38.24303335977207,-109.408738
51702,17,36,15,13,12,0,93,38.24303335977207,-109.4084685
51703,17,36,15,13,12,0,93,38.24303335977207,-109.408199
51704,14,39,14,12,13,0,92,38.24303335977207,-109.4079295
51705,13,38,14,12,14,0,91,38.24303335977207,-109.40766
51706,15,38,14,12,14,0,93,38.24303335977207,-109.4073905
51707,16,37,14,12,13,0,92,38.24303335977207,-109.407121
51708,16,37,14,12,13,0,92,38.24303335977207,-109.4068515
51709,13,38,14,12,14,0,91,38.24303335977207,-109.406582
51710,13,37,13,12,14,0,89,38.24303335977207,-109.4063125
51711,15,35,13,12,14,0,89,38.24303335977207,-109.406043
51712,18,34,13,12,13,0,90,38.24303335977207,-109.4057735
51713,16,35,13,12,14,0,90,38.24303335977207,-109.405504
51714,17,34,13,12,14,0,90,38.24303335977207,-109.4052345
51715,18,33,13,12,14,0,90,38.24303335977207,-109.4049651
51716,16,33,13,13,15,0,90,38.24303335977207,-109.4046956
51717,19,31,13,13,13,0,89,38.24303335977207,-109.4044261
51718,23,30,13,13,12,0,91,38.24303335977207,-109.4041566
51719,22,31,14,13,12,0,92,38.24303335977207,-109.4038871
51720,19,33,14,13,12,0,91,38.24303335977207,-109.4036176
51721,19,35,13,12,12,0,91,38.24303335977207,-109.4033481
51722,21,34,13,12,11,0,91,38.24303335977207,-109.4030786
51723,16,35,13,13,12,0,89,38.24303335977207,-109.4028091
51724,15,36,13,13,13,0,90,38.24303335977207,-109.4025396
51725,15,35,14,13,13,0,90,38.24303335977207,-109.4022701
51726,14,38,14,13,13,0,92,38.24303335977207,-109.4020006
51727,12,38,14,14,14,0,92,38.24303335977207,-109.4017311
51728,8,42,13,12,14,1,90,38.24303335977207,-109.4014616
51729,6,46,13,9,14,2,90,38.24303335977207,-109.4011921
51730,4,48,13,8,13,3,89,38.24303335977207,-109.4009226
51731,4,49,13,6,14,3,89,38.24303335977207,-109.4006531
51732,4,49,13,6,14,2,88,38.24303335977207,-109.4003836
51733,4,48,13,6,14,2,87,38.24303335977207,-109.4001142
51734,5,46,13,7,14,2,87,38.24303335977207,-109.3998447
51735,5,46,13,7,15,2,88,38.24303335977207,-109.3995752
51736,6,45,14,9,16,1,91,38.24303335977207,-109.3993057
51737,6,46,14,8,15,1,90,38.24303335977207,-109.3990362
51738,5,45,14,7,15,2,88,38.24303335977207,-109.3987667
51739,5,43,13,7,14,3,85,38.24303335977207,-109.3984972
51740,5,44,14,6,14,3,86,38.24303335977207,-109.3982277
51741,5,47,14,6,15,2,89,38.24303335977207,-109.3979582
51742,7,45,14,7,15,2,90,38.24303335977207,-109.3976887
51743,8,43,14,8,15,2,90,38.24303335977207,-109.3974192
51744,7,42,14,9,15,2,89,38.24303335977207,-109.3971497
51745,7,42,14,8,15,2,88,38.24303335977207,-109.3968802
51746,6,41,14,8,15,2,86,38.24303335977207,-109.3966107
51747,5,43,14,7,15,3,87,38.24303335977207,-109.3963412
51748,5,44,14,7,14,2,86,38.24303335977207,-109.3960717
51749,5,42,13,8,14,2,84,38.24303335977207,-109.3958022
51750,6,42,13,9,15,2,87,38.24303335977207,-109.3955327
51751,6,44,13,9,16,1,89,38.24303335977207,-109.3952632
51752,5,45,13,7,16,2,88,38.24303335977207,-109.3949938
51753,5,47,13,6,16,2,89,38.24303335977207,-109.3947243
51754,5,47,13,6,16,2,89,38.24303335977207,-109.3944548
51755,6,45,13,8,16,2,90,38.24303335977207,-109.3941853
51756,6,44,14,8,17,1,90,38.24303335977207,-109.3939158
51757,6,45,14,8,17,1,91,38.24303335977207,-109.3936463
51758,6,45,13,8,17,1,90,38.24303335977207,-109.3933768
51759,5,45,13,7,17,2,89,38.24303335977207,-109.3931073
51760,5,46,13,7,17,2,90,38.24303335977207,-109.3928378
51761,4,45,13,8,17,2,89,38.24303335977207,-109.3925683
51762,4,44,14,9,16,2,89,38.24303335977207,-109.3922988
51763,5,43,14,9,16,2,89,38.24303335977207,-109.3920293
51764,5,43,14,10,15,2,89,38.24303335977207,-109.3917598
51765,6,42,15,11,15,2,91,38.24303335977207,-109.3914903
51766,6,42,15,12,14,2,91,38.24303335977207,-109.3912208
51767,6,41,15,12,14,2,90,38.24303335977207,-109.3909513
51768,6,41,14,12,14,2,89,38.24303335977207,-109.3906818
51769,6,42,14,11,14,2,89,38.24303335977207,-109.3904123
51770,7,39,12,11,13,3,85,38.24303335977207,-109.3901429
51771,8,37,13,12,13,3,86,38.24303335977207,-109.3898734
51772,8,40,14,12,13,3,90,38.24303335977207,-109.3896039
51773,6,42,14,11,14,3,90,38.24303335977207,-109.3893344
51774,6,41,14,11,14,4,90,38.24303335977207,-109.3890649
51775,7,40,14,11,13,4,89,38.24303335977207,-109.3887954
51776,8,39,15,11,13,4,90,38.24303335977207,-109.3885259
51777,9,38,15,12,13,3,90,38.24303335977207,-109.3882564
51778,9,37,15,14,14,2,91,38.24303335977207,-109.3879869
51779,10,36,15,15,13,2,91,38.24303335977207,-109.3877174
51780,10,36,15,14,13,3,91,38.24303335977207,-109.3874479
51781,10,35,15,14,12,4,90,38.24303335977207,-109.3871784
51782,11,35,15,13,12,3,89,38.24303335977207,-109.3869089
51783,11,36,15,13,11,3,89,38.24303335977207,-109.3866394
51784,13,36,15,13,10,3,90,38.24303335977207,-109.3863699
51785,13,35,15,14,11,3,91,38.24303335977207,-109.3861004
51786,12,35,15,13,12,3,90,38.24303335977207,-109.3858309
51787,12,37,14,12,11,3,89,38.24303335977207,-109.3855614
51788,12,37,14,12,12,3,90,38.24303335977207,-109.3852919
51789,14,35,15,14,12,1,91,38.24303335977207,-109.3850225
51790,16,33,15,14,12,1,91,38.24303335977207,-109.384753
51791,18,32,15,14,12,1,92,38.24303335977207,-109.3844835
51792,19,32,14,14,11,1,91,38.24303335977207,-109.384214
51793,16,33,15,14,11,1,90,38.24303335977207,-109.3839445
51794,12,34,14,14,11,3,88,38.24303335977207,-109.383675
51795,11,35,14,15,12,2,89,38.24303335977207,-109.3834055
51796,13,36,15,14,12,1,91,38.24303335977207,-109.383136
51797,11,37,14,14,12,2,90,38.24303335977207,-109.3828665
51798,12,38,13,11,13,1,88,38.24303335977207,-109.382597
51799,13,41,12,10,12,1,89,38.24303335977207,-109.3823275
51800,11,41,13,11,11,2,89,38.24303335977207,-109.382058
51801,11,41,13,10,13,2,90,38.24303335977207,-109.3817885
51802,7,33,11,9,12,4,76,38.24303335977207,-109.381519
51803,6,25,9,13,11,2,66,38.24303335977207,-109.3812495
51804,8,25,10,13,13,1,70,38.24303335977207,-109.38098
51805,14,34,12,9,13,3,85,38.24303335977207,-109.3807105
51806,15,36,12,10,13,2,88,38.24303335977207,-109.380441
51807,17,37,13,9,12,2,90,38.24303335977207,-109.3801716
51808,15,39,13,8,12,2,89,38.24303335977207,-109.3799021
51809,10,42,13,8,12,4,89,38.24303335977207,-109.3796326
51810,6,47,13,7,12,5,90,38.24303335977207,-109.3793631
51811,7,47,13,7,14,4,92,38.24303335977207,-109.3790936
51812,6,46,12,7,14,3,88,38.24303335977207,-109.3788241
51813,4,47,10,5,14,4,84,38.24303335977207,-109.3785546
51814,2,47,9,4,13,4,79,38.24303335977207,-109.3782851
51815,0,48,7,1,11,4,71,38.24303335977207,-109.3780156
51816,0,49,6,2,10,2,69,38.24303335977207,-109.3777461
51817,1,52,7,3,9,2,74,38.24303335977207,-109.3774766
51818,1,52,7,2,10,2,74,38.24303335977207,-109.3772071
51819,0,55,8,2,11,3,79,38.24303335977207,-109.3769376
51820,0,53,8,1,11,4,77,38.24303335977207,-109.3766681
51821,1,42,9,3,12,7,74,38.24303335977207,-109.3763986
51822,2,35,14,2,7,16,76,38.24303335977207,-109.3761291
51823,2,31,14,0,6,20,73,38.24303335977207,-109.3758596
51824,2,31,14,0,7,19,73,38.24303335977207,-109.3755901
51825,2,32,11,5,9,12,71,38.24303335977207,-109.3753206
51826,0,33,10,2,11,10,66,38.24303335977207,-109.3750512
51827,0,36,8,3,11,7,65,38.24303335977207,-109.3747817
51828,0,34,8,8,10,8,68,38.24303335977207,-109.3745122
51829,5,29,11,0,10,12,67,38.24303335977207,-109.3742427
51830,3,30,12,1,5,13,64,38.24303335977207,-109.3739732
51831,2,33,7,4,4,8,58,38.24303335977207,-109.3737037
51832,1,45,5,2,8,3,64,38.24303335977207,-109.3734342
51833,1,44,5,2,9,2,63,38.24303335977207,-109.3731647
51834,3,44,6,5,9,2,69,38.24303335977207,-109.3728952
51835,2,43,8,6,10,3,72,38.24303335977207,-109.3726257
51836,2,36,9,7,11,6,71,38.24303335977207,-109.3723562
51837,1,34,9,5,9,8,66,38.24303335977207,-109.3720867
51838,1,37,9,3,8,5,63,38.24303335977207,-109.3718172
51839,4,41,9,7,10,2,73,38.24303335977207,-109.3715477
51840,3,40,8,7,10,3,71,38.24303335977207,-109.3712782
51841,2,26,7,6,11,4,56,38.24303335977207,-109.3710087
51842,2,22,7,5,11,4,51,38.24303335977207,-109.3707392
51843,5,26,7,10,10,1,59,38.24303335977207,-109.3704697
51844,3,18,10,3,9,8,51,38.24303335977207,-109.3702003
51845,2,20,11,2,4,14,53,38.24303335977207,-109.3699308
51846,3,23,12,3,7,11,59,38.24303335977207,-109.3696613
51847,3,24,11,4,7,10,59,38.24303335977207,-109.3693918
51848,1,18,9,3,2,14,47,38.24303335977207,-109.3691223
51849,1,16,9,3,2,14,45,38.24303335977207,-109.3688528
51850,1,16,9,5,4,12,47,38.24303335977207,-109.3685833
51851,1,26,9,5,7,9,57,38.24303335977207,-109.3683138
51852,2,27,9,5,9,7,59,38.24303335977207,-109.3680443
51853,3,34,9,5,10,4,65,38.24303335977207,-109.3677748
51854,2,17,9,7,9,5,49,38.24303335977207,-109.3675053
51855,4,15,9,8,10,6,52,38.24303335977207,-109.3672358
51856,0,18,11,1,4,17,51,38.24303335977207,-109.3669663
51857,2,22,12,0,5,18,59,38.24303335977207,-109.3666968
51858,1,24,12,0,4,19,60,38.24303335977207,-109.3664273
51859,1,25,11,0,4,19,60,38.24303335977207,-109.3661578
51860,1,24,11,0,5,19,60,38.24303335977207,-109.3658883
51861,1,24,12,0,4,21,62,38.24303335977207,-109.3656188
51862,1,24,12,0,3,21,61,38.24303335977207,-109.3653493
51863,1,25,12,0,4,20,62,38.24303335977207,-109.3650799
51864,1,26,11,0,5,19,62,38.24303335977207,-109.3648104
51865,1,28,11,0,6,18,64,38.24303335977207,-109.3645409
51866,1,28,11,0,5,19,64,38.24303335977207,-109.3642714
51867,1,27,11,0,3,19,61,38.24303335977207,-109.3640019
51868,1,26,11,2,4,17,61,38.24303335977207,-109.3637324
51869,1,26,10,3,7,13,60,38.24303335977207,-109.3634629
51870,4,31,9,6,6,8,64,38.24303335977207,-109.3631934
51871,2,38,5,4,9,3,61,38.24303335977207,-109.3629239
51872,3,29,5,2,8,5,52,38.24303335977207,-109.3626544
51873,3,28,7,4,8,4,54,38.24303335977207,-109.3623849
51874,2,33,7,5,9,3,59,38.24303335977207,-109.3621154
51875,3,34,6,5,8,4,60,38.24303335977207,-109.3618459
51876,2,31,6,5,7,5,56,38.24303335977207,-109.3615764
51877,2,31,6,5,7,5,56,38.24303335977207,-109.3613069
51878,2,27,5,4,7,5,50,38.24303335977207,-109.3610374
51879,4,24,6,3,8,6,51,38.24303335977207,-109.3607679
51880,5,26,10,6,7,11,65,38.24303335977207,-109.3604984
51881,7,25,12,5,3,18,70,38.24303335977207,-109.360229
51882,2,26,12,2,5,19,66,38.24303335977207,-109.3599595
51883,2,25,12,3,4,19,65,38.24303335977207,-109.35969
51884,1,26,11,4,5,16,63,38.24303335977207,-109.3594205
51885,1,30,11,1,5,17,65,38.24303335977207,-109.359151
51886,1,32,10,0,6,16,65,38.24303335977207,-109.3588815
51887,1,34,11,2,10,12,70,38.24303335977207,-109.358612
51888,2,34,11,4,11,10,72,38.24303335977207,-109.3583425
51889,2,34,10,5,10,8,69,38.24303335977207,-109.358073
51890,2,37,10,4,11,7,71,38.24303335977207,-109.3578035
51891,2,32,11,4,10,11,70,38.24303335977207,-109.357534
51892,2,30,12,1,6,16,67,38.24303335977207,-109.3572645
51893,0,29,11,0,5,19,64,38.24303335977207,-109.356995
51894,0,36,10,0,10,12,68,38.24303335977207,-109.3567255
51895,3,41,8,4,9,3,68,38.24303335977207,-109.356456
51896,2,26,9,4,8,7,56,38.24303335977207,-109.3561865
51897,3,23,10,6,8,9,59,38.24303335977207,-109.355917
51898,2,29,11,3,7,13,65,38.24303335977207,-109.3556475
51899,1,32,11,2,5,12,63,38.24303335977207,-109.355378
51900,2,27,11,4,6,9,59,38.24303335977207,-109.3551086
51901,2,23,12,5,6,13,61,38.24303335977207,-109.3548391
51902,3,19,13,9,7,16,67,38.24303335977207,-109.3545696
51903,18,23,14,14,10,7,86,38.24303335977207,-109.3543001
51904,28,20,12,16,10,4,90,38.24303335977207,-109.3540306
51905,15,20,13,12,9,7,76,38.24303335977207,-109.3537611
51906,7,21,11,8,8,10,65,38.24303335977207,-109.3534916
51907,11,21,12,10,7,9,70,38.24303335977207,-109.3532221
51908,30,16,14,20,12,2,94,38.24303335977207,-109.3529526
51909,33,12,12,24,10,2,93,38.24303335977207,-109.3526831
51910,20,18,12,24,10,4,88,38.24303335977207,-109.3524136
51911,11,21,11,11,11,7,72,38.24303335977207,-109.3521441
51912,11,19,11,12,8,5,66,38.24303335977207,-109.3518746
51913,11,19,12,17,10,3,72,38.24303335977207,-109.3516051
51914,15,21,12,20,10,2,80,38.24303335977207,-109.3513356
51915,17,23,12,21,11,2,86,38.24303335977207,-109.3510661
51916,25,19,13,20,13,1,91,38.24303335977207,-109.3507966
51917,33,16,12,19,10,2,92,38.24303335977207,-109.3505271
51918,34,15,11,21,9,2,92,38.24303335977207,-109.3502577
51919,31,14,10,23,12,2,92,38.24303335977207,-109.3499882
51920,22,16,10,27,15,2,92,38.24303335977207,-109.3497187
51921,10,21,11,25,15,5,87,38.24303335977207,-109.3494492
51922,2,26,14,10,11,15,78,38.24303335977207,-109.3491797
51923,3,27,13,9,11,13,76,38.24303335977207,-109.3489102
51924,1,29,13,7,11,15,76,38.24303335977207,-109.3486407
51925,1,31,14,5,11,15,77,38.24303335977207,-109.3483712
51926,1,33,14,5,12,14,79,38.24303335977207,-109.3481017
51927,1,33,15,5,10,17,81,38.24303335977207,-109.3478322
51928,1,33,15,5,9,18,81,38.24303335977207,-109.3475627
51929,0,30,14,4,8,19,75,38.24303335977207,-109.3472932
51930,1,30,14,3,11,15,74,38.24303335977207,-109.3470237
51931,1,32,13,1,14,13,74,38.24303335977207,-109.3467542
51932,0,30,12,3,12,13,70,38.24303335977207,-109.3464847
51933,1,31,13,1,15,13,74,38.24303335977207,-109.3462152
51934,1,29,13,3,13,13,72,38.24303335977207,-109.3459457
51935,0,28,12,1,10,16,67,38.24303335977207,-109.3456762
51936,0,28,12,2,11,15,68,38.24303335977207,-109.3454068
51937,2,30,14,4,14,11,75,38.24303335977207,-109.3451373
51938,1,29,12,4,14,9,69,38.24303335977207,-109.3448678
51939,1,28,13,3,12,11,68,38.24303335977207,-109.3445983
51940,1,28,13,3,12,13,70,38.24303335977207,-109.3443288
51941,1,30,12,3,13,11,70,38.24303335977207,-109.3440593
51942,1,33,12,0,13,14,73,38.24303335977207,-109.3437898
51943,1,34,13,0,11,16,75,38.24303335977207,-109.3435203
51944,1,32,12,0,9,17,71,38.24303335977207,-109.3432508
51945,1,30,11,0,8,17,67,38.24303335977207,-109.3429813
51946,1,30,11,0,10,12,64,38.24303335977207,-109.3427118
51947,0,33,10,0,8,14,65,38.24303335977207,-109.3424423
51948,1,34,11,0,7,15,68,38.24303335977207,-109.3421728
51949,1,30,11,0,7,15,64,38.24303335977207,-109.3419033
51950,1,32,10,0,10,13,66,38.24303335977207,-109.3416338
51951,1,30,10,0,11,11,63,38.24303335977207,-109.3413643
51952,1,35,10,1,11,9,67,38.24303335977207,-109.3410948
51953,1,43,10,0,12,9,75,38.24303335977207,-109.3408253
51954,2,44,11,0,12,10,79,38.24303335977207,-109.3405558
51955,2,46,12,0,13,10,83,38.24303335977207,-109.3402864
51956,2,32,12,0,7,17,70,38.24303335977207,-109.3400169
51957,2,29,12,0,5,19,67,38.24303335977207,-109.3397474
51958,2,30,13,0,5,18,68,38.24303335977207,-109.3394779
51959,4,31,13,0,5,18,71,38.24303335977207,-109.3392084
51960,4,32,13,1,8,16,74,38.24303335977207,-109.3389389
51961,3,33,13,1,8,17,75,38.24303335977207,-109.3386694
51962,3,33,14,1,8,18,77,38.24303335977207,-109.3383999
51963,3,32,14,2,7,19,77,38.24303335977207,-109.3381304
51964,3,32,13,1,5,20,74,38.24303335977207,-109.3378609
51965,2,27,13,1,3,22,68,38.24303335977207,-109.3375914
51966,2,25,14,0,1,24,66,38.24303335977207,-109.3373219
51967,0,33,10,0,6,13,62,38.24303335977207,-109.3370524
51968,1,44,7,3,10,4,69,38.24303335977207,-109.3367829
51969,1,43,5,1,8,3,61,38.24303335977207,-109.3365134
51970,1,36,5,1,8,5,56,38.24303335977207,-109.3362439
51971,2,30,6,1,8,5,52,38.24303335977207,-109.3359744
51972,5,28,9,4,9,6,61,38.24303335977207,-109.3357049
51973,5,20,14,6,6,16,67,38.24303335977207,-109.3354355
51974,6,22,16,4,4,21,73,38.24303335977207,-109.335166
51975,3,20,13,4,5,18,63,38.24303335977207,-109.3348965
51976,2,24,11,4,7,14,62,38.24303335977207,-109.334627
51977,2,29,11,3,7,14,66,38.24303335977207,-109.3343575
51978,2,31,11,5,8,11,68,38.24303335977207,-109.334088
51979,2,24,10,8,9,9,62,38.24303335977207,-109.3338185
51980,2,24,11,13,13,6,69,38.24303335977207,-109.333549
51981,3,28,12,12,17,5,77,38.24303335977207,-109.3332795
51982,4,30,12,7,15,10,78,38.24303335977207,-109.33301
51983,1,25,13,3,9,18,69,38.24303335977207,-109.3327405
51984,1,21,12,3,5,18,60,38.24303335977207,-109.332471
51985,2,24,12,1,6,17,62,38.24303335977207,-109.3322015
51986,2,29,11,1,6,15,64,38.24303335977207,-109.331932
51987,1,27,11,1,5,15,60,38.24303335977207,-109.3316625
51988,0,6,5,15,18,20,64,38.24276386518684,-109.4402688
51989,0,2,5,22,17,24,70,38.24276386518684,-109.4399993
51990,2,10,6,24,13,19,74,38.24276386518684,-109.4397299
51991,14,19,12,13,27,8,93,38.24276386518684,-109.4394604
51992,9,20,11,24,23,3,90,38.24276386518684,-109.4391909
51993,3,21,11,28,22,5,90,38.24276386518684,-109.4389214
51994,2,18,12,27,22,6,87,38.24276386518684,-109.4386519
51995,1,21,12,24,17,5,80,38.24276386518684,-109.4383824
51996,0,27,10,16,20,2,75,38.24276386518684,-109.4381129
51997,0,27,9,12,13,4,65,38.24276386518684,-109.4378434
51998,0,30,9,7,9,7,62,38.24276386518684,-109.4375739
51999,1,36,10,2,12,8,69,38.24276386518684,-109.4373044
52000,3,41,10,5,14,4,77,38.24276386518684,-109.4370349
52001,4,44,10,8,14,2,82,38.24276386518684,-109.4367654
52002,6,44,12,10,13,1,86,38.24276386518684,-109.4364959
52003,6,44,13,12,13,1,89,38.24276386518684,-109.4362264
52004,6,42,12,11,15,1,87,38.24276386518684,-109.4359569
52005,7,42,12,9,16,1,87,38.24276386518684,-109.4356874
52006,8,41,12,10,15,1,87,38.24276386518684,-109.4354179
52007,9,40,12,12,14,1,88,38.24276386518684,-109.4351484
52008,11,41,13,13,13,0,91,38.24276386518684,-109.434879
52009,10,43,14,12,14,0,93,38.24276386518684,-109.4346095
52010,9,42,14,13,14,0,92,38.24276386518684,-109.43434
52011,8,42,14,13,14,0,91,38.24276386518684,-109.4340705
52012,8,43,14,12,14,1,92,38.24276386518684,-109.433801
52013,8,42,14,13,14,1,92,38.24276386518684,-109.4335315
52014,7,41,13,13,14,1,89,38.24276386518684,-109.433262
52015,7,42,13,13,15,1,91,38.24276386518684,-109.4329925
52016,7,42,13,11,15,1,89,38.24276386518684,-109.432723
52017,6,40,12,9,15,2,84,38.24276386518684,-109.4324535
52018,2,34,11,3,12,10,72,38.24276386518684,-109.432184
52019,1,38,10,2,13,8,72,38.24276386518684,-109.4319145
52020,0,40,9,1,10,8,68,38.24276386518684,-109.431645
52021,1,46,8,2,10,5,72,38.24276386518684,-109.4313755
52022,2,51,9,3,13,2,80,38.24276386518684,-109.431106
52023,2,47,11,2,18,3,83,38.24276386518684,-109.4308365
52024,2,39,11,2,14,8,76,38.24276386518684,-109.430567
52025,2,37,11,2,13,9,74,38.24276386518684,-109.4302975
52026,3,41,11,2,14,7,78,38.24276386518684,-109.430028
52027,4,43,12,6,15,3,83,38.24276386518684,-109.4297586
52028,4,44,13,12,15,1,89,38.24276386518684,-109.4294891
52029,5,43,14,15,14,1,92,38.24276386518684,-109.4292196
52030,6,43,14,16,14,1,94,38.24276386518684,-109.4289501
52031,6,42,14,16,14,1,93,38.24276386518684,-109.4286806
52032,7,39,14,15,13,1,89,38.24276386518684,-109.4284111
52033,7,38,14,16,13,1,89,38.24276386518684,-109.4281416
52034,8,38,14,16,14,1,91,38.24276386518684,-109.4278721
52035,9,36,14,14,15,1,89,38.24276386518684,-109.4276026
52036,9,34,13,11,14,3,84,38.24276386518684,-109.4273331
52037,8,35,12,9,13,5,82,38.24276386518684,-109.4270636
52038,7,34,11,11,13,3,79,38.24276386518684,-109.4267941
52039,8,33,10,9,13,2,75,38.24276386518684,-109.4265246
52040,6,29,9,6,13,3,66,38.24276386518684,-109.4262551
52041,4,26,9,5,11,6,61,38.24276386518684,-109.4259856
52042,3,30,9,6,11,6,65,38.24276386518684,-109.4257161
52043,3,32,10,6,11,6,68,38.24276386518684,-109.4254466
52044,3,35,9,7,12,4,70,38.24276386518684,-109.4251771
52045,4,37,9,6,13,4,73,38.24276386518684,-109.4249077
52046,3,36,10,6,12,5,72,38.24276386518684,-109.4246382
52047,2,38,9,5,12,6,72,38.24276386518684,-109.4243687
52048,3,46,9,6,13,4,81,38.24276386518684,-109.4240992
52049,3,49,9,6,12,3,82,38.24276386518684,-109.4238297
52050,3,48,9,8,12,2,82,38.24276386518684,-109.4235602
52051,3,50,9,7,12,2,83,38.24276386518684,-109.4232907
52052,3,51,9,7,11,1,82,38.24276386518684,-109.4230212
52053,4,50,9,8,12,1,84,38.24276386518684,-109.4227517
52054,4,48,10,9,12,1,84,38.24276386518684,-109.4224822
52055,14,38,14,13,14,0,93,38.24276386518684,-109.4068515
52056,13,38,14,13,14,0,92,38.24276386518684,-109.406582
52057,12,39,14,14,14,0,93,38.24276386518684,-109.4063125
52058,13,38,14,14,14,0,93,38.24276386518684,-109.406043
52059,17,36,14,12,14,0,93,38.24276386518684,-109.4057735
52060,16,35,14,13,13,0,91,38.24276386518684,-109.405504
52061,17,35,14,14,13,0,93,38.24276386518684,-109.4052345
52062,17,35,13,13,13,0,91,38.24276386518684,-109.4049651
52063,17,35,13,12,14,0,91,38.24276386518684,-109.4046956
52064,19,34,13,12,13,0,91,38.24276386518684,-109.4044261
52065,21,31,13,13,13,0,91,38.24276386518684,-109.4041566
52066,21,32,14,13,12,0,92,38.24276386518684,-109.4038871
52067,20,33,14,12,12,0,91,38.24276386518684,-109.4036176
52068,18,36,13,11,12,0,90,38.24276386518684,-109.4033481
52069,18,35,14,13,12,0,92,38.24276386518684,-109.4030786
52070,14,37,14,13,13,0,91,38.24276386518684,-109.4028091
52071,14,38,13,12,13,0,90,38.24276386518684,-109.4025396
52072,14,38,13,12,13,0,90,38.24276386518684,-109.4022701
52073,12,39,13,13,13,0,90,38.24276386518684,-109.4020006
52074,13,38,13,13,14,0,91,38.24276386518684,-109.4017311
52075,9,44,13,11,14,1,92,38.24276386518684,-109.4014616
52076,6,47,13,10,13,2,91,38.24276386518684,-109.4011921
52077,5,50,12,8,13,2,90,38.24276386518684,-109.4009226
52078,4,51,12,7,13,2,89,38.24276386518684,-109.4006531
52079,4,53,12,6,15,2,92,38.24276386518684,-109.4003836
52080,5,51,12,7,14,1,90,38.24276386518684,-109.4001142
52081,6,49,13,8,15,1,92,38.24276386518684,-109.3998447
52082,7,47,13,9,15,1,92,38.24276386518684,-109.3995752
52083,6,45,13,9,15,1,89,38.24276386518684,-109.3993057
52084,6,43,13,9,15,1,87,38.24276386518684,-109.3990362
52085,6,43,13,9,14,1,86,38.24276386518684,-109.3987667
52086,6,45,13,8,15,1,88,38.24276386518684,-109.3984972
52087,5,45,13,6,15,3,87,38.24276386518684,-109.3982277
52088,6,47,14,6,15,2,90,38.24276386518684,-109.3979582
52089,8,46,13,7,15,1,90,38.24276386518684,-109.3976887
52090,8,43,14,8,16,1,90,38.24276386518684,-109.3974192
52091,8,43,14,9,15,1,90,38.24276386518684,-109.3971497
52092,7,41,14,8,14,2,86,38.24276386518684,-109.3968802
52093,6,42,14,9,15,2,88,38.24276386518684,-109.3966107
52094,5,43,14,8,15,2,87,38.24276386518684,-109.3963412
52095,5,43,14,8,14,2,86,38.24276386518684,-109.3960717
52096,5,43,13,9,15,2,87,38.24276386518684,-109.3958022
52097,5,44,13,9,15,2,88,38.24276386518684,-109.3955327
52098,5,44,13,9,16,2,89,38.24276386518684,-109.3952632
52099,5,45,13,8,16,2,89,38.24276386518684,-109.3949938
52100,5,47,13,6,15,2,88,38.24276386518684,-109.3947243
52101,5,49,13,5,16,2,90,38.24276386518684,-109.3944548
52102,5,46,13,7,16,2,89,38.24276386518684,-109.3941853
52103,5,46,13,6,17,2,89,38.24276386518684,-109.3939158
52104,5,47,13,7,17,2,91,38.24276386518684,-109.3936463
52105,5,45,13,8,17,2,90,38.24276386518684,-109.3933768
52106,5,44,13,8,17,2,89,38.24276386518684,-109.3931073
52107,5,45,13,8,17,2,90,38.24276386518684,-109.3928378
52108,4,45,13,8,16,2,88,38.24276386518684,-109.3925683
52109,4,43,14,8,16,3,88,38.24276386518684,-109.3922988
52110,5,42,14,9,15,3,88,38.24276386518684,-109.3920293
52111,5,42,14,9,14,3,87,38.24276386518684,-109.3917598
52112,5,42,14,10,14,3,88,38.24276386518684,-109.3914903
52113,5,42,14,10,13,3,87,38.24276386518684,-109.3912208
52114,5,42,14,10,13,3,87,38.24276386518684,-109.3909513
52115,5,42,14,9,14,2,86,38.24276386518684,-109.3906818
52116,7,39,13,10,13,3,85,38.24276386518684,-109.3904123
52117,8,36,12,11,13,3,83,38.24276386518684,-109.3901429
52118,8,37,13,11,12,4,85,38.24276386518684,-109.3898734
52119,8,40,14,11,13,3,89,38.24276386518684,-109.3896039
52120,7,41,14,10,13,3,88,38.24276386518684,-109.3893344
52121,6,41,14,9,13,3,86,38.24276386518684,-109.3890649
52122,6,40,14,10,13,3,86,38.24276386518684,-109.3887954
52123,7,38,14,11,13,3,86,38.24276386518684,-109.3885259
52124,9,36,15,12,13,3,88,38.24276386518684,-109.3882564
52125,9,36,15,13,13,3,89,38.24276386518684,-109.3879869
52126,10,36,15,14,12,3,90,38.24276386518684,-109.3877174
52127,11,35,16,14,11,3,90,38.24276386518684,-109.3874479
52128,13,34,16,14,10,3,90,38.24276386518684,-109.3871784
52129,13,35,15,14,10,3,90,38.24276386518684,-109.3869089
52130,16,33,15,14,9,3,90,38.24276386518684,-109.3866394
52131,19,31,15,14,9,2,90,38.24276386518684,-109.3863699
52132,22,30,15,14,9,2,92,38.24276386518684,-109.3861004
52133,21,31,15,14,9,2,92,38.24276386518684,-109.3858309
52134,19,32,15,13,9,2,90,38.24276386518684,-109.3855614
52135,18,32,15,14,9,2,90,38.24276386518684,-109.3852919
52136,21,29,14,15,9,2,90,38.24276386518684,-109.3850225
52137,23,28,14,15,9,2,91,38.24276386518684,-109.384753
52138,22,28,14,15,10,1,90,38.24276386518684,-109.3844835
52139,23,27,14,15,10,1,90,38.24276386518684,-109.384214
52140,21,29,14,15,11,1,91,38.24276386518684,-109.3839445
52141,21,30,14,14,10,1,90,38.24276386518684,-109.383675
52142,25,29,14,13,10,1,92,38.24276386518684,-109.3834055
52143,29,28,15,12,9,1,94,38.24276386518684,-109.383136
52144,19,34,13,12,11,1,90,38.24276386518684,-109.3828665
52145,12,40,12,11,13,1,89,38.24276386518684,-109.382597
52146,10,43,11,9,13,1,87,38.24276386518684,-109.3823275
52147,10,44,12,9,13,1,89,38.24276386518684,-109.382058
52148,9,44,12,10,14,1,90,38.24276386518684,-109.3817885
52149,7,39,11,9,14,2,82,38.24276386518684,-109.381519
52150,5,28,9,10,10,3,65,38.24276386518684,-109.3812495
52151,6,25,9,12,11,1,64,38.24276386518684,-109.38098
52152,10,31,11,9,15,2,78,38.24276386518684,-109.3807105
52153,12,34,13,10,14,3,86,38.24276386518684,-109.380441
52154,17,34,13,9,12,2,87,38.24276386518684,-109.3801716
52155,12,40,13,9,13,2,89,38.24276386518684,-109.3799021
52156,5,42,12,6,14,5,84,38.24276386518684,-109.3796326
52157,3,43,11,4,12,7,80,38.24276386518684,-109.3793631
52158,6,45,11,5,13,4,84,38.24276386518684,-109.3790936
52159,5,45,11,4,13,4,82,38.24276386518684,-109.3788241
52160,3,46,9,4,12,4,78,38.24276386518684,-109.3785546
52161,1,49,8,2,12,3,75,38.24276386518684,-109.3782851
52162,0,56,6,1,10,3,76,38.24276386518684,-109.3780156
52163,1,56,6,3,10,2,78,38.24276386518684,-109.3777461
52164,0,54,6,2,9,3,74,38.24276386518684,-109.3774766
52165,0,54,6,1,10,3,74,38.24276386518684,-109.3772071
52166,1,56,7,5,11,2,82,38.24276386518684,-109.3769376
52167,1,46,8,4,12,6,77,38.24276386518684,-109.3766681
52168,3,34,11,6,12,9,75,38.24276386518684,-109.3763986
52169,3,30,14,3,6,18,74,38.24276386518684,-109.3761291
52170,0,24,9,0,12,13,58,38.24276386518684,-109.3758596
52171,3,34,13,5,9,10,74,38.24276386518684,-109.3755901
52172,0,33,10,4,14,7,68,38.24276386518684,-109.3753206
52173,0,34,10,6,12,7,69,38.24276386518684,-109.3750512
52174,0,32,8,5,13,9,67,38.24276386518684,-109.3747817
52175,0,27,9,4,14,8,62,38.24276386518684,-109.3745122
52176,19,33,12,1,11,2,78,38.24276386518684,-109.3742427
52177,4,37,8,4,7,6,66,38.24276386518684,-109.3739732
52178,1,44,5,2,9,3,64,38.24276386518684,-109.3737037
52179,1,50,5,2,9,1,68,38.24276386518684,-109.3734342
52180,3,51,7,5,11,2,79,38.24276386518684,-109.3731647
52181,2,48,8,6,10,3,77,38.24276386518684,-109.3728952
52182,3,38,8,6,11,5,71,38.24276386518684,-109.3726257
52183,3,27,11,6,8,11,66,38.24276386518684,-109.3723562
52184,2,24,12,6,7,14,65,38.24276386518684,-109.3720867
52185,4,36,9,6,9,4,68,38.24276386518684,-109.3718172
52186,5,38,9,9,10,3,74,38.24276386518684,-109.3715477
52187,5,35,12,10,9,5,76,38.24276386518684,-109.3712782
52188,2,25,10,5,10,8,60,38.24276386518684,-109.3710087
52189,0,27,13,0,15,9,64,38.24276386518684,-109.3707392
52190,2,22,11,1,14,5,55,38.24276386518684,-109.3704697
52191,2,15,10,3,8,9,47,38.24276386518684,-109.3702003
52192,1,17,11,3,3,14,49,38.24276386518684,-109.3699308
52193,3,21,11,4,2,13,54,38.24276386518684,-109.3696613
52194,5,20,9,5,4,9,52,38.24276386518684,-109.3693918
52195,6,25,8,4,7,5,55,38.24276386518684,-109.3691223
52196,2,32,7,5,9,5,60,38.24276386518684,-109.3688528
52197,2,41,9,4,10,5,71,38.24276386518684,-109.3685833
52198,3,42,9,4,11,3,72,38.24276386518684,-109.3683138
52199,6,33,11,7,12,2,71,38.24276386518684,-109.3680443
52200,10,31,12,2,7,6,68,38.24276386518684,-109.3677748
52201,1,25,12,0,14,7,59,38.24276386518684,-109.3675053
52202,1,26,15,2,8,15,67,38.24276386518684,-109.3672358
52203,3,25,14,1,8,17,68,38.24276386518684,-109.3669663
52204,1,25,14,0,5,23,68,38.24276386518684,-109.3666968
52205,1,24,13,0,4,23,65,38.24276386518684,-109.3664273
52206,1,24,12,0,4,22,63,38.24276386518684,-109.3661578
52207,0,24,12,0,3,23,62,38.24276386518684,-109.3658883
52208,1,24,13,0,3,23,64,38.24276386518684,-109.3656188
52209,0,23,12,0,2,22,59,38.24276386518684,-109.3653493
52210,0,22,12,0,2,22,58,38.24276386518684,-109.3650799
52211,1,25,12,0,4,20,62,38.24276386518684,-109.3648104
52212,2,27,12,1,4,20,66,38.24276386518684,-109.3645409
52213,1,24,12,1,2,22,62,38.24276386518684,-109.3642714
52214,2,26,11,0,4,17,60,38.24276386518684,-109.3640019
52215,2,28,11,2,4,16,63,38.24276386518684,-109.3637324
52216,1,23,10,2,5,15,56,38.24276386518684,-109.3634629
52217,2,24,10,4,8,8,56,38.24276386518684,-109.3631934
52218,4,35,7,8,8,4,66,38.24276386518684,-109.3629239
52219,5,26,9,7,7,10,64,38.24276386518684,-109.3626544
52220,2,29,9,3,7,13,63,38.24276386518684,-109.3623849
52221,2,33,8,4,9,8,64,38.24276386518684,-109.3621154
52222,4,34,8,7,10,7,70,38.24276386518684,-109.3618459
52223,4,37,9,8,10,6,74,38.24276386518684,-109.3615764
52224,3,38,10,6,11,7,75,38.24276386518684,-109.3613069
52225,4,36,9,6,9,7,71,38.24276386518684,-109.3610374
52226,3,30,10,4,6,12,65,38.24276386518684,-109.3607679
52227,5,21,15,4,1,23,69,38.24276386518684,-109.3604984
52228,4,23,14,4,2,25,72,38.24276386518684,-109.360229
52229,2,27,15,0,5,23,72,38.24276386518684,-109.3599595
52230,2,26,13,0,4,22,67,38.24276386518684,-109.35969
52231,1,27,13,1,4,22,68,38.24276386518684,-109.3594205
52232,1,24,14,0,1,25,65,38.24276386518684,-109.359151
52233,1,25,13,0,3,22,64,38.24276386518684,-109.3588815
52234,1,26,12,2,5,19,65,38.24276386518684,-109.358612
52235,1,28,11,2,7,16,65,38.24276386518684,-109.3583425
52236,2,27,10,4,7,12,62,38.24276386518684,-109.358073
52237,3,32,10,5,10,7,67,38.24276386518684,-109.3578035
52238,2,33,11,4,11,9,70,38.24276386518684,-109.357534
52239,1,30,11,1,7,16,66,38.24276386518684,-109.3572645
52240,0,29,11,0,4,20,64,38.24276386518684,-109.356995
52241,1,36,10,0,7,14,68,38.24276386518684,-109.3567255
52242,2,31,9,5,9,6,62,38.24276386518684,-109.356456
52243,3,29,10,3,9,7,61,38.24276386518684,-109.3561865
52244,2,30,10,4,8,10,64,38.24276386518684,-109.355917
52245,1,31,10,2,7,13,64,38.24276386518684,-109.3556475
52246,1,29,11,2,4,14,61,38.24276386518684,-109.355378
52247,2,30,11,3,6,9,61,38.24276386518684,-109.3551086
52248,2,27,11,4,7,11,62,38.24276386518684,-109.3548391
52249,2,22,12,6,6,14,62,38.24276386518684,-109.3545696
52250,10,25,13,10,8,9,75,38.24276386518684,-109.3543001
52251,32,21,12,15,9,2,91,38.24276386518684,-109.3540306
52252,31,19,12,17,10,2,91,38.24276386518684,-109.3537611
52253,20,19,12,13,9,6,79,38.24276386518684,-109.3534916
52254,18,19,13,12,8,8,78,38.24276386518684,-109.3532221
52255,35,17,13,17,10,1,93,38.24276386518684,-109.3529526
52256,39,14,11,18,11,1,94,38.24276386518684,-109.3526831
52257,28,19,12,18,9,3,89,38.24276386518684,-109.3524136
52258,23,23,14,18,8,3,89,38.24276386518684,-109.3521441
52259,23,22,14,21,8,1,89,38.24276386518684,-109.3518746
52260,28,19,13,19,11,1,91,38.24276386518684,-109.3516051
52261,31,16,12,17,10,0,86,38.24276386518684,-109.3513356
52262,33,16,13,18,10,1,91,38.24276386518684,-109.3510661
52263,31,15,12,19,11,2,90,38.24276386518684,-109.3507966
52264,32,16,11,20,9,3,91,38.24276386518684,-109.3505271
52265,29,16,10,20,11,3,89,38.24276386518684,-109.3502577
52266,15,17,12,22,17,7,90,38.24276386518684,-109.3499882
52267,6,22,14,18,14,9,83,38.24276386518684,-109.3497187
52268,2,28,14,9,12,13,78,38.24276386518684,-109.3494492
52269,0,27,13,3,12,17,72,38.24276386518684,-109.3491797
52270,1,30,14,2,11,18,76,38.24276386518684,-109.3489102
52271,1,31,13,0,9,18,72,38.24276386518684,-109.3486407
52272,1,27,13,0,6,18,65,38.24276386518684,-109.3483712
52273,1,26,12,0,5,19,63,38.24276386518684,-109.3481017
52274,1,26,12,2,5,19,65,38.24276386518684,-109.3478322
52275,1,26,12,0,5,20,64,38.24276386518684,-109.3475627
52276,1,29,13,0,5,20,68,38.24276386518684,-109.3472932
52277,1,30,13,0,8,19,71,38.24276386518684,-109.3470237
52278,2,32,12,0,11,15,72,38.24276386518684,-109.3467542
52279,4,36,13,6,16,6,81,38.24276386518684,-109.3464847
52280,7,35,14,6,17,6,85,38.24276386518684,-109.3462152
52281,4,33,14,9,15,6,81,38.24276386518684,-109.3459457
52282,1,28,13,5,11,13,71,38.24276386518684,-109.3456762
52283,1,28,13,5,10,13,70,38.24276386518684,-109.3454068
52284,0,28,12,2,9,15,66,38.24276386518684,-109.3451373
52285,0,29,12,0,10,16,67,38.24276386518684,-109.3448678
52286,0,30,11,0,9,17,67,38.24276386518684,-109.3445983
52287,1,31,12,0,9,16,69,38.24276386518684,-109.3443288
52288,0,29,14,0,7,22,72,38.24276386518684,-109.3440593
52289,1,31,11,0,9,15,67,38.24276386518684,-109.3437898
52290,1,34,11,0,10,14,70,38.24276386518684,-109.3435203
52291,1,34,11,0,10,15,71,38.24276386518684,-109.3432508
52292,1,36,11,0,11,12,71,38.24276386518684,-109.3429813
52293,1,36,10,0,12,10,69,38.24276386518684,-109.3427118
52294,0,32,10,0,10,13,65,38.24276386518684,-109.3424423
52295,1,31,10,0,10,14,66,38.24276386518684,-109.3421728
52296,0,28,10,0,8,14,60,38.24276386518684,-109.3419033
52297,2,29,9,0,10,10,60,38.24276386518684,-109.3416338
52298,1,42,8,0,11,7,69,38.24276386518684,-109.3413643
52299,1,42,9,1,11,7,71,38.24276386518684,-109.3410948
52300,1,42,10,1,14,7,75,38.24276386518684,-109.3408253
52301,2,38,11,0,12,11,74,38.24276386518684,-109.3405558
52302,2,33,12,0,7,17,71,38.24276386518684,-109.3402864
52303,2,29,13,0,5,19,68,38.24276386518684,-109.3400169
52304,2,28,12,0,6,17,65,38.24276386518684,-109.3397474
52305,3,29,12,0,6,16,66,38.24276386518684,-109.3394779
52306,3,29,12,0,5,17,66,38.24276386518684,-109.3392084
52307,3,30,13,0,6,16,68,38.24276386518684,-109.3389389
52308,3,31,13,1,8,16,72,38.24276386518684,-109.3386694
52309,3,29,13,1,5,19,70,38.24276386518684,-109.3383999
52310,3,27,13,0,3,20,66,38.24276386518684,-109.3381304
52311,2,26,12,0,2,20,62,38.24276386518684,-109.3378609
52312,3,27,12,0,3,19,64,38.24276386518684,-109.3375914
52313,2,26,11,0,2,19,60,38.24276386518684,-109.3373219
52314,1,39,9,1,10,8,68,38.24276386518684,-109.3370524
52315,1,47,7,3,10,3,71,38.24276386518684,-109.3367829
52316,1,43,5,1,9,4,63,38.24276386518684,-109.3365134
52317,1,34,5,0,8,5,53,38.24276386518684,-109.3362439
52318,4,29,8,3,9,5,58,38.24276386518684,-109.3359744
52319,7,31,11,6,7,7,69,38.24276386518684,-109.3357049
52320,2,22,14,2,5,21,66,38.24276386518684,-109.3354355
52321,5,29,15,2,6,19,76,38.24276386518684,-109.335166
52322,2,23,12,4,6,18,65,38.24276386518684,-109.3348965
52323,2,24,12,6,9,13,66,38.24276386518684,-109.334627
52324,1,27,12,5,10,14,69,38.24276386518684,-109.3343575
52325,1,28,12,5,11,16,73,38.24276386518684,-109.334088
52326,1,26,12,7,12,13,71,38.24276386518684,-109.3338185
52327,2,27,13,8,14,12,76,38.24276386518684,-109.333549
52328,2,31,14,3,13,16,79,38.24276386518684,-109.3332795
52329,4,31,13,0,9,16,73,38.24276386518684,-109.33301
52330,4,24,12,3,6,15,64,38.24276386518684,-109.3327405
52331,5,19,12,3,5,14,58,38.24276386518684,-109.332471
52332,3,21,10,6,7,11,58,38.24276386518684,-109.3322015
52333,2,23,10,5,8,9,57,38.24276386518684,-109.331932
52334,12,39,14,13,14,0,92,38.24249437,-109.4068515
52335,12,39,14,12,14,0,91,38.24249437,-109.406582
52336,14,38,14,12,14,0,92,38.24249437,-109.4063125
52337,16,38,14,12,14,0,94,38.24249437,-109.406043
52338,19,36,14,11,13,0,93,38.24249437,-109.4057735
52339,16,35,14,13,14,0,92,38.24249437,-109.405504
52340,17,35,13,13,13,0,91,38.24249437,-109.4052345
52341,20,34,13,12,13,0,92,38.24249437,-109.4049651
52342,20,34,13,12,13,0,92,38.24249437,-109.4046956
52343,19,33,13,13,13,0,91,38.24249437,-109.4044261
52344,21,32,14,13,12,0,92,38.24249437,-109.4041566
52345,19,34,14,13,12,0,92,38.24249437,-109.4038871
52346,18,36,15,13,11,0,93,38.24249437,-109.4036176
52347,15,40,14,12,12,0,93,38.24249437,-109.4033481
52348,13,41,14,12,12,0,92,38.24249437,-109.4030786
52349,12,42,14,11,13,0,92,38.24249437,-109.4028091
52350,10,42,13,11,13,1,90,38.24249437,-109.4025396
52351,9,43,13,10,14,1,90,38.24249437,-109.4022701
52352,8,44,13,11,14,1,91,38.24249437,-109.4020006
52353,8,42,13,12,15,1,91,38.24249437,-109.4017311
52354,7,43,13,11,14,1,89,38.24249437,-109.4014616
52355,7,44,13,10,14,1,89,38.24249437,-109.4011921
52356,6,47,13,9,13,1,89,38.24249437,-109.4009226
52357,4,51,12,7,13,2,89,38.24249437,-109.4006531
52358,5,51,12,8,14,1,91,38.24249437,-109.4003836
52359,6,50,12,8,15,0,91,38.24249437,-109.4001142
52360,8,49,13,9,15,0,94,38.24249437,-109.3998447
52361,8,46,13,10,16,0,93,38.24249437,-109.3995752
52362,7,46,13,9,16,0,91,38.24249437,-109.3993057
52363,6,45,13,9,15,1,89,38.24249437,-109.3990362
52364,8,44,14,9,14,1,90,38.24249437,-109.3987667
52365,10,46,14,9,14,0,93,38.24249437,-109.3984972
52366,10,45,14,8,15,0,92,38.24249437,-109.3982277
52367,10,46,14,9,15,0,94,38.24249437,-109.3979582
52368,10,45,14,9,15,0,93,38.24249437,-109.3976887
52369,10,44,14,9,15,0,92,38.24249437,-109.3974192
52370,9,43,14,9,15,1,91,38.24249437,-109.3971497
52371,8,42,14,9,14,2,89,38.24249437,-109.3968802
52372,8,43,14,9,15,1,90,38.24249437,-109.3966107
52373,7,42,14,9,15,2,89,38.24249437,-109.3963412
52374,6,43,14,9,15,2,89,38.24249437,-109.3960717
52375,4,44,13,8,15,2,86,38.24249437,-109.3958022
52376,4,46,13,8,15,2,88,38.24249437,-109.3955327
52377,5,46,13,8,15,2,89,38.24249437,-109.3952632
52378,5,47,13,8,15,2,90,38.24249437,-109.3949938
52379,5,49,13,7,15,2,91,38.24249437,-109.3947243
52380,6,49,13,7,16,1,92,38.24249437,-109.3944548
52381,5,48,13,7,16,1,90,38.24249437,-109.3941853
52382,4,48,13,7,16,2,90,38.24249437,-109.3939158
52383,5,47,14,7,16,2,91,38.24249437,-109.3936463
52384,5,44,14,9,17,2,91,38.24249437,-109.3933768
52385,5,43,14,10,16,2,90,38.24249437,-109.3931073
52386,5,44,14,9,16,2,90,38.24249437,-109.3928378
52387,5,44,14,8,16,2,89,38.24249437,-109.3925683
52388,5,43,14,8,16,3,89,38.24249437,-109.3922988
52389,5,43,13,8,15,3,87,38.24249437,-109.3920293
52390,4,44,13,8,15,3,87,38.24249437,-109.3917598
52391,5,42,13,9,13,4,86,38.24249437,-109.3914903
52392,5,41,13,9,13,3,84,38.24249437,-109.3912208
52393,6,41,14,9,13,3,86,38.24249437,-109.3909513
52394,7,40,14,9,13,3,86,38.24249437,-109.3906818
52395,9,36,12,10,12,3,82,38.24249437,-109.3904123
52396,9,36,12,10,13,3,83,38.24249437,-109.3901429
52397,8,38,13,10,13,3,85,38.24249437,-109.3898734
52398,7,39,14,10,13,3,86,38.24249437,-109.3896039
52399,6,39,13,8,12,4,82,38.24249437,-109.3893344
52400,6,40,14,8,12,4,84,38.24249437,-109.3890649
52401,6,39,14,9,12,4,84,38.24249437,-109.3887954
52402,7,38,14,10,12,3,84,38.24249437,-109.3885259
52403,8,37,14,11,13,3,86,38.24249437,-109.3882564
52404,8,35,15,12,13,3,86,38.24249437,-109.3879869
52405,9,35,15,13,12,3,87,38.24249437,-109.3877174
52406,10,34,15,14,12,3,88,38.24249437,-109.3874479
52407,12,35,15,14,11,2,89,38.24249437,-109.3871784
52408,12,36,15,13,11,3,90,38.24249437,-109.3869089
52409,16,34,15,14,10,2,91,38.24249437,-109.3866394
52410,20,32,15,14,10,2,93,38.24249437,-109.3863699
52411,22,30,14,14,9,1,90,38.24249437,-109.3861004
52412,22,30,14,15,9,1,91,38.24249437,-109.3858309
52413,24,29,14,13,9,1,90,38.24249437,-109.3855614
52414,25,28,14,14,9,1,91,38.24249437,-109.3852919
52415,26,27,14,14,9,2,92,38.24249437,-109.3850225
52416,25,28,14,14,10,1,92,38.24249437,-109.384753
52417,22,29,14,13,11,1,90,38.24249437,-109.3844835
52418,19,30,14,11,11,2,87,38.24249437,-109.384214
52419,18,32,13,12,12,1,88,38.24249437,-109.3839445
52420,20,31,13,12,12,1,89,38.24249437,-109.383675
52421,20,31,13,12,11,1,88,38.24249437,-109.3834055
52422,19,33,13,12,12,0,89,38.24249437,-109.383136
52423,14,37,11,9,13,1,85,38.24249437,-109.3828665
52424,8,44,10,8,13,1,84,38.24249437,-109.382597
52425,4,45,9,7,13,1,79,38.24249437,-109.3823275
52426,5,42,9,6,13,1,76,38.24249437,-109.382058
52427,5,41,9,7,13,2,77,38.24249437,-109.3817885
52428,4,42,9,6,14,2,77,38.24249437,-109.381519
52429,5,36,9,10,10,1,71,38.24249437,-109.3812495
52430,5,28,10,15,8,1,67,38.24249437,-109.38098
52431,7,25,10,8,12,3,65,38.24249437,-109.3807105
52432,9,32,12,10,15,3,81,38.24249437,-109.380441
52433,11,36,13,9,14,2,85,38.24249437,-109.3801716
52434,9,36,13,9,13,4,84,38.24249437,-109.3799021
52435,5,40,11,6,13,4,79,38.24249437,-109.3796326
52436,1,49,9,1,12,5,77,38.24249437,-109.3793631
52437,0,49,7,1,11,4,72,38.24249437,-109.3790936
52438,1,51,8,2,11,3,76,38.24249437,-109.3788241
52439,0,52,8,2,11,3,76,38.24249437,-109.3785546
52440,0,54,7,0,11,3,75,38.24249437,-109.3782851
52441,0,55,6,1,9,4,75,38.24249437,-109.3780156
52442,2,52,8,4,10,4,80,38.24249437,-109.3777461
52443,1,49,7,2,10,6,75,38.24249437,-109.3774766
52444,0,49,7,1,11,5,73,38.24249437,-109.3772071
52445,1,48,8,4,12,5,78,38.24249437,-109.3769376
52446,1,35,11,4,12,11,74,38.24249437,-109.3766681
52447,9,21,12,13,8,14,77,38.24249437,-109.3763986
52448,9,24,13,14,7,14,81,38.24249437,-109.3761291
52449,2,30,8,9,13,5,67,38.24249437,-109.3758596
52450,1,40,9,6,14,2,72,38.24249437,-109.3755901
52451,7,35,10,14,10,3,79,38.24249437,-109.3753206
52452,2,38,10,17,14,0,81,38.24249437,-109.3750512
52453,0,30,11,12,17,4,74,38.24249437,-109.3747817
52454,0,27,10,7,15,8,67,38.24249437,-109.3745122
52455,16,46,11,6,5,0,84,38.24249437,-109.3742427
52456,2,49,7,4,10,3,75,38.24249437,-109.3739732
52457,2,52,6,4,10,2,76,38.24249437,-109.3737037
52458,3,47,7,6,10,2,75,38.24249437,-109.3734342
52459,2,50,8,6,10,4,80,38.24249437,-109.3731647
52460,3,41,8,6,12,5,75,38.24249437,-109.3728952
52461,3,32,11,5,8,11,70,38.24249437,-109.3726257
52462,2,23,13,7,8,14,67,38.24249437,-109.3723562
52463,2,20,13,6,7,16,64,38.24249437,-109.3720867
52464,1,32,10,2,9,12,66,38.24249437,-109.3718172
52465,6,30,13,12,9,8,78,38.24249437,-109.3715477
52466,5,26,14,4,4,17,70,38.24249437,-109.3712782
52467,2,26,14,0,11,13,66,38.24249437,-109.3710087
52468,2,27,14,0,14,9,66,38.24249437,-109.3707392
52469,0,19,11,2,11,7,50,38.24249437,-109.3704697
52470,0,30,8,4,3,9,54,38.24249437,-109.3702003
52471,2,32,7,5,8,6,60,38.24249437,-109.3699308
52472,2,36,6,5,9,5,63,38.24249437,-109.3696613
52473,1,34,7,5,8,4,59,38.24249437,-109.3693918
52474,5,40,7,4,10,2,68,38.24249437,-109.3691223
52475,2,47,9,6,13,2,79,38.24249437,-109.3688528
52476,2,43,11,4,14,4,78,38.24249437,-109.3685833
52477,3,32,11,5,13,5,69,38.24249437,-109.3683138
52478,9,34,13,1,15,5,77,38.24249437,-109.3680443
52479,2,33,14,0,20,7,76,38.24249437,-109.3677748
52480,1,26,10,3,17,5,62,38.24249437,-109.3675053
52481,1,26,12,0,12,9,60,38.24249437,-109.3672358
52482,1,23,12,1,8,14,59,38.24249437,-109.3669663
52483,2,24,12,0,4,19,61,38.24249437,-109.3666968
52484,2,24,11,0,4,19,60,38.24249437,-109.3664273
52485,1,23,11,0,3,19,57,38.24249437,-109.3661578
52486,1,22,12,0,2,20,57,38.24249437,-109.3658883
52487,1,23,12,0,2,22,60,38.24249437,-109.3656188
52488,1,23,13,0,2,22,61,38.24249437,-109.3653493
52489,1,28,12,0,4,18,63,38.24249437,-109.3650799
52490,2,28,12,1,4,20,67,38.24249437,-109.3648104
52491,2,26,12,1,3,20,64,38.24249437,-109.3645409
52492,2,24,11,1,3,19,60,38.24249437,-109.3642714
52493,2,27,10,2,5,14,60,38.24249437,-109.3640019
52494,2,24,11,3,5,16,61,38.24249437,-109.3637324
52495,2,23,11,2,4,16,58,38.24249437,-109.3634629
52496,1,26,9,3,5,10,54,38.24249437,-109.3631934
52497,7,32,7,6,7,6,65,38.24249437,-109.3629239
52498,3,26,11,6,7,11,64,38.24249437,-109.3626544
52499,3,27,13,3,5,19,70,38.24249437,-109.3623849
52500,2,25,15,3,4,22,71,38.24249437,-109.3621154
52501,2,23,17,3,3,25,73,38.24249437,-109.3618459
52502,2,21,17,4,4,25,73,38.24249437,-109.3615764
52503,6,21,15,4,3,26,75,38.24249437,-109.3613069
52504,2,23,16,2,3,28,74,38.24249437,-109.3610374
52505,1,27,16,1,3,27,75,38.24249437,-109.3607679
52506,2,26,17,0,4,27,76,38.24249437,-109.3604984
52507,2,25,15,0,4,25,71,38.24249437,-109.360229
52508,2,24,14,1,5,22,68,38.24249437,-109.3599595
52509,2,24,14,1,4,23,68,38.24249437,-109.35969
52510,2,24,15,0,3,26,70,38.24249437,-109.3594205
52511,1,26,15,0,3,26,71,38.24249437,-109.359151
52512,1,27,15,0,4,25,72,38.24249437,-109.3588815
52513,1,25,14,0,4,24,68,38.24249437,-109.358612
52514,1,25,12,1,4,20,63,38.24249437,-109.3583425
52515,2,28,10,2,6,15,63,38.24249437,-109.358073
52516,2,30,9,3,7,10,61,38.24249437,-109.3578035
52517,2,32,10,3,8,11,66,38.24249437,-109.357534
52518,1,29,11,2,5,16,64,38.24249437,-109.3572645
52519,1,29,11,1,5,18,65,38.24249437,-109.356995
52520,1,31,10,1,7,14,64,38.24249437,-109.3567255
52521,2,27,10,4,8,7,58,38.24249437,-109.356456
52522,3,28,10,4,8,8,61,38.24249437,-109.3561865
52523,2,29,11,3,7,11,63,38.24249437,-109.355917
52524,1,28,11,2,6,13,61,38.24249437,-109.3556475
52525,2,31,11,3,6,9,62,38.24249437,-109.355378
52526,2,28,10,5,8,6,59,38.24249437,-109.3551086
52527,2,23,10,4,7,8,54,38.24249437,-109.3548391
52528,2,22,11,5,6,11,57,38.24249437,-109.3545696
52529,4,25,12,8,7,10,66,38.24249437,-109.3543001
52530,18,25,13,16,10,3,85,38.24249437,-109.3540306
52531,31,19,12,18,10,1,91,38.24249437,-109.3537611
52532,30,19,13,18,9,3,92,38.24249437,-109.3534916
52533,29,20,13,15,8,4,89,38.24249437,-109.3532221
52534,38,19,12,15,10,1,95,38.24249437,-109.3529526
52535,44,17,11,14,9,1,96,38.24249437,-109.3526831
52536,38,19,11,14,10,1,93,38.24249437,-109.3524136
52537,33,21,12,15,9,1,91,38.24249437,-109.3521441
52538,28,18,12,19,6,0,83,38.24249437,-109.3518746
52539,37,15,11,18,8,1,90,38.24249437,-109.3516051
52540,44,16,11,13,6,1,91,38.24249437,-109.3513356
52541,9,41,14,12,15,0,91,38.242224876016365,-109.4068515
52542,8,40,13,12,16,0,89,38.242224876016365,-109.406582
52543,11,40,13,11,16,0,91,38.242224876016365,-109.4063125
52544,14,38,13,11,14,0,90,38.242224876016365,-109.406043
52545,15,37,14,13,14,0,93,38.242224876016365,-109.4057735
52546,14,37,14,13,14,0,92,38.242224876016365,-109.405504
52547,16,35,13,13,14,0,91,38.242224876016365,-109.4052345
52548,19,34,13,12,13,0,91,38.242224876016365,-109.4049651
52549,22,33,13,11,12,0,91,38.242224876016365,-109.4046956
52550,21,33,13,12,13,0,92,38.242224876016365,-109.4044261
52551,20,33,14,13,12,0,92,38.242224876016365,-109.4041566
52552,20,33,14,12,12,0,91,38.242224876016365,-109.4038871
52553,18,35,14,12,12,0,91,38.242224876016365,-109.4036176
52554,14,38,14,13,13,0,92,38.242224876016365,-109.4033481
52555,12,40,14,12,13,0,91,38.242224876016365,-109.4030786
52556,11,42,14,11,13,0,91,38.242224876016365,-109.4028091
52557,10,43,14,11,14,0,92,38.242224876016365,-109.4025396
52558,10,44,14,11,14,0,93,38.242224876016365,-109.4022701
52559,9,45,14,11,14,0,93,38.242224876016365,-109.4020006
52560,5,44,13,11,14,1,88,38.242224876016365,-109.4017311
52561,5,46,13,10,14,1,89,38.242224876016365,-109.4014616
52562,6,45,13,10,14,1,89,38.242224876016365,-109.4011921
52563,8,47,13,9,14,0,91,38.242224876016365,-109.4009226
52564,9,49,12,8,15,0,93,38.242224876016365,-109.4006531
52565,5,51,12,7,16,0,91,38.242224876016365,-109.4003836
52566,5,52,12,7,15,1,92,38.242224876016365,-109.4001142
52567,6,50,12,7,15,1,91,38.242224876016365,-109.3998447
52568,9,47,12,9,15,0,92,38.242224876016365,-109.3995752
52569,8,45,13,8,15,1,90,38.242224876016365,-109.3993057
52570,8,47,13,8,15,1,92,38.242224876016365,-109.3990362
52571,10,45,13,8,15,0,91,38.242224876016365,-109.3987667
52572,13,43,13,9,14,0,92,38.242224876016365,-109.3984972
52573,14,43,14,10,13,0,94,38.242224876016365,-109.3982277
52574,13,45,14,9,14,0,95,38.242224876016365,-109.3979582
52575,10,46,14,9,14,0,93,38.242224876016365,-109.3976887
52576,9,44,14,10,14,0,91,38.242224876016365,-109.3974192
52577,10,43,14,10,14,1,92,38.242224876016365,-109.3971497
52578,9,43,14,10,15,1,92,38.242224876016365,-109.3968802
52579,12,42,14,10,14,0,92,38.242224876016365,-109.3966107
52580,9,43,14,10,15,1,92,38.242224876016365,-109.3963412
52581,6,43,14,8,15,2,88,38.242224876016365,-109.3960717
52582,4,45,13,7,15,2,86,38.242224876016365,-109.3958022
52583,5,43,13,8,14,3,86,38.242224876016365,-109.3955327
52584,5,46,13,8,14,2,88,38.242224876016365,-109.3952632
52585,6,48,13,9,15,2,93,38.242224876016365,-109.3949938
52586,7,48,13,8,16,1,93,38.242224876016365,-109.3947243
52587,7,46,14,9,17,1,94,38.242224876016365,-109.3944548
52588,6,47,14,9,16,1,93,38.242224876016365,-109.3941853
52589,5,47,13,9,16,1,91,38.242224876016365,-109.3939158
52590,5,48,13,8,15,2,91,38.242224876016365,-109.3936463
52591,5,48,13,7,16,2,91,38.242224876016365,-109.3933768
52592,4,47,13,7,16,3,90,38.242224876016365,-109.3931073
52593,4,44,13,8,16,3,88,38.242224876016365,-109.3928378
52594,5,43,14,8,16,2,88,38.242224876016365,-109.3925683
52595,5,43,13,8,16,2,87,38.242224876016365,-109.3922988
52596,5,42,13,8,14,3,85,38.242224876016365,-109.3920293
52597,6,41,14,9,14,3,87,38.242224876016365,-109.3917598
52598,7,40,14,10,13,3,87,38.242224876016365,-109.3914903
52599,7,39,14,10,13,3,86,38.242224876016365,-109.3912208
52600,8,39,14,10,14,2,87,38.242224876016365,-109.3909513
52601,11,35,13,12,13,2,86,38.242224876016365,-109.3906818
52602,12,34,12,11,12,2,83,38.242224876016365,-109.3904123
52603,10,37,12,10,13,2,84,38.242224876016365,-109.3901429
52604,8,40,13,10,13,2,86,38.242224876016365,-109.3898734
52605,7,41,14,9,13,3,87,38.242224876016365,-109.3896039
52606,6,42,13,7,12,4,84,38.242224876016365,-109.3893344
52607,6,41,14,8,11,4,84,38.242224876016365,-109.3890649
52608,7,39,14,8,11,4,83,38.242224876016365,-109.3887954
52609,7,38,14,9,12,3,83,38.242224876016365,-109.3885259
52610,8,38,14,10,13,2,85,38.242224876016365,-109.3882564
52611,9,35,14,11,12,3,84,38.242224876016365,-109.3879869
52612,10,34,14,12,13,2,85,38.242224876016365,-109.3877174
52613,10,34,13,11,12,3,83,38.242224876016365,-109.3874479
52614,10,34,12,11,11,3,81,38.242224876016365,-109.3871784
52615,12,35,13,11,11,2,84,38.242224876016365,-109.3869089
52616,18,34,14,12,10,2,90,38.242224876016365,-109.3866394
52617,21,30,13,12,10,1,87,38.242224876016365,-109.3863699
52618,20,30,13,13,11,1,88,38.242224876016365,-109.3861004
52619,16,31,13,12,12,1,85,38.242224876016365,-109.3858309
52620,15,30,14,12,12,2,85,38.242224876016365,-109.3855614
52621,18,29,14,12,11,2,86,38.242224876016365,-109.3852919
52622,17,30,14,12,12,2,87,38.242224876016365,-109.3850225
52623,18,30,13,11,13,1,86,38.242224876016365,-109.384753
52624,17,29,13,11,13,1,84,38.242224876016365,-109.3844835
52625,13,27,12,10,12,3,77,38.242224876016365,-109.384214
52626,10,29,11,9,12,3,74,38.242224876016365,-109.3839445
52627,7,37,10,8,12,2,76,38.242224876016365,-109.383675
52628,4,42,9,7,12,1,75,38.242224876016365,-109.3834055
52629,4,44,9,7,11,1,76,38.242224876016365,-109.383136
52630,4,46,9,7,11,1,78,38.242224876016365,-109.3828665
52631,3,50,8,6,11,1,79,38.242224876016365,-109.382597
52632,3,50,8,6,11,1,79,38.242224876016365,-109.3823275
52633,3,47,8,6,10,1,75,38.242224876016365,-109.382058
52634,2,44,7,5,11,1,70,38.242224876016365,-109.3817885
52635,2,46,7,5,10,1,71,38.242224876016365,-109.381519
52636,1,43,8,9,9,1,71,38.242224876016365,-109.3812495
52637,1,32,8,13,7,2,63,38.242224876016365,-109.38098
52638,5,27,9,8,10,2,61,38.242224876016365,-109.3807105
52639,2,30,10,4,14,7,67,38.242224876016365,-109.380441
52640,4,36,10,3,13,7,73,38.242224876016365,-109.3801716
52641,3,43,10,3,15,4,78,38.242224876016365,-109.3799021
52642,2,49,9,3,12,3,78,38.242224876016365,-109.3796326
52643,0,50,7,0,10,4,71,38.242224876016365,-109.3793631
52644,1,59,6,4,10,2,82,38.242224876016365,-109.3790936
52645,1,62,6,4,10,1,84,38.242224876016365,-109.3788241
52646,2,63,6,5,11,1,88,38.242224876016365,-109.3785546
52647,0,54,6,3,10,2,75,38.242224876016365,-109.3782851
52648,1,44,8,3,9,6,71,38.242224876016365,-109.3780156
52649,2,43,10,5,12,6,78,38.242224876016365,-109.3777461
52650,2,35,10,5,11,9,72,38.242224876016365,-109.3774766
52651,3,35,13,5,12,10,78,38.242224876016365,-109.3772071
52652,4,29,13,4,10,12,72,38.242224876016365,-109.3769376
52653,2,25,13,5,12,16,73,38.242224876016365,-109.3766681
52654,7,23,11,12,9,16,78,38.242224876016365,-109.3763986
52655,6,25,11,15,8,11,76,38.242224876016365,-109.3761291
52656,7,42,10,12,8,4,83,38.242224876016365,-109.3758596
52657,10,46,10,7,9,1,83,38.242224876016365,-109.3755901
52658,11,27,9,14,10,3,74,38.242224876016365,-109.3753206
52659,7,27,9,14,11,5,73,38.242224876016365,-109.3750512
52660,0,29,10,0,16,12,67,38.242224876016365,-109.3747817
52661,2,32,10,3,7,10,64,38.242224876016365,-109.3745122
52662,3,49,7,4,10,2,75,38.242224876016365,-109.3742427
52663,2,52,7,6,10,2,79,38.242224876016365,-109.3739732
52664,2,52,7,6,10,2,79,38.242224876016365,-109.3737037
52665,3,47,8,6,11,2,77,38.242224876016365,-109.3734342
52666,2,41,11,6,11,6,77,38.242224876016365,-109.3731647
52667,4,33,12,7,10,8,74,38.242224876016365,-109.3728952
52668,3,23,15,7,8,16,72,38.242224876016365,-109.3726257
52669,3,17,16,6,7,18,67,38.242224876016365,-109.3723562
52670,2,16,15,4,5,21,63,38.242224876016365,-109.3720867
52671,1,21,12,2,5,18,59,38.242224876016365,-109.3718172
52672,3,26,13,0,4,19,65,38.242224876016365,-109.3715477
52673,7,25,11,8,8,17,76,38.242224876016365,-109.3712782
52674,7,23,10,13,9,9,71,38.242224876016365,-109.3710087
52675,8,22,10,15,9,5,69,38.242224876016365,-109.3707392
52676,0,17,7,5,4,7,40,38.242224876016365,-109.3704697
52677,1,38,6,4,8,6,63,38.242224876016365,-109.3702003
52678,1,43,6,4,9,4,67,38.242224876016365,-109.3699308
52679,1,45,6,4,9,3,68,38.242224876016365,-109.3696613
52680,1,42,7,4,9,4,67,38.242224876016365,-109.3693918
52681,2,50,9,4,11,5,81,38.242224876016365,-109.3691223
52682,2,43,11,3,15,5,79,38.242224876016365,-109.3688528
52683,0,29,10,1,12,11,63,38.242224876016365,-109.3685833
52684,0,29,10,1,14,10,64,38.242224876016365,-109.3683138
52685,2,25,10,4,18,4,63,38.242224876016365,-109.3680443
52686,1,30,11,3,22,3,70,38.242224876016365,-109.3677748
52687,2,31,13,2,18,5,71,38.242224876016365,-109.3675053
52688,2,30,13,0,13,9,67,38.242224876016365,-109.3672358
52689,3,24,11,0,7,14,59,38.242224876016365,-109.3669663
52690,2,25,12,0,4,18,61,38.242224876016365,-109.3666968
52691,2,23,11,0,3,18,57,38.242224876016365,-109.3664273
52692,2,24,12,0,4,18,60,38.242224876016365,-109.3661578
52693,2,24,12,0,4,19,61,38.242224876016365,-109.3658883
52694,2,24,13,0,3,20,62,38.242224876016365,-109.3656188
52695,2,25,12,1,3,19,62,38.242224876016365,-109.3653493
52696,2,31,11,0,5,16,65,38.242224876016365,-109.3650799
52697,2,30,11,1,5,16,65,38.242224876016365,-109.3648104
52698,3,25,12,1,4,16,61,38.242224876016365,-109.3645409
52699,3,21,12,1,4,16,57,38.242224876016365,-109.3642714
52700,4,28,11,2,8,10,63,38.242224876016365,-109.3640019
52701,3,21,13,1,3,17,58,38.242224876016365,-109.3637324
52702,1,18,12,2,3,18,54,38.242224876016365,-109.3634629
52703,1,27,9,3,6,9,55,38.242224876016365,-109.3631934
52704,4,36,8,4,7,3,62,38.242224876016365,-109.3629239
52705,7,22,11,8,10,8,66,38.242224876016365,-109.3626544
52706,3,23,15,4,5,18,68,38.242224876016365,-109.3623849
52707,2,23,17,1,3,26,72,38.242224876016365,-109.3621154
52708,2,21,18,1,3,28,73,38.242224876016365,-109.3618459
52709,1,21,19,0,3,35,79,38.242224876016365,-109.3615764
52710,2,22,17,0,2,28,71,38.242224876016365,-109.3613069
52711,2,25,13,0,4,22,66,38.242224876016365,-109.3610374
52712,2,31,12,1,7,17,70,38.242224876016365,-109.3607679
52713,3,28,14,2,7,18,72,38.242224876016365,-109.3604984
52714,1,23,16,0,3,27,70,38.242224876016365,-109.360229
52715,1,24,16,0,5,27,73,38.242224876016365,-109.3599595
52716,1,27,16,0,6,25,75,38.242224876016365,-109.35969
52717,2,29,16,0,6,24,77,38.242224876016365,-109.3594205
52718,3,32,15,1,8,20,79,38.242224876016365,-109.359151
52719,3,32,14,2,8,18,77,38.242224876016365,-109.3588815
52720,2,28,12,1,5,20,68,38.242224876016365,-109.358612
52721,1,31,11,0,6,18,67,38.242224876016365,-109.3583425
52722,1,28,10,1,6,15,61,38.242224876016365,-109.358073
52723,3,29,9,2,6,10,59,38.242224876016365,-109.3578035
52724,3,31,10,2,8,8,62,38.242224876016365,-109.357534
52725,3,30,10,3,8,9,63,38.242224876016365,-109.3572645
52726,2,28,10,2,7,10,59,38.242224876016365,-109.356995
52727,1,30,10,2,5,13,61,38.242224876016365,-109.3567255
52728,2,26,10,4,7,10,59,38.242224876016365,-109.356456
52729,2,27,11,5,6,11,62,38.242224876016365,-109.3561865
52730,1,28,12,2,4,16,63,38.242224876016365,-109.355917
52731,1,29,11,1,4,16,62,38.242224876016365,-109.3556475
52732,2,30,10,3,5,9,59,38.242224876016365,-109.355378
52733,3,27,10,5,8,7,60,38.242224876016365,-109.3551086
52734,2,24,11,6,8,9,60,38.242224876016365,-109.3548391
52735,2,23,11,5,7,12,60,38.242224876016365,-109.3545696
52736,4,27,12,9,7,11,70,38.242224876016365,-109.3543001
52737,14,25,13,15,11,4,82,38.242224876016365,-109.3540306
52738,31,17,12,20,9,0,89,38.242224876016365,-109.3537611
52739,36,18,11,17,8,0,90,38.242224876016365,-109.3534916
52740,34,21,13,16,9,1,94,38.242224876016365,-109.3532221
52741,32,22,13,16,9,1,93,38.242224876016365,-109.3529526
52742,41,19,11,12,8,0,91,38.242224876016365,-109.3526831
52743,37,20,11,16,9,1,94,38.242224876016365,-109.3524136
52744,34,20,12,18,6,1,91,38.242224876016365,-109.3521441
52745,33,18,13,21,6,1,92,38.242224876016365,-109.3518746
52746,41,14,12,18,9,1,95,38.242224876016365,-109.3516051
52747,37,16,12,17,9,1,92,38.242224876016365,-109.3513356
52748,7,41,12,10,14,1,85,38.241955381431126,-109.4068515
52749,6,40,12,10,15,1,84,38.241955381431126,-109.406582
52750,9,40,12,10,15,0,86,38.241955381431126,-109.4063125
52751,13,39,13,11,14,0,90,38.241955381431126,-109.406043
52752,14,37,13,12,14,0,90,38.241955381431126,-109.4057735
52753,15,36,14,13,14,0,92,38.241955381431126,-109.405504
52754,17,35,13,12,14,0,91,38.241955381431126,-109.4052345
52755,18,34,13,12,13,0,90,38.241955381431126,-109.4049651
52756,18,34,14,12,12,0,90,38.241955381431126,-109.4046956
52757,17,35,14,13,13,0,92,38.241955381431126,-109.4044261
52758,16,35,14,13,13,0,91,38.241955381431126,-109.4041566
52759,15,35,14,13,13,0,90,38.241955381431126,-109.4038871
52760,13,37,14,13,14,0,91,38.241955381431126,-109.4036176
52761,10,40,14,13,14,0,91,38.241955381431126,-109.4033481
52762,11,41,14,12,13,0,91,38.241955381431126,-109.4030786
52763,12,42,14,12,13,0,93,38.241955381431126,-109.4028091
52764,10,42,14,13,13,0,92,38.241955381431126,-109.4025396
52765,9,42,14,13,13,0,91,38.241955381431126,-109.4022701
52766,8,43,14,13,14,0,92,38.241955381431126,-109.4020006
52767,7,43,13,12,15,0,90,38.241955381431126,-109.4017311
52768,7,44,13,12,14,0,90,38.241955381431126,-109.4014616
52769,8,45,13,11,15,0,92,38.241955381431126,-109.4011921
52770,9,44,13,11,15,0,92,38.241955381431126,-109.4009226
52771,11,43,13,10,15,0,92,38.241955381431126,-109.4006531
52772,6,45,13,10,16,0,90,38.241955381431126,-109.4003836
52773,7,48,12,8,16,0,91,38.241955381431126,-109.4001142
52774,8,48,12,8,16,0,92,38.241955381431126,-109.3998447
52775,8,46,13,10,16,0,93,38.241955381431126,-109.3995752
52776,9,43,13,11,16,0,92,38.241955381431126,-109.3993057
52777,10,45,13,10,15,0,93,38.241955381431126,-109.3990362
52778,12,44,13,9,15,0,93,38.241955381431126,-109.3987667
52779,13,43,13,9,14,0,92,38.241955381431126,-109.3984972
52780,12,45,14,9,14,0,94,38.241955381431126,-109.3982277
52781,9,49,14,9,15,0,96,38.241955381431126,-109.3979582
52782,8,48,13,9,14,0,92,38.241955381431126,-109.3976887
52783,8,46,14,10,14,1,93,38.241955381431126,-109.3974192
52784,9,44,14,10,14,1,92,38.241955381431126,-109.3971497
52785,9,42,14,11,15,1,92,38.241955381431126,-109.3968802
52786,13,40,14,11,14,0,92,38.241955381431126,-109.3966107
52787,10,41,14,10,15,1,91,38.241955381431126,-109.3963412
52788,8,42,14,9,15,1,89,38.241955381431126,-109.3960717
52789,6,43,14,8,15,2,88,38.241955381431126,-109.3958022
52790,7,41,14,9,14,2,87,38.241955381431126,-109.3955327
52791,8,44,14,9,15,2,92,38.241955381431126,-109.3952632
52792,9,45,14,9,15,1,93,38.241955381431126,-109.3949938
52793,10,44,13,9,15,1,92,38.241955381431126,-109.3947243
52794,10,43,14,10,15,0,92,38.241955381431126,-109.3944548
52795,8,45,14,10,15,1,93,38.241955381431126,-109.3941853
52796,6,46,14,9,16,1,92,38.241955381431126,-109.3939158
52797,6,47,13,8,16,1,91,38.241955381431126,-109.3936463
52798,5,47,13,8,15,2,90,38.241955381431126,-109.3933768
52799,5,47,13,9,15,2,91,38.241955381431126,-109.3931073
52800,6,44,13,8,14,3,88,38.241955381431126,-109.3928378
52801,7,43,13,9,16,2,90,38.241955381431126,-109.3925683
52802,8,41,13,11,15,2,90,38.241955381431126,-109.3922988
52803,8,40,14,10,15,2,89,38.241955381431126,-109.3920293
52804,10,41,14,11,14,2,92,38.241955381431126,-109.3917598
52805,11,39,14,12,14,1,91,38.241955381431126,-109.3914903
52806,11,39,14,12,13,1,90,38.241955381431126,-109.3912208
52807,12,38,14,12,13,1,90,38.241955381431126,-109.3909513
52808,15,34,13,14,12,1,89,38.241955381431126,-109.3906818
52809,14,33,12,12,12,1,84,38.241955381431126,-109.3904123
52810,10,39,13,10,13,1,86,38.241955381431126,-109.3901429
52811,8,42,14,10,13,2,89,38.241955381431126,-109.3898734
52812,8,41,14,10,13,2,88,38.241955381431126,-109.3896039
52813,7,43,14,8,12,2,86,38.241955381431126,-109.3893344
52814,8,40,14,9,12,3,86,38.241955381431126,-109.3890649
52815,8,40,14,9,12,3,86,38.241955381431126,-109.3887954
52816,10,38,14,9,13,3,87,38.241955381431126,-109.3885259
52817,13,36,14,9,13,2,87,38.241955381431126,-109.3882564
52818,18,30,14,9,10,3,84,38.241955381431126,-109.3879869
52819,17,31,14,10,11,2,85,38.241955381431126,-109.3877174
52820,13,36,12,8,10,3,82,38.241955381431126,-109.3874479
52821,9,40,10,6,10,3,78,38.241955381431126,-109.3871784
52822,5,43,9,6,11,3,77,38.241955381431126,-109.3869089
52823,13,35,11,8,13,1,81,38.241955381431126,-109.3866394
52824,17,29,12,9,11,2,80,38.241955381431126,-109.3863699
52825,19,30,12,9,10,2,82,38.241955381431126,-109.3861004
52826,19,31,12,9,10,2,83,38.241955381431126,-109.3858309
52827,18,31,12,8,10,2,81,38.241955381431126,-109.3855614
52828,19,28,12,9,12,2,82,38.241955381431126,-109.3852919
52829,18,30,12,9,12,2,83,38.241955381431126,-109.3850225
52830,13,31,12,8,12,2,78,38.241955381431126,-109.384753
52831,8,31,11,7,10,3,70,38.241955381431126,-109.3844835
52832,6,27,9,7,10,4,63,38.241955381431126,-109.384214
52833,2,39,8,4,10,3,66,38.241955381431126,-109.3839445
52834,0,46,7,3,9,3,68,38.241955381431126,-109.383675
52835,0,50,6,1,9,3,69,38.241955381431126,-109.3834055
52836,0,55,6,1,8,2,72,38.241955381431126,-109.383136
52837,0,54,6,2,8,2,72,38.241955381431126,-109.3828665
52838,0,58,6,3,9,1,77,38.241955381431126,-109.382597
52839,0,54,7,3,10,2,76,38.241955381431126,-109.3823275
52840,1,43,7,3,11,3,68,38.241955381431126,-109.382058
52841,2,47,8,1,10,5,73,38.241955381431126,-109.3817885
52842,1,44,8,1,11,6,71,38.241955381431126,-109.381519
52843,1,36,9,5,10,6,67,38.241955381431126,-109.3812495
52844,1,29,9,16,8,1,64,38.241955381431126,-109.38098
52845,3,30,9,15,8,0,65,38.241955381431126,-109.3807105
52846,1,35,10,5,11,5,67,38.241955381431126,-109.380441
52847,2,43,9,5,12,3,74,38.241955381431126,-109.3801716
52848,2,51,8,5,11,1,78,38.241955381431126,-109.3799021
52849,1,54,6,3,11,1,76,38.241955381431126,-109.3796326
52850,3,56,7,6,10,4,86,38.241955381431126,-109.3793631
52851,3,49,8,7,9,6,82,38.241955381431126,-109.3790936
52852,3,48,8,7,10,5,81,38.241955381431126,-109.3788241
52853,1,58,8,4,12,3,86,38.241955381431126,-109.3785546
52854,1,57,8,3,11,4,84,38.241955381431126,-109.3782851
52855,3,35,10,7,10,7,72,38.241955381431126,-109.3780156
52856,7,35,14,10,14,6,86,38.241955381431126,-109.3777461
52857,9,30,14,8,13,8,82,38.241955381431126,-109.3774766
52858,7,31,13,4,12,11,78,38.241955381431126,-109.3772071
52859,3,28,13,5,10,14,73,38.241955381431126,-109.3769376
52860,2,31,14,0,10,21,78,38.241955381431126,-109.3766681
52861,1,35,11,7,9,12,75,38.241955381431126,-109.3763986
52862,9,38,10,15,8,2,82,38.241955381431126,-109.3761291
52863,10,38,10,14,9,2,83,38.241955381431126,-109.3758596
52864,7,44,10,10,11,0,82,38.241955381431126,-109.3755901
52865,16,35,11,5,14,1,82,38.241955381431126,-109.3753206
52866,6,27,10,13,8,10,74,38.241955381431126,-109.3750512
52867,1,30,10,3,8,8,60,38.241955381431126,-109.3747817
52868,1,40,7,3,8,5,64,38.241955381431126,-109.3745122
52869,2,46,6,3,9,3,69,38.241955381431126,-109.3742427
52870,2,51,7,5,10,2,77,38.241955381431126,-109.3739732
52871,1,41,8,4,12,5,71,38.241955381431126,-109.3737037
52872,2,43,10,5,12,5,77,38.241955381431126,-109.3734342
52873,2,44,11,1,16,7,81,38.241955381431126,-109.3731647
52874,3,32,13,4,10,13,75,38.241955381431126,-109.3728952
52875,4,28,14,6,10,14,76,38.241955381431126,-109.3726257
52876,3,21,16,6,6,19,71,38.241955381431126,-109.3723562
52877,2,18,16,4,5,21,66,38.241955381431126,-109.3720867
52878,3,28,13,4,14,10,72,38.241955381431126,-109.3718172
52879,1,31,10,0,11,13,66,38.241955381431126,-109.3715477
52880,7,25,9,13,10,8,72,38.241955381431126,-109.3712782
52881,6,25,9,14,11,5,70,38.241955381431126,-109.3710087
52882,3,35,10,4,9,2,63,38.241955381431126,-109.3707392
52883,1,50,7,3,10,4,75,38.241955381431126,-109.3704697
52884,4,49,8,7,10,4,82,38.241955381431126,-109.3702003
52885,2,57,7,5,11,3,85,38.241955381431126,-109.3699308
52886,2,57,8,5,11,3,86,38.241955381431126,-109.3696613
52887,1,39,9,1,9,8,67,38.241955381431126,-109.3693918
52888,3,40,13,4,8,10,78,38.241955381431126,-109.3691223
52889,7,27,11,11,10,8,74,38.241955381431126,-109.3688528
52890,8,33,14,4,10,12,81,38.241955381431126,-109.3685833
52891,6,34,14,5,16,8,83,38.241955381431126,-109.3683138
52892,8,35,11,12,9,5,80,38.241955381431126,-109.3680443
52893,6,31,9,11,13,4,74,38.241955381431126,-109.3677748
52894,1,26,10,3,23,0,63,38.241955381431126,-109.3675053
52895,1,24,11,0,14,7,57,38.241955381431126,-109.3672358
52896,2,23,13,1,5,17,61,38.241955381431126,-109.3669663
52897,4,28,14,0,4,19,69,38.241955381431126,-109.3666968
52898,1,23,14,0,4,24,66,38.241955381431126,-109.3664273
52899,1,25,13,0,4,23,66,38.241955381431126,-109.3661578
52900,2,24,13,0,3,23,65,38.241955381431126,-109.3658883
52901,1,24,13,0,3,22,63,38.241955381431126,-109.3656188
52902,2,24,12,0,4,19,61,38.241955381431126,-109.3653493
52903,2,24,11,3,6,14,60,38.241955381431126,-109.3650799
52904,2,22,11,4,5,14,58,38.241955381431126,-109.3648104
52905,3,18,13,2,4,17,57,38.241955381431126,-109.3645409
52906,5,19,15,1,2,21,63,38.241955381431126,-109.3642714
52907,2,20,14,0,2,23,61,38.241955381431126,-109.3640019
52908,2,19,14,0,2,24,61,38.241955381431126,-109.3637324
52909,0,17,13,0,2,24,56,38.241955381431126,-109.3634629
52910,1,23,11,2,4,14,55,38.241955381431126,-109.3631934
52911,3,36,8,5,5,5,62,38.241955381431126,-109.3629239
52912,5,23,12,7,8,8,63,38.241955381431126,-109.3626544
52913,6,20,15,5,5,15,66,38.241955381431126,-109.3623849
52914,3,20,18,0,3,28,72,38.241955381431126,-109.3621154
52915,2,21,19,0,3,32,77,38.241955381431126,-109.3618459
52916,2,22,17,0,1,30,72,38.241955381431126,-109.3615764
52917,2,27,13,0,4,21,67,38.241955381431126,-109.3613069
52918,1,27,12,0,5,20,65,38.241955381431126,-109.3610374
52919,1,25,13,0,3,22,64,38.241955381431126,-109.3607679
52920,1,24,15,0,2,27,69,38.241955381431126,-109.3604984
52921,0,25,17,0,6,28,76,38.241955381431126,-109.360229
52922,2,29,15,2,9,20,77,38.241955381431126,-109.3599595
52923,3,32,14,4,11,14,78,38.241955381431126,-109.35969
52924,4,34,14,6,12,11,81,38.241955381431126,-109.3594205
52925,5,36,14,6,12,11,84,38.241955381431126,-109.359151
52926,3,32,13,3,10,14,75,38.241955381431126,-109.3588815
52927,1,31,11,0,7,18,68,38.241955381431126,-109.358612
52928,1,32,10,0,6,17,66,38.241955381431126,-109.3583425
52929,1,28,11,2,6,14,62,38.241955381431126,-109.358073
52930,4,33,8,5,8,4,62,38.241955381431126,-109.3578035
52931,1,27,8,4,6,6,52,38.241955381431126,-109.357534
52932,1,25,8,4,7,7,52,38.241955381431126,-109.3572645
52933,2,25,10,2,8,9,56,38.241955381431126,-109.356995
52934,1,28,11,2,7,13,62,38.241955381431126,-109.3567255
52935,2,27,11,5,6,12,63,38.241955381431126,-109.356456
52936,2,28,11,4,6,13,64,38.241955381431126,-109.3561865
52937,1,28,11,1,5,17,63,38.241955381431126,-109.355917
52938,1,31,11,0,4,19,66,38.241955381431126,-109.3556475
52939,1,28,11,2,4,16,62,38.241955381431126,-109.355378
52940,2,26,11,2,6,12,59,38.241955381431126,-109.3551086
52941,2,24,12,6,7,12,63,38.241955381431126,-109.3548391
52942,1,22,13,5,6,16,63,38.241955381431126,-109.3545696
52943,4,25,13,7,7,14,70,38.241955381431126,-109.3543001
52944,22,26,14,16,10,3,91,38.241955381431126,-109.3540306
52945,33,18,13,22,6,1,93,38.241955381431126,-109.3537611
52946,35,17,11,19,4,0,86,38.241955381431126,-109.3534916
52947,36,20,11,15,6,0,88,38.241955381431126,-109.3532221
52948,33,24,13,15,8,0,93,38.241955381431126,-109.3529526
52949,38,20,11,13,9,0,91,38.241955381431126,-109.3526831
52950,35,19,11,15,8,0,88,38.241955381431126,-109.3524136
52951,36,19,13,16,8,1,93,38.241955381431126,-109.3521441
52952,39,17,13,17,9,0,95,38.241955381431126,-109.3518746
52953,34,16,12,20,11,1,94,38.241955381431126,-109.3516051
52954,26,16,12,19,14,2,89,38.241955381431126,-109.3513356
52955,5,44,11,8,13,2,83,38.24168588684589,-109.4068515
52956,6,42,12,11,16,0,87,38.24168588684589,-109.406582
52957,10,40,13,11,15,0,89,38.24168588684589,-109.4063125
52958,14,38,13,11,14,0,90,38.24168588684589,-109.406043
52959,16,36,14,12,13,0,91,38.24168588684589,-109.4057735
52960,17,35,14,12,13,0,91,38.24168588684589,-109.405504
52961,20,33,14,12,13,0,92,38.24168588684589,-109.4052345
52962,20,33,14,12,13,0,92,38.24168588684589,-109.4049651
52963,19,33,14,12,12,0,90,38.24168588684589,-109.4046956
52964,19,33,14,13,12,0,91,38.24168588684589,-109.4044261
52965,16,34,14,13,13,0,90,38.24168588684589,-109.4041566
52966,15,37,14,12,13,0,91,38.24168588684589,-109.4038871
52967,12,40,14,12,13,0,91,38.24168588684589,-109.4036176
52968,10,42,13,11,14,1,91,38.24168588684589,-109.4033481
52969,11,42,13,11,13,0,90,38.24168588684589,-109.4030786
52970,12,40,14,13,13,0,92,38.24168588684589,-109.4028091
52971,13,38,14,14,13,0,92,38.24168588684589,-109.4025396
52972,12,39,14,14,13,0,92,38.24168588684589,-109.4022701
52973,11,42,14,12,14,0,93,38.24168588684589,-109.4020006
52974,9,43,14,12,15,0,93,38.24168588684589,-109.4017311
52975,8,42,14,12,15,0,91,38.24168588684589,-109.4014616
52976,9,42,13,11,15,0,90,38.24168588684589,-109.4011921
52977,9,43,13,11,15,0,91,38.24168588684589,-109.4009226
52978,9,42,13,12,15,0,91,38.24168588684589,-109.4006531
52979,10,42,13,11,15,0,91,38.24168588684589,-109.4003836
52980,10,44,13,9,16,0,92,38.24168588684589,-109.4001142
52981,8,46,12,8,16,0,90,38.24168588684589,-109.3998447
52982,5,47,12,7,16,1,88,38.24168588684589,-109.3995752
52983,6,46,13,8,17,1,91,38.24168588684589,-109.3993057
52984,7,44,13,9,17,0,90,38.24168588684589,-109.3990362
52985,10,44,13,9,16,0,92,38.24168588684589,-109.3987667
52986,10,46,13,9,15,0,93,38.24168588684589,-109.3984972
52987,9,47,13,10,15,0,94,38.24168588684589,-109.3982277
52988,6,49,13,10,15,0,93,38.24168588684589,-109.3979582
52989,8,48,14,10,15,0,95,38.24168588684589,-109.3976887
52990,9,46,14,11,14,0,94,38.24168588684589,-109.3974192
52991,10,43,14,11,15,0,93,38.24168588684589,-109.3971497
52992,11,41,14,12,15,0,93,38.24168588684589,-109.3968802
52993,13,41,14,12,14,0,94,38.24168588684589,-109.3966107
52994,12,40,14,12,15,0,93,38.24168588684589,-109.3963412
52995,11,40,14,10,15,1,91,38.24168588684589,-109.3960717
52996,10,40,14,10,15,1,90,38.24168588684589,-109.3958022
52997,11,40,14,11,15,1,92,38.24168588684589,-109.3955327
52998,11,40,14,11,14,1,91,38.24168588684589,-109.3952632
52999,10,42,13,10,14,1,90,38.24168588684589,-109.3949938
53000,10,42,13,10,15,1,91,38.24168588684589,-109.3947243
53001,10,42,13,10,14,1,90,38.24168588684589,-109.3944548
53002,9,45,13,10,14,1,92,38.24168588684589,-109.3941853
53003,9,46,13,10,15,1,94,38.24168588684589,-109.3939158
53004,7,45,13,10,15,1,91,38.24168588684589,-109.3936463
53005,7,45,13,11,14,1,91,38.24168588684589,-109.3933768
53006,9,44,13,12,14,1,93,38.24168588684589,-109.3931073
53007,9,44,14,11,15,1,94,38.24168588684589,-109.3928378
53008,9,42,14,11,15,1,92,38.24168588684589,-109.3925683
53009,8,41,14,12,14,1,90,38.24168588684589,-109.3922988
53010,9,41,14,12,14,1,91,38.24168588684589,-109.3920293
53011,11,40,14,13,13,1,92,38.24168588684589,-109.3917598
53012,12,40,13,12,13,1,91,38.24168588684589,-109.3914903
53013,11,41,14,12,13,1,92,38.24168588684589,-109.3912208
53014,11,41,14,12,13,1,92,38.24168588684589,-109.3909513
53015,13,38,13,12,12,1,89,38.24168588684589,-109.3906818
53016,11,35,11,11,13,1,82,38.24168588684589,-109.3904123
53017,7,42,13,8,13,2,85,38.24168588684589,-109.3901429
53018,7,43,14,9,12,2,87,38.24168588684589,-109.3898734
53019,9,43,15,9,12,2,90,38.24168588684589,-109.3896039
53020,8,42,14,10,12,2,88,38.24168588684589,-109.3893344
53021,7,40,14,10,13,3,87,38.24168588684589,-109.3890649
53022,7,40,14,9,13,3,86,38.24168588684589,-109.3887954
53023,9,37,15,9,12,3,85,38.24168588684589,-109.3885259
53024,17,32,15,10,10,3,87,38.24168588684589,-109.3882564
53025,30,24,16,10,8,2,90,38.24168588684589,-109.3879869
53026,21,28,15,10,8,2,84,38.24168588684589,-109.3877174
53027,14,34,12,9,9,3,81,38.24168588684589,-109.3874479
53028,9,41,10,7,9,3,79,38.24168588684589,-109.3871784
53029,3,47,7,5,11,2,75,38.24168588684589,-109.3869089
53030,6,42,9,6,11,2,76,38.24168588684589,-109.3866394
53031,10,37,9,5,10,3,74,38.24168588684589,-109.3863699
53032,11,37,10,6,9,3,76,38.24168588684589,-109.3861004
53033,13,37,10,6,9,3,78,38.24168588684589,-109.3858309
53034,16,36,10,6,9,3,80,38.24168588684589,-109.3855614
53035,12,32,10,6,11,3,74,38.24168588684589,-109.3852919
53036,8,34,9,6,10,3,70,38.24168588684589,-109.3850225
53037,4,39,8,4,10,3,68,38.24168588684589,-109.384753
53038,1,45,7,2,10,3,68,38.24168588684589,-109.3844835
53039,1,46,7,2,9,3,68,38.24168588684589,-109.384214
53040,0,50,6,1,9,3,69,38.24168588684589,-109.3839445
53041,0,50,6,1,9,3,69,38.24168588684589,-109.383675
53042,0,49,6,1,9,4,69,38.24168588684589,-109.3834055
53043,1,50,6,3,9,2,71,38.24168588684589,-109.383136
53044,1,48,7,3,10,2,71,38.24168588684589,-109.3828665
53045,1,56,7,2,9,2,77,38.24168588684589,-109.382597
53046,2,52,7,2,11,3,77,38.24168588684589,-109.3823275
53047,3,35,10,4,12,6,70,38.24168588684589,-109.382058
53048,4,30,13,3,7,13,70,38.24168588684589,-109.3817885
53049,1,30,11,2,9,13,66,38.24168588684589,-109.381519
53050,2,26,10,3,8,11,60,38.24168588684589,-109.3812495
53051,3,21,9,8,9,5,55,38.24168588684589,-109.38098
53052,4,25,9,17,10,1,66,38.24168588684589,-109.3807105
53053,2,36,9,6,11,5,69,38.24168588684589,-109.380441
53054,0,51,7,2,11,3,74,38.24168588684589,-109.3801716
53055,0,53,6,1,10,3,73,38.24168588684589,-109.3799021
53056,0,62,6,2,10,3,83,38.24168588684589,-109.3796326
53057,2,57,7,4,10,4,84,38.24168588684589,-109.3793631
53058,3,46,9,7,10,6,81,38.24168588684589,-109.3790936
53059,2,43,10,5,11,7,78,38.24168588684589,-109.3788241
53060,1,49,9,3,11,7,80,38.24168588684589,-109.3785546
53061,0,47,9,2,10,8,76,38.24168588684589,-109.3782851
53062,5,27,12,7,9,12,72,38.24168588684589,-109.3780156
53063,8,31,14,7,12,11,83,38.24168588684589,-109.3777461
53064,4,31,12,6,14,9,76,38.24168588684589,-109.3774766
53065,4,32,11,8,14,9,78,38.24168588684589,-109.3772071
53066,6,35,12,11,12,8,84,38.24168588684589,-109.3769376
53067,1,38,12,5,16,8,80,38.24168588684589,-109.3766681
53068,0,33,9,11,17,2,72,38.24168588684589,-109.3763986
53069,2,31,9,12,13,0,67,38.24168588684589,-109.3761291
53070,2,29,8,7,12,1,59,38.24168588684589,-109.3758596
53071,1,34,8,7,8,4,62,38.24168588684589,-109.3755901
53072,4,38,9,6,9,3,69,38.24168588684589,-109.3753206
53073,2,41,8,4,9,3,67,38.24168588684589,-109.3750512
53074,1,44,6,4,8,3,66,38.24168588684589,-109.3747817
53075,1,44,6,4,9,4,68,38.24168588684589,-109.3745122
53076,3,43,8,6,11,4,75,38.24168588684589,-109.3742427
53077,3,41,10,6,12,5,77,38.24168588684589,-109.3739732
53078,1,34,10,4,9,10,68,38.24168588684589,-109.3737037
53079,1,38,11,2,13,10,75,38.24168588684589,-109.3734342
53080,2,45,11,1,17,6,82,38.24168588684589,-109.3731647
53081,2,40,11,3,12,9,77,38.24168588684589,-109.3728952
53082,5,40,12,5,14,6,82,38.24168588684589,-109.3726257
53083,4,26,14,6,8,15,73,38.24168588684589,-109.3723562
53084,2,21,15,5,6,20,69,38.24168588684589,-109.3720867
53085,3,33,15,9,4,16,80,38.24168588684589,-109.3718172
53086,4,42,11,7,6,9,79,38.24168588684589,-109.3715477
53087,3,36,9,6,8,8,70,38.24168588684589,-109.3712782
53088,2,41,9,3,10,4,69,38.24168588684589,-109.3710087
53089,1,53,9,4,12,2,81,38.24168588684589,-109.3707392
53090,3,47,8,6,10,5,79,38.24168588684589,-109.3704697
53091,3,46,9,5,11,6,80,38.24168588684589,-109.3702003
53092,4,40,10,7,11,5,77,38.24168588684589,-109.3699308
53093,2,40,11,3,11,8,75,38.24168588684589,-109.3696613
53094,2,36,13,1,10,13,75,38.24168588684589,-109.3693918
53095,7,29,13,9,6,14,78,38.24168588684589,-109.3691223
53096,10,23,10,13,10,7,73,38.24168588684589,-109.3688528
53097,13,30,13,14,9,7,86,38.24168588684589,-109.3685833
53098,8,29,10,13,15,4,79,38.24168588684589,-109.3683138
53099,6,20,10,14,16,5,71,38.24168588684589,-109.3680443
53100,5,12,9,9,13,7,55,38.24168588684589,-109.3677748
53101,0,17,11,3,17,6,54,38.24168588684589,-109.3675053
53102,0,22,12,0,11,13,58,38.24168588684589,-109.3672358
53103,2,24,14,0,4,19,63,38.24168588684589,-109.3669663
53104,1,26,16,0,5,25,73,38.24168588684589,-109.3666968
53105,2,27,17,0,5,25,76,38.24168588684589,-109.3664273
53106,1,24,14,0,2,25,66,38.24168588684589,-109.3661578
53107,1,22,13,0,1,23,60,38.24168588684589,-109.3658883
53108,2,21,13,1,3,19,59,38.24168588684589,-109.3656188
53109,3,20,12,1,3,17,56,38.24168588684589,-109.3653493
53110,3,19,11,4,5,15,57,38.24168588684589,-109.3650799
53111,3,20,11,4,5,14,57,38.24168588684589,-109.3648104
53112,2,18,12,5,4,15,56,38.24168588684589,-109.3645409
53113,2,15,13,4,3,17,54,38.24168588684589,-109.3642714
53114,5,19,16,0,1,23,64,38.24168588684589,-109.3640019
53115,1,16,16,0,0,27,60,38.24168588684589,-109.3637324
53116,0,16,14,0,2,25,57,38.24168588684589,-109.3634629
53117,0,17,13,1,3,19,53,38.24168588684589,-109.3631934
53118,1,26,10,4,5,11,57,38.24168588684589,-109.3629239
53119,2,31,9,6,5,6,59,38.24168588684589,-109.3626544
53120,3,25,12,8,7,10,65,38.24168588684589,-109.3623849
53121,0,20,14,1,4,24,63,38.24168588684589,-109.3621154
53122,1,21,18,0,2,30,72,38.24168588684589,-109.3618459
53123,2,23,17,0,2,28,72,38.24168588684589,-109.3615764
53124,1,21,18,0,2,30,72,38.24168588684589,-109.3613069
53125,1,21,17,0,2,31,72,38.24168588684589,-109.3610374
53126,0,21,18,0,2,33,74,38.24168588684589,-109.3607679
53127,1,23,18,0,4,31,77,38.24168588684589,-109.3604984
53128,2,29,17,1,7,23,79,38.24168588684589,-109.360229
53129,4,34,15,4,11,14,82,38.24168588684589,-109.3599595
53130,5,35,14,5,12,11,82,38.24168588684589,-109.35969
53131,4,34,14,4,11,13,80,38.24168588684589,-109.3594205
53132,3,32,13,2,9,16,75,38.24168588684589,-109.359151
53133,2,30,12,0,6,17,67,38.24168588684589,-109.3588815
53134,2,32,11,0,7,16,68,38.24168588684589,-109.358612
53135,1,31,10,0,6,16,64,38.24168588684589,-109.3583425
53136,1,27,10,2,6,13,59,38.24168588684589,-109.358073
53137,4,28,9,6,8,5,60,38.24168588684589,-109.3578035
53138,2,26,8,5,7,5,53,38.24168588684589,-109.357534
53139,1,25,7,5,8,5,51,38.24168588684589,-109.3572645
53140,2,28,8,4,8,5,55,38.24168588684589,-109.356995
53141,4,32,9,3,9,6,63,38.24168588684589,-109.3567255
53142,2,29,11,4,8,10,64,38.24168588684589,-109.356456
53143,2,32,11,4,6,12,67,38.24168588684589,-109.3561865
53144,2,30,11,1,5,16,65,38.24168588684589,-109.355917
53145,1,29,11,1,5,17,64,38.24168588684589,-109.3556475
53146,1,30,11,2,7,13,64,38.24168588684589,-109.355378
53147,1,29,11,3,7,11,62,38.24168588684589,-109.3551086
53148,2,26,11,5,8,11,63,38.24168588684589,-109.3548391
53149,2,23,12,4,5,16,62,38.24168588684589,-109.3545696
53150,2,25,13,3,5,19,67,38.24168588684589,-109.3543001
53151,11,26,13,11,9,9,79,38.24168588684589,-109.3540306
53152,34,22,13,17,6,1,93,38.24168588684589,-109.3537611
53153,36,21,12,17,4,1,91,38.24168588684589,-109.3534916
53154,38,21,11,15,4,0,89,38.24168588684589,-109.3532221
53155,39,22,11,16,6,0,94,38.24168588684589,-109.3529526
53156,42,20,11,16,7,0,96,38.24168588684589,-109.3526831
53157,37,19,11,15,7,0,89,38.24168588684589,-109.3524136
53158,33,20,11,13,8,0,85,38.24168588684589,-109.3521441
53159,35,19,12,13,11,0,90,38.24168588684589,-109.3518746
53160,30,17,12,19,13,1,92,38.24168588684589,-109.3516051
53161,16,19,11,22,16,5,89,38.24168588684589,-109.3513356
53162,4,48,10,6,13,2,83,38.24141639226066,-109.4068515
53163,7,44,12,10,16,0,89,38.24141639226066,-109.406582
53164,13,40,13,11,15,0,92,38.24141639226066,-109.4063125
53165,16,37,13,11,14,0,91,38.24141639226066,-109.406043
53166,17,36,14,12,13,0,92,38.24141639226066,-109.4057735
53167,17,36,13,12,13,0,91,38.24141639226066,-109.405504
53168,18,34,14,12,13,0,91,38.24141639226066,-109.4052345
53169,17,35,14,12,13,0,91,38.24141639226066,-109.4049651
53170,16,35,14,12,14,0,91,38.24141639226066,-109.4046956
53171,17,35,14,12,13,0,91,38.24141639226066,-109.4044261
53172,16,35,14,12,13,0,90,38.24141639226066,-109.4041566
53173,14,36,14,12,13,0,89,38.24141639226066,-109.4038871
53174,12,39,14,11,13,1,90,38.24141639226066,-109.4036176
53175,10,42,13,11,13,1,90,38.24141639226066,-109.4033481
53176,12,40,13,11,13,0,89,38.24141639226066,-109.4030786
53177,14,37,14,14,13,0,92,38.24141639226066,-109.4028091
53178,16,35,14,14,13,0,92,38.24141639226066,-109.4025396
53179,15,36,14,13,13,0,91,38.24141639226066,-109.4022701
53180,12,39,14,13,14,0,92,38.24141639226066,-109.4020006
53181,12,41,14,12,13,0,92,38.24141639226066,-109.4017311
53182,13,41,14,11,14,0,93,38.24141639226066,-109.4014616
53183,13,40,13,10,14,0,90,38.24141639226066,-109.4011921
53184,12,41,13,10,15,0,91,38.24141639226066,-109.4009226
53185,11,41,13,10,15,0,90,38.24141639226066,-109.4006531
53186,9,42,13,10,16,0,90,38.24141639226066,-109.4003836
53187,8,43,13,10,16,0,90,38.24141639226066,-109.4001142
53188,7,42,14,10,17,0,90,38.24141639226066,-109.3998447
53189,5,42,13,9,18,1,88,38.24141639226066,-109.3995752
53190,5,45,13,8,18,1,90,38.24141639226066,-109.3993057
53191,5,45,13,8,18,1,90,38.24141639226066,-109.3990362
53192,8,45,13,8,17,0,91,38.24141639226066,-109.3987667
53193,10,46,13,9,16,0,94,38.24141639226066,-109.3984972
53194,10,46,14,10,15,0,95,38.24141639226066,-109.3982277
53195,9,48,14,10,15,0,96,38.24141639226066,-109.3979582
53196,9,47,14,10,15,0,95,38.24141639226066,-109.3976887
53197,10,45,13,10,15,0,93,38.24141639226066,-109.3974192
53198,11,44,14,11,15,0,95,38.24141639226066,-109.3971497
53199,10,43,14,11,16,0,94,38.24141639226066,-109.3968802
53200,12,43,14,11,15,0,95,38.24141639226066,-109.3966107
53201,13,41,14,11,14,0,93,38.24141639226066,-109.3963412
53202,13,40,14,12,14,0,93,38.24141639226066,-109.3960717
53203,13,40,14,12,13,0,92,38.24141639226066,-109.3958022
53204,11,39,14,12,13,1,90,38.24141639226066,-109.3955327
53205,9,39,14,11,14,1,88,38.24141639226066,-109.3952632
53206,8,40,13,10,14,2,87,38.24141639226066,-109.3949938
53207,7,41,13,9,14,2,86,38.24141639226066,-109.3947243
53208,8,42,13,10,14,1,88,38.24141639226066,-109.3944548
53209,7,43,13,11,14,1,89,38.24141639226066,-109.3941853
53210,7,44,13,10,14,1,89,38.24141639226066,-109.3939158
53211,8,44,13,11,13,1,90,38.24141639226066,-109.3936463
53212,9,43,13,11,14,1,91,38.24141639226066,-109.3933768
53213,10,44,13,11,14,1,93,38.24141639226066,-109.3931073
53214,10,42,14,12,14,1,93,38.24141639226066,-109.3928378
53215,9,44,13,12,14,1,93,38.24141639226066,-109.3925683
53216,9,44,14,11,14,1,93,38.24141639226066,-109.3922988
53217,10,43,14,11,15,1,94,38.24141639226066,-109.3920293
53218,12,40,14,12,14,1,93,38.24141639226066,-109.3917598
53219,12,42,14,11,13,1,93,38.24141639226066,-109.3914903
53220,12,42,14,11,12,1,92,38.24141639226066,-109.3912208
53221,12,42,14,11,12,1,92,38.24141639226066,-109.3909513
53222,13,40,13,11,12,1,90,38.24141639226066,-109.3906818
53223,11,36,12,11,13,1,84,38.24141639226066,-109.3904123
53224,8,44,13,9,14,2,90,38.24141639226066,-109.3901429
53225,7,45,14,9,13,2,90,38.24141639226066,-109.3898734
53226,8,45,15,9,13,2,92,38.24141639226066,-109.3896039
53227,7,44,14,9,12,2,88,38.24141639226066,-109.3893344
53228,7,43,13,9,14,2,88,38.24141639226066,-109.3890649
53229,6,45,13,8,14,3,89,38.24141639226066,-109.3887954
53230,7,40,13,9,13,3,85,38.24141639226066,-109.3885259
53231,13,33,14,10,11,4,85,38.24141639226066,-109.3882564
53232,24,27,15,10,8,3,87,38.24141639226066,-109.3879869
53233,12,35,13,8,10,4,82,38.24141639226066,-109.3877174
53234,6,42,10,6,10,3,77,38.24141639226066,-109.3874479
53235,2,47,8,4,10,3,74,38.24141639226066,-109.3871784
53236,1,50,6,4,9,2,72,38.24141639226066,-109.3869089
53237,1,50,7,4,9,2,73,38.24141639226066,-109.3866394
53238,2,44,7,3,10,4,70,38.24141639226066,-109.3863699
53239,2,41,7,3,9,4,66,38.24141639226066,-109.3861004
53240,3,43,8,4,10,4,72,38.24141639226066,-109.3858309
53241,6,44,9,6,11,2,78,38.24141639226066,-109.3855614
53242,4,43,8,6,10,2,73,38.24141639226066,-109.3852919
53243,1,44,7,3,10,3,68,38.24141639226066,-109.3850225
53244,1,46,7,2,10,3,69,38.24141639226066,-109.384753
53245,1,47,8,1,10,3,70,38.24141639226066,-109.3844835
53246,1,48,8,2,11,3,73,38.24141639226066,-109.384214
53247,1,48,7,2,10,3,71,38.24141639226066,-109.3839445
53248,1,44,7,2,10,4,68,38.24141639226066,-109.383675
53249,2,36,9,2,9,8,66,38.24141639226066,-109.3834055
53250,3,32,11,2,9,11,68,38.24141639226066,-109.383136
53251,4,35,12,3,12,7,73,38.24141639226066,-109.3828665
53252,2,42,10,2,14,5,75,38.24141639226066,-109.382597
53253,3,36,10,3,14,5,71,38.24141639226066,-109.3823275
53254,4,33,11,2,12,8,70,38.24141639226066,-109.382058
53255,2,35,11,1,9,11,69,38.24141639226066,-109.3817885
53256,3,34,11,2,8,12,70,38.24141639226066,-109.381519
53257,2,28,11,3,6,14,64,38.24141639226066,-109.3812495
53258,2,21,9,9,10,7,58,38.24141639226066,-109.38098
53259,2,21,9,15,12,3,62,38.24141639226066,-109.3807105
53260,4,30,9,7,10,5,65,38.24141639226066,-109.380441
53261,1,43,8,3,11,5,71,38.24141639226066,-109.3801716
53262,0,48,7,1,11,4,71,38.24141639226066,-109.3799021
53263,1,52,7,3,10,4,77,38.24141639226066,-109.3796326
53264,1,47,8,2,9,7,74,38.24141639226066,-109.3793631
53265,2,45,9,4,13,5,78,38.24141639226066,-109.3790936
53266,2,41,11,6,14,5,79,38.24141639226066,-109.3788241
53267,4,37,12,7,14,7,81,38.24141639226066,-109.3785546
53268,6,32,13,7,11,10,79,38.24141639226066,-109.3782851
53269,6,33,11,7,11,9,77,38.24141639226066,-109.3780156
53270,6,31,11,6,13,10,77,38.24141639226066,-109.3777461
53271,8,32,11,13,17,4,85,38.24141639226066,-109.3774766
53272,12,38,11,10,17,1,89,38.24141639226066,-109.3772071
53273,10,37,10,12,14,0,83,38.24141639226066,-109.3769376
53274,6,39,9,15,15,0,84,38.24141639226066,-109.3766681
53275,3,45,12,11,8,1,80,38.24141639226066,-109.3763986
53276,2,50,8,6,11,1,78,38.24141639226066,-109.3761291
53277,1,52,7,5,11,1,77,38.24141639226066,-109.3758596
53278,1,57,7,5,10,1,81,38.24141639226066,-109.3755901
53279,2,54,6,4,11,3,80,38.24141639226066,-109.3753206
53280,2,49,7,5,10,2,75,38.24141639226066,-109.3750512
53281,1,48,6,4,9,3,71,38.24141639226066,-109.3747817
53282,2,45,7,4,10,5,73,38.24141639226066,-109.3745122
53283,2,42,9,5,12,6,76,38.24141639226066,-109.3742427
53284,1,44,9,3,10,8,75,38.24141639226066,-109.3739732
53285,1,41,10,0,12,11,75,38.24141639226066,-109.3737037
53286,1,43,10,1,15,8,78,38.24141639226066,-109.3734342
53287,1,45,11,1,16,7,81,38.24141639226066,-109.3731647
53288,2,44,11,3,13,6,79,38.24141639226066,-109.3728952
53289,4,39,12,5,14,6,80,38.24141639226066,-109.3726257
53290,3,26,14,6,9,14,72,38.24141639226066,-109.3723562
53291,2,21,15,4,6,21,69,38.24141639226066,-109.3720867
53292,5,28,14,8,4,15,74,38.24141639226066,-109.3718172
53293,4,41,9,8,9,6,77,38.24141639226066,-109.3715477
53294,1,38,9,5,10,6,69,38.24141639226066,-109.3712782
53295,1,50,9,4,13,1,78,38.24141639226066,-109.3710087
53296,2,49,8,5,12,3,79,38.24141639226066,-109.3707392
53297,4,34,10,7,10,7,72,38.24141639226066,-109.3704697
53298,2,39,11,5,12,7,76,38.24141639226066,-109.3702003
53299,3,36,13,2,13,11,78,38.24141639226066,-109.3699308
53300,2,32,13,0,12,16,75,38.24141639226066,-109.3696613
53301,2,30,13,0,10,18,73,38.24141639226066,-109.3693918
53302,4,37,15,2,9,19,86,38.24141639226066,-109.3691223
53303,2,37,16,8,13,12,88,38.24141639226066,-109.3688528
53304,3,26,14,10,20,4,77,38.24141639226066,-109.3685833
53305,4,27,12,13,19,2,77,38.24141639226066,-109.3683138
53306,4,22,12,11,17,4,70,38.24141639226066,-109.3680443
53307,5,8,7,3,11,4,38,38.24141639226066,-109.3677748
53308,3,27,12,7,15,10,74,38.24141639226066,-109.3675053
53309,1,23,13,5,8,16,66,38.24141639226066,-109.3672358
53310,2,23,14,0,5,22,66,38.24141639226066,-109.3669663
53311,0,25,16,0,5,26,72,38.24141639226066,-109.3666968
53312,1,26,14,0,4,25,70,38.24141639226066,-109.3664273
53313,1,23,13,0,1,24,62,38.24141639226066,-109.3661578
53314,2,24,12,0,3,19,60,38.24141639226066,-109.3658883
53315,3,22,11,2,4,16,58,38.24141639226066,-109.3656188
53316,2,25,11,3,5,14,60,38.24141639226066,-109.3653493
53317,1,17,11,5,4,15,53,38.24141639226066,-109.3650799
53318,1,18,10,5,6,12,52,38.24141639226066,-109.3648104
53319,2,21,8,5,7,9,52,38.24141639226066,-109.3645409
53320,5,24,8,5,8,6,56,38.24141639226066,-109.3642714
53321,7,15,13,5,8,10,58,38.24141639226066,-109.3640019
53322,2,18,13,4,3,17,57,38.24141639226066,-109.3637324
53323,1,18,13,2,3,20,57,38.24141639226066,-109.3634629
53324,1,19,13,0,3,21,57,38.24141639226066,-109.3631934
53325,1,24,12,0,3,19,59,38.24141639226066,-109.3629239
53326,1,31,10,5,5,9,61,38.24141639226066,-109.3626544
53327,2,37,10,5,7,7,68,38.24141639226066,-109.3623849
53328,2,30,13,3,7,14,69,38.24141639226066,-109.3621154
53329,0,21,17,0,2,29,69,38.24141639226066,-109.3618459
53330,0,16,19,0,2,35,72,38.24141639226066,-109.3615764
53331,1,19,19,0,3,33,75,38.24141639226066,-109.3613069
53332,1,21,20,0,5,33,80,38.24141639226066,-109.3610374
53333,0,23,20,0,5,33,81,38.24141639226066,-109.3607679
53334,0,25,17,0,5,29,76,38.24141639226066,-109.3604984
53335,3,31,15,3,8,17,77,38.24141639226066,-109.360229
53336,6,38,15,5,12,11,87,38.24141639226066,-109.3599595
53337,5,36,14,3,11,14,83,38.24141639226066,-109.35969
53338,2,30,13,1,7,18,71,38.24141639226066,-109.3594205
53339,2,27,13,0,4,21,67,38.24141639226066,-109.359151
53340,2,28,12,0,5,19,66,38.24141639226066,-109.3588815
53341,2,30,10,0,5,16,63,38.24141639226066,-109.358612
53342,1,33,10,0,6,16,66,38.24141639226066,-109.3583425
53343,0,30,10,0,6,16,62,38.24141639226066,-109.358073
53344,1,27,10,4,4,11,57,38.24141639226066,-109.3578035
53345,2,26,9,6,8,6,57,38.24141639226066,-109.357534
53346,4,25,9,6,10,4,58,38.24141639226066,-109.3572645
53347,3,25,8,6,9,5,56,38.24141639226066,-109.356995
53348,3,29,9,6,8,6,61,38.24141639226066,-109.3567255
53349,2,26,10,5,10,9,62,38.24141639226066,-109.356456
53350,2,30,11,2,6,14,65,38.24141639226066,-109.3561865
53351,1,31,11,1,6,16,66,38.24141639226066,-109.355917
53352,1,31,11,2,4,16,65,38.24141639226066,-109.3556475
53353,2,32,10,3,5,10,62,38.24141639226066,-109.355378
53354,2,26,11,5,7,9,60,38.24141639226066,-109.3551086
53355,2,27,10,5,7,8,59,38.24141639226066,-109.3548391
53356,2,28,10,5,7,10,62,38.24141639226066,-109.3545696
53357,2,28,11,5,7,12,65,38.24141639226066,-109.3543001
53358,4,30,11,7,10,9,71,38.24141639226066,-109.3540306
53359,23,27,15,15,9,2,91,38.24141639226066,-109.3537611
53360,35,23,13,14,5,1,91,38.24141639226066,-109.3534916
53361,37,22,11,14,4,1,89,38.24141639226066,-109.3532221
53362,39,23,10,14,5,1,92,38.24141639226066,-109.3529526
53363,41,22,10,14,5,1,93,38.24141639226066,-109.3526831
53364,35,22,10,15,6,0,88,38.24141639226066,-109.3524136
53365,29,22,10,14,8,0,83,38.24141639226066,-109.3521441
53366,30,22,12,15,11,0,90,38.24141639226066,-109.3518746
53367,25,20,10,20,15,2,92,38.24141639226066,-109.3516051
53368,6,27,12,15,15,9,84,38.24141639226066,-109.3513356
53369,3,49,10,6,14,1,83,38.24114689767542,-109.4068515
53370,8,44,12,10,16,0,90,38.24114689767542,-109.406582
53371,13,39,13,11,14,0,90,38.24114689767542,-109.4063125
53372,16,37,14,11,13,0,91,38.24114689767542,-109.406043
53373,17,37,14,11,13,0,92,38.24114689767542,-109.4057735
53374,16,37,14,11,13,0,91,38.24114689767542,-109.405504
53375,16,37,14,12,13,0,92,38.24114689767542,-109.4052345
53376,14,39,14,11,13,0,91,38.24114689767542,-109.4049651
53377,10,40,13,10,14,1,88,38.24114689767542,-109.4046956
53378,10,40,12,10,13,1,86,38.24114689767542,-109.4044261
53379,15,39,14,10,13,0,91,38.24114689767542,-109.4041566
53380,15,36,14,13,13,0,91,38.24114689767542,-109.4038871
53381,14,37,14,13,13,0,91,38.24114689767542,-109.4036176
53382,13,39,13,12,13,0,90,38.24114689767542,-109.4033481
53383,15,38,13,12,14,0,92,38.24114689767542,-109.4030786
53384,18,34,13,13,13,0,91,38.24114689767542,-109.4028091
53385,17,34,14,13,13,0,91,38.24114689767542,-109.4025396
53386,15,35,14,13,13,0,90,38.24114689767542,-109.4022701
53387,13,37,14,13,13,0,90,38.24114689767542,-109.4020006
53388,12,40,14,13,13,0,92,38.24114689767542,-109.4017311
53389,14,39,14,11,14,0,92,38.24114689767542,-109.4014616
53390,14,39,13,10,13,0,89,38.24114689767542,-109.4011921
53391,13,38,12,9,13,0,85,38.24114689767542,-109.4009226
53392,12,38,13,9,14,1,87,38.24114689767542,-109.4006531
53393,9,41,14,10,15,1,90,38.24114689767542,-109.4003836
53394,10,41,14,11,16,0,92,38.24114689767542,-109.4001142
53395,13,38,14,11,16,0,92,38.24114689767542,-109.3998447
53396,13,36,14,12,16,0,91,38.24114689767542,-109.3995752
53397,8,40,14,12,17,0,91,38.24114689767542,-109.3993057
53398,6,47,13,8,18,0,92,38.24114689767542,-109.3990362
53399,6,50,13,8,17,0,94,38.24114689767542,-109.3987667
53400,8,48,13,8,17,0,94,38.24114689767542,-109.3984972
53401,11,43,14,11,15,0,94,38.24114689767542,-109.3982277
53402,10,44,14,12,15,0,95,38.24114689767542,-109.3979582
53403,11,43,14,13,14,0,95,38.24114689767542,-109.3976887
53404,10,43,14,13,15,0,95,38.24114689767542,-109.3974192
53405,11,42,14,12,15,0,94,38.24114689767542,-109.3971497
53406,12,41,14,11,15,0,93,38.24114689767542,-109.3968802
53407,11,42,14,11,15,0,93,38.24114689767542,-109.3966107
53408,11,42,13,11,14,0,91,38.24114689767542,-109.3963412
53409,12,41,14,12,13,0,92,38.24114689767542,-109.3960717
53410,12,40,14,12,13,1,92,38.24114689767542,-109.3958022
53411,11,38,14,13,13,1,90,38.24114689767542,-109.3955327
53412,8,39,14,12,13,1,87,38.24114689767542,-109.3952632
53413,7,40,13,10,14,2,86,38.24114689767542,-109.3949938
53414,6,42,14,10,15,1,88,38.24114689767542,-109.3947243
53415,7,43,14,11,15,1,91,38.24114689767542,-109.3944548
53416,7,43,13,11,15,1,90,38.24114689767542,-109.3941853
53417,6,44,13,11,15,1,90,38.24114689767542,-109.3939158
53418,7,43,13,12,14,1,90,38.24114689767542,-109.3936463
53419,8,42,13,12,14,1,90,38.24114689767542,-109.3933768
53420,10,43,14,12,14,1,94,38.24114689767542,-109.3931073
53421,10,43,14,12,14,1,94,38.24114689767542,-109.3928378
53422,9,45,14,11,14,1,94,38.24114689767542,-109.3925683
53423,9,44,14,10,14,1,92,38.24114689767542,-109.3922988
53424,10,43,14,10,14,1,92,38.24114689767542,-109.3920293
53425,13,42,14,10,14,0,93,38.24114689767542,-109.3917598
53426,13,41,14,11,13,1,93,38.24114689767542,-109.3914903
53427,13,41,14,11,12,1,92,38.24114689767542,-109.3912208
53428,12,42,14,11,12,1,92,38.24114689767542,-109.3909513
53429,13,41,13,11,12,0,90,38.24114689767542,-109.3906818
53430,14,37,12,11,13,0,87,38.24114689767542,-109.3904123
53431,9,44,14,11,14,1,93,38.24114689767542,-109.3901429
53432,8,47,14,10,14,1,94,38.24114689767542,-109.3898734
53433,6,48,13,9,13,2,91,38.24114689767542,-109.3896039
53434,6,48,13,9,12,2,90,38.24114689767542,-109.3893344
53435,7,45,13,11,12,1,89,38.24114689767542,-109.3890649
53436,7,45,13,9,13,2,89,38.24114689767542,-109.3887954
53437,6,44,13,8,13,3,87,38.24114689767542,-109.3885259
53438,8,40,13,10,12,3,86,38.24114689767542,-109.3882564
53439,11,38,13,9,12,3,86,38.24114689767542,-109.3879869
53440,7,43,12,8,12,3,85,38.24114689767542,-109.3877174
53441,4,48,9,5,11,3,80,38.24114689767542,-109.3874479
53442,1,49,8,4,10,2,74,38.24114689767542,-109.3871784
53443,1,49,6,4,8,2,70,38.24114689767542,-109.3869089
53444,1,46,6,3,9,2,67,38.24114689767542,-109.3866394
53445,1,43,8,4,11,3,70,38.24114689767542,-109.3863699
53446,3,39,8,5,10,4,69,38.24114689767542,-109.3861004
53447,3,39,8,5,10,3,68,38.24114689767542,-109.3858309
53448,3,45,8,7,9,1,73,38.24114689767542,-109.3855614
53449,2,42,7,4,10,3,68,38.24114689767542,-109.3852919
53450,0,42,7,2,11,5,67,38.24114689767542,-109.3850225
53451,0,41,7,1,10,6,65,38.24114689767542,-109.384753
53452,1,40,8,1,9,8,67,38.24114689767542,-109.3844835
53453,2,39,9,4,12,6,72,38.24114689767542,-109.384214
53454,1,43,8,2,11,6,71,38.24114689767542,-109.3839445
53455,3,41,9,2,11,6,72,38.24114689767542,-109.383675
53456,4,32,12,2,9,11,70,38.24114689767542,-109.3834055
53457,3,29,15,2,6,20,75,38.24114689767542,-109.383136
53458,5,29,16,3,6,21,80,38.24114689767542,-109.3828665
53459,4,33,11,0,10,13,71,38.24114689767542,-109.382597
53460,4,39,10,1,15,4,73,38.24114689767542,-109.3823275
53461,3,46,9,1,16,3,78,38.24114689767542,-109.382058
53462,2,45,10,3,12,7,79,38.24114689767542,-109.3817885
53463,4,38,11,2,10,10,75,38.24114689767542,-109.381519
53464,3,34,12,1,7,14,71,38.24114689767542,-109.3812495
53465,2,26,11,5,5,13,62,38.24114689767542,-109.38098
53466,1,21,9,16,9,6,62,38.24114689767542,-109.3807105
53467,4,28,9,11,11,4,67,38.24114689767542,-109.380441
53468,2,44,8,5,10,4,73,38.24114689767542,-109.3801716
53469,1,45,8,3,10,5,72,38.24114689767542,-109.3799021
53470,1,45,9,2,10,5,72,38.24114689767542,-109.3796326
53471,1,42,10,2,9,9,73,38.24114689767542,-109.3793631
53472,2,38,12,4,12,8,76,38.24114689767542,-109.3790936
53473,3,31,12,6,13,9,74,38.24114689767542,-109.3788241
53474,6,25,13,9,11,11,75,38.24114689767542,-109.3785546
53475,8,30,13,7,13,11,82,38.24114689767542,-109.3782851
53476,7,36,11,7,15,5,81,38.24114689767542,-109.3780156
53477,3,38,8,16,14,0,79,38.24114689767542,-109.3777461
53478,4,39,10,6,10,2,71,38.24114689767542,-109.3774766
53479,1,44,8,10,8,1,72,38.24114689767542,-109.3772071
53480,1,47,8,7,8,1,72,38.24114689767542,-109.3769376
53481,3,63,8,5,10,0,89,38.24114689767542,-109.3766681
53482,1,53,7,4,10,2,77,38.24114689767542,-109.3763986
53483,1,57,6,4,11,1,80,38.24114689767542,-109.3761291
53484,2,56,7,5,11,1,82,38.24114689767542,-109.3758596
53485,2,57,7,5,10,1,82,38.24114689767542,-109.3755901
53486,2,57,7,4,12,1,83,38.24114689767542,-109.3753206
53487,2,49,7,4,11,2,75,38.24114689767542,-109.3750512
53488,1,40,7,3,10,5,66,38.24114689767542,-109.3747817
53489,1,39,8,4,11,6,69,38.24114689767542,-109.3745122
53490,1,42,9,3,12,7,74,38.24114689767542,-109.3742427
53491,1,42,10,1,12,9,75,38.24114689767542,-109.3739732
53492,0,41,10,0,11,12,74,38.24114689767542,-109.3737037
53493,0,43,10,0,14,10,77,38.24114689767542,-109.3734342
53494,1,46,10,0,15,7,79,38.24114689767542,-109.3731647
53495,2,45,11,2,14,6,80,38.24114689767542,-109.3728952
53496,3,39,11,4,13,8,78,38.24114689767542,-109.3726257
53497,3,29,14,7,10,12,75,38.24114689767542,-109.3723562
53498,2,23,14,7,8,14,68,38.24114689767542,-109.3720867
53499,0,28,10,2,10,11,61,38.24114689767542,-109.3718172
53500,1,38,9,1,10,8,67,38.24114689767542,-109.3715477
53501,1,44,9,2,11,7,74,38.24114689767542,-109.3712782
53502,1,50,9,3,12,7,82,38.24114689767542,-109.3710087
53503,1,49,10,2,12,7,81,38.24114689767542,-109.3707392
53504,5,35,13,5,9,9,76,38.24114689767542,-109.3704697
53505,4,31,14,0,10,18,77,38.24114689767542,-109.3702003
53506,5,34,15,2,14,15,85,38.24114689767542,-109.3699308
53507,5,33,15,5,14,13,85,38.24114689767542,-109.3696613
53508,5,32,15,5,13,14,84,38.24114689767542,-109.3693918
53509,3,29,17,7,13,16,85,38.24114689767542,-109.3691223
53510,3,24,17,12,13,13,82,38.24114689767542,-109.3688528
53511,3,22,14,11,15,8,73,38.24114689767542,-109.3685833
53512,2,22,13,10,18,4,69,38.24114689767542,-109.3683138
53513,3,22,12,7,17,2,63,38.24114689767542,-109.3680443
53514,8,21,10,10,15,4,68,38.24114689767542,-109.3677748
53515,4,27,14,7,10,14,76,38.24114689767542,-109.3675053
53516,1,23,16,2,6,23,71,38.24114689767542,-109.3672358
53517,1,23,16,0,5,26,71,38.24114689767542,-109.3669663
53518,1,24,15,0,3,26,69,38.24114689767542,-109.3666968
53519,1,23,14,0,3,22,63,38.24114689767542,-109.3664273
53520,1,26,11,1,4,18,61,38.24114689767542,-109.3661578
53521,1,26,11,2,5,15,60,38.24114689767542,-109.3658883
53522,2,24,11,3,6,13,59,38.24114689767542,-109.3656188
53523,1,20,10,5,5,13,54,38.24114689767542,-109.3653493
53524,0,23,9,2,7,12,53,38.24114689767542,-109.3650799
53525,2,26,7,3,8,6,52,38.24114689767542,-109.3648104
53526,2,28,7,4,7,5,53,38.24114689767542,-109.3645409
53527,3,33,6,7,6,5,60,38.24114689767542,-109.3642714
53528,4,26,8,6,3,9,56,38.24114689767542,-109.3640019
53529,2,25,9,4,3,11,54,38.24114689767542,-109.3637324
53530,2,22,11,4,4,12,55,38.24114689767542,-109.3634629
53531,2,23,11,5,5,12,58,38.24114689767542,-109.3631934
53532,1,26,9,5,9,9,59,38.24114689767542,-109.3629239
53533,1,36,9,4,10,4,64,38.24114689767542,-109.3626544
53534,2,33,9,6,7,4,61,38.24114689767542,-109.3623849
53535,3,33,11,8,8,5,68,38.24114689767542,-109.3621154
53536,2,31,13,5,8,10,69,38.24114689767542,-109.3618459
53537,1,21,15,0,3,26,66,38.24114689767542,-109.3615764
53538,0,19,21,0,4,37,81,38.24114689767542,-109.3613069
53539,0,22,22,0,5,35,84,38.24114689767542,-109.3610374
53540,1,27,21,0,5,30,84,38.24114689767542,-109.3607679
53541,1,27,17,0,6,27,78,38.24114689767542,-109.3604984
53542,4,32,15,2,8,18,79,38.24114689767542,-109.360229
53543,5,36,15,3,10,14,83,38.24114689767542,-109.3599595
53544,3,31,14,1,8,17,74,38.24114689767542,-109.35969
53545,1,25,13,0,4,21,64,38.24114689767542,-109.3594205
53546,1,26,12,0,3,21,63,38.24114689767542,-109.359151
53547,2,27,12,0,3,19,63,38.24114689767542,-109.3588815
53548,1,30,10,0,4,17,62,38.24114689767542,-109.358612
53549,1,33,10,0,7,15,66,38.24114689767542,-109.3583425
53550,0,29,10,1,7,14,61,38.24114689767542,-109.358073
53551,2,31,10,4,6,7,60,38.24114689767542,-109.3578035
53552,1,24,8,5,9,6,53,38.24114689767542,-109.357534
53553,3,26,11,9,12,6,67,38.24114689767542,-109.3572645
53554,3,23,10,9,14,8,67,38.24114689767542,-109.356995
53555,2,25,9,8,8,7,59,38.24114689767542,-109.3567255
53556,3,27,10,4,8,9,61,38.24114689767542,-109.356456
53557,1,28,11,0,5,17,62,38.24114689767542,-109.3561865
53558,1,32,11,0,5,17,66,38.24114689767542,-109.355917
53559,2,32,10,3,5,12,64,38.24114689767542,-109.3556475
53560,3,28,10,3,6,9,59,38.24114689767542,-109.355378
53561,1,25,11,4,7,9,57,38.24114689767542,-109.3551086
53562,2,29,10,4,7,9,61,38.24114689767542,-109.3548391
53563,2,29,10,4,7,10,62,38.24114689767542,-109.3545696
53564,2,31,11,5,8,9,66,38.24114689767542,-109.3543001
53565,4,37,11,5,10,6,73,38.24114689767542,-109.3540306
53566,14,31,15,16,10,2,88,38.24114689767542,-109.3537611
53567,30,26,14,10,5,1,86,38.24114689767542,-109.3534916
53568,34,22,11,10,4,1,82,38.24114689767542,-109.3532221
53569,38,23,10,15,6,1,93,38.24114689767542,-109.3529526
53570,40,22,10,14,7,0,93,38.24114689767542,-109.3526831
53571,37,22,10,16,7,1,93,38.24114689767542,-109.3524136
53572,34,23,11,15,8,0,91,38.24114689767542,-109.3521441
53573,32,24,11,14,10,1,92,38.24114689767542,-109.3518746
53574,21,24,12,16,12,5,90,38.24114689767542,-109.3516051
53575,2,28,13,6,11,16,76,38.24114689767542,-109.3513356
53576,3,48,10,8,15,1,85,38.24087740309018,-109.4068515
53577,7,43,12,10,16,0,88,38.24087740309018,-109.406582
53578,12,40,13,11,14,0,90,38.24087740309018,-109.4063125
53579,14,39,14,12,13,0,92,38.24087740309018,-109.406043
53580,13,40,13,11,14,0,91,38.24087740309018,-109.4057735
53581,11,40,13,11,14,0,89,38.24087740309018,-109.405504
53582,10,40,12,10,14,0,86,38.24087740309018,-109.4052345
53583,10,40,13,10,14,1,88,38.24087740309018,-109.4049651
53584,11,40,13,11,14,1,90,38.24087740309018,-109.4046956
53585,13,39,13,12,13,0,90,38.24087740309018,-109.4044261
53586,14,39,13,11,13,0,90,38.24087740309018,-109.4041566
53587,15,37,14,13,12,0,91,38.24087740309018,-109.4038871
53588,17,35,14,13,12,0,91,38.24087740309018,-109.4036176
53589,19,34,14,13,12,0,92,38.24087740309018,-109.4033481
53590,17,34,14,13,13,0,91,38.24087740309018,-109.4030786
53591,19,33,14,13,13,0,92,38.24087740309018,-109.4028091
53592,16,34,14,13,13,0,90,38.24087740309018,-109.4025396
53593,13,37,14,13,13,0,90,38.24087740309018,-109.4022701
53594,12,40,14,12,13,0,91,38.24087740309018,-109.4020006
53595,12,39,14,12,14,0,91,38.24087740309018,-109.4017311
53596,14,37,13,11,13,0,88,38.24087740309018,-109.4014616
53597,14,37,13,10,13,0,87,38.24087740309018,-109.4011921
53598,13,38,13,10,14,1,89,38.24087740309018,-109.4009226
53599,10,37,13,11,15,1,87,38.24087740309018,-109.4006531
53600,8,40,14,10,16,1,89,38.24087740309018,-109.4003836
53601,13,37,14,12,15,0,91,38.24087740309018,-109.4001142
53602,16,34,14,13,14,0,91,38.24087740309018,-109.3998447
53603,14,35,14,13,15,0,91,38.24087740309018,-109.3995752
53604,11,41,14,10,16,0,92,38.24087740309018,-109.3993057
53605,6,42,13,8,15,1,85,38.24087740309018,-109.3990362
53606,5,46,12,7,15,1,86,38.24087740309018,-109.3987667
53607,7,48,12,7,15,1,90,38.24087740309018,-109.3984972
53608,9,45,13,10,15,0,92,38.24087740309018,-109.3982277
53609,12,43,14,11,14,0,94,38.24087740309018,-109.3979582
53610,13,41,15,13,14,0,96,38.24087740309018,-109.3976887
53611,12,41,14,13,14,0,94,38.24087740309018,-109.3974192
53612,12,42,14,12,14,0,94,38.24087740309018,-109.3971497
53613,12,42,14,12,14,0,94,38.24087740309018,-109.3968802
53614,11,43,13,11,14,0,92,38.24087740309018,-109.3966107
53615,9,43,13,11,13,1,90,38.24087740309018,-109.3963412
53616,9,42,13,11,13,1,89,38.24087740309018,-109.3960717
53617,9,41,14,11,13,1,89,38.24087740309018,-109.3958022
53618,12,40,14,12,13,0,91,38.24087740309018,-109.3955327
53619,9,40,13,11,13,2,88,38.24087740309018,-109.3952632
53620,7,41,13,11,14,2,88,38.24087740309018,-109.3949938
53621,7,43,14,11,15,1,91,38.24087740309018,-109.3947243
53622,9,43,14,11,16,1,94,38.24087740309018,-109.3944548
53623,8,43,14,12,16,0,93,38.24087740309018,-109.3941853
53624,7,43,14,12,15,1,92,38.24087740309018,-109.3939158
53625,7,43,14,12,14,1,91,38.24087740309018,-109.3936463
53626,9,43,14,12,14,1,93,38.24087740309018,-109.3933768
53627,11,41,14,13,14,0,93,38.24087740309018,-109.3931073
53628,9,44,14,12,14,1,94,38.24087740309018,-109.3928378
53629,9,46,14,10,14,1,94,38.24087740309018,-109.3925683
53630,9,45,14,10,14,1,93,38.24087740309018,-109.3922988
53631,11,43,14,9,15,1,93,38.24087740309018,-109.3920293
53632,12,42,14,10,14,1,93,38.24087740309018,-109.3917598
53633,13,40,14,11,13,1,92,38.24087740309018,-109.3914903
53634,12,41,14,12,12,1,92,38.24087740309018,-109.3912208
53635,10,42,14,11,13,1,91,38.24087740309018,-109.3909513
53636,10,41,13,11,13,1,89,38.24087740309018,-109.3906818
53637,11,42,13,10,13,1,90,38.24087740309018,-109.3904123
53638,7,47,14,10,14,1,93,38.24087740309018,-109.3901429
53639,5,47,12,8,13,3,88,38.24087740309018,-109.3898734
53640,3,48,11,7,12,3,84,38.24087740309018,-109.3896039
53641,4,48,11,7,12,3,85,38.24087740309018,-109.3893344
53642,6,44,13,9,12,2,86,38.24087740309018,-109.3890649
53643,7,44,13,9,12,3,88,38.24087740309018,-109.3887954
53644,7,43,13,9,12,3,87,38.24087740309018,-109.3885259
53645,8,41,13,9,12,2,85,38.24087740309018,-109.3882564
53646,9,40,12,9,12,2,84,38.24087740309018,-109.3879869
53647,9,41,12,8,10,3,83,38.24087740309018,-109.3877174
53648,7,40,11,9,10,3,80,38.24087740309018,-109.3874479
53649,4,43,9,7,10,3,76,38.24087740309018,-109.3871784
53650,2,46,7,5,10,2,72,38.24087740309018,-109.3869089
53651,2,44,8,4,10,3,71,38.24087740309018,-109.3866394
53652,1,44,8,3,10,3,69,38.24087740309018,-109.3863699
53653,1,44,7,3,10,3,68,38.24087740309018,-109.3861004
53654,2,45,6,4,8,2,67,38.24087740309018,-109.3858309
53655,2,45,7,5,9,2,70,38.24087740309018,-109.3855614
53656,1,41,7,2,9,4,64,38.24087740309018,-109.3852919
53657,0,47,7,2,11,3,70,38.24087740309018,-109.3850225
53658,0,47,7,1,11,4,70,38.24087740309018,-109.384753
53659,1,44,8,2,11,5,71,38.24087740309018,-109.3844835
53660,2,39,9,4,12,6,72,38.24087740309018,-109.384214
53661,2,38,10,4,12,7,73,38.24087740309018,-109.3839445
53662,2,35,10,2,10,11,70,38.24087740309018,-109.383675
53663,3,30,13,2,7,16,71,38.24087740309018,-109.3834055
53664,7,26,15,5,5,20,78,38.24087740309018,-109.383136
53665,4,27,13,2,5,19,70,38.24087740309018,-109.3828665
53666,4,42,10,1,14,5,76,38.24087740309018,-109.382597
53667,2,49,9,0,16,4,80,38.24087740309018,-109.3823275
53668,2,47,10,0,15,6,80,38.24087740309018,-109.382058
53669,3,40,11,0,11,10,75,38.24087740309018,-109.3817885
53670,4,39,11,2,12,8,76,38.24087740309018,-109.381519
53671,4,40,11,2,10,10,77,38.24087740309018,-109.3812495
53672,4,35,11,2,8,12,72,38.24087740309018,-109.38098
53673,5,23,11,5,8,9,61,38.24087740309018,-109.3807105
53674,2,26,8,13,8,5,62,38.24087740309018,-109.380441
53675,4,46,7,5,9,3,74,38.24087740309018,-109.3801716
53676,1,49,8,3,10,3,74,38.24087740309018,-109.3799021
53677,0,49,8,3,10,4,74,38.24087740309018,-109.3796326
53678,1,43,9,1,9,9,72,38.24087740309018,-109.3793631
53679,3,32,12,3,10,13,73,38.24087740309018,-109.3790936
53680,3,28,12,5,9,14,71,38.24087740309018,-109.3788241
53681,4,25,13,8,9,13,72,38.24087740309018,-109.3785546
53682,8,25,13,7,7,12,72,38.24087740309018,-109.3782851
53683,1,27,8,4,12,6,58,38.24087740309018,-109.3780156
53684,1,57,7,7,9,1,82,38.24087740309018,-109.3777461
53685,2,61,6,4,11,0,84,38.24087740309018,-109.3774766
53686,2,61,7,5,10,1,86,38.24087740309018,-109.3772071
53687,2,56,7,5,10,3,83,38.24087740309018,-109.3769376
53688,2,64,6,5,12,0,89,38.24087740309018,-109.3766681
53689,0,59,7,2,11,4,83,38.24087740309018,-109.3763986
53690,0,50,8,3,11,3,75,38.24087740309018,-109.3761291
53691,2,51,8,5,11,2,79,38.24087740309018,-109.3758596
53692,0,51,7,0,11,5,74,38.24087740309018,-109.3755901
53693,3,48,9,5,11,2,78,38.24087740309018,-109.3753206
53694,0,50,8,2,11,3,74,38.24087740309018,-109.3750512
53695,0,44,8,0,10,6,68,38.24087740309018,-109.3747817
53696,0,40,8,1,11,7,67,38.24087740309018,-109.3745122
53697,1,43,9,3,12,7,75,38.24087740309018,-109.3742427
53698,1,38,10,1,10,13,73,38.24087740309018,-109.3739732
53699,1,37,11,0,9,16,74,38.24087740309018,-109.3737037
53700,1,39,11,0,11,13,75,38.24087740309018,-109.3734342
53701,1,43,10,0,14,9,77,38.24087740309018,-109.3731647
53702,2,45,11,2,16,7,83,38.24087740309018,-109.3728952
53703,2,41,11,3,13,8,78,38.24087740309018,-109.3726257
53704,2,35,12,4,13,10,76,38.24087740309018,-109.3723562
53705,2,31,12,4,11,12,72,38.24087740309018,-109.3720867
53706,1,35,10,2,10,12,70,38.24087740309018,-109.3718172
53707,1,38,11,0,10,12,72,38.24087740309018,-109.3715477
53708,1,38,11,2,10,11,73,38.24087740309018,-109.3712782
53709,1,41,9,2,12,9,74,38.24087740309018,-109.3710087
53710,2,41,10,0,12,9,74,38.24087740309018,-109.3707392
53711,2,32,14,2,6,17,73,38.24087740309018,-109.3704697
53712,2,33,14,2,6,17,74,38.24087740309018,-109.3702003
53713,1,36,13,2,6,16,74,38.24087740309018,-109.3699308
53714,2,34,13,4,13,10,76,38.24087740309018,-109.3696613
53715,3,34,12,6,16,7,78,38.24087740309018,-109.3693918
53716,3,28,16,4,13,16,80,38.24087740309018,-109.3691223
53717,2,26,15,8,12,16,79,38.24087740309018,-109.3688528
53718,5,26,13,9,18,5,76,38.24087740309018,-109.3685833
53719,5,16,12,14,19,0,66,38.24087740309018,-109.3683138
53720,3,20,14,14,12,6,69,38.24087740309018,-109.3680443
53721,3,18,15,10,8,15,69,38.24087740309018,-109.3677748
53722,1,21,15,2,4,22,65,38.24087740309018,-109.3675053
53723,0,21,15,0,3,27,66,38.24087740309018,-109.3672358
53724,1,24,15,0,2,25,67,38.24087740309018,-109.3669663
53725,1,21,14,0,2,24,62,38.24087740309018,-109.3666968
53726,1,21,13,3,4,18,60,38.24087740309018,-109.3664273
53727,1,23,11,4,6,14,59,38.24087740309018,-109.3661578
53728,0,25,10,4,7,11,57,38.24087740309018,-109.3658883
53729,2,26,8,4,7,9,56,38.24087740309018,-109.3656188
53730,2,29,6,4,8,6,55,38.24087740309018,-109.3653493
53731,6,38,7,5,7,3,66,38.24087740309018,-109.3650799
53732,8,38,8,6,7,2,69,38.24087740309018,-109.3648104
53733,2,33,7,4,9,6,61,38.24087740309018,-109.3645409
53734,2,34,7,5,8,6,62,38.24087740309018,-109.3642714
53735,3,42,6,5,8,4,68,38.24087740309018,-109.3640019
53736,4,46,6,6,9,2,73,38.24087740309018,-109.3637324
53737,5,44,6,6,9,1,71,38.24087740309018,-109.3634629
53738,5,41,7,7,9,2,71,38.24087740309018,-109.3631934
53739,3,34,8,7,9,4,65,38.24087740309018,-109.3629239
53740,3,38,9,11,9,1,71,38.24087740309018,-109.3626544
53741,3,34,11,8,9,3,68,38.24087740309018,-109.3623849
53742,2,35,10,6,8,6,67,38.24087740309018,-109.3621154
53743,2,36,11,5,8,8,70,38.24087740309018,-109.3618459
53744,1,33,12,1,7,14,68,38.24087740309018,-109.3615764
53745,2,20,18,1,4,26,71,38.24087740309018,-109.3613069
53746,0,23,20,0,5,34,82,38.24087740309018,-109.3610374
53747,0,25,19,0,5,31,80,38.24087740309018,-109.3607679
53748,0,25,16,0,4,28,73,38.24087740309018,-109.3604984
53749,1,27,15,0,5,23,71,38.24087740309018,-109.360229
53750,2,32,13,1,7,18,73,38.24087740309018,-109.3599595
53751,2,31,13,1,8,17,72,38.24087740309018,-109.35969
53752,2,27,12,0,6,18,65,38.24087740309018,-109.3594205
53753,2,26,12,0,3,20,63,38.24087740309018,-109.359151
53754,1,29,12,0,3,19,64,38.24087740309018,-109.3588815
53755,1,32,10,0,6,15,64,38.24087740309018,-109.358612
53756,0,32,9,0,6,16,63,38.24087740309018,-109.3583425
53757,0,29,9,1,6,12,57,38.24087740309018,-109.358073
53758,2,30,9,4,6,5,56,38.24087740309018,-109.3578035
53759,2,26,8,5,10,5,56,38.24087740309018,-109.357534
53760,3,27,11,7,13,8,69,38.24087740309018,-109.3572645
53761,3,22,11,7,13,12,68,38.24087740309018,-109.356995
53762,3,23,10,9,8,6,59,38.24087740309018,-109.3567255
53763,3,28,9,6,9,6,61,38.24087740309018,-109.356456
53764,1,26,10,1,6,15,59,38.24087740309018,-109.3561865
53765,1,32,10,1,4,15,63,38.24087740309018,-109.355917
53766,1,32,10,3,5,10,61,38.24087740309018,-109.3556475
53767,2,29,10,3,7,8,59,38.24087740309018,-109.355378
53768,1,28,11,3,7,11,61,38.24087740309018,-109.3551086
53769,2,32,11,3,7,12,67,38.24087740309018,-109.3548391
53770,2,29,11,3,7,14,66,38.24087740309018,-109.3545696
53771,3,30,11,4,8,12,68,38.24087740309018,-109.3543001
53772,9,36,12,7,9,4,77,38.24087740309018,-109.3540306
53773,19,32,16,16,9,1,93,38.24087740309018,-109.3537611
53774,32,25,14,10,3,1,85,38.24087740309018,-109.3534916
53775,35,22,11,9,3,1,81,38.24087740309018,-109.3532221
53776,34,23,11,16,6,1,91,38.24087740309018,-109.3529526
53777,37,22,11,14,8,1,93,38.24087740309018,-109.3526831
53778,38,21,11,14,8,1,93,38.24087740309018,-109.3524136
53779,34,23,11,15,8,1,92,38.24087740309018,-109.3521441
53780,31,25,11,14,9,2,92,38.24087740309018,-109.3518746
53781,24,25,13,13,11,4,90,38.24087740309018,-109.3516051
53782,2,21,12,5,6,19,65,38.24087740309018,-109.3513356
53783,4,46,10,8,15,1,84,38.24060790850495,-109.4068515
53784,10,43,13,12,14,0,92,38.24060790850495,-109.406582
53785,12,39,14,13,14,0,92,38.24060790850495,-109.4063125
53786,10,40,13,12,13,1,89,38.24060790850495,-109.406043
53787,7,44,12,9,13,1,86,38.24060790850495,-109.4057735
53788,4,45,10,7,13,2,81,38.24060790850495,-109.405504
53789,4,43,11,8,14,2,82,38.24060790850495,-109.4052345
53790,6,41,12,10,15,1,85,38.24060790850495,-109.4049651
53791,14,37,14,13,14,0,92,38.24060790850495,-109.4046956
53792,17,36,14,13,12,0,92,38.24060790850495,-109.4044261
53793,15,36,14,14,13,0,92,38.24060790850495,-109.4041566
53794,17,36,14,13,12,0,92,38.24060790850495,-109.4038871
53795,17,35,14,13,12,0,91,38.24060790850495,-109.4036176
53796,18,35,14,12,12,0,91,38.24060790850495,-109.4033481
53797,18,34,13,12,12,0,89,38.24060790850495,-109.4030786
53798,18,33,14,12,12,0,89,38.24060790850495,-109.4028091
53799,16,35,14,13,13,0,91,38.24060790850495,-109.4025396
53800,13,38,14,13,12,0,90,38.24060790850495,-109.4022701
53801,13,40,14,12,12,0,91,38.24060790850495,-109.4020006
53802,13,39,14,12,13,0,91,38.24060790850495,-109.4017311
53803,12,42,13,10,13,0,90,38.24060790850495,-109.4014616
53804,11,44,13,9,14,0,91,38.24060790850495,-109.4011921
53805,9,45,13,9,14,0,90,38.24060790850495,-109.4009226
53806,8,43,13,9,16,1,90,38.24060790850495,-109.4006531
53807,11,40,14,10,16,0,91,38.24060790850495,-109.4003836
53808,14,34,14,13,15,0,90,38.24060790850495,-109.4001142
53809,13,34,14,13,15,1,90,38.24060790850495,-109.3998447
53810,10,35,12,10,14,1,82,38.24060790850495,-109.3995752
53811,9,38,12,10,14,1,84,38.24060790850495,-109.3993057
53812,10,36,13,11,14,1,85,38.24060790850495,-109.3990362
53813,9,37,14,10,13,1,84,38.24060790850495,-109.3987667
53814,9,41,13,9,14,1,87,38.24060790850495,-109.3984972
53815,7,44,12,9,14,2,88,38.24060790850495,-109.3982277
53816,6,45,12,10,13,2,88,38.24060790850495,-109.3979582
53817,10,44,14,12,14,1,95,38.24060790850495,-109.3976887
53818,12,40,15,13,13,0,93,38.24060790850495,-109.3974192
53819,14,38,15,12,13,0,92,38.24060790850495,-109.3971497
53820,14,39,15,12,13,0,93,38.24060790850495,-109.3968802
53821,13,42,14,12,12,0,93,38.24060790850495,-109.3966107
53822,9,44,13,10,12,1,89,38.24060790850495,-109.3963412
53823,7,45,13,9,12,2,88,38.24060790850495,-109.3960717
53824,8,46,13,9,13,1,90,38.24060790850495,-109.3958022
53825,11,42,13,10,13,1,90,38.24060790850495,-109.3955327
53826,10,41,13,10,13,1,88,38.24060790850495,-109.3952632
53827,9,42,13,11,14,1,90,38.24060790850495,-109.3949938
53828,9,43,14,12,15,0,93,38.24060790850495,-109.3947243
53829,9,43,14,12,16,0,94,38.24060790850495,-109.3944548
53830,7,45,14,12,15,1,94,38.24060790850495,-109.3941853
53831,7,44,14,13,14,1,93,38.24060790850495,-109.3939158
53832,8,43,14,13,14,1,93,38.24060790850495,-109.3936463
53833,8,42,14,13,14,1,92,38.24060790850495,-109.3933768
53834,9,41,14,14,14,0,92,38.24060790850495,-109.3931073
53835,8,44,14,12,14,1,93,38.24060790850495,-109.3928378
53836,8,46,14,11,14,1,94,38.24060790850495,-109.3925683
53837,9,44,14,11,14,1,93,38.24060790850495,-109.3922988
53838,13,42,14,10,14,0,93,38.24060790850495,-109.3920293
53839,14,41,14,11,13,0,93,38.24060790850495,-109.3917598
53840,14,40,14,11,12,0,91,38.24060790850495,-109.3914903
53841,14,40,14,12,12,1,93,38.24060790850495,-109.3912208
53842,11,40,14,12,14,1,92,38.24060790850495,-109.3909513
53843,8,40,13,11,15,1,88,38.24060790850495,-109.3906818
53844,7,46,13,9,16,0,91,38.24060790850495,-109.3904123
53845,4,47,12,6,14,3,86,38.24060790850495,-109.3901429
53846,4,45,12,6,13,4,84,38.24060790850495,-109.3898734
53847,4,45,12,6,12,3,82,38.24060790850495,-109.3896039
53848,5,45,13,8,12,3,86,38.24060790850495,-109.3893344
53849,6,43,13,8,11,3,84,38.24060790850495,-109.3890649
53850,7,43,13,8,12,3,86,38.24060790850495,-109.3887954
53851,9,40,13,9,12,2,85,38.24060790850495,-109.3885259
53852,12,36,13,10,11,2,84,38.24060790850495,-109.3882564
53853,15,36,13,9,11,1,85,38.24060790850495,-109.3879869
53854,15,30,12,9,9,3,78,38.24060790850495,-109.3877174
53855,15,28,13,11,8,4,79,38.24060790850495,-109.3874479
53856,12,29,12,10,8,4,75,38.24060790850495,-109.3871784
53857,9,37,9,8,10,3,76,38.24060790850495,-109.3869089
53858,6,41,9,6,10,3,75,38.24060790850495,-109.3866394
53859,2,45,8,4,10,4,73,38.24060790850495,-109.3863699
53860,1,46,7,3,10,3,70,38.24060790850495,-109.3861004
53861,2,47,7,4,9,2,71,38.24060790850495,-109.3858309
53862,2,45,7,3,10,2,69,38.24060790850495,-109.3855614
53863,2,41,8,3,11,4,69,38.24060790850495,-109.3852919
53864,2,43,8,2,11,5,71,38.24060790850495,-109.3850225
53865,1,42,8,2,10,6,69,38.24060790850495,-109.384753
53866,1,38,8,3,11,7,68,38.24060790850495,-109.3844835
53867,2,38,10,4,12,7,73,38.24060790850495,-109.384214
53868,4,41,11,5,13,5,79,38.24060790850495,-109.3839445
53869,5,34,12,6,11,11,79,38.24060790850495,-109.383675
53870,5,29,14,5,7,17,77,38.24060790850495,-109.3834055
53871,5,27,15,3,4,19,73,38.24060790850495,-109.383136
53872,3,31,11,0,9,13,67,38.24060790850495,-109.3828665
53873,3,39,10,2,16,5,75,38.24060790850495,-109.382597
53874,3,44,10,2,15,4,78,38.24060790850495,-109.3823275
53875,4,41,10,3,11,7,76,38.24060790850495,-109.382058
53876,7,30,13,4,7,10,71,38.24060790850495,-109.3817885
53877,5,32,13,4,8,9,71,38.24060790850495,-109.381519
53878,1,31,12,0,6,16,66,38.24060790850495,-109.3812495
53879,1,31,11,0,6,14,63,38.24060790850495,-109.38098
53880,3,29,10,7,9,7,65,38.24060790850495,-109.3807105
53881,5,37,9,14,6,1,72,38.24060790850495,-109.380441
53882,2,47,7,6,8,2,72,38.24060790850495,-109.3801716
53883,2,47,8,6,10,2,75,38.24060790850495,-109.3799021
53884,3,44,9,6,12,4,78,38.24060790850495,-109.3796326
53885,3,40,10,3,13,7,76,38.24060790850495,-109.3793631
53886,4,45,11,4,12,6,82,38.24060790850495,-109.3790936
53887,3,42,11,2,12,10,80,38.24060790850495,-109.3788241
53888,4,34,12,5,11,10,76,38.24060790850495,-109.3785546
53889,4,31,11,7,10,9,72,38.24060790850495,-109.3782851
53890,3,43,8,6,9,2,71,38.24060790850495,-109.3780156
53891,2,61,7,6,10,1,87,38.24060790850495,-109.3777461
53892,2,54,7,5,10,3,81,38.24060790850495,-109.3774766
53893,1,49,7,4,11,4,76,38.24060790850495,-109.3772071
53894,1,50,7,3,10,5,76,38.24060790850495,-109.3769376
53895,2,61,7,6,11,1,88,38.24060790850495,-109.3766681
53896,1,56,7,4,11,1,80,38.24060790850495,-109.3763986
53897,1,59,7,4,9,2,82,38.24060790850495,-109.3761291
53898,0,47,8,1,12,5,73,38.24060790850495,-109.3758596
53899,1,51,7,0,10,5,74,38.24060790850495,-109.3755901
53900,2,46,8,7,9,2,74,38.24060790850495,-109.3753206
53901,0,52,7,2,9,3,73,38.24060790850495,-109.3750512
53902,0,50,7,1,9,4,71,38.24060790850495,-109.3747817
53903,1,45,9,2,11,5,73,38.24060790850495,-109.3745122
53904,2,36,11,4,11,10,74,38.24060790850495,-109.3742427
53905,2,34,11,3,10,13,73,38.24060790850495,-109.3739732
53906,3,40,11,2,11,11,78,38.24060790850495,-109.3737037
53907,2,40,11,1,12,10,76,38.24060790850495,-109.3734342
53908,2,40,11,1,15,8,77,38.24060790850495,-109.3731647
53909,2,47,11,2,15,6,83,38.24060790850495,-109.3728952
53910,2,45,11,2,14,7,81,38.24060790850495,-109.3726257
53911,2,42,11,3,15,8,81,38.24060790850495,-109.3723562
53912,2,39,11,2,13,10,77,38.24060790850495,-109.3720867
53913,1,36,11,1,9,15,73,38.24060790850495,-109.3718172
53914,0,36,10,0,7,16,69,38.24060790850495,-109.3715477
53915,0,38,11,0,13,12,74,38.24060790850495,-109.3712782
53916,1,38,11,1,15,9,75,38.24060790850495,-109.3710087
53917,1,37,11,1,14,10,74,38.24060790850495,-109.3707392
53918,2,31,12,0,12,11,68,38.24060790850495,-109.3704697
53919,1,31,11,1,13,9,66,38.24060790850495,-109.3702003
53920,0,35,11,0,14,9,69,38.24060790850495,-109.3699308
53921,0,34,11,2,15,8,70,38.24060790850495,-109.3696613
53922,2,30,10,6,15,6,69,38.24060790850495,-109.3693918
53923,2,28,15,3,13,15,76,38.24060790850495,-109.3691223
53924,2,24,15,4,13,16,74,38.24060790850495,-109.3688528
53925,4,22,12,8,15,6,67,38.24060790850495,-109.3685833
53926,9,21,10,15,17,0,72,38.24060790850495,-109.3683138
53927,7,15,11,16,13,2,64,38.24060790850495,-109.3680443
53928,3,25,15,6,7,16,72,38.24060790850495,-109.3677748
53929,0,22,15,0,3,26,66,38.24060790850495,-109.3675053
53930,0,22,14,0,3,25,64,38.24060790850495,-109.3672358
53931,0,21,13,0,2,23,59,38.24060790850495,-109.3669663
53932,0,24,11,0,3,19,57,38.24060790850495,-109.3666968
53933,0,24,11,4,7,13,59,38.24060790850495,-109.3664273
53934,2,26,9,2,9,9,57,38.24060790850495,-109.3661578
53935,2,27,7,4,7,7,54,38.24060790850495,-109.3658883
53936,1,26,6,4,7,6,50,38.24060790850495,-109.3656188
53937,2,30,6,4,8,5,55,38.24060790850495,-109.3653493
53938,5,37,7,5,9,5,68,38.24060790850495,-109.3650799
53939,3,36,7,6,9,5,66,38.24060790850495,-109.3648104
53940,2,38,10,4,11,7,72,38.24060790850495,-109.3645409
53941,3,40,10,5,11,4,73,38.24060790850495,-109.3642714
53942,3,40,8,5,10,3,69,38.24060790850495,-109.3640019
53943,3,39,8,5,11,3,69,38.24060790850495,-109.3637324
53944,3,40,8,6,11,3,71,38.24060790850495,-109.3634629
53945,6,34,12,3,8,2,65,38.24060790850495,-109.3631934
53946,9,28,13,7,12,3,72,38.24060790850495,-109.3629239
53947,8,23,10,12,12,7,72,38.24060790850495,-109.3626544
53948,0,20,12,1,6,18,57,38.24060790850495,-109.3623849
53949,0,22,11,0,5,18,56,38.24060790850495,-109.3621154
53950,0,29,11,2,6,15,63,38.24060790850495,-109.3618459
53951,0,31,12,4,7,12,66,38.24060790850495,-109.3615764
53952,1,27,13,5,10,14,70,38.24060790850495,-109.3613069
53953,0,20,15,0,3,25,63,38.24060790850495,-109.3610374
53954,1,20,16,0,2,29,68,38.24060790850495,-109.3607679
53955,1,22,15,0,3,26,67,38.24060790850495,-109.3604984
53956,2,26,14,0,5,22,69,38.24060790850495,-109.360229
53957,2,31,13,0,7,19,72,38.24060790850495,-109.3599595
53958,1,25,13,0,5,21,65,38.24060790850495,-109.35969
53959,0,21,13,0,3,23,60,38.24060790850495,-109.3594205
53960,1,21,14,0,2,24,62,38.24060790850495,-109.359151
53961,1,28,12,0,2,21,64,38.24060790850495,-109.3588815
53962,0,32,10,0,8,14,64,38.24060790850495,-109.358612
53963,0,32,9,0,7,14,62,38.24060790850495,-109.3583425
53964,1,28,9,4,6,8,56,38.24060790850495,-109.358073
53965,2,29,7,4,7,4,53,38.24060790850495,-109.3578035
53966,2,24,7,4,10,4,51,38.24060790850495,-109.357534
53967,4,24,11,13,13,6,71,38.24060790850495,-109.3572645
53968,3,21,11,8,15,10,68,38.24060790850495,-109.356995
53969,1,26,9,6,10,6,58,38.24060790850495,-109.3567255
53970,4,34,8,6,8,3,63,38.24060790850495,-109.356456
53971,2,31,9,3,8,9,62,38.24060790850495,-109.3561865
53972,1,34,10,1,7,10,63,38.24060790850495,-109.355917
53973,2,34,10,3,6,8,63,38.24060790850495,-109.3556475
53974,3,32,9,4,8,6,62,38.24060790850495,-109.355378
53975,2,31,12,2,7,12,66,38.24060790850495,-109.3551086
53976,1,24,12,2,6,17,62,38.24060790850495,-109.3548391
53977,1,28,11,3,6,15,64,38.24060790850495,-109.3545696
53978,5,31,11,5,8,11,71,38.24060790850495,-109.3543001
53979,17,30,14,12,8,3,84,38.24060790850495,-109.3540306
53980,32,25,15,16,5,0,93,38.24060790850495,-109.3537611
53981,39,21,12,13,2,0,87,38.24060790850495,-109.3534916
53982,39,22,11,9,3,0,84,38.24060790850495,-109.3532221
53983,35,24,10,11,6,1,87,38.24060790850495,-109.3529526
53984,32,22,11,15,8,1,89,38.24060790850495,-109.3526831
53985,37,21,11,15,8,1,93,38.24060790850495,-109.3524136
53986,34,21,10,16,10,1,92,38.24060790850495,-109.3521441
53987,33,20,10,15,12,2,92,38.24060790850495,-109.3518746
53988,18,23,12,17,15,5,90,38.24060790850495,-109.3516051
53989,2,25,13,7,10,16,73,38.24060790850495,-109.3513356
53990,6,48,10,7,15,0,86,38.240338413919716,-109.4068515
53991,7,50,12,9,14,0,92,38.240338413919716,-109.406582
53992,6,48,11,10,13,1,89,38.240338413919716,-109.4063125
53993,5,48,10,9,13,1,86,38.240338413919716,-109.406043
53994,3,48,10,7,13,1,82,38.240338413919716,-109.4057735
53995,3,49,10,7,14,1,84,38.240338413919716,-109.405504
53996,5,43,11,10,15,1,85,38.240338413919716,-109.4052345
53997,11,40,13,13,14,0,91,38.240338413919716,-109.4049651
53998,14,38,14,15,13,0,94,38.240338413919716,-109.4046956
53999,14,37,15,16,12,0,94,38.240338413919716,-109.4044261
54000,14,37,15,15,12,0,93,38.240338413919716,-109.4041566
54001,15,37,15,14,12,0,93,38.240338413919716,-109.4038871
54002,15,37,14,13,12,0,91,38.240338413919716,-109.4036176
54003,16,36,14,12,13,0,91,38.240338413919716,-109.4033481
54004,16,33,14,14,13,0,90,38.240338413919716,-109.4030786
54005,18,33,14,13,12,0,90,38.240338413919716,-109.4028091
54006,14,35,14,13,13,0,89,38.240338413919716,-109.4025396
54007,11,38,14,13,13,1,90,38.240338413919716,-109.4022701
54008,9,40,14,13,13,1,90,38.240338413919716,-109.4020006
54009,13,40,14,11,13,0,91,38.240338413919716,-109.4017311
54010,12,39,14,12,14,0,91,38.240338413919716,-109.4014616
54011,11,41,14,12,14,0,92,38.240338413919716,-109.4011921
54012,11,44,13,10,14,0,92,38.240338413919716,-109.4009226
54013,11,44,13,10,14,0,92,38.240338413919716,-109.4006531
54014,13,38,14,12,15,0,92,38.240338413919716,-109.4003836
54015,12,36,14,13,15,0,90,38.240338413919716,-109.4001142
54016,9,36,13,10,14,2,84,38.240338413919716,-109.3998447
54017,6,38,12,8,13,2,79,38.240338413919716,-109.3995752
54018,8,38,12,8,13,1,80,38.240338413919716,-109.3993057
54019,11,35,14,11,13,1,85,38.240338413919716,-109.3990362
54020,14,35,14,12,14,0,89,38.240338413919716,-109.3987667
54021,13,37,14,11,14,0,89,38.240338413919716,-109.3984972
54022,8,42,13,10,14,1,88,38.240338413919716,-109.3982277
54023,5,47,11,9,13,2,87,38.240338413919716,-109.3979582
54024,7,45,12,10,13,2,89,38.240338413919716,-109.3976887
54025,11,41,14,12,13,1,92,38.240338413919716,-109.3974192
54026,15,37,14,12,13,0,91,38.240338413919716,-109.3971497
54027,14,41,14,11,12,0,92,38.240338413919716,-109.3968802
54028,10,42,13,11,12,1,89,38.240338413919716,-109.3966107
54029,7,45,13,10,12,2,89,38.240338413919716,-109.3963412
54030,6,47,12,8,12,2,87,38.240338413919716,-109.3960717
54031,6,47,12,8,12,2,87,38.240338413919716,-109.3958022
54032,7,43,12,10,12,1,85,38.240338413919716,-109.3955327
54033,9,41,13,11,12,1,87,38.240338413919716,-109.3952632
54034,9,42,13,12,14,1,91,38.240338413919716,-109.3949938
54035,10,43,14,12,14,0,93,38.240338413919716,-109.3947243
54036,10,44,14,12,15,1,96,38.240338413919716,-109.3944548
54037,7,45,14,12,14,1,93,38.240338413919716,-109.3941853
54038,7,44,14,12,14,1,92,38.240338413919716,-109.3939158
54039,8,43,14,13,14,1,93,38.240338413919716,-109.3936463
54040,7,42,14,13,14,1,91,38.240338413919716,-109.3933768
54041,7,43,14,13,14,1,92,38.240338413919716,-109.3931073
54042,8,43,14,12,14,1,92,38.240338413919716,-109.3928378
54043,8,44,14,11,14,1,92,38.240338413919716,-109.3925683
54044,10,42,14,12,14,1,93,38.240338413919716,-109.3922988
54045,14,40,14,11,13,0,92,38.240338413919716,-109.3920293
54046,15,39,14,11,12,0,91,38.240338413919716,-109.3917598
54047,18,38,14,11,12,0,93,38.240338413919716,-109.3914903
54048,17,37,14,11,12,0,91,38.240338413919716,-109.3912208
54049,14,39,14,12,13,0,92,38.240338413919716,-109.3909513
54050,10,41,13,10,15,0,89,38.240338413919716,-109.3906818
54051,6,47,12,8,16,0,89,38.240338413919716,-109.3904123
54052,5,46,12,7,14,2,86,38.240338413919716,-109.3901429
54053,7,43,13,8,12,2,85,38.240338413919716,-109.3898734
54054,9,42,14,9,11,2,87,38.240338413919716,-109.3896039
54055,8,42,14,9,11,2,86,38.240338413919716,-109.3893344
54056,7,41,14,8,11,3,84,38.240338413919716,-109.3890649
54057,9,40,14,9,11,3,86,38.240338413919716,-109.3887954
54058,11,38,14,9,11,2,85,38.240338413919716,-109.3885259
54059,14,35,14,9,11,1,84,38.240338413919716,-109.3882564
54060,16,33,14,9,10,2,84,38.240338413919716,-109.3879869
54061,20,26,14,10,9,3,82,38.240338413919716,-109.3877174
54062,26,21,16,10,7,4,84,38.240338413919716,-109.3874479
54063,24,25,14,10,9,3,85,38.240338413919716,-109.3871784
54064,14,33,11,7,12,3,80,38.240338413919716,-109.3869089
54065,8,42,10,5,13,2,80,38.240338413919716,-109.3866394
54066,5,43,9,5,11,3,76,38.240338413919716,-109.3863699
54067,2,42,8,3,11,4,70,38.240338413919716,-109.3861004
54068,1,42,8,2,11,5,69,38.240338413919716,-109.3858309
54069,2,44,8,2,11,5,72,38.240338413919716,-109.3855614
54070,4,41,10,4,13,4,76,38.240338413919716,-109.3852919
54071,5,37,10,5,12,5,74,38.240338413919716,-109.3850225
54072,4,32,10,4,10,9,69,38.240338413919716,-109.384753
54073,3,29,11,4,8,12,67,38.240338413919716,-109.3844835
54074,3,27,12,4,6,16,68,38.240338413919716,-109.384214
54075,7,28,14,6,9,13,77,38.240338413919716,-109.3839445
54076,10,31,14,7,10,11,83,38.240338413919716,-109.383675
54077,7,33,14,5,8,13,80,38.240338413919716,-109.3834055
54078,4,33,13,0,6,17,73,38.240338413919716,-109.383136
54079,3,30,11,1,6,15,66,38.240338413919716,-109.3828665
54080,4,41,10,1,12,8,76,38.240338413919716,-109.382597
54081,2,50,9,1,15,3,80,38.240338413919716,-109.3823275
54082,3,47,9,3,14,3,79,38.240338413919716,-109.382058
54083,3,36,9,4,11,7,70,38.240338413919716,-109.3817885
54084,2,45,8,1,10,6,72,38.240338413919716,-109.381519
54085,2,47,7,4,8,3,71,38.240338413919716,-109.3812495
54086,1,52,7,5,9,2,76,38.240338413919716,-109.38098
54087,2,51,6,7,8,1,75,38.240338413919716,-109.3807105
54088,4,44,8,11,6,1,74,38.240338413919716,-109.380441
54089,5,27,9,10,10,5,66,38.240338413919716,-109.3801716
54090,5,38,9,6,12,4,74,38.240338413919716,-109.3799021
54091,2,46,10,3,16,4,81,38.240338413919716,-109.3796326
54092,2,51,10,2,14,4,83,38.240338413919716,-109.3793631
54093,2,52,9,2,13,5,83,38.240338413919716,-109.3790936
54094,3,47,10,2,12,7,81,38.240338413919716,-109.3788241
54095,3,32,11,4,10,12,72,38.240338413919716,-109.3785546
54096,3,30,11,6,7,12,69,38.240338413919716,-109.3782851
54097,4,42,8,7,11,3,75,38.240338413919716,-109.3780156
54098,3,55,8,8,10,1,85,38.240338413919716,-109.3777461
54099,3,45,8,7,11,3,77,38.240338413919716,-109.3774766
54100,2,43,8,4,11,5,73,38.240338413919716,-109.3772071
54101,1,45,8,3,12,5,74,38.240338413919716,-109.3769376
54102,2,54,8,6,12,2,84,38.240338413919716,-109.3766681
54103,2,51,9,6,11,2,81,38.240338413919716,-109.3763986
54104,1,55,7,3,10,2,78,38.240338413919716,-109.3761291
54105,1,52,7,3,10,3,76,38.240338413919716,-109.3758596
54106,1,53,6,3,9,3,75,38.240338413919716,-109.3755901
54107,2,54,7,6,9,1,79,38.240338413919716,-109.3753206
54108,2,59,6,5,10,1,83,38.240338413919716,-109.3750512
54109,2,51,7,5,10,2,77,38.240338413919716,-109.3747817
54110,2,42,9,3,10,6,72,38.240338413919716,-109.3745122
54111,5,26,14,5,6,17,73,38.240338413919716,-109.3742427
54112,4,28,13,6,7,15,73,38.240338413919716,-109.3739732
54113,4,43,12,4,12,8,83,38.240338413919716,-109.3737037
54114,3,43,11,2,11,9,79,38.240338413919716,-109.3734342
54115,3,41,11,1,12,9,77,38.240338413919716,-109.3731647
54116,3,49,11,3,15,4,85,38.240338413919716,-109.3728952
54117,2,45,10,2,12,8,79,38.240338413919716,-109.3726257
54118,2,43,11,3,14,7,80,38.240338413919716,-109.3723562
54119,2,41,11,2,14,8,78,38.240338413919716,-109.3720867
54120,1,39,10,0,12,11,73,38.240338413919716,-109.3718172
54121,1,32,11,1,8,13,66,38.240338413919716,-109.3715477
54122,1,35,11,2,13,9,71,38.240338413919716,-109.3712782
54123,2,34,12,1,13,10,72,38.240338413919716,-109.3710087
54124,1,29,12,0,10,14,66,38.240338413919716,-109.3707392
54125,4,30,14,3,4,17,72,38.240338413919716,-109.3704697
54126,4,33,15,7,5,14,78,38.240338413919716,-109.3702003
54127,0,33,12,0,13,12,70,38.240338413919716,-109.3699308
54128,0,34,11,1,14,8,68,38.240338413919716,-109.3696613
54129,0,30,9,4,15,6,64,38.240338413919716,-109.3693918
54130,0,24,12,0,18,9,63,38.240338413919716,-109.3691223
54131,1,24,10,1,19,4,59,38.240338413919716,-109.3688528
54132,0,17,10,5,19,5,56,38.240338413919716,-109.3685833
54133,0,15,10,10,15,5,55,38.240338413919716,-109.3683138
54134,4,18,13,9,10,7,61,38.240338413919716,-109.3680443
54135,2,22,17,5,6,22,74,38.240338413919716,-109.3677748
54136,0,20,15,0,2,28,65,38.240338413919716,-109.3675053
54137,0,20,14,0,2,25,61,38.240338413919716,-109.3672358
54138,0,20,13,0,2,21,56,38.240338413919716,-109.3669663
54139,0,27,11,1,5,16,60,38.240338413919716,-109.3666968
54140,4,30,11,5,9,7,66,38.240338413919716,-109.3664273
54141,3,27,7,2,7,9,55,38.240338413919716,-109.3661578
54142,3,23,7,3,7,9,52,38.240338413919716,-109.3658883
54143,3,26,8,4,8,8,57,38.240338413919716,-109.3656188
54144,3,33,7,4,9,8,64,38.240338413919716,-109.3653493
54145,2,34,7,4,9,8,64,38.240338413919716,-109.3650799
54146,2,36,10,3,9,8,68,38.240338413919716,-109.3648104
54147,1,35,11,3,10,8,68,38.240338413919716,-109.3645409
54148,7,30,8,11,10,6,72,38.240338413919716,-109.3642714
54149,6,30,7,11,10,4,68,38.240338413919716,-109.3640019
54150,5,33,9,8,9,3,67,38.240338413919716,-109.3637324
54151,13,28,14,9,7,5,76,38.240338413919716,-109.3634629
54152,11,22,12,14,7,5,71,38.240338413919716,-109.3631934
54153,6,20,11,11,12,9,69,38.240338413919716,-109.3629239
54154,6,24,12,10,12,7,71,38.240338413919716,-109.3626544
54155,0,19,12,1,6,20,58,38.240338413919716,-109.3623849
54156,0,18,13,0,4,21,56,38.240338413919716,-109.3621154
54157,0,21,12,0,3,20,56,38.240338413919716,-109.3618459
54158,0,27,11,3,5,14,60,38.240338413919716,-109.3615764
54159,1,37,10,3,9,8,68,38.240338413919716,-109.3613069
54160,0,35,10,0,9,13,67,38.240338413919716,-109.3610374
54161,1,32,11,1,7,15,67,38.240338413919716,-109.3607679
54162,1,28,11,2,7,15,64,38.240338413919716,-109.3604984
54163,1,30,10,2,7,13,63,38.240338413919716,-109.360229
54164,1,25,10,3,7,13,59,38.240338413919716,-109.3599595
54165,1,23,10,3,6,14,57,38.240338413919716,-109.35969
54166,1,22,11,4,5,15,58,38.240338413919716,-109.3594205
54167,1,23,11,2,3,17,57,38.240338413919716,-109.359151
54168,0,22,12,1,2,21,58,38.240338413919716,-109.3588815
54169,0,28,11,1,5,17,62,38.240338413919716,-109.358612
54170,0,30,10,0,6,14,60,38.240338413919716,-109.3583425
54171,1,28,9,4,7,7,56,38.240338413919716,-109.358073
54172,2,29,7,5,7,4,54,38.240338413919716,-109.3578035
54173,3,27,8,5,9,4,56,38.240338413919716,-109.357534
54174,6,26,11,16,14,4,77,38.240338413919716,-109.3572645
54175,5,23,11,11,14,8,72,38.240338413919716,-109.356995
54176,2,22,10,4,13,9,60,38.240338413919716,-109.3567255
54177,5,31,8,7,9,2,62,38.240338413919716,-109.356456
54178,4,30,9,4,8,6,61,38.240338413919716,-109.3561865
54179,3,35,9,3,6,6,62,38.240338413919716,-109.355917
54180,3,31,8,5,6,5,58,38.240338413919716,-109.3556475
54181,4,29,8,6,8,5,60,38.240338413919716,-109.355378
54182,3,32,11,2,6,10,64,38.240338413919716,-109.3551086
54183,3,29,10,5,8,10,65,38.240338413919716,-109.3548391
54184,2,27,11,6,8,10,64,38.240338413919716,-109.3545696
54185,8,31,12,8,8,8,75,38.240338413919716,-109.3543001
54186,31,26,15,15,7,1,95,38.240338413919716,-109.3540306
54187,37,21,13,15,2,0,88,38.240338413919716,-109.3537611
54188,41,20,11,11,2,0,85,38.240338413919716,-109.3534916
54189,38,22,9,7,4,0,80,38.240338413919716,-109.3532221
54190,30,23,8,7,5,0,73,38.240338413919716,-109.3529526
54191,21,23,8,12,6,0,70,38.240338413919716,-109.3526831
54192,35,18,11,17,8,1,90,38.240338413919716,-109.3524136
54193,33,16,10,18,15,2,94,38.240338413919716,-109.3521441
54194,13,20,11,21,17,7,89,38.240338413919716,-109.3518746
54195,5,25,14,13,14,13,84,38.240338413919716,-109.3516051
54196,3,26,13,9,13,13,77,38.240338413919716,-109.3513356
54197,3,49,9,5,16,1,83,38.240068919334476,-109.4068515
54198,3,54,10,7,14,0,88,38.240068919334476,-109.406582
54199,3,54,9,6,13,1,86,38.240068919334476,-109.4063125
54200,3,51,9,6,14,1,84,38.240068919334476,-109.406043
54201,4,49,10,7,14,1,85,38.240068919334476,-109.4057735
54202,7,43,12,11,14,1,88,38.240068919334476,-109.405504
54203,12,40,13,11,14,0,90,38.240068919334476,-109.4052345
54204,13,39,14,12,13,0,91,38.240068919334476,-109.4049651
54205,13,39,14,13,12,0,91,38.240068919334476,-109.4046956
54206,14,39,14,13,11,0,91,38.240068919334476,-109.4044261
54207,15,37,14,14,12,0,92,38.240068919334476,-109.4041566
54208,16,36,14,13,12,0,91,38.240068919334476,-109.4038871
54209,17,35,14,13,12,0,91,38.240068919334476,-109.4036176
54210,17,35,14,13,12,0,91,38.240068919334476,-109.4033481
54211,14,35,15,15,13,0,92,38.240068919334476,-109.4030786
54212,13,36,15,14,13,0,91,38.240068919334476,-109.4028091
54213,11,36,14,14,13,1,89,38.240068919334476,-109.4025396
54214,9,37,14,13,13,1,87,38.240068919334476,-109.4022701
54215,9,39,14,13,14,1,90,38.240068919334476,-109.4020006
54216,9,41,14,12,14,0,90,38.240068919334476,-109.4017311
54217,10,41,13,11,14,0,89,38.240068919334476,-109.4014616
54218,9,41,14,11,14,0,89,38.240068919334476,-109.4011921
54219,9,42,14,11,14,0,90,38.240068919334476,-109.4009226
54220,11,42,13,11,14,0,91,38.240068919334476,-109.4006531
54221,10,40,13,10,16,1,90,38.240068919334476,-109.4003836
54222,10,39,13,10,15,1,88,38.240068919334476,-109.4001142
54223,10,38,13,9,14,1,85,38.240068919334476,-109.3998447
54224,9,38,13,10,13,2,85,38.240068919334476,-109.3995752
54225,8,36,14,10,13,2,83,38.240068919334476,-109.3993057
54226,11,35,14,11,13,1,85,38.240068919334476,-109.3990362
54227,13,35,14,11,14,1,88,38.240068919334476,-109.3987667
54228,13,36,14,11,14,1,89,38.240068919334476,-109.3984972
54229,9,40,13,10,14,1,87,38.240068919334476,-109.3982277
54230,5,44,12,9,12,2,84,38.240068919334476,-109.3979582
54231,6,46,12,8,12,2,86,38.240068919334476,-109.3976887
54232,9,45,13,10,12,1,90,38.240068919334476,-109.3974192
54233,13,42,13,10,12,1,91,38.240068919334476,-109.3971497
54234,13,42,13,10,12,0,90,38.240068919334476,-109.3968802
54235,11,42,14,11,13,1,92,38.240068919334476,-109.3966107
54236,9,44,13,11,13,1,91,38.240068919334476,-109.3963412
54237,9,46,13,10,13,1,92,38.240068919334476,-109.3960717
54238,9,45,13,10,13,1,91,38.240068919334476,-109.3958022
54239,7,43,12,11,12,1,86,38.240068919334476,-109.3955327
54240,7,42,13,11,12,1,86,38.240068919334476,-109.3952632
54241,7,43,13,11,13,1,88,38.240068919334476,-109.3949938
54242,9,44,14,11,14,1,93,38.240068919334476,-109.3947243
54243,10,43,14,12,14,1,94,38.240068919334476,-109.3944548
54244,7,44,13,12,14,1,91,38.240068919334476,-109.3941853
54245,9,41,14,12,14,1,91,38.240068919334476,-109.3939158
54246,8,41,14,13,13,1,90,38.240068919334476,-109.3936463
54247,7,41,14,13,13,1,89,38.240068919334476,-109.3933768
54248,7,42,13,11,12,2,87,38.240068919334476,-109.3931073
54249,8,39,14,12,13,1,87,38.240068919334476,-109.3928378
54250,10,40,14,12,13,1,90,38.240068919334476,-109.3925683
54251,13,40,14,12,13,0,92,38.240068919334476,-109.3922988
54252,15,39,14,12,12,0,92,38.240068919334476,-109.3920293
54253,15,38,14,12,12,0,91,38.240068919334476,-109.3917598
54254,18,37,14,11,11,0,91,38.240068919334476,-109.3914903
54255,18,38,14,11,11,0,92,38.240068919334476,-109.3912208
54256,15,39,13,10,12,0,89,38.240068919334476,-109.3909513
54257,11,41,12,10,14,1,89,38.240068919334476,-109.3906818
54258,8,43,13,9,16,0,89,38.240068919334476,-109.3904123
54259,7,42,13,9,14,2,87,38.240068919334476,-109.3901429
54260,10,38,14,9,12,2,85,38.240068919334476,-109.3898734
54261,12,36,14,11,11,2,86,38.240068919334476,-109.3896039
54262,10,38,15,12,11,2,88,38.240068919334476,-109.3893344
54263,8,41,14,11,11,3,88,38.240068919334476,-109.3890649
54264,10,42,15,11,11,2,91,38.240068919334476,-109.3887954
54265,13,39,15,12,11,1,91,38.240068919334476,-109.3885259
54266,15,35,14,11,11,1,87,38.240068919334476,-109.3882564
54267,18,32,15,11,10,2,88,38.240068919334476,-109.3879869
54268,31,25,14,10,8,1,89,38.240068919334476,-109.3877174
54269,28,24,14,10,9,2,87,38.240068919334476,-109.3874479
54270,21,30,13,9,12,2,87,38.240068919334476,-109.3871784
54271,13,38,12,8,14,1,86,38.240068919334476,-109.3869089
54272,11,41,11,7,13,1,84,38.240068919334476,-109.3866394
54273,12,35,11,6,11,2,77,38.240068919334476,-109.3863699
54274,8,31,10,7,10,4,70,38.240068919334476,-109.3861004
54275,7,29,10,7,9,7,69,38.240068919334476,-109.3858309
54276,6,33,11,6,11,7,74,38.240068919334476,-109.3855614
54277,7,38,12,8,14,3,82,38.240068919334476,-109.3852919
54278,6,42,12,5,13,5,83,38.240068919334476,-109.3850225
54279,6,42,12,4,12,7,83,38.240068919334476,-109.384753
54280,6,31,13,6,10,11,77,38.240068919334476,-109.3844835
54281,7,24,14,7,7,16,75,38.240068919334476,-109.384214
54282,9,30,13,8,10,9,79,38.240068919334476,-109.3839445
54283,5,32,12,7,12,8,76,38.240068919334476,-109.383675
54284,3,33,11,2,11,10,70,38.240068919334476,-109.3834055
54285,3,34,11,1,9,12,70,38.240068919334476,-109.383136
54286,3,38,10,0,10,11,72,38.240068919334476,-109.3828665
54287,2,47,9,2,15,4,79,38.240068919334476,-109.382597
54288,2,49,8,2,15,3,79,38.240068919334476,-109.3823275
54289,3,43,10,1,14,6,77,38.240068919334476,-109.382058
54290,4,31,12,3,8,14,72,38.240068919334476,-109.3817885
54291,1,35,10,0,7,12,65,38.240068919334476,-109.381519
54292,3,56,8,6,8,1,82,38.240068919334476,-109.3812495
54293,1,60,6,5,8,1,81,38.240068919334476,-109.38098
54294,1,53,6,4,8,1,73,38.240068919334476,-109.3807105
54295,3,45,7,7,5,3,70,38.240068919334476,-109.380441
54296,11,24,11,14,10,3,73,38.240068919334476,-109.3801716
54297,6,23,12,10,10,7,68,38.240068919334476,-109.3799021
54298,5,29,13,6,7,12,72,38.240068919334476,-109.3796326
54299,7,35,12,6,10,8,78,38.240068919334476,-109.3793631
54300,7,43,11,5,13,5,84,38.240068919334476,-109.3790936
54301,5,45,11,3,13,7,84,38.240068919334476,-109.3788241
54302,4,40,11,2,12,10,79,38.240068919334476,-109.3785546
54303,4,35,12,3,9,12,75,38.240068919334476,-109.3782851
54304,4,33,12,6,8,11,74,38.240068919334476,-109.3780156
54305,3,34,11,9,13,6,76,38.240068919334476,-109.3777461
54306,5,34,11,7,12,7,76,38.240068919334476,-109.3774766
54307,4,33,11,6,10,10,74,38.240068919334476,-109.3772071
54308,3,37,10,5,10,9,74,38.240068919334476,-109.3769376
54309,1,45,8,2,13,5,74,38.240068919334476,-109.3766681
54310,1,51,8,3,10,3,76,38.240068919334476,-109.3763986
54311,1,53,7,4,9,2,76,38.240068919334476,-109.3761291
54312,1,51,7,3,9,2,73,38.240068919334476,-109.3758596
54313,1,50,7,3,9,2,72,38.240068919334476,-109.3755901
54314,2,55,7,5,10,2,81,38.240068919334476,-109.3753206
54315,2,55,6,5,10,2,80,38.240068919334476,-109.3750512
54316,2,47,7,5,10,3,74,38.240068919334476,-109.3747817
54317,2,38,9,3,8,9,69,38.240068919334476,-109.3745122
54318,3,25,14,3,5,21,71,38.240068919334476,-109.3742427
54319,4,29,13,6,6,16,74,38.240068919334476,-109.3739732
54320,5,36,13,4,9,12,79,38.240068919334476,-109.3737037
54321,4,38,12,2,10,11,77,38.240068919334476,-109.3734342
54322,3,42,10,1,11,10,77,38.240068919334476,-109.3731647
54323,3,49,10,3,14,4,83,38.240068919334476,-109.3728952
54324,1,50,9,1,13,6,80,38.240068919334476,-109.3726257
54325,1,44,10,1,13,7,76,38.240068919334476,-109.3723562
54326,2,41,10,1,13,8,75,38.240068919334476,-109.3720867
54327,2,39,10,1,12,9,73,38.240068919334476,-109.3718172
54328,3,32,11,3,10,9,68,38.240068919334476,-109.3715477
54329,2,31,11,2,9,11,66,38.240068919334476,-109.3712782
54330,2,28,12,1,7,15,65,38.240068919334476,-109.3710087
54331,2,27,13,0,4,22,68,38.240068919334476,-109.3707392
54332,2,27,13,0,3,23,68,38.240068919334476,-109.3704697
54333,2,30,13,0,6,21,72,38.240068919334476,-109.3702003
54334,0,26,12,0,5,21,64,38.240068919334476,-109.3699308
54335,1,31,12,0,9,15,68,38.240068919334476,-109.3696613
54336,3,40,10,6,7,8,74,38.240068919334476,-109.3693918
54337,0,31,8,5,17,1,62,38.240068919334476,-109.3691223
54338,7,31,9,4,12,5,68,38.240068919334476,-109.3688528
54339,7,30,10,4,10,6,67,38.240068919334476,-109.3685833
54340,4,19,9,6,11,4,53,38.240068919334476,-109.3683138
54341,5,15,10,7,11,5,53,38.240068919334476,-109.3680443
54342,2,17,13,6,6,16,60,38.240068919334476,-109.3677748
54343,1,18,13,0,2,22,56,38.240068919334476,-109.3675053
54344,1,20,12,0,3,19,55,38.240068919334476,-109.3672358
54345,1,23,11,3,5,15,58,38.240068919334476,-109.3669663
54346,0,26,10,3,9,11,59,38.240068919334476,-109.3666968
54347,6,31,10,5,10,4,66,38.240068919334476,-109.3664273
54348,2,28,7,3,8,8,56,38.240068919334476,-109.3661578
54349,2,28,8,4,8,9,59,38.240068919334476,-109.3658883
54350,3,31,10,5,9,7,65,38.240068919334476,-109.3656188
54351,3,29,8,6,10,6,62,38.240068919334476,-109.3653493
54352,3,29,9,5,9,9,64,38.240068919334476,-109.3650799
54353,3,31,12,5,8,11,70,38.240068919334476,-109.3648104
54354,2,29,12,5,10,9,67,38.240068919334476,-109.3645409
54355,7,30,10,12,10,8,77,38.240068919334476,-109.3642714
54356,8,28,10,13,10,5,74,38.240068919334476,-109.3640019
54357,3,25,12,1,6,14,61,38.240068919334476,-109.3637324
54358,0,22,12,0,6,15,55,38.240068919334476,-109.3634629
54359,1,23,13,1,7,14,59,38.240068919334476,-109.3631934
54360,4,17,11,4,13,8,57,38.240068919334476,-109.3629239
54361,4,20,12,8,9,7,60,38.240068919334476,-109.3626544
54362,1,22,14,2,6,19,64,38.240068919334476,-109.3623849
54363,0,21,13,0,5,20,59,38.240068919334476,-109.3621154
54364,0,20,12,1,4,20,57,38.240068919334476,-109.3618459
54365,0,22,11,1,4,18,56,38.240068919334476,-109.3615764
54366,1,34,10,4,8,9,66,38.240068919334476,-109.3613069
54367,0,40,10,2,9,8,69,38.240068919334476,-109.3610374
54368,0,36,9,2,10,6,63,38.240068919334476,-109.3607679
54369,1,32,9,2,10,8,62,38.240068919334476,-109.3604984
54370,2,29,9,2,7,10,59,38.240068919334476,-109.360229
54371,1,24,10,5,9,9,58,38.240068919334476,-109.3599595
54372,1,28,9,4,10,8,60,38.240068919334476,-109.35969
54373,1,32,9,4,10,7,63,38.240068919334476,-109.3594205
54374,2,33,9,4,10,7,65,38.240068919334476,-109.359151
54375,1,28,10,4,9,10,62,38.240068919334476,-109.3588815
54376,0,30,11,1,7,15,64,38.240068919334476,-109.358612
54377,0,30,10,0,6,15,61,38.240068919334476,-109.3583425
54378,1,29,9,5,7,8,59,38.240068919334476,-109.358073
54379,2,29,9,6,6,6,58,38.240068919334476,-109.3578035
54380,3,24,11,10,11,4,63,38.240068919334476,-109.357534
54381,6,24,13,15,14,6,78,38.240068919334476,-109.3572645
54382,8,21,11,15,13,9,77,38.240068919334476,-109.356995
54383,3,18,11,11,11,12,66,38.240068919334476,-109.3567255
54384,3,25,8,7,10,5,58,38.240068919334476,-109.356456
54385,4,27,8,4,8,5,56,38.240068919334476,-109.3561865
54386,3,32,7,4,7,3,56,38.240068919334476,-109.355917
54387,2,33,7,5,7,4,58,38.240068919334476,-109.3556475
54388,3,32,8,5,8,4,60,38.240068919334476,-109.355378
54389,2,35,9,3,8,6,63,38.240068919334476,-109.3551086
54390,3,28,10,5,10,7,63,38.240068919334476,-109.3548391
54391,5,25,11,10,9,8,68,38.240068919334476,-109.3545696
54392,18,28,13,14,10,3,86,38.240068919334476,-109.3543001
54393,36,20,12,20,4,0,92,38.240068919334476,-109.3540306
54394,35,20,11,16,2,0,84,38.240068919334476,-109.3537611
54395,35,22,10,12,4,0,83,38.240068919334476,-109.3534916
54396,31,22,8,9,5,0,75,38.240068919334476,-109.3532221
54397,28,21,7,10,5,0,71,38.240068919334476,-109.3529526
54398,30,21,10,16,5,0,82,38.240068919334476,-109.3526831
54399,37,14,10,18,12,1,92,38.240068919334476,-109.3524136
54400,14,17,10,29,18,3,91,38.240068919334476,-109.3521441
54401,3,23,14,12,14,15,81,38.240068919334476,-109.3518746
54402,4,31,13,6,14,13,81,38.240068919334476,-109.3516051
54403,3,27,12,11,16,6,75,38.240068919334476,-109.3513356
54404,1,55,8,2,14,2,82,38.23979942474924,-109.4068515
54405,2,56,8,5,14,1,86,38.23979942474924,-109.406582
54406,3,53,9,6,14,0,85,38.23979942474924,-109.4063125
54407,5,48,10,7,14,1,85,38.23979942474924,-109.406043
54408,8,41,12,12,15,0,88,38.23979942474924,-109.4057735
54409,12,38,13,15,13,0,91,38.23979942474924,-109.405504
54410,14,37,14,15,13,0,93,38.23979942474924,-109.4052345
54411,14,38,14,14,13,0,93,38.23979942474924,-109.4049651
54412,14,39,14,13,13,0,93,38.23979942474924,-109.4046956
54413,16,37,14,13,12,0,92,38.23979942474924,-109.4044261
54414,18,35,14,13,12,0,92,38.23979942474924,-109.4041566
54415,17,35,15,14,12,0,93,38.23979942474924,-109.4038871
54416,15,37,15,14,12,0,93,38.23979942474924,-109.4036176
54417,12,39,15,14,12,0,92,38.23979942474924,-109.4033481
54418,11,40,15,14,13,0,93,38.23979942474924,-109.4030786
54419,11,39,15,13,13,1,92,38.23979942474924,-109.4028091
54420,11,37,14,13,13,1,89,38.23979942474924,-109.4025396
54421,11,37,14,14,13,1,90,38.23979942474924,-109.4022701
54422,11,37,15,15,13,0,91,38.23979942474924,-109.4020006
54423,8,39,14,13,14,1,89,38.23979942474924,-109.4017311
54424,9,40,13,12,14,1,89,38.23979942474924,-109.4014616
54425,9,42,14,11,14,1,91,38.23979942474924,-109.4011921
54426,8,43,14,11,14,1,91,38.23979942474924,-109.4009226
54427,7,44,13,10,14,1,89,38.23979942474924,-109.4006531
54428,8,44,13,9,15,1,90,38.23979942474924,-109.4003836
54429,9,43,13,10,15,1,91,38.23979942474924,-109.4001142
54430,10,42,13,10,14,1,90,38.23979942474924,-109.3998447
54431,10,40,13,10,13,1,87,38.23979942474924,-109.3995752
54432,9,37,14,11,13,1,85,38.23979942474924,-109.3993057
54433,11,37,14,11,13,1,87,38.23979942474924,-109.3990362
54434,11,36,14,12,14,1,88,38.23979942474924,-109.3987667
54435,10,36,14,13,14,1,88,38.23979942474924,-109.3984972
54436,8,39,13,11,14,2,87,38.23979942474924,-109.3982277
54437,6,43,13,10,13,1,86,38.23979942474924,-109.3979582
54438,7,45,13,10,13,1,89,38.23979942474924,-109.3976887
54439,8,46,12,10,14,1,91,38.23979942474924,-109.3974192
54440,10,45,13,11,14,0,93,38.23979942474924,-109.3971497
54441,12,41,13,11,14,0,91,38.23979942474924,-109.3968802
54442,12,39,14,12,14,1,92,38.23979942474924,-109.3966107
54443,11,42,14,11,14,1,93,38.23979942474924,-109.3963412
54444,12,44,13,10,13,0,92,38.23979942474924,-109.3960717
54445,12,46,14,10,12,0,94,38.23979942474924,-109.3958022
54446,10,45,13,11,12,1,92,38.23979942474924,-109.3955327
54447,8,45,13,11,13,1,91,38.23979942474924,-109.3952632
54448,8,44,13,11,13,1,90,38.23979942474924,-109.3949938
54449,9,44,13,12,13,1,92,38.23979942474924,-109.3947243
54450,10,44,13,11,13,1,92,38.23979942474924,-109.3944548
54451,8,42,13,11,13,1,88,38.23979942474924,-109.3941853
54452,11,41,14,12,13,1,92,38.23979942474924,-109.3939158
54453,9,42,14,13,13,1,92,38.23979942474924,-109.3936463
54454,8,42,13,13,13,1,90,38.23979942474924,-109.3933768
54455,7,41,13,12,12,2,87,38.23979942474924,-109.3931073
54456,9,39,14,11,13,1,87,38.23979942474924,-109.3928378
54457,11,41,14,11,13,1,91,38.23979942474924,-109.3925683
54458,13,40,14,11,12,0,90,38.23979942474924,-109.3922988
54459,15,39,14,12,12,0,92,38.23979942474924,-109.3920293
54460,15,38,14,13,12,0,92,38.23979942474924,-109.3917598
54461,14,39,14,13,12,0,92,38.23979942474924,-109.3914903
54462,14,39,14,12,12,0,91,38.23979942474924,-109.3912208
54463,13,40,13,11,12,0,89,38.23979942474924,-109.3909513
54464,13,41,12,9,13,1,89,38.23979942474924,-109.3906818
54465,10,42,12,8,14,1,87,38.23979942474924,-109.3904123
54466,6,41,13,9,14,2,85,38.23979942474924,-109.3901429
54467,9,37,14,10,12,2,84,38.23979942474924,-109.3898734
54468,10,36,15,12,11,2,86,38.23979942474924,-109.3896039
54469,11,39,15,12,12,2,91,38.23979942474924,-109.3893344
54470,10,41,14,11,11,2,89,38.23979942474924,-109.3890649
54471,11,39,14,11,11,1,87,38.23979942474924,-109.3887954
54472,13,39,15,12,11,1,91,38.23979942474924,-109.3885259
54473,17,35,15,13,10,1,91,38.23979942474924,-109.3882564
54474,23,32,14,12,9,1,91,38.23979942474924,-109.3879869
54475,25,29,13,9,10,2,88,38.23979942474924,-109.3877174
54476,18,30,12,9,12,2,83,38.23979942474924,-109.3874479
54477,12,34,12,8,12,3,81,38.23979942474924,-109.3871784
54478,12,36,12,7,12,2,81,38.23979942474924,-109.3869089
54479,13,34,12,7,11,2,79,38.23979942474924,-109.3866394
54480,16,25,12,10,11,2,76,38.23979942474924,-109.3863699
54481,13,22,12,11,11,4,73,38.23979942474924,-109.3861004
54482,11,24,12,10,11,6,74,38.23979942474924,-109.3858309
54483,10,35,13,8,12,4,82,38.23979942474924,-109.3855614
54484,7,41,14,10,13,2,87,38.23979942474924,-109.3852919
54485,5,45,12,7,13,3,85,38.23979942474924,-109.3850225
54486,5,45,12,6,13,3,84,38.23979942474924,-109.384753
54487,6,37,12,10,14,4,83,38.23979942474924,-109.3844835
54488,11,21,13,13,11,8,77,38.23979942474924,-109.384214
54489,8,20,12,12,11,8,71,38.23979942474924,-109.3839445
54490,3,29,11,5,11,8,67,38.23979942474924,-109.383675
54491,4,37,10,0,11,9,71,38.23979942474924,-109.3834055
54492,3,39,10,0,10,9,71,38.23979942474924,-109.383136
54493,3,38,10,1,10,11,73,38.23979942474924,-109.3828665
54494,3,44,10,3,13,5,78,38.23979942474924,-109.382597
54495,3,43,10,2,13,5,76,38.23979942474924,-109.3823275
54496,5,36,11,4,12,6,74,38.23979942474924,-109.382058
54497,6,31,13,7,9,11,77,38.23979942474924,-109.3817885
54498,4,44,8,6,9,1,72,38.23979942474924,-109.381519
54499,2,55,7,5,9,1,79,38.23979942474924,-109.3812495
54500,1,53,6,3,9,1,73,38.23979942474924,-109.38098
54501,2,46,7,4,9,2,70,38.23979942474924,-109.3807105
54502,3,36,9,8,7,4,67,38.23979942474924,-109.380441
54503,6,24,9,17,10,1,67,38.23979942474924,-109.3801716
54504,10,24,11,10,12,3,70,38.23979942474924,-109.3799021
54505,10,35,12,8,12,4,81,38.23979942474924,-109.3796326
54506,7,43,12,7,12,3,84,38.23979942474924,-109.3793631
54507,4,46,12,4,12,5,83,38.23979942474924,-109.3790936
54508,3,44,12,2,12,9,82,38.23979942474924,-109.3788241
54509,3,47,11,2,13,7,83,38.23979942474924,-109.3785546
54510,4,48,12,3,15,6,88,38.23979942474924,-109.3782851
54511,4,47,12,4,15,5,87,38.23979942474924,-109.3780156
54512,4,45,11,1,11,10,82,38.23979942474924,-109.3777461
54513,5,44,12,4,13,6,84,38.23979942474924,-109.3774766
54514,5,40,12,5,12,7,81,38.23979942474924,-109.3772071
54515,4,38,11,4,11,8,76,38.23979942474924,-109.3769376
54516,1,40,9,2,14,6,72,38.23979942474924,-109.3766681
54517,1,52,8,5,10,2,78,38.23979942474924,-109.3763986
54518,1,52,7,3,9,2,74,38.23979942474924,-109.3761291
54519,1,50,8,3,10,2,74,38.23979942474924,-109.3758596
54520,1,48,8,4,11,2,74,38.23979942474924,-109.3755901
54521,1,50,8,3,10,5,77,38.23979942474924,-109.3753206
54522,3,49,8,3,12,4,79,38.23979942474924,-109.3750512
54523,2,45,9,3,11,6,76,38.23979942474924,-109.3747817
54524,2,40,10,0,11,11,74,38.23979942474924,-109.3745122
54525,2,37,11,0,10,15,75,38.23979942474924,-109.3742427
54526,4,34,12,4,9,14,77,38.23979942474924,-109.3739732
54527,5,33,14,4,8,15,79,38.23979942474924,-109.3737037
54528,5,37,12,2,10,12,78,38.23979942474924,-109.3734342
54529,3,44,11,1,13,9,81,38.23979942474924,-109.3731647
54530,2,48,10,1,13,6,80,38.23979942474924,-109.3728952
54531,1,49,9,0,13,6,78,38.23979942474924,-109.3726257
54532,2,44,10,0,12,8,76,38.23979942474924,-109.3723562
54533,3,40,10,0,11,9,73,38.23979942474924,-109.3720867
54534,3,40,10,0,11,8,72,38.23979942474924,-109.3718172
54535,1,37,10,2,10,9,69,38.23979942474924,-109.3715477
54536,1,30,10,0,9,12,62,38.23979942474924,-109.3712782
54537,1,27,11,0,5,18,62,38.23979942474924,-109.3710087
54538,2,29,13,0,5,20,69,38.23979942474924,-109.3707392
54539,1,28,15,0,3,26,73,38.23979942474924,-109.3704697
54540,2,28,15,0,5,25,75,38.23979942474924,-109.3702003
54541,0,27,12,0,4,23,66,38.23979942474924,-109.3699308
54542,0,28,11,0,6,19,64,38.23979942474924,-109.3696613
54543,4,31,11,5,5,13,69,38.23979942474924,-109.3693918
54544,4,34,8,4,9,6,65,38.23979942474924,-109.3691223
54545,3,34,9,6,10,3,65,38.23979942474924,-109.3688528
54546,3,35,8,6,10,3,65,38.23979942474924,-109.3685833
54547,2,32,7,5,9,3,58,38.23979942474924,-109.3683138
54548,3,23,9,7,10,2,54,38.23979942474924,-109.3680443
54549,2,12,9,4,7,10,44,38.23979942474924,-109.3677748
54550,2,16,13,1,3,20,55,38.23979942474924,-109.3675053
54551,2,20,13,0,3,19,57,38.23979942474924,-109.3672358
54552,1,24,11,2,5,15,58,38.23979942474924,-109.3669663
54553,1,30,10,3,10,9,63,38.23979942474924,-109.3666968
54554,3,33,9,4,9,4,62,38.23979942474924,-109.3664273
54555,5,30,8,4,8,4,59,38.23979942474924,-109.3661578
54556,3,34,7,4,9,5,62,38.23979942474924,-109.3658883
54557,3,31,8,5,10,6,63,38.23979942474924,-109.3656188
54558,3,36,9,4,11,6,69,38.23979942474924,-109.3653493
54559,3,33,11,6,10,9,72,38.23979942474924,-109.3650799
54560,3,25,13,4,4,18,67,38.23979942474924,-109.3648104
54561,5,26,12,3,5,12,63,38.23979942474924,-109.3645409
54562,4,33,11,4,11,6,69,38.23979942474924,-109.3642714
54563,4,30,14,4,9,13,74,38.23979942474924,-109.3640019
54564,4,21,15,2,3,20,65,38.23979942474924,-109.3637324
54565,2,23,15,2,6,17,65,38.23979942474924,-109.3634629
54566,2,24,13,0,10,12,61,38.23979942474924,-109.3631934
54567,2,17,13,5,12,10,59,38.23979942474924,-109.3629239
54568,6,21,14,11,9,7,68,38.23979942474924,-109.3626544
54569,0,20,13,2,5,19,59,38.23979942474924,-109.3623849
54570,0,20,12,0,3,22,57,38.23979942474924,-109.3621154
54571,0,21,12,0,4,20,57,38.23979942474924,-109.3618459
54572,0,21,12,1,5,18,57,38.23979942474924,-109.3615764
54573,0,27,10,3,8,12,60,38.23979942474924,-109.3613069
54574,1,37,9,3,6,7,63,38.23979942474924,-109.3610374
54575,1,40,9,3,8,5,66,38.23979942474924,-109.3607679
54576,0,36,9,2,10,8,65,38.23979942474924,-109.3604984
54577,1,25,11,3,7,16,63,38.23979942474924,-109.360229
54578,1,20,13,6,6,17,63,38.23979942474924,-109.3599595
54579,1,21,12,5,6,16,61,38.23979942474924,-109.35969
54580,1,24,11,5,8,14,63,38.23979942474924,-109.3594205
54581,1,26,10,3,8,13,61,38.23979942474924,-109.359151
54582,0,30,11,3,9,11,64,38.23979942474924,-109.3588815
54583,1,35,10,1,10,13,70,38.23979942474924,-109.358612
54584,0,34,10,0,8,14,66,38.23979942474924,-109.3583425
54585,0,31,9,3,8,8,59,38.23979942474924,-109.358073
54586,1,27,9,6,6,7,56,38.23979942474924,-109.3578035
54587,4,22,11,9,9,6,61,38.23979942474924,-109.357534
54588,5,22,13,14,10,10,74,38.23979942474924,-109.3572645
54589,13,21,13,17,14,9,87,38.23979942474924,-109.356995
54590,10,15,12,20,10,12,79,38.23979942474924,-109.3567255
54591,3,18,10,7,10,9,57,38.23979942474924,-109.356456
54592,3,26,9,5,8,7,58,38.23979942474924,-109.3561865
54593,2,32,8,5,6,6,59,38.23979942474924,-109.355917
54594,2,31,8,4,7,6,58,38.23979942474924,-109.3556475
54595,2,30,8,4,8,5,57,38.23979942474924,-109.355378
54596,2,32,8,3,9,6,60,38.23979942474924,-109.3551086
54597,3,23,11,7,8,9,61,38.23979942474924,-109.3548391
54598,9,23,13,15,11,6,77,38.23979942474924,-109.3545696
54599,29,20,12,17,9,2,89,38.23979942474924,-109.3543001
54600,37,18,11,22,3,0,91,38.23979942474924,-109.3540306
54601,31,21,9,10,2,0,73,38.23979942474924,-109.3537611
54602,27,22,8,7,5,0,69,38.23979942474924,-109.3534916
54603,26,20,7,9,5,0,67,38.23979942474924,-109.3532221
54604,37,20,9,12,5,0,83,38.23979942474924,-109.3529526
54605,37,17,10,15,10,1,90,38.23979942474924,-109.3526831
54606,24,14,8,27,19,0,92,38.23979942474924,-109.3524136
54607,10,19,10,26,17,3,85,38.23979942474924,-109.3521441
54608,2,27,13,9,16,11,78,38.23979942474924,-109.3518746
54609,2,31,13,7,18,9,80,38.23979942474924,-109.3516051
54610,1,28,11,9,19,4,72,38.23979942474924,-109.3513356
54611,2,58,9,3,15,1,88,38.239529930164004,-109.4068515
54612,3,53,10,7,14,0,87,38.239529930164004,-109.406582
54613,4,47,10,8,15,1,85,38.239529930164004,-109.4063125
54614,6,43,11,10,15,0,85,38.239529930164004,-109.406043
54615,10,41,12,14,14,0,91,38.239529930164004,-109.4057735
54616,15,38,14,15,12,0,94,38.239529930164004,-109.405504
54617,16,36,14,16,13,0,95,38.239529930164004,-109.4052345
54618,15,37,14,15,13,0,94,38.239529930164004,-109.4049651
54619,14,38,14,13,13,0,92,38.239529930164004,-109.4046956
54620,15,36,14,13,14,0,92,38.239529930164004,-109.4044261
54621,17,36,14,13,13,0,93,38.239529930164004,-109.4041566
54622,12,38,15,14,13,0,92,38.239529930164004,-109.4038871
54623,9,41,15,15,13,0,93,38.239529930164004,-109.4036176
54624,8,42,15,14,13,1,93,38.239529930164004,-109.4033481
54625,10,41,15,14,14,0,94,38.239529930164004,-109.4030786
54626,12,37,15,15,13,0,92,38.239529930164004,-109.4028091
54627,12,37,15,14,13,0,91,38.239529930164004,-109.4025396
54628,11,37,14,14,13,1,90,38.239529930164004,-109.4022701
54629,10,37,14,14,14,1,90,38.239529930164004,-109.4020006
54630,8,40,14,13,14,1,90,38.239529930164004,-109.4017311
54631,10,43,14,11,13,0,91,38.239529930164004,-109.4014616
54632,10,45,14,11,12,1,93,38.239529930164004,-109.4011921
54633,9,46,14,11,12,1,93,38.239529930164004,-109.4009226
54634,8,46,13,10,13,1,91,38.239529930164004,-109.4006531
54635,7,46,13,10,13,1,90,38.239529930164004,-109.4003836
54636,9,45,13,11,12,1,91,38.239529930164004,-109.4001142
54637,10,44,13,11,13,1,92,38.239529930164004,-109.3998447
54638,10,44,13,11,13,1,92,38.239529930164004,-109.3995752
54639,10,44,13,11,14,1,93,38.239529930164004,-109.3993057
54640,12,40,14,13,13,0,92,38.239529930164004,-109.3990362
54641,12,38,14,13,13,1,91,38.239529930164004,-109.3987667
54642,10,38,14,13,14,1,90,38.239529930164004,-109.3984972
54643,8,39,13,13,13,1,87,38.239529930164004,-109.3982277
54644,8,40,13,12,13,1,87,38.239529930164004,-109.3979582
54645,9,42,13,12,13,1,90,38.239529930164004,-109.3976887
54646,9,43,13,12,14,1,92,38.239529930164004,-109.3974192
54647,9,43,13,11,14,1,91,38.239529930164004,-109.3971497
54648,9,43,13,10,14,2,91,38.239529930164004,-109.3968802
54649,8,42,12,10,13,2,87,38.239529930164004,-109.3966107
54650,7,44,12,9,13,2,87,38.239529930164004,-109.3963412
54651,8,44,12,9,13,1,87,38.239529930164004,-109.3960717
54652,10,43,13,10,13,1,90,38.239529930164004,-109.3958022
54653,11,43,13,11,14,0,92,38.239529930164004,-109.3955327
54654,9,44,13,11,14,1,92,38.239529930164004,-109.3952632
54655,9,43,13,12,13,1,91,38.239529930164004,-109.3949938
54656,9,44,13,12,13,1,92,38.239529930164004,-109.3947243
54657,9,43,13,12,13,1,91,38.239529930164004,-109.3944548
54658,11,40,14,13,13,1,92,38.239529930164004,-109.3941853
54659,13,38,14,14,13,1,93,38.239529930164004,-109.3939158
54660,11,43,14,12,13,1,94,38.239529930164004,-109.3936463
54661,8,44,13,12,13,1,91,38.239529930164004,-109.3933768
54662,8,41,14,11,12,2,88,38.239529930164004,-109.3931073
54663,12,39,14,12,13,1,91,38.239529930164004,-109.3928378
54664,13,40,14,12,12,0,91,38.239529930164004,-109.3925683
54665,14,40,14,11,12,0,91,38.239529930164004,-109.3922988
54666,14,40,14,11,12,0,91,38.239529930164004,-109.3920293
54667,14,39,14,12,12,0,91,38.239529930164004,-109.3917598
54668,10,41,15,13,12,1,92,38.239529930164004,-109.3914903
54669,10,40,15,13,13,1,92,38.239529930164004,-109.3912208
54670,11,40,14,12,13,1,91,38.239529930164004,-109.3909513
54671,11,38,12,11,14,1,87,38.239529930164004,-109.3906818
54672,10,40,12,10,13,1,86,38.239529930164004,-109.3904123
54673,7,40,13,9,13,1,83,38.239529930164004,-109.3901429
54674,10,36,14,11,11,1,83,38.239529930164004,-109.3898734
54675,12,34,15,13,11,1,86,38.239529930164004,-109.3896039
54676,11,37,15,12,12,1,88,38.239529930164004,-109.3893344
54677,11,40,13,11,11,2,88,38.239529930164004,-109.3890649
54678,12,38,13,10,10,1,84,38.239529930164004,-109.3887954
54679,13,38,14,11,10,1,87,38.239529930164004,-109.3885259
54680,18,36,15,12,9,1,91,38.239529930164004,-109.3882564
54681,24,33,14,11,8,1,91,38.239529930164004,-109.3879869
54682,20,30,13,10,10,3,86,38.239529930164004,-109.3877174
54683,14,32,13,10,11,3,83,38.239529930164004,-109.3874479
54684,11,36,12,8,11,3,81,38.239529930164004,-109.3871784
54685,10,37,12,7,11,3,80,38.239529930164004,-109.3869089
54686,11,33,13,8,11,3,79,38.239529930164004,-109.3866394
54687,25,24,14,11,10,2,86,38.239529930164004,-109.3863699
54688,29,19,14,9,9,5,85,38.239529930164004,-109.3861004
54689,23,23,14,11,10,4,85,38.239529930164004,-109.3858309
54690,14,37,15,11,11,2,90,38.239529930164004,-109.3855614
54691,8,41,14,10,12,2,87,38.239529930164004,-109.3852919
54692,7,45,13,7,12,2,86,38.239529930164004,-109.3850225
54693,6,46,12,9,13,1,87,38.239529930164004,-109.384753
54694,8,40,13,13,14,1,89,38.239529930164004,-109.3844835
54695,12,25,12,13,16,1,79,38.239529930164004,-109.384214
54696,11,23,11,11,12,4,72,38.239529930164004,-109.3839445
54697,4,41,10,2,14,4,75,38.239529930164004,-109.383675
54698,2,48,9,0,15,5,79,38.239529930164004,-109.3834055
54699,2,44,10,1,14,6,77,38.239529930164004,-109.383136
54700,2,39,11,0,9,14,75,38.239529930164004,-109.3828665
54701,3,33,12,3,9,11,71,38.239529930164004,-109.382597
54702,4,33,11,6,12,5,71,38.239529930164004,-109.3823275
54703,5,35,9,7,11,2,69,38.239529930164004,-109.382058
54704,8,49,9,9,6,0,81,38.239529930164004,-109.3817885
54705,4,62,7,6,7,0,86,38.239529930164004,-109.381519
54706,2,44,9,8,11,2,76,38.239529930164004,-109.3812495
54707,6,34,11,11,14,2,78,38.239529930164004,-109.38098
54708,10,29,13,12,12,2,78,38.239529930164004,-109.3807105
54709,9,28,12,8,11,4,72,38.239529930164004,-109.380441
54710,4,21,9,16,11,1,62,38.239529930164004,-109.3801716
54711,6,23,9,13,11,2,64,38.239529930164004,-109.3799021
54712,12,31,12,8,10,3,76,38.239529930164004,-109.3796326
54713,9,42,13,7,12,3,86,38.239529930164004,-109.3793631
54714,7,45,13,6,13,2,86,38.239529930164004,-109.3790936
54715,6,46,12,5,13,4,86,38.239529930164004,-109.3788241
54716,4,48,12,3,14,4,85,38.239529930164004,-109.3785546
54717,3,49,12,3,14,5,86,38.239529930164004,-109.3782851
54718,3,49,11,3,14,6,86,38.239529930164004,-109.3780156
54719,4,48,11,4,13,5,85,38.239529930164004,-109.3777461
54720,5,45,12,5,13,5,85,38.239529930164004,-109.3774766
54721,5,45,12,5,12,5,84,38.239529930164004,-109.3772071
54722,3,44,10,4,14,4,79,38.239529930164004,-109.3769376
54723,1,50,8,5,12,2,78,38.239529930164004,-109.3766681
54724,0,57,7,3,10,1,78,38.239529930164004,-109.3763986
54725,1,54,7,2,9,2,75,38.239529930164004,-109.3761291
54726,1,47,8,3,11,3,73,38.239529930164004,-109.3758596
54727,3,45,10,6,13,2,79,38.239529930164004,-109.3755901
54728,2,51,10,1,15,4,83,38.239529930164004,-109.3753206
54729,2,50,10,2,13,5,82,38.239529930164004,-109.3750512
54730,2,48,10,2,12,7,81,38.239529930164004,-109.3747817
54731,2,46,10,1,12,8,79,38.239529930164004,-109.3745122
54732,3,44,11,1,12,9,80,38.239529930164004,-109.3742427
54733,3,31,13,3,5,18,73,38.239529930164004,-109.3739732
54734,3,31,13,2,6,17,72,38.239529930164004,-109.3737037
54735,3,41,12,1,12,10,79,38.239529930164004,-109.3734342
54736,2,47,11,1,14,7,82,38.239529930164004,-109.3731647
54737,2,47,10,0,13,8,80,38.239529930164004,-109.3728952
54738,2,45,10,0,13,8,78,38.239529930164004,-109.3726257
54739,2,44,10,1,13,8,78,38.239529930164004,-109.3723562
54740,2,43,10,1,14,6,76,38.239529930164004,-109.3720867
54741,2,42,10,0,14,7,75,38.239529930164004,-109.3718172
54742,1,39,9,0,11,10,70,38.239529930164004,-109.3715477
54743,2,31,11,0,10,14,68,38.239529930164004,-109.3712782
54744,2,32,11,0,9,15,69,38.239529930164004,-109.3710087
54745,2,32,12,0,8,17,71,38.239529930164004,-109.3707392
54746,2,28,14,0,5,23,72,38.239529930164004,-109.3704697
54747,2,27,17,0,4,29,79,38.239529930164004,-109.3702003
54748,1,29,14,0,5,23,72,38.239529930164004,-109.3699308
54749,2,28,13,0,5,19,67,38.239529930164004,-109.3696613
54750,7,30,13,11,8,9,78,38.239529930164004,-109.3693918
54751,6,36,11,10,8,5,76,38.239529930164004,-109.3691223
54752,3,48,7,6,9,2,75,38.239529930164004,-109.3688528
54753,2,44,8,5,10,3,72,38.239529930164004,-109.3685833
54754,2,32,7,4,10,4,59,38.239529930164004,-109.3683138
54755,0,20,5,3,10,5,43,38.239529930164004,-109.3680443
54756,2,21,11,0,13,7,54,38.239529930164004,-109.3677748
54757,2,17,10,0,4,16,49,38.239529930164004,-109.3675053
54758,3,20,13,0,2,19,57,38.239529930164004,-109.3672358
54759,2,23,10,2,4,14,55,38.239529930164004,-109.3669663
54760,5,38,8,5,8,3,67,38.239529930164004,-109.3666968
54761,2,40,6,3,8,2,61,38.239529930164004,-109.3664273
54762,5,32,7,3,8,4,59,38.239529930164004,-109.3661578
54763,4,42,7,3,8,6,70,38.239529930164004,-109.3658883
54764,1,37,8,3,9,8,66,38.239529930164004,-109.3656188
54765,1,42,9,3,11,6,72,38.239529930164004,-109.3653493
54766,3,39,10,4,10,8,74,38.239529930164004,-109.3650799
54767,3,30,13,3,6,17,72,38.239529930164004,-109.3648104
54768,3,34,11,2,6,14,70,38.239529930164004,-109.3645409
54769,2,39,10,1,10,11,73,38.239529930164004,-109.3642714
54770,2,32,12,3,9,14,72,38.239529930164004,-109.3640019
54771,5,23,14,5,6,17,70,38.239529930164004,-109.3637324
54772,2,18,11,4,9,13,57,38.239529930164004,-109.3634629
54773,1,19,12,5,9,11,57,38.239529930164004,-109.3631934
54774,2,23,12,4,12,6,59,38.239529930164004,-109.3629239
54775,3,17,9,9,11,4,53,38.239529930164004,-109.3626544
54776,2,19,11,6,8,10,56,38.239529930164004,-109.3623849
54777,1,21,11,2,5,16,56,38.239529930164004,-109.3621154
54778,1,23,11,0,6,17,58,38.239529930164004,-109.3618459
54779,1,22,12,0,5,19,59,38.239529930164004,-109.3615764
54780,0,22,12,0,2,21,57,38.239529930164004,-109.3613069
54781,0,30,9,2,7,10,58,38.239529930164004,-109.3610374
54782,2,40,6,2,7,7,64,38.239529930164004,-109.3607679
54783,2,40,7,3,8,7,67,38.239529930164004,-109.3604984
54784,4,30,9,5,9,10,67,38.239529930164004,-109.360229
54785,2,28,14,1,6,21,72,38.239529930164004,-109.3599595
54786,1,26,14,1,6,22,70,38.239529930164004,-109.35969
54787,1,25,13,1,6,22,68,38.239529930164004,-109.3594205
54788,1,27,12,1,5,20,66,38.239529930164004,-109.359151
54789,1,29,11,2,7,15,65,38.239529930164004,-109.3588815
54790,1,33,11,2,10,12,69,38.239529930164004,-109.358612
54791,0,37,9,1,10,11,68,38.239529930164004,-109.3583425
54792,0,32,8,3,9,7,59,38.239529930164004,-109.358073
54793,3,31,8,6,7,4,59,38.239529930164004,-109.3578035
54794,1,20,10,7,6,8,52,38.239529930164004,-109.357534
54795,3,18,12,13,7,10,63,38.239529930164004,-109.3572645
54796,16,22,14,20,13,5,90,38.239529930164004,-109.356995
54797,15,17,14,22,13,7,88,38.239529930164004,-109.3567255
54798,3,15,12,9,7,15,61,38.239529930164004,-109.356456
54799,1,23,10,3,8,10,55,38.239529930164004,-109.3561865
54800,2,33,9,3,9,7,63,38.239529930164004,-109.355917
54801,1,35,8,3,9,6,62,38.239529930164004,-109.3556475
54802,1,32,8,3,9,6,59,38.239529930164004,-109.355378
54803,3,33,8,3,10,5,62,38.239529930164004,-109.3551086
54804,4,24,12,12,9,6,67,38.239529930164004,-109.3548391
54805,20,23,15,20,11,1,90,38.239529930164004,-109.3545696
54806,32,18,11,22,6,1,90,38.239529930164004,-109.3543001
54807,39,19,11,20,4,0,93,38.239529930164004,-109.3540306
54808,32,23,9,7,5,0,76,38.239529930164004,-109.3537611
54809,25,22,8,7,6,0,68,38.239529930164004,-109.3534916
54810,24,19,8,10,5,0,66,38.239529930164004,-109.3532221
54811,34,19,10,13,7,1,84,38.239529930164004,-109.3529526
54812,22,17,10,20,12,1,82,38.239529930164004,-109.3526831
54813,17,16,10,28,19,1,91,38.239529930164004,-109.3524136
54814,3,24,12,15,18,6,78,38.239529930164004,-109.3521441
54815,1,29,12,6,17,9,74,38.239529930164004,-109.3518746
54816,1,33,11,6,18,7,76,38.239529930164004,-109.3516051
54817,2,34,11,3,15,7,72,38.239529930164004,-109.3513356
54818,5,50,11,9,15,0,90,38.23926043557877,-109.4068515
54819,6,45,11,11,14,1,88,38.23926043557877,-109.406582
54820,7,44,11,10,15,0,87,38.23926043557877,-109.4063125
54821,10,42,12,11,15,0,90,38.23926043557877,-109.406043
54822,15,39,13,12,14,0,93,38.23926043557877,-109.4057735
54823,15,38,13,12,13,0,91,38.23926043557877,-109.405504
54824,14,38,14,14,13,0,93,38.23926043557877,-109.4052345
54825,14,38,14,15,13,0,94,38.23926043557877,-109.4049651
54826,13,38,14,15,13,0,93,38.23926043557877,-109.4046956
54827,12,38,14,14,14,0,92,38.23926043557877,-109.4044261
54828,14,38,14,13,14,0,93,38.23926043557877,-109.4041566
54829,10,40,14,13,14,0,91,38.23926043557877,-109.4038871
54830,8,42,14,12,14,1,91,38.23926043557877,-109.4036176
54831,7,40,14,13,14,1,89,38.23926043557877,-109.4033481
54832,10,38,15,16,14,0,93,38.23926043557877,-109.4030786
54833,14,36,15,15,13,0,93,38.23926043557877,-109.4028091
54834,13,36,15,15,13,0,92,38.23926043557877,-109.4025396
54835,10,39,15,15,13,0,92,38.23926043557877,-109.4022701
54836,9,41,14,14,14,1,93,38.23926043557877,-109.4020006
54837,9,43,15,13,14,0,94,38.23926043557877,-109.4017311
54838,10,45,14,10,13,1,93,38.23926043557877,-109.4014616
54839,8,45,13,10,14,1,91,38.23926043557877,-109.4011921
54840,7,44,14,12,15,0,92,38.23926043557877,-109.4009226
54841,9,44,14,12,14,0,93,38.23926043557877,-109.4006531
54842,11,44,14,11,13,0,93,38.23926043557877,-109.4003836
54843,9,45,13,10,12,1,90,38.23926043557877,-109.4001142
54844,9,47,13,10,13,1,93,38.23926043557877,-109.3998447
54845,9,47,13,11,14,1,95,38.23926043557877,-109.3995752
54846,9,45,14,11,14,0,93,38.23926043557877,-109.3993057
54847,10,43,14,12,13,0,92,38.23926043557877,-109.3990362
54848,8,41,14,12,13,1,89,38.23926043557877,-109.3987667
54849,6,40,13,10,13,2,84,38.23926043557877,-109.3984972
54850,6,40,13,10,13,2,84,38.23926043557877,-109.3982277
54851,8,42,13,11,12,1,87,38.23926043557877,-109.3979582
54852,11,43,14,12,13,1,94,38.23926043557877,-109.3976887
54853,11,41,14,12,14,1,93,38.23926043557877,-109.3974192
54854,9,41,13,12,14,1,90,38.23926043557877,-109.3971497
54855,8,43,13,11,13,2,90,38.23926043557877,-109.3968802
54856,6,45,12,9,13,3,88,38.23926043557877,-109.3966107
54857,5,45,12,9,14,2,87,38.23926043557877,-109.3963412
54858,7,43,13,11,14,1,89,38.23926043557877,-109.3960717
54859,9,42,13,11,14,1,90,38.23926043557877,-109.3958022
54860,9,42,13,11,13,1,89,38.23926043557877,-109.3955327
54861,8,42,13,11,13,1,88,38.23926043557877,-109.3952632
54862,7,42,13,12,14,1,89,38.23926043557877,-109.3949938
54863,8,42,13,13,14,1,91,38.23926043557877,-109.3947243
54864,9,41,14,13,14,1,92,38.23926043557877,-109.3944548
54865,12,39,14,14,14,0,93,38.23926043557877,-109.3941853
54866,13,38,14,14,13,0,92,38.23926043557877,-109.3939158
54867,10,42,14,13,13,1,93,38.23926043557877,-109.3936463
54868,8,43,14,12,13,1,91,38.23926043557877,-109.3933768
54869,9,41,14,13,13,1,91,38.23926043557877,-109.3931073
54870,14,37,14,13,14,0,92,38.23926043557877,-109.3928378
54871,14,39,14,13,12,0,92,38.23926043557877,-109.3925683
54872,14,39,14,12,12,0,91,38.23926043557877,-109.3922988
54873,14,39,14,12,12,0,91,38.23926043557877,-109.3920293
54874,13,39,14,13,12,0,91,38.23926043557877,-109.3917598
54875,9,42,14,12,12,1,90,38.23926043557877,-109.3914903
54876,10,41,15,12,12,1,91,38.23926043557877,-109.3912208
54877,11,40,14,12,13,0,90,38.23926043557877,-109.3909513
54878,12,39,13,11,13,0,88,38.23926043557877,-109.3906818
54879,12,40,13,11,14,0,90,38.23926043557877,-109.3904123
54880,7,41,13,9,13,1,84,38.23926043557877,-109.3901429
54881,9,36,14,10,12,2,83,38.23926043557877,-109.3898734
54882,10,34,14,12,11,2,83,38.23926043557877,-109.3896039
54883,10,37,15,12,11,2,87,38.23926043557877,-109.3893344
54884,12,40,14,12,11,2,91,38.23926043557877,-109.3890649
54885,14,36,12,9,10,1,82,38.23926043557877,-109.3887954
54886,16,33,12,7,8,1,77,38.23926043557877,-109.3885259
54887,17,32,13,8,7,1,78,38.23926043557877,-109.3882564
54888,24,31,15,10,8,1,89,38.23926043557877,-109.3879869
54889,23,24,14,14,10,3,88,38.23926043557877,-109.3877174
54890,20,31,14,12,11,2,90,38.23926043557877,-109.3874479
54891,13,39,14,11,12,1,90,38.23926043557877,-109.3871784
54892,8,42,13,10,12,2,87,38.23926043557877,-109.3869089
54893,7,38,12,9,12,2,80,38.23926043557877,-109.3866394
54894,13,28,14,12,11,3,81,38.23926043557877,-109.3863699
54895,25,24,14,11,9,4,87,38.23926043557877,-109.3861004
54896,25,26,15,11,9,3,89,38.23926043557877,-109.3858309
54897,11,39,15,11,11,3,90,38.23926043557877,-109.3855614
54898,9,42,15,9,12,2,89,38.23926043557877,-109.3852919
54899,8,45,13,7,12,2,87,38.23926043557877,-109.3850225
54900,7,46,12,8,13,2,88,38.23926043557877,-109.384753
54901,8,47,12,9,14,1,91,38.23926043557877,-109.3844835
54902,8,44,11,10,13,1,87,38.23926043557877,-109.384214
54903,4,41,9,5,14,3,76,38.23926043557877,-109.3839445
54904,2,46,9,2,15,3,77,38.23926043557877,-109.383675
54905,1,48,9,0,15,4,77,38.23926043557877,-109.3834055
54906,1,40,10,1,14,6,72,38.23926043557877,-109.383136
54907,2,33,11,0,11,12,69,38.23926043557877,-109.3828665
54908,4,36,12,1,9,10,72,38.23926043557877,-109.382597
54909,5,35,11,6,13,4,74,38.23926043557877,-109.3823275
54910,5,36,9,7,12,3,72,38.23926043557877,-109.382058
54911,5,42,9,8,11,1,76,38.23926043557877,-109.3817885
54912,4,46,8,6,11,3,78,38.23926043557877,-109.381519
54913,13,24,12,13,12,2,76,38.23926043557877,-109.3812495
54914,14,28,13,14,12,2,83,38.23926043557877,-109.38098
54915,13,32,13,14,11,2,85,38.23926043557877,-109.3807105
54916,17,31,13,13,11,1,86,38.23926043557877,-109.380441
54917,5,21,9,15,13,2,65,38.23926043557877,-109.3801716
54918,5,30,9,14,8,1,67,38.23926043557877,-109.3799021
54919,9,36,9,9,9,2,74,38.23926043557877,-109.3796326
54920,11,43,12,8,11,3,88,38.23926043557877,-109.3793631
54921,11,44,15,7,12,2,91,38.23926043557877,-109.3790936
54922,8,45,14,6,13,2,88,38.23926043557877,-109.3788241
54923,5,49,12,7,14,2,89,38.23926043557877,-109.3785546
54924,4,52,11,6,14,2,89,38.23926043557877,-109.3782851
54925,3,49,11,4,14,4,85,38.23926043557877,-109.3780156
54926,3,48,10,3,13,6,83,38.23926043557877,-109.3777461
54927,3,46,11,2,12,7,81,38.23926043557877,-109.3774766
54928,4,45,11,3,12,6,81,38.23926043557877,-109.3772071
54929,3,47,10,4,13,3,80,38.23926043557877,-109.3769376
54930,2,51,9,5,10,2,79,38.23926043557877,-109.3766681
54931,0,49,7,3,11,3,73,38.23926043557877,-109.3763986
54932,1,45,8,2,10,4,70,38.23926043557877,-109.3761291
54933,2,42,10,4,12,4,74,38.23926043557877,-109.3758596
54934,3,44,10,6,14,2,79,38.23926043557877,-109.3755901
54935,2,51,9,3,13,4,82,38.23926043557877,-109.3753206
54936,2,51,9,2,10,6,80,38.23926043557877,-109.3750512
54937,2,50,9,2,11,7,81,38.23926043557877,-109.3747817
54938,2,48,10,2,12,6,80,38.23926043557877,-109.3745122
54939,3,45,11,3,14,5,81,38.23926043557877,-109.3742427
54940,3,36,12,3,10,12,76,38.23926043557877,-109.3739732
54941,3,35,12,2,8,14,74,38.23926043557877,-109.3737037
54942,2,46,11,0,11,10,80,38.23926043557877,-109.3734342
54943,2,48,10,1,13,6,80,38.23926043557877,-109.3731647
54944,2,47,10,0,13,8,80,38.23926043557877,-109.3728952
54945,2,41,10,0,12,9,74,38.23926043557877,-109.3726257
54946,2,44,10,1,12,8,77,38.23926043557877,-109.3723562
54947,2,43,10,0,14,7,76,38.23926043557877,-109.3720867
54948,1,40,10,0,14,8,73,38.23926043557877,-109.3718172
54949,0,30,10,0,7,16,63,38.23926043557877,-109.3715477
54950,4,33,12,0,11,13,73,38.23926043557877,-109.3712782
54951,2,33,12,0,9,15,71,38.23926043557877,-109.3710087
54952,2,34,12,0,8,15,71,38.23926043557877,-109.3707392
54953,3,33,12,0,8,16,72,38.23926043557877,-109.3704697
54954,3,28,16,1,4,24,76,38.23926043557877,-109.3702003
54955,3,30,12,0,5,17,67,38.23926043557877,-109.3699308
54956,2,32,10,1,7,13,65,38.23926043557877,-109.3696613
54957,2,30,10,1,11,10,64,38.23926043557877,-109.3693918
54958,4,36,11,6,8,10,75,38.23926043557877,-109.3691223
54959,4,41,9,6,9,5,74,38.23926043557877,-109.3688528
54960,3,30,9,5,10,4,61,38.23926043557877,-109.3685833
54961,2,21,8,7,9,5,52,38.23926043557877,-109.3683138
54962,5,26,12,6,11,6,66,38.23926043557877,-109.3680443
54963,1,21,10,5,18,3,58,38.23926043557877,-109.3677748
54964,3,24,11,3,9,12,62,38.23926043557877,-109.3675053
54965,3,22,13,0,3,19,60,38.23926043557877,-109.3672358
54966,1,33,7,2,4,12,59,38.23926043557877,-109.3669663
54967,4,33,6,3,7,5,58,38.23926043557877,-109.3666968
54968,5,38,5,3,8,3,62,38.23926043557877,-109.3664273
54969,4,26,7,3,7,7,54,38.23926043557877,-109.3661578
54970,3,42,8,3,7,8,71,38.23926043557877,-109.3658883
54971,3,42,10,3,9,8,75,38.23926043557877,-109.3656188
54972,1,45,9,3,10,7,75,38.23926043557877,-109.3653493
54973,3,42,10,2,10,8,75,38.23926043557877,-109.3650799
54974,3,34,12,2,7,15,73,38.23926043557877,-109.3648104
54975,3,36,11,1,8,14,73,38.23926043557877,-109.3645409
54976,2,37,10,1,8,12,70,38.23926043557877,-109.3642714
54977,2,28,11,2,4,18,65,38.23926043557877,-109.3640019
54978,4,23,12,2,3,17,61,38.23926043557877,-109.3637324
54979,2,20,13,1,6,20,62,38.23926043557877,-109.3634629
54980,2,25,13,0,13,13,66,38.23926043557877,-109.3631934
54981,5,28,15,0,13,9,70,38.23926043557877,-109.3629239
54982,1,18,11,11,12,2,55,38.23926043557877,-109.3626544
54983,4,16,10,7,11,5,53,38.23926043557877,-109.3623849
54984,2,21,11,1,4,17,56,38.23926043557877,-109.3621154
54985,2,23,12,0,3,20,60,38.23926043557877,-109.3618459
54986,2,24,13,0,4,19,62,38.23926043557877,-109.3615764
54987,2,24,13,0,4,19,62,38.23926043557877,-109.3613069
54988,0,28,9,1,7,13,58,38.23926043557877,-109.3610374
54989,4,35,6,2,5,8,60,38.23926043557877,-109.3607679
54990,5,39,6,2,7,4,63,38.23926043557877,-109.3604984
54991,6,28,8,5,9,5,61,38.23926043557877,-109.360229
54992,4,31,9,5,8,10,67,38.23926043557877,-109.3599595
54993,1,39,11,1,12,12,76,38.23926043557877,-109.35969
54994,2,42,11,0,12,13,80,38.23926043557877,-109.3594205
54995,1,38,12,0,10,15,76,38.23926043557877,-109.359151
54996,1,31,11,1,6,18,68,38.23926043557877,-109.3588815
54997,0,34,10,2,8,13,67,38.23926043557877,-109.358612
54998,0,43,8,0,11,8,70,38.23926043557877,-109.3583425
54999,1,36,8,3,10,5,63,38.23926043557877,-109.358073
55000,3,32,8,7,7,3,60,38.23926043557877,-109.3578035
55001,3,27,11,7,7,6,61,38.23926043557877,-109.357534
55002,3,20,12,12,8,9,64,38.23926043557877,-109.3572645
55003,12,20,14,19,11,7,83,38.23926043557877,-109.356995
55004,17,17,14,19,13,7,87,38.23926043557877,-109.3567255
55005,3,11,13,9,7,19,62,38.23926043557877,-109.356456
55006,5,23,10,5,11,6,60,38.23926043557877,-109.3561865
55007,3,31,10,4,10,7,65,38.23926043557877,-109.355917
55008,1,33,9,3,9,8,63,38.23926043557877,-109.3556475
55009,1,31,9,4,9,7,61,38.23926043557877,-109.355378
55010,5,28,9,5,11,5,63,38.23926043557877,-109.3551086
55011,8,24,13,18,11,3,77,38.23926043557877,-109.3548391
55012,25,21,13,23,9,1,92,38.23926043557877,-109.3545696
55013,37,16,11,22,6,0,92,38.23926043557877,-109.3543001
55014,38,16,11,19,8,1,93,38.23926043557877,-109.3540306
55015,34,22,11,10,7,2,86,38.23926043557877,-109.3537611
55016,27,22,10,13,8,0,80,38.23926043557877,-109.3534916
55017,34,19,11,16,8,1,89,38.23926043557877,-109.3532221
55018,23,18,10,20,13,1,85,38.23926043557877,-109.3529526
55019,12,21,10,25,16,2,86,38.23926043557877,-109.3526831
55020,2,25,12,18,20,3,80,38.23926043557877,-109.3524136
55021,1,25,11,7,17,7,68,38.23926043557877,-109.3521441
55022,1,33,11,2,16,8,71,38.23926043557877,-109.3518746
55023,3,38,11,2,14,8,76,38.23926043557877,-109.3516051
55024,2,35,12,1,13,11,74,38.23926043557877,-109.3513356
55025,9,44,12,11,15,0,91,38.23899094099353,-109.4068515
55026,12,41,12,11,14,0,90,38.23899094099353,-109.406582
55027,15,38,13,11,14,0,91,38.23899094099353,-109.4063125
55028,17,37,13,11,13,0,91,38.23899094099353,-109.406043
55029,17,37,14,12,12,0,92,38.23899094099353,-109.4057735
55030,16,38,14,13,12,0,93,38.23899094099353,-109.405504
55031,16,37,14,14,12,0,93,38.23899094099353,-109.4052345
55032,15,37,14,14,13,0,93,38.23899094099353,-109.4049651
55033,15,37,14,14,13,0,93,38.23899094099353,-109.4046956
55034,15,37,14,13,13,0,92,38.23899094099353,-109.4044261
55035,15,37,14,14,13,0,93,38.23899094099353,-109.4041566
55036,14,38,14,12,13,0,91,38.23899094099353,-109.4038871
55037,10,39,14,12,14,1,90,38.23899094099353,-109.4036176
55038,9,39,14,12,14,1,89,38.23899094099353,-109.4033481
55039,11,36,14,13,14,0,88,38.23899094099353,-109.4030786
55040,13,38,14,14,13,0,92,38.23899094099353,-109.4028091
55041,12,38,15,15,13,0,93,38.23899094099353,-109.4025396
55042,9,39,15,15,13,0,91,38.23899094099353,-109.4022701
55043,8,41,14,13,14,1,91,38.23899094099353,-109.4020006
55044,9,42,14,12,13,1,91,38.23899094099353,-109.4017311
55045,8,43,14,11,13,1,90,38.23899094099353,-109.4014616
55046,8,45,14,11,14,1,93,38.23899094099353,-109.4011921
55047,9,44,14,12,14,0,93,38.23899094099353,-109.4009226
55048,10,43,14,12,14,0,93,38.23899094099353,-109.4006531
55049,11,43,14,12,14,0,94,38.23899094099353,-109.4003836
55050,10,44,14,12,13,0,93,38.23899094099353,-109.4001142
55051,10,46,14,11,14,0,95,38.23899094099353,-109.3998447
55052,9,48,13,10,15,0,95,38.23899094099353,-109.3995752
55053,8,46,14,10,16,0,94,38.23899094099353,-109.3993057
55054,8,42,14,11,15,1,91,38.23899094099353,-109.3990362
55055,8,42,14,11,14,1,90,38.23899094099353,-109.3987667
55056,7,41,13,10,14,1,86,38.23899094099353,-109.3984972
55057,7,40,13,10,13,1,84,38.23899094099353,-109.3982277
55058,9,40,13,11,13,1,87,38.23899094099353,-109.3979582
55059,12,40,14,12,14,0,92,38.23899094099353,-109.3976887
55060,10,41,14,12,14,1,92,38.23899094099353,-109.3974192
55061,7,41,13,11,14,1,87,38.23899094099353,-109.3971497
55062,5,44,12,10,13,2,86,38.23899094099353,-109.3968802
55063,6,45,12,11,13,2,89,38.23899094099353,-109.3966107
55064,6,46,12,9,14,2,89,38.23899094099353,-109.3963412
55065,6,46,12,9,14,2,89,38.23899094099353,-109.3960717
55066,6,45,12,9,13,2,87,38.23899094099353,-109.3958022
55067,6,44,12,10,13,2,87,38.23899094099353,-109.3955327
55068,7,42,13,13,13,1,89,38.23899094099353,-109.3952632
55069,7,42,13,12,14,1,89,38.23899094099353,-109.3949938
55070,9,42,13,12,14,1,91,38.23899094099353,-109.3947243
55071,9,41,14,14,14,1,93,38.23899094099353,-109.3944548
55072,11,39,14,14,13,0,91,38.23899094099353,-109.3941853
55073,11,40,14,15,13,1,94,38.23899094099353,-109.3939158
55074,9,43,14,13,13,1,93,38.23899094099353,-109.3936463
55075,9,42,14,13,13,1,92,38.23899094099353,-109.3933768
55076,12,39,14,13,13,1,92,38.23899094099353,-109.3931073
55077,15,37,14,13,13,0,92,38.23899094099353,-109.3928378
55078,14,39,14,13,12,0,92,38.23899094099353,-109.3925683
55079,14,39,14,13,12,0,92,38.23899094099353,-109.3922988
55080,13,39,14,13,12,0,91,38.23899094099353,-109.3920293
55081,12,40,15,13,12,0,92,38.23899094099353,-109.3917598
55082,10,41,15,14,12,1,93,38.23899094099353,-109.3914903
55083,13,39,15,13,12,0,92,38.23899094099353,-109.3912208
55084,14,38,14,13,13,0,92,38.23899094099353,-109.3909513
55085,13,37,13,11,14,0,88,38.23899094099353,-109.3906818
55086,12,40,13,10,14,0,89,38.23899094099353,-109.3904123
55087,7,43,13,9,13,1,86,38.23899094099353,-109.3901429
55088,8,39,14,10,12,1,84,38.23899094099353,-109.3898734
55089,10,38,14,11,12,2,87,38.23899094099353,-109.3896039
55090,9,39,15,11,11,2,87,38.23899094099353,-109.3893344
55091,12,39,15,12,11,2,91,38.23899094099353,-109.3890649
55092,16,36,14,10,10,1,87,38.23899094099353,-109.3887954
55093,19,32,12,7,8,1,79,38.23899094099353,-109.3885259
55094,20,30,12,8,7,1,78,38.23899094099353,-109.3882564
55095,21,30,15,11,9,2,88,38.23899094099353,-109.3879869
55096,24,20,14,16,11,4,89,38.23899094099353,-109.3877174
55097,27,23,14,15,10,1,90,38.23899094099353,-109.3874479
55098,22,33,15,12,10,1,93,38.23899094099353,-109.3871784
55099,11,41,14,11,11,2,90,38.23899094099353,-109.3869089
55100,9,40,14,11,11,2,87,38.23899094099353,-109.3866394
55101,13,35,15,13,11,2,89,38.23899094099353,-109.3863699
55102,22,31,15,11,9,2,90,38.23899094099353,-109.3861004
55103,19,35,15,11,9,1,90,38.23899094099353,-109.3858309
55104,10,38,15,12,10,2,87,38.23899094099353,-109.3855614
55105,10,39,15,10,11,2,87,38.23899094099353,-109.3852919
55106,7,42,13,8,12,3,85,38.23899094099353,-109.3850225
55107,6,39,13,8,14,3,83,38.23899094099353,-109.384753
55108,5,38,13,9,16,2,83,38.23899094099353,-109.3844835
55109,3,39,11,6,16,3,78,38.23899094099353,-109.384214
55110,2,42,10,2,17,4,77,38.23899094099353,-109.3839445
55111,2,41,10,2,16,4,75,38.23899094099353,-109.383675
55112,2,38,10,1,12,8,71,38.23899094099353,-109.3834055
55113,3,33,11,1,10,10,68,38.23899094099353,-109.383136
55114,2,33,11,2,11,10,69,38.23899094099353,-109.3828665
55115,5,41,12,6,14,3,81,38.23899094099353,-109.382597
55116,6,42,11,6,16,1,82,38.23899094099353,-109.3823275
55117,5,39,10,5,15,3,77,38.23899094099353,-109.382058
55118,7,34,12,7,13,5,78,38.23899094099353,-109.3817885
55119,11,33,12,10,12,3,81,38.23899094099353,-109.381519
55120,15,32,12,12,13,1,85,38.23899094099353,-109.3812495
55121,16,35,13,12,12,1,89,38.23899094099353,-109.38098
55122,17,36,13,11,11,0,88,38.23899094099353,-109.3807105
55123,21,36,13,9,11,0,90,38.23899094099353,-109.380441
55124,14,32,11,9,9,1,76,38.23899094099353,-109.3801716
55125,6,39,9,13,6,0,73,38.23899094099353,-109.3799021
55126,8,42,8,9,8,1,76,38.23899094099353,-109.3796326
55127,9,45,11,8,12,1,86,38.23899094099353,-109.3793631
55128,10,43,14,8,12,2,89,38.23899094099353,-109.3790936
55129,11,43,14,6,13,2,89,38.23899094099353,-109.3788241
55130,5,47,12,2,12,6,84,38.23899094099353,-109.3785546
55131,3,46,11,2,11,8,81,38.23899094099353,-109.3782851
55132,3,41,12,3,12,8,79,38.23899094099353,-109.3780156
55133,3,40,12,3,12,9,79,38.23899094099353,-109.3777461
55134,4,43,12,5,13,6,83,38.23899094099353,-109.3774766
55135,3,44,11,3,12,7,80,38.23899094099353,-109.3772071
55136,3,41,10,3,11,8,76,38.23899094099353,-109.3769376
55137,3,39,10,4,12,6,74,38.23899094099353,-109.3766681
55138,2,38,9,5,13,5,72,38.23899094099353,-109.3763986
55139,2,36,10,3,11,8,70,38.23899094099353,-109.3761291
55140,2,40,10,3,12,7,74,38.23899094099353,-109.3758596
55141,3,48,10,4,15,3,83,38.23899094099353,-109.3755901
55142,1,57,8,2,12,4,84,38.23899094099353,-109.3753206
55143,1,51,9,2,11,7,81,38.23899094099353,-109.3750512
55144,2,44,11,1,13,8,79,38.23899094099353,-109.3747817
55145,2,45,9,2,12,6,76,38.23899094099353,-109.3745122
55146,2,46,9,2,12,5,76,38.23899094099353,-109.3742427
55147,3,40,12,3,13,8,79,38.23899094099353,-109.3739732
55148,3,40,11,1,11,10,76,38.23899094099353,-109.3737037
55149,2,44,10,1,12,8,77,38.23899094099353,-109.3734342
55150,2,45,10,1,14,6,78,38.23899094099353,-109.3731647
55151,2,44,10,1,14,6,77,38.23899094099353,-109.3728952
55152,2,42,10,1,12,7,74,38.23899094099353,-109.3726257
55153,2,42,10,1,12,8,75,38.23899094099353,-109.3723562
55154,2,39,11,1,12,9,74,38.23899094099353,-109.3720867
55155,2,32,11,0,10,12,67,38.23899094099353,-109.3718172
55156,1,32,11,0,9,15,68,38.23899094099353,-109.3715477
55157,4,36,12,1,11,10,74,38.23899094099353,-109.3712782
55158,4,39,12,3,12,9,79,38.23899094099353,-109.3710087
55159,5,41,13,5,13,7,84,38.23899094099353,-109.3707392
55160,5,40,13,5,12,7,82,38.23899094099353,-109.3704697
55161,5,38,12,4,10,10,79,38.23899094099353,-109.3702003
55162,4,42,11,2,12,8,79,38.23899094099353,-109.3699308
55163,2,38,10,1,12,9,72,38.23899094099353,-109.3696613
55164,2,33,10,1,11,10,67,38.23899094099353,-109.3693918
55165,7,31,14,3,5,14,74,38.23899094099353,-109.3691223
55166,7,32,13,5,7,12,76,38.23899094099353,-109.3688528
55167,5,31,12,3,14,8,73,38.23899094099353,-109.3685833
55168,3,23,11,4,17,4,62,38.23899094099353,-109.3683138
55169,3,24,11,11,15,2,66,38.23899094099353,-109.3680443
55170,1,23,10,9,17,3,63,38.23899094099353,-109.3677748
55171,2,27,11,1,8,14,63,38.23899094099353,-109.3675053
55172,4,25,11,6,3,11,60,38.23899094099353,-109.3672358
55173,4,29,7,3,5,8,56,38.23899094099353,-109.3669663
55174,2,30,5,3,7,5,52,38.23899094099353,-109.3666968
55175,5,27,5,3,9,4,53,38.23899094099353,-109.3664273
55176,4,30,7,4,8,6,59,38.23899094099353,-109.3661578
55177,4,35,10,3,7,10,69,38.23899094099353,-109.3658883
55178,3,42,12,1,9,12,79,38.23899094099353,-109.3656188
55179,1,45,10,0,11,10,77,38.23899094099353,-109.3653493
55180,4,45,11,2,10,8,80,38.23899094099353,-109.3650799
55181,5,38,13,3,9,11,79,38.23899094099353,-109.3648104
55182,4,33,12,1,6,14,70,38.23899094099353,-109.3645409
55183,4,34,11,0,6,15,70,38.23899094099353,-109.3642714
55184,4,31,12,0,3,16,66,38.23899094099353,-109.3640019
55185,5,23,13,1,1,19,62,38.23899094099353,-109.3637324
55186,5,22,13,2,2,20,64,38.23899094099353,-109.3634629
55187,9,28,14,6,4,14,75,38.23899094099353,-109.3631934
55188,8,26,14,10,5,8,71,38.23899094099353,-109.3629239
55189,8,26,10,13,7,3,67,38.23899094099353,-109.3626544
55190,2,18,9,9,11,3,52,38.23899094099353,-109.3623849
55191,4,18,11,6,6,9,54,38.23899094099353,-109.3621154
55192,2,21,13,1,4,17,58,38.23899094099353,-109.3618459
55193,1,20,13,2,4,18,58,38.23899094099353,-109.3615764
55194,1,25,12,3,5,15,61,38.23899094099353,-109.3613069
55195,4,34,6,4,7,5,60,38.23899094099353,-109.3610374
55196,2,36,5,2,8,4,57,38.23899094099353,-109.3607679
55197,2,33,6,1,7,7,56,38.23899094099353,-109.3604984
55198,3,34,7,3,9,6,62,38.23899094099353,-109.360229
55199,1,38,8,2,9,10,68,38.23899094099353,-109.3599595
55200,1,41,10,2,11,9,74,38.23899094099353,-109.35969
55201,1,45,10,1,12,9,78,38.23899094099353,-109.3594205
55202,1,43,10,0,11,11,76,38.23899094099353,-109.359151
55203,0,35,10,0,8,15,68,38.23899094099353,-109.3588815
55204,0,40,9,0,10,12,71,38.23899094099353,-109.358612
55205,0,43,8,1,12,6,70,38.23899094099353,-109.3583425
55206,2,35,8,4,10,4,63,38.23899094099353,-109.358073
55207,2,31,8,6,6,6,59,38.23899094099353,-109.3578035
55208,3,28,10,6,8,6,61,38.23899094099353,-109.357534
55209,3,24,12,10,10,7,66,38.23899094099353,-109.3572645
55210,8,23,13,16,11,6,77,38.23899094099353,-109.356995
55211,17,21,14,16,12,7,87,38.23899094099353,-109.3567255
55212,16,17,14,14,11,9,81,38.23899094099353,-109.356456
55213,7,17,12,11,11,8,66,38.23899094099353,-109.3561865
55214,3,24,12,5,10,10,64,38.23899094099353,-109.355917
55215,1,30,10,3,8,10,62,38.23899094099353,-109.3556475
55216,4,28,10,6,11,6,65,38.23899094099353,-109.355378
55217,8,24,12,13,12,4,73,38.23899094099353,-109.3551086
55218,21,26,14,20,11,1,93,38.23899094099353,-109.3548391
55219,28,20,11,22,8,1,90,38.23899094099353,-109.3545696
55220,34,18,11,19,8,1,91,38.23899094099353,-109.3543001
55221,33,17,12,16,10,3,91,38.23899094099353,-109.3540306
55222,36,20,12,14,9,3,94,38.23899094099353,-109.3537611
55223,38,18,10,15,10,1,92,38.23899094099353,-109.3534916
55224,28,17,9,19,15,2,90,38.23899094099353,-109.3532221
55225,8,21,10,25,17,4,85,38.23899094099353,-109.3529526
55226,4,29,12,9,18,7,79,38.23899094099353,-109.3526831
55227,1,26,11,7,15,9,69,38.23899094099353,-109.3524136
55228,0,28,12,3,16,11,70,38.23899094099353,-109.3521441
55229,1,33,12,0,17,11,74,38.23899094099353,-109.3518746
55230,2,36,13,0,15,13,79,38.23899094099353,-109.3516051
55231,1,35,12,0,13,15,76,38.23899094099353,-109.3513356
55232,15,39,13,12,13,0,92,38.23872145,-109.4068515
55233,17,38,13,13,12,0,93,38.23872145,-109.406582
55234,18,37,13,12,12,0,92,38.23872145,-109.4063125
55235,17,38,13,12,12,0,92,38.23872145,-109.406043
55236,15,39,13,12,12,0,91,38.23872145,-109.4057735
55237,14,39,13,14,13,0,93,38.23872145,-109.405504
55238,15,37,14,15,13,0,94,38.23872145,-109.4052345
55239,15,37,14,14,13,0,93,38.23872145,-109.4049651
55240,15,38,14,12,12,0,91,38.23872145,-109.4046956
55241,15,38,14,13,13,0,93,38.23872145,-109.4044261
55242,13,38,15,15,13,0,94,38.23872145,-109.4041566
55243,14,37,14,13,13,0,91,38.23872145,-109.4038871
55244,12,38,14,13,14,0,91,38.23872145,-109.4036176
55245,11,37,14,13,15,0,90,38.23872145,-109.4033481
55246,14,36,14,12,15,0,91,38.23872145,-109.4030786
55247,14,38,14,11,14,0,91,38.23872145,-109.4028091
55248,11,37,14,14,14,0,90,38.23872145,-109.4025396
55249,11,39,15,14,14,0,93,38.23872145,-109.4022701
55250,10,41,14,13,14,0,92,38.23872145,-109.4020006
55251,9,42,15,13,13,1,93,38.23872145,-109.4017311
55252,9,42,14,13,13,1,92,38.23872145,-109.4014616
55253,10,41,14,13,13,1,92,38.23872145,-109.4011921
55254,10,40,15,13,13,1,92,38.23872145,-109.4009226
55255,10,41,14,13,13,1,92,38.23872145,-109.4006531
55256,10,41,14,13,13,1,92,38.23872145,-109.4003836
55257,10,43,14,12,13,0,92,38.23872145,-109.4001142
55258,9,45,14,12,14,0,94,38.23872145,-109.3998447
55259,9,45,14,11,15,0,94,38.23872145,-109.3995752
55260,10,44,14,11,14,0,93,38.23872145,-109.3993057
55261,9,43,14,11,14,1,92,38.23872145,-109.3990362
55262,9,42,14,10,13,1,89,38.23872145,-109.3987667
55263,8,42,13,10,14,1,88,38.23872145,-109.3984972
55264,7,40,13,11,14,1,86,38.23872145,-109.3982277
55265,9,39,14,13,14,1,90,38.23872145,-109.3979582
55266,10,39,14,13,14,0,90,38.23872145,-109.3976887
55267,6,41,14,11,14,1,87,38.23872145,-109.3974192
55268,4,44,13,9,14,2,86,38.23872145,-109.3971497
55269,4,45,12,9,13,2,85,38.23872145,-109.3968802
55270,6,43,13,12,13,2,89,38.23872145,-109.3966107
55271,7,45,12,11,14,1,90,38.23872145,-109.3963412
55272,4,49,12,8,14,2,89,38.23872145,-109.3960717
55273,4,47,11,8,11,4,85,38.23872145,-109.3958022
55274,5,44,12,9,12,3,85,38.23872145,-109.3955327
55275,7,42,13,12,14,1,89,38.23872145,-109.3952632
55276,9,43,13,13,14,1,93,38.23872145,-109.3949938
55277,11,42,13,13,13,0,92,38.23872145,-109.3947243
55278,11,41,14,13,13,1,93,38.23872145,-109.3944548
55279,12,40,14,14,13,1,94,38.23872145,-109.3941853
55280,11,40,14,14,12,1,92,38.23872145,-109.3939158
55281,10,41,14,13,13,1,92,38.23872145,-109.3936463
55282,11,40,14,13,12,1,91,38.23872145,-109.3933768
55283,14,38,14,14,12,0,92,38.23872145,-109.3931073
55284,15,36,14,14,12,0,91,38.23872145,-109.3928378
55285,13,38,14,14,12,1,92,38.23872145,-109.3925683
55286,12,39,14,13,12,0,90,38.23872145,-109.3922988
55287,10,41,14,14,12,0,91,38.23872145,-109.3920293
55288,8,42,14,14,12,1,91,38.23872145,-109.3917598
55289,9,41,14,13,12,1,90,38.23872145,-109.3914903
55290,13,37,15,14,12,0,91,38.23872145,-109.3912208
55291,15,35,13,13,13,0,89,38.23872145,-109.3909513
55292,14,34,12,11,14,1,86,38.23872145,-109.3906818
55293,12,38,13,11,14,1,89,38.23872145,-109.3904123
55294,8,44,13,8,12,2,87,38.23872145,-109.3901429
55295,9,42,14,9,12,1,87,38.23872145,-109.3898734
55296,10,41,14,9,11,1,86,38.23872145,-109.3896039
55297,9,40,14,10,11,2,86,38.23872145,-109.3893344
55298,9,39,15,12,11,2,88,38.23872145,-109.3890649
55299,13,38,15,12,10,2,90,38.23872145,-109.3887954
55300,18,33,13,8,8,1,81,38.23872145,-109.3885259
55301,20,32,12,9,7,1,81,38.23872145,-109.3882564
55302,21,32,15,11,8,2,89,38.23872145,-109.3879869
55303,27,25,14,13,9,2,90,38.23872145,-109.3877174
55304,31,26,14,12,7,1,91,38.23872145,-109.3874479
55305,25,31,14,10,8,1,89,38.23872145,-109.3871784
55306,18,36,15,11,9,1,90,38.23872145,-109.3869089
55307,20,35,15,11,10,1,92,38.23872145,-109.3866394
55308,26,31,14,11,8,1,91,38.23872145,-109.3863699
55309,25,33,15,10,8,1,92,38.23872145,-109.3861004
55310,14,37,16,12,10,2,91,38.23872145,-109.3858309
55311,10,36,16,12,10,3,87,38.23872145,-109.3855614
55312,10,37,15,11,11,2,86,38.23872145,-109.3852919
55313,9,39,14,9,12,3,86,38.23872145,-109.3850225
55314,7,35,12,7,13,5,79,38.23872145,-109.384753
55315,5,36,11,4,14,5,75,38.23872145,-109.3844835
55316,4,43,10,3,15,3,78,38.23872145,-109.384214
55317,5,41,11,4,17,2,80,38.23872145,-109.3839445
55318,3,38,11,2,16,5,75,38.23872145,-109.383675
55319,3,38,11,3,15,6,76,38.23872145,-109.3834055
55320,4,43,11,3,14,5,80,38.23872145,-109.383136
55321,4,49,11,3,14,4,85,38.23872145,-109.3828665
55322,5,41,12,6,14,3,81,38.23872145,-109.382597
55323,7,42,11,8,15,1,84,38.23872145,-109.3823275
55324,7,41,10,8,15,1,82,38.23872145,-109.382058
55325,8,40,10,7,15,1,81,38.23872145,-109.3817885
55326,8,40,11,6,14,1,80,38.23872145,-109.381519
55327,11,39,12,9,15,1,87,38.23872145,-109.3812495
55328,19,38,13,9,12,0,91,38.23872145,-109.38098
55329,27,34,13,8,9,0,91,38.23872145,-109.3807105
55330,33,29,14,8,8,0,92,38.23872145,-109.380441
55331,20,34,12,8,10,1,85,38.23872145,-109.3801716
55332,8,35,9,11,7,0,70,38.23872145,-109.3799021
55333,6,40,8,8,8,2,72,38.23872145,-109.3796326
55334,7,45,10,7,12,2,83,38.23872145,-109.3793631
55335,9,44,13,8,10,3,87,38.23872145,-109.3790936
55336,14,41,14,8,12,2,91,38.23872145,-109.3788241
55337,10,39,14,6,11,5,85,38.23872145,-109.3785546
55338,7,40,13,4,11,7,82,38.23872145,-109.3782851
55339,7,43,13,5,11,6,85,38.23872145,-109.3780156
55340,5,43,13,3,12,7,83,38.23872145,-109.3777461
55341,4,46,12,4,13,5,84,38.23872145,-109.3774766
55342,5,46,12,6,13,3,85,38.23872145,-109.3772071
55343,7,40,12,5,12,6,82,38.23872145,-109.3769376
55344,5,33,12,5,10,9,74,38.23872145,-109.3766681
55345,3,37,11,5,11,8,75,38.23872145,-109.3763986
55346,2,41,9,3,12,6,73,38.23872145,-109.3761291
55347,2,44,9,2,13,6,76,38.23872145,-109.3758596
55348,2,47,10,2,15,4,80,38.23872145,-109.3755901
55349,1,55,8,1,13,4,82,38.23872145,-109.3753206
55350,3,45,10,3,12,7,80,38.23872145,-109.3750512
55351,3,35,12,0,10,11,71,38.23872145,-109.3747817
55352,1,38,10,2,13,7,71,38.23872145,-109.3745122
55353,1,41,9,3,12,5,71,38.23872145,-109.3742427
55354,3,41,12,0,10,10,76,38.23872145,-109.3739732
55355,2,36,10,1,10,12,71,38.23872145,-109.3737037
55356,2,39,10,1,11,9,72,38.23872145,-109.3734342
55357,1,44,9,0,14,6,74,38.23872145,-109.3731647
55358,1,47,9,0,13,6,76,38.23872145,-109.3728952
55359,1,47,9,1,14,5,77,38.23872145,-109.3726257
55360,2,41,11,1,12,9,76,38.23872145,-109.3723562
55361,3,32,11,0,9,13,68,38.23872145,-109.3720867
55362,3,33,11,0,9,13,69,38.23872145,-109.3718172
55363,2,35,11,0,11,11,70,38.23872145,-109.3715477
55364,5,43,12,4,14,4,82,38.23872145,-109.3712782
55365,6,45,13,7,14,3,88,38.23872145,-109.3710087
55366,8,43,13,8,13,2,87,38.23872145,-109.3707392
55367,8,42,13,7,13,2,85,38.23872145,-109.3704697
55368,6,42,11,6,12,3,80,38.23872145,-109.3702003
55369,4,41,10,2,13,7,77,38.23872145,-109.3699308
55370,2,32,11,0,9,14,68,38.23872145,-109.3696613
55371,2,28,12,0,7,20,69,38.23872145,-109.3693918
55372,4,29,14,4,4,22,77,38.23872145,-109.3691223
55373,3,31,13,2,15,15,79,38.23872145,-109.3688528
55374,4,26,12,7,18,4,71,38.23872145,-109.3685833
55375,3,28,10,8,19,2,70,38.23872145,-109.3683138
55376,1,25,10,9,17,1,63,38.23872145,-109.3680443
55377,5,19,11,14,9,2,60,38.23872145,-109.3677748
55378,2,37,7,6,6,4,62,38.23872145,-109.3675053
55379,2,38,6,6,8,3,63,38.23872145,-109.3672358
55380,1,40,5,4,8,3,61,38.23872145,-109.3669663
55381,1,34,4,3,8,4,54,38.23872145,-109.3666968
55382,3,27,6,2,8,5,51,38.23872145,-109.3664273
55383,2,31,7,3,8,8,59,38.23872145,-109.3661578
55384,4,30,10,3,6,10,63,38.23872145,-109.3658883
55385,2,43,11,1,10,10,77,38.23872145,-109.3656188
55386,2,48,10,1,11,8,80,38.23872145,-109.3653493
55387,4,45,11,6,10,6,82,38.23872145,-109.3650799
55388,5,38,13,2,8,12,78,38.23872145,-109.3648104
55389,4,30,13,2,6,17,72,38.23872145,-109.3645409
55390,2,31,12,0,4,19,68,38.23872145,-109.3642714
55391,2,32,11,0,4,16,65,38.23872145,-109.3640019
55392,3,29,10,4,8,10,64,38.23872145,-109.3637324
55393,2,26,10,3,6,13,60,38.23872145,-109.3634629
55394,8,28,12,10,7,9,74,38.23872145,-109.3631934
55395,5,30,10,10,7,4,66,38.23872145,-109.3629239
55396,4,28,7,7,8,3,57,38.23872145,-109.3626544
55397,6,32,8,10,8,3,67,38.23872145,-109.3623849
55398,3,19,10,8,8,6,54,38.23872145,-109.3621154
55399,3,16,11,5,5,13,53,38.23872145,-109.3618459
55400,2,19,9,5,5,12,52,38.23872145,-109.3615764
55401,6,29,7,2,6,6,56,38.23872145,-109.3613069
55402,0,34,5,3,7,4,53,38.23872145,-109.3610374
55403,1,31,4,2,8,4,50,38.23872145,-109.3607679
55404,3,31,6,4,8,5,57,38.23872145,-109.3604984
55405,4,39,7,2,8,7,67,38.23872145,-109.360229
55406,1,38,7,2,9,9,66,38.23872145,-109.3599595
55407,1,41,9,3,11,6,71,38.23872145,-109.35969
55408,1,40,9,3,12,6,71,38.23872145,-109.3594205
55409,1,39,10,2,11,8,71,38.23872145,-109.359151
55410,1,38,10,0,8,12,69,38.23872145,-109.3588815
55411,0,39,9,0,10,11,69,38.23872145,-109.358612
55412,2,39,9,6,11,4,71,38.23872145,-109.3583425
55413,3,33,8,4,10,4,62,38.23872145,-109.358073
55414,2,32,8,5,6,5,58,38.23872145,-109.3578035
55415,5,32,9,6,9,4,65,38.23872145,-109.357534
55416,3,29,9,5,10,7,63,38.23872145,-109.3572645
55417,3,23,13,8,9,10,66,38.23872145,-109.356995
55418,10,22,14,12,10,9,77,38.23872145,-109.3567255
55419,24,20,13,15,11,6,89,38.23872145,-109.356456
55420,17,18,14,17,10,7,83,38.23872145,-109.3561865
55421,5,18,12,8,8,11,62,38.23872145,-109.355917
55422,3,26,10,5,8,9,61,38.23872145,-109.3556475
55423,6,26,12,12,11,5,72,38.23872145,-109.355378
55424,19,27,14,19,11,1,91,38.23872145,-109.3551086
55425,30,23,12,21,8,0,94,38.23872145,-109.3548391
55426,29,19,11,20,10,1,90,38.23872145,-109.3545696
55427,31,16,11,17,8,1,84,38.23872145,-109.3543001
55428,30,17,11,17,8,1,84,38.23872145,-109.3540306
55429,37,18,11,13,10,2,91,38.23872145,-109.3537611
55430,35,16,9,16,13,3,92,38.23872145,-109.3534916
55431,17,17,11,19,19,5,88,38.23872145,-109.3532221
55432,3,25,12,13,17,9,79,38.23872145,-109.3529526
55433,0,33,12,4,21,9,79,38.23872145,-109.3526831
55434,0,29,13,2,15,14,73,38.23872145,-109.3524136
55435,0,30,13,0,14,15,72,38.23872145,-109.3521441
55436,0,32,12,0,15,14,73,38.23872145,-109.3518746
55437,0,34,12,0,15,13,74,38.23872145,-109.3516051
55438,1,34,13,0,12,17,77,38.23872145,-109.3513356
55439,19,36,13,11,12,0,91,38.238451951823066,-109.4068515
55440,18,36,14,13,12,0,93,38.238451951823066,-109.406582
55441,18,36,14,12,12,0,92,38.238451951823066,-109.4063125
55442,17,38,13,12,12,0,92,38.238451951823066,-109.406043
55443,15,38,14,13,12,0,92,38.238451951823066,-109.4057735
55444,15,37,14,14,13,0,93,38.238451951823066,-109.405504
55445,15,37,14,13,12,0,91,38.238451951823066,-109.4052345
55446,15,37,14,13,13,0,92,38.238451951823066,-109.4049651
55447,14,39,14,12,13,0,92,38.238451951823066,-109.4046956
55448,13,40,14,12,13,0,92,38.238451951823066,-109.4044261
55449,12,39,15,15,12,0,93,38.238451951823066,-109.4041566
55450,14,39,14,12,13,0,92,38.238451951823066,-109.4038871
55451,14,38,14,12,14,0,92,38.238451951823066,-109.4036176
55452,13,37,14,12,14,0,90,38.238451951823066,-109.4033481
55453,14,38,14,12,14,0,92,38.238451951823066,-109.4030786
55454,12,40,14,11,13,0,90,38.238451951823066,-109.4028091
55455,12,40,14,11,14,0,91,38.238451951823066,-109.4025396
55456,14,38,14,12,14,0,92,38.238451951823066,-109.4022701
55457,14,39,14,12,13,0,92,38.238451951823066,-109.4020006
55458,11,42,15,13,13,0,94,38.238451951823066,-109.4017311
55459,10,42,14,13,14,0,93,38.238451951823066,-109.4014616
55460,11,41,14,13,13,0,92,38.238451951823066,-109.4011921
55461,12,41,14,13,13,0,93,38.238451951823066,-109.4009226
55462,11,42,14,12,13,0,92,38.238451951823066,-109.4006531
55463,10,45,14,11,14,0,94,38.238451951823066,-109.4003836
55464,9,44,14,11,14,0,92,38.238451951823066,-109.4001142
55465,10,42,14,12,14,0,92,38.238451951823066,-109.3998447
55466,12,40,14,12,14,0,92,38.238451951823066,-109.3995752
55467,13,40,14,12,13,0,92,38.238451951823066,-109.3993057
55468,11,40,15,13,14,0,93,38.238451951823066,-109.3990362
55469,10,41,14,13,14,0,92,38.238451951823066,-109.3987667
55470,9,41,14,12,14,1,91,38.238451951823066,-109.3984972
55471,9,41,14,12,14,1,91,38.238451951823066,-109.3982277
55472,9,41,14,13,15,1,93,38.238451951823066,-109.3979582
55473,7,40,14,13,15,1,90,38.238451951823066,-109.3976887
55474,5,41,14,12,14,1,87,38.238451951823066,-109.3974192
55475,4,43,13,10,14,2,86,38.238451951823066,-109.3971497
55476,4,45,12,10,13,2,86,38.238451951823066,-109.3968802
55477,6,43,13,11,13,1,87,38.238451951823066,-109.3966107
55478,5,45,13,10,14,2,89,38.238451951823066,-109.3963412
55479,4,49,12,9,13,2,89,38.238451951823066,-109.3960717
55480,4,49,11,7,12,4,87,38.238451951823066,-109.3958022
55481,4,48,11,8,12,3,86,38.238451951823066,-109.3955327
55482,8,43,13,12,14,1,91,38.238451951823066,-109.3952632
55483,10,42,14,13,14,1,94,38.238451951823066,-109.3949938
55484,11,41,14,13,14,0,93,38.238451951823066,-109.3947243
55485,11,40,14,14,14,0,93,38.238451951823066,-109.3944548
55486,11,40,14,14,14,1,94,38.238451951823066,-109.3941853
55487,10,42,13,13,13,1,92,38.238451951823066,-109.3939158
55488,11,41,14,13,13,1,93,38.238451951823066,-109.3936463
55489,12,40,14,13,13,1,93,38.238451951823066,-109.3933768
55490,14,39,15,13,12,1,94,38.238451951823066,-109.3931073
55491,15,37,14,13,12,0,91,38.238451951823066,-109.3928378
55492,15,36,14,14,12,0,91,38.238451951823066,-109.3925683
55493,11,39,14,14,12,1,91,38.238451951823066,-109.3922988
55494,8,41,13,13,13,1,89,38.238451951823066,-109.3920293
55495,6,43,14,12,13,1,89,38.238451951823066,-109.3917598
55496,7,42,14,12,13,1,89,38.238451951823066,-109.3914903
55497,12,38,15,14,12,0,91,38.238451951823066,-109.3912208
55498,14,36,13,13,13,0,89,38.238451951823066,-109.3909513
55499,15,34,13,12,13,0,87,38.238451951823066,-109.3906818
55500,14,37,13,12,13,0,89,38.238451951823066,-109.3904123
55501,8,41,14,11,12,1,87,38.238451951823066,-109.3901429
55502,9,40,14,11,12,1,87,38.238451951823066,-109.3898734
55503,9,41,14,10,11,2,87,38.238451951823066,-109.3896039
55504,9,40,14,10,11,2,86,38.238451951823066,-109.3893344
55505,9,41,15,11,11,2,89,38.238451951823066,-109.3890649
55506,12,40,16,12,11,2,93,38.238451951823066,-109.3887954
55507,17,35,13,8,8,1,82,38.238451951823066,-109.3885259
55508,20,32,12,9,7,1,81,38.238451951823066,-109.3882564
55509,21,32,13,10,8,2,86,38.238451951823066,-109.3879869
55510,27,28,11,9,6,1,82,38.238451951823066,-109.3877174
55511,30,27,11,9,6,1,84,38.238451951823066,-109.3874479
55512,32,27,12,9,6,1,87,38.238451951823066,-109.3871784
55513,32,28,13,11,6,1,91,38.238451951823066,-109.3869089
55514,30,30,14,11,7,1,93,38.238451951823066,-109.3866394
55515,25,33,14,11,7,1,91,38.238451951823066,-109.3863699
55516,22,34,14,10,7,1,88,38.238451951823066,-109.3861004
55517,15,38,15,12,9,2,91,38.238451951823066,-109.3858309
55518,12,39,16,12,11,2,92,38.238451951823066,-109.3855614
55519,11,40,15,11,12,1,90,38.238451951823066,-109.3852919
55520,10,39,13,9,12,2,85,38.238451951823066,-109.3850225
55521,6,36,12,5,13,6,78,38.238451951823066,-109.384753
55522,4,33,12,3,11,10,73,38.238451951823066,-109.3844835
55523,5,36,12,4,12,7,76,38.238451951823066,-109.384214
55524,6,37,12,7,14,4,80,38.238451951823066,-109.3839445
55525,5,42,11,4,16,3,81,38.238451951823066,-109.383675
55526,3,43,11,3,17,3,80,38.238451951823066,-109.3834055
55527,3,45,10,3,16,3,80,38.238451951823066,-109.383136
55528,4,47,10,3,14,4,82,38.238451951823066,-109.3828665
55529,4,43,10,4,13,5,79,38.238451951823066,-109.382597
55530,5,40,10,5,12,4,76,38.238451951823066,-109.3823275
55531,5,38,9,5,12,4,73,38.238451951823066,-109.382058
55532,7,40,9,6,13,2,77,38.238451951823066,-109.3817885
55533,10,40,9,7,12,1,79,38.238451951823066,-109.381519
55534,15,36,12,8,12,1,84,38.238451951823066,-109.3812495
55535,20,38,13,9,10,0,90,38.238451951823066,-109.38098
55536,26,36,14,8,9,0,93,38.238451951823066,-109.3807105
55537,28,34,14,8,8,0,92,38.238451951823066,-109.380441
55538,18,38,12,8,11,1,88,38.238451951823066,-109.3801716
55539,8,29,9,10,7,2,65,38.238451951823066,-109.3799021
55540,7,35,9,9,8,2,70,38.238451951823066,-109.3796326
55541,10,43,9,6,12,2,82,38.238451951823066,-109.3793631
55542,7,41,11,6,10,4,79,38.238451951823066,-109.3790936
55543,14,39,13,8,10,2,86,38.238451951823066,-109.3788241
55544,14,37,14,9,10,2,86,38.238451951823066,-109.3785546
55545,12,39,15,9,10,2,87,38.238451951823066,-109.3782851
55546,10,43,15,9,10,2,89,38.238451951823066,-109.3780156
55547,10,42,15,9,10,2,88,38.238451951823066,-109.3777461
55548,8,43,15,9,11,3,89,38.238451951823066,-109.3774766
55549,6,45,13,6,12,4,86,38.238451951823066,-109.3772071
55550,5,45,12,5,12,5,84,38.238451951823066,-109.3769376
55551,4,43,11,4,13,6,81,38.238451951823066,-109.3766681
55552,3,43,10,2,13,7,78,38.238451951823066,-109.3763986
55553,3,42,10,5,14,4,78,38.238451951823066,-109.3761291
55554,3,41,10,4,13,5,76,38.238451951823066,-109.3758596
55555,2,42,11,2,12,8,77,38.238451951823066,-109.3755901
55556,2,46,10,1,13,7,79,38.238451951823066,-109.3753206
55557,3,38,10,1,12,8,72,38.238451951823066,-109.3750512
55558,2,29,11,0,6,15,63,38.238451951823066,-109.3747817
55559,2,36,11,3,13,6,71,38.238451951823066,-109.3745122
55560,2,45,10,4,13,3,77,38.238451951823066,-109.3742427
55561,1,41,10,0,10,10,72,38.238451951823066,-109.3739732
55562,2,36,10,1,10,11,70,38.238451951823066,-109.3737037
55563,1,39,10,1,10,10,71,38.238451951823066,-109.3734342
55564,1,41,10,1,14,7,74,38.238451951823066,-109.3731647
55565,2,44,10,3,15,4,78,38.238451951823066,-109.3728952
55566,2,42,11,3,15,6,79,38.238451951823066,-109.3726257
55567,3,33,13,3,10,13,75,38.238451951823066,-109.3723562
55568,3,34,13,1,10,16,77,38.238451951823066,-109.3720867
55569,2,35,12,0,9,15,73,38.238451951823066,-109.3718172
55570,3,39,11,0,12,10,75,38.238451951823066,-109.3715477
55571,6,43,13,5,14,4,85,38.238451951823066,-109.3712782
55572,6,46,13,7,14,2,88,38.238451951823066,-109.3710087
55573,6,46,12,7,13,2,86,38.238451951823066,-109.3707392
55574,4,45,11,6,13,4,83,38.238451951823066,-109.3704697
55575,4,41,10,4,12,6,77,38.238451951823066,-109.3702003
55576,3,34,10,0,10,13,70,38.238451951823066,-109.3699308
55577,2,26,13,0,6,22,69,38.238451951823066,-109.3696613
55578,2,28,14,0,7,25,76,38.238451951823066,-109.3693918
55579,2,28,15,3,10,21,79,38.238451951823066,-109.3691223
55580,1,30,14,7,14,14,80,38.238451951823066,-109.3688528
55581,3,24,12,13,18,4,74,38.238451951823066,-109.3685833
55582,0,20,10,14,15,2,61,38.238451951823066,-109.3683138
55583,2,28,10,12,8,3,63,38.238451951823066,-109.3680443
55584,2,39,7,5,8,4,65,38.238451951823066,-109.3677748
55585,2,42,6,5,8,3,66,38.238451951823066,-109.3675053
55586,2,46,6,4,8,3,69,38.238451951823066,-109.3672358
55587,2,43,6,3,7,4,65,38.238451951823066,-109.3669663
55588,2,39,5,2,7,4,59,38.238451951823066,-109.3666968
55589,2,36,6,3,8,4,59,38.238451951823066,-109.3664273
55590,2,35,7,4,9,6,63,38.238451951823066,-109.3661578
55591,4,34,10,3,7,9,67,38.238451951823066,-109.3658883
55592,3,47,11,0,13,7,81,38.238451951823066,-109.3656188
55593,2,50,11,1,12,6,82,38.238451951823066,-109.3653493
55594,3,47,10,2,10,8,80,38.238451951823066,-109.3650799
55595,4,35,12,2,9,13,75,38.238451951823066,-109.3648104
55596,5,33,13,2,7,15,75,38.238451951823066,-109.3645409
55597,4,35,13,0,6,16,74,38.238451951823066,-109.3642714
55598,3,33,12,0,5,17,70,38.238451951823066,-109.3640019
55599,3,27,11,2,5,14,62,38.238451951823066,-109.3637324
55600,5,26,10,3,6,12,62,38.238451951823066,-109.3634629
55601,2,28,10,4,9,9,62,38.238451951823066,-109.3631934
55602,3,32,10,5,10,7,67,38.238451951823066,-109.3629239
55603,3,32,9,4,10,5,63,38.238451951823066,-109.3626544
55604,3,29,8,7,9,3,59,38.238451951823066,-109.3623849
55605,2,29,9,7,8,4,59,38.238451951823066,-109.3621154
55606,4,36,8,7,5,4,64,38.238451951823066,-109.3618459
55607,3,38,6,5,8,3,63,38.238451951823066,-109.3615764
55608,2,44,5,5,7,2,65,38.238451951823066,-109.3613069
55609,1,36,4,2,8,3,54,38.238451951823066,-109.3610374
55610,2,33,6,4,8,4,57,38.238451951823066,-109.3607679
55611,2,34,7,4,9,6,62,38.238451951823066,-109.3604984
55612,2,44,7,3,8,6,70,38.238451951823066,-109.360229
55613,1,32,9,2,8,9,61,38.238451951823066,-109.3599595
55614,3,35,9,3,9,7,66,38.238451951823066,-109.35969
55615,1,31,9,2,7,11,61,38.238451951823066,-109.3594205
55616,2,30,10,1,5,15,63,38.238451951823066,-109.359151
55617,1,33,11,0,5,15,65,38.238451951823066,-109.3588815
55618,1,40,9,0,10,11,71,38.238451951823066,-109.358612
55619,4,37,8,5,11,3,68,38.238451951823066,-109.3583425
55620,3,33,7,4,10,4,61,38.238451951823066,-109.358073
55621,2,32,8,4,6,6,58,38.238451951823066,-109.3578035
55622,5,33,8,5,10,5,66,38.238451951823066,-109.357534
55623,2,29,9,4,9,8,61,38.238451951823066,-109.3572645
55624,1,26,10,4,8,12,61,38.238451951823066,-109.356995
55625,3,21,13,8,7,14,66,38.238451951823066,-109.3567255
55626,16,22,14,11,8,10,81,38.238451951823066,-109.356456
55627,30,21,11,16,10,3,91,38.238451951823066,-109.3561865
55628,19,22,14,13,9,6,83,38.238451951823066,-109.355917
55629,13,24,13,15,9,5,79,38.238451951823066,-109.3556475
55630,21,27,15,17,10,1,91,38.238451951823066,-109.355378
55631,29,24,13,18,9,1,94,38.238451951823066,-109.3551086
55632,32,22,11,20,8,1,94,38.238451951823066,-109.3548391
55633,32,19,10,18,11,1,91,38.238451951823066,-109.3545696
55634,33,16,11,18,9,2,89,38.238451951823066,-109.3543001
55635,33,17,12,16,8,1,87,38.238451951823066,-109.3540306
55636,31,21,11,17,7,1,88,38.238451951823066,-109.3537611
55637,21,18,9,22,16,3,89,38.238451951823066,-109.3534916
55638,4,25,12,12,14,11,78,38.238451951823066,-109.3532221
55639,0,30,11,5,19,9,74,38.238451951823066,-109.3529526
55640,0,32,11,1,18,9,71,38.238451951823066,-109.3526831
55641,0,31,11,1,11,13,67,38.238451951823066,-109.3524136
55642,0,29,12,0,11,15,67,38.238451951823066,-109.3521441
55643,1,29,12,2,13,12,69,38.238451951823066,-109.3518746
55644,1,31,12,2,13,12,71,38.238451951823066,-109.3516051
55645,1,34,12,0,11,17,75,38.238451951823066,-109.3513356
55646,19,37,13,10,12,0,91,38.238182457237826,-109.4068515
55647,19,37,13,11,12,0,92,38.238182457237826,-109.406582
55648,19,38,13,10,12,0,92,38.238182457237826,-109.4063125
55649,18,39,13,11,12,0,93,38.238182457237826,-109.406043
55650,16,39,14,12,12,0,93,38.238182457237826,-109.4057735
55651,15,38,14,13,13,0,93,38.238182457237826,-109.405504
55652,16,37,14,13,12,0,92,38.238182457237826,-109.4052345
55653,15,38,14,13,13,0,93,38.238182457237826,-109.4049651
55654,13,40,14,13,13,0,93,38.238182457237826,-109.4046956
55655,12,40,14,13,13,0,92,38.238182457237826,-109.4044261
55656,15,38,15,14,12,0,94,38.238182457237826,-109.4041566
55657,14,37,14,13,13,0,91,38.238182457237826,-109.4038871
55658,14,37,14,14,13,0,92,38.238182457237826,-109.4036176
55659,14,36,14,13,14,0,91,38.238182457237826,-109.4033481
55660,14,36,14,12,14,0,90,38.238182457237826,-109.4030786
55661,15,37,14,12,13,0,91,38.238182457237826,-109.4028091
55662,15,38,14,12,13,0,92,38.238182457237826,-109.4025396
55663,15,38,14,12,13,0,92,38.238182457237826,-109.4022701
55664,13,40,14,13,13,0,93,38.238182457237826,-109.4020006
55665,9,42,14,13,14,0,92,38.238182457237826,-109.4017311
55666,13,39,14,12,14,0,92,38.238182457237826,-109.4014616
55667,12,41,14,12,14,0,93,38.238182457237826,-109.4011921
55668,13,41,14,12,13,0,93,38.238182457237826,-109.4009226
55669,14,41,14,12,12,0,93,38.238182457237826,-109.4006531
55670,12,42,14,12,12,0,92,38.238182457237826,-109.4003836
55671,12,40,14,12,14,0,92,38.238182457237826,-109.4001142
55672,12,39,14,13,14,0,92,38.238182457237826,-109.3998447
55673,13,38,14,13,14,0,92,38.238182457237826,-109.3995752
55674,14,37,14,13,14,0,92,38.238182457237826,-109.3993057
55675,10,39,15,14,15,0,93,38.238182457237826,-109.3990362
55676,10,40,14,12,15,0,91,38.238182457237826,-109.3987667
55677,11,42,13,11,14,0,91,38.238182457237826,-109.3984972
55678,10,43,13,11,14,0,91,38.238182457237826,-109.3982277
55679,9,42,14,11,15,1,92,38.238182457237826,-109.3979582
55680,7,43,14,11,15,1,91,38.238182457237826,-109.3976887
55681,5,42,14,11,15,2,89,38.238182457237826,-109.3974192
55682,5,44,13,11,14,1,88,38.238182457237826,-109.3971497
55683,7,44,13,12,14,1,91,38.238182457237826,-109.3968802
55684,10,43,14,12,14,0,93,38.238182457237826,-109.3966107
55685,7,43,13,13,15,1,92,38.238182457237826,-109.3963412
55686,5,45,13,11,14,2,90,38.238182457237826,-109.3960717
55687,4,48,12,10,13,2,89,38.238182457237826,-109.3958022
55688,5,48,12,10,13,2,90,38.238182457237826,-109.3955327
55689,10,43,13,12,15,1,94,38.238182457237826,-109.3952632
55690,10,42,14,13,15,0,94,38.238182457237826,-109.3949938
55691,11,41,14,13,15,0,94,38.238182457237826,-109.3947243
55692,10,41,14,13,15,1,94,38.238182457237826,-109.3944548
55693,8,42,13,13,14,1,91,38.238182457237826,-109.3941853
55694,7,44,13,11,13,1,89,38.238182457237826,-109.3939158
55695,9,42,13,12,14,1,91,38.238182457237826,-109.3936463
55696,11,40,14,14,14,1,94,38.238182457237826,-109.3933768
55697,12,40,14,13,14,1,94,38.238182457237826,-109.3931073
55698,14,39,14,12,13,1,93,38.238182457237826,-109.3928378
55699,15,37,14,13,13,0,92,38.238182457237826,-109.3925683
55700,12,39,14,13,13,0,91,38.238182457237826,-109.3922988
55701,9,41,14,14,13,1,92,38.238182457237826,-109.3920293
55702,9,40,14,13,13,1,90,38.238182457237826,-109.3917598
55703,11,39,14,13,13,1,91,38.238182457237826,-109.3914903
55704,11,40,14,14,13,0,92,38.238182457237826,-109.3912208
55705,12,38,13,13,13,0,89,38.238182457237826,-109.3909513
55706,14,36,13,13,13,0,89,38.238182457237826,-109.3906818
55707,13,38,14,14,12,0,91,38.238182457237826,-109.3904123
55708,11,39,15,14,12,1,92,38.238182457237826,-109.3901429
55709,9,38,14,11,12,2,86,38.238182457237826,-109.3898734
55710,9,38,14,11,12,2,86,38.238182457237826,-109.3896039
55711,9,38,14,11,12,2,86,38.238182457237826,-109.3893344
55712,9,41,15,13,12,1,91,38.238182457237826,-109.3890649
55713,10,42,16,13,11,2,94,38.238182457237826,-109.3887954
55714,15,37,13,9,9,1,84,38.238182457237826,-109.3885259
55715,21,32,12,9,7,1,82,38.238182457237826,-109.3882564
55716,22,31,11,9,7,1,81,38.238182457237826,-109.3879869
55717,23,28,10,8,6,1,76,38.238182457237826,-109.3877174
55718,29,27,11,10,6,1,84,38.238182457237826,-109.3874479
55719,35,26,12,12,5,1,91,38.238182457237826,-109.3871784
55720,35,28,11,11,4,0,89,38.238182457237826,-109.3869089
55721,26,29,10,9,6,1,81,38.238182457237826,-109.3866394
55722,19,33,13,10,8,1,84,38.238182457237826,-109.3863699
55723,17,35,15,11,8,2,88,38.238182457237826,-109.3861004
55724,18,36,16,11,8,2,91,38.238182457237826,-109.3858309
55725,16,38,16,11,9,1,91,38.238182457237826,-109.3855614
55726,12,39,14,11,11,2,89,38.238182457237826,-109.3852919
55727,10,36,14,9,12,4,85,38.238182457237826,-109.3850225
55728,10,36,13,6,12,6,83,38.238182457237826,-109.384753
55729,9,39,13,7,13,4,85,38.238182457237826,-109.3844835
55730,8,42,13,8,14,2,87,38.238182457237826,-109.384214
55731,6,48,12,5,15,2,88,38.238182457237826,-109.3839445
55732,3,51,10,3,13,3,83,38.238182457237826,-109.383675
55733,4,43,11,3,13,5,79,38.238182457237826,-109.3834055
55734,4,36,11,4,13,6,74,38.238182457237826,-109.383136
55735,3,37,11,3,14,5,73,38.238182457237826,-109.3828665
55736,3,39,9,3,13,5,72,38.238182457237826,-109.382597
55737,5,38,9,4,10,6,72,38.238182457237826,-109.3823275
55738,5,36,10,3,10,6,70,38.238182457237826,-109.382058
55739,6,39,9,4,11,5,74,38.238182457237826,-109.3817885
55740,9,45,9,5,10,2,80,38.238182457237826,-109.381519
55741,15,39,10,6,10,1,81,38.238182457237826,-109.3812495
55742,19,35,12,7,10,1,84,38.238182457237826,-109.38098
55743,21,38,13,7,10,0,89,38.238182457237826,-109.3807105
55744,21,39,13,7,10,0,90,38.238182457237826,-109.380441
55745,21,40,13,8,10,0,92,38.238182457237826,-109.3801716
55746,13,27,10,8,8,1,67,38.238182457237826,-109.3799021
55747,7,27,9,11,7,2,63,38.238182457237826,-109.3796326
55748,7,34,9,8,8,3,69,38.238182457237826,-109.3793631
55749,8,38,11,6,9,4,76,38.238182457237826,-109.3790936
55750,12,33,13,7,9,3,77,38.238182457237826,-109.3788241
55751,11,33,13,9,10,3,79,38.238182457237826,-109.3785546
55752,10,39,14,8,9,3,83,38.238182457237826,-109.3782851
55753,10,40,14,8,8,3,83,38.238182457237826,-109.3780156
55754,9,39,16,10,8,3,85,38.238182457237826,-109.3777461
55755,9,41,15,11,10,2,88,38.238182457237826,-109.3774766
55756,7,46,14,10,12,2,91,38.238182457237826,-109.3772071
55757,4,49,13,8,14,2,90,38.238182457237826,-109.3769376
55758,4,48,13,7,15,2,89,38.238182457237826,-109.3766681
55759,3,48,12,5,14,3,85,38.238182457237826,-109.3763986
55760,3,46,11,5,15,4,84,38.238182457237826,-109.3761291
55761,3,41,10,3,12,7,76,38.238182457237826,-109.3758596
55762,2,41,10,3,12,7,75,38.238182457237826,-109.3755901
55763,3,45,10,2,13,6,79,38.238182457237826,-109.3753206
55764,3,33,10,0,11,8,65,38.238182457237826,-109.3750512
55765,1,31,11,0,8,15,66,38.238182457237826,-109.3747817
55766,4,37,12,3,14,5,75,38.238182457237826,-109.3745122
55767,2,47,10,4,14,2,79,38.238182457237826,-109.3742427
55768,1,35,9,2,9,9,65,38.238182457237826,-109.3739732
55769,3,39,11,2,12,8,75,38.238182457237826,-109.3737037
55770,1,37,10,1,10,11,70,38.238182457237826,-109.3734342
55771,2,39,11,1,12,9,74,38.238182457237826,-109.3731647
55772,3,40,12,3,14,7,79,38.238182457237826,-109.3728952
55773,3,37,12,4,12,9,77,38.238182457237826,-109.3726257
55774,2,32,13,2,9,15,73,38.238182457237826,-109.3723562
55775,2,32,13,1,9,16,73,38.238182457237826,-109.3720867
55776,3,36,12,0,10,13,74,38.238182457237826,-109.3718172
55777,4,41,12,2,12,8,79,38.238182457237826,-109.3715477
55778,6,44,13,5,13,4,85,38.238182457237826,-109.3712782
55779,5,47,12,5,13,4,86,38.238182457237826,-109.3710087
55780,5,43,12,7,14,3,84,38.238182457237826,-109.3707392
55781,4,39,12,4,12,8,79,38.238182457237826,-109.3704697
55782,3,32,13,1,9,14,72,38.238182457237826,-109.3702003
55783,1,31,11,0,9,17,69,38.238182457237826,-109.3699308
55784,1,29,12,0,8,22,72,38.238182457237826,-109.3696613
55785,2,29,14,1,9,24,79,38.238182457237826,-109.3693918
55786,2,31,15,5,12,18,83,38.238182457237826,-109.3691223
55787,3,28,12,11,17,2,73,38.238182457237826,-109.3688528
55788,2,28,10,9,16,0,65,38.238182457237826,-109.3685833
55789,2,43,7,7,7,2,68,38.238182457237826,-109.3683138
55790,1,46,6,2,8,4,67,38.238182457237826,-109.3680443
55791,1,45,6,2,8,5,67,38.238182457237826,-109.3677748
55792,1,46,6,3,8,5,69,38.238182457237826,-109.3675053
55793,1,48,6,4,8,5,72,38.238182457237826,-109.3672358
55794,1,47,6,3,8,5,70,38.238182457237826,-109.3669663
55795,1,42,6,2,8,6,65,38.238182457237826,-109.3666968
55796,2,39,7,3,10,5,66,38.238182457237826,-109.3664273
55797,3,43,9,3,10,5,73,38.238182457237826,-109.3661578
55798,4,45,11,0,11,9,80,38.238182457237826,-109.3658883
55799,4,50,12,1,14,5,86,38.238182457237826,-109.3656188
55800,3,50,11,2,12,6,84,38.238182457237826,-109.3653493
55801,3,46,11,2,10,9,81,38.238182457237826,-109.3650799
55802,4,39,12,2,9,11,77,38.238182457237826,-109.3648104
55803,3,40,11,1,10,10,75,38.238182457237826,-109.3645409
55804,3,42,11,1,11,11,79,38.238182457237826,-109.3642714
55805,4,38,12,1,9,13,77,38.238182457237826,-109.3640019
55806,3,29,11,2,5,14,64,38.238182457237826,-109.3637324
55807,2,25,11,2,7,14,61,38.238182457237826,-109.3634629
55808,1,25,10,2,8,12,58,38.238182457237826,-109.3631934
55809,1,30,10,2,10,11,64,38.238182457237826,-109.3629239
55810,0,32,7,1,12,4,56,38.238182457237826,-109.3626544
55811,5,40,7,9,8,2,71,38.238182457237826,-109.3623849
55812,3,41,8,9,6,1,68,38.238182457237826,-109.3621154
55813,4,45,6,8,6,2,71,38.238182457237826,-109.3618459
55814,2,44,5,5,8,2,66,38.238182457237826,-109.3615764
55815,2,44,5,3,8,2,64,38.238182457237826,-109.3613069
55816,4,43,7,4,8,4,70,38.238182457237826,-109.3610374
55817,2,34,7,4,9,5,61,38.238182457237826,-109.3607679
55818,3,35,8,5,10,6,67,38.238182457237826,-109.3604984
55819,2,33,9,3,8,9,64,38.238182457237826,-109.360229
55820,2,29,10,2,6,12,61,38.238182457237826,-109.3599595
55821,2,30,9,3,6,11,61,38.238182457237826,-109.35969
55822,1,29,10,2,5,14,61,38.238182457237826,-109.3594205
55823,2,30,10,2,4,16,64,38.238182457237826,-109.359151
55824,2,36,10,1,6,13,68,38.238182457237826,-109.3588815
55825,1,45,9,0,11,9,75,38.238182457237826,-109.358612
55826,2,36,8,5,10,4,65,38.238182457237826,-109.3583425
55827,2,32,7,4,8,5,58,38.238182457237826,-109.358073
55828,2,34,8,2,7,7,60,38.238182457237826,-109.3578035
55829,2,29,9,4,7,9,60,38.238182457237826,-109.357534
55830,1,30,8,4,9,8,60,38.238182457237826,-109.3572645
55831,1,31,9,3,8,11,63,38.238182457237826,-109.356995
55832,2,26,10,4,6,14,62,38.238182457237826,-109.3567255
55833,6,25,13,10,7,11,72,38.238182457237826,-109.356456
55834,33,23,11,16,7,1,91,38.238182457237826,-109.3561865
55835,33,23,11,17,7,1,92,38.238182457237826,-109.355917
55836,34,23,11,16,6,1,91,38.238182457237826,-109.3556475
55837,31,24,11,13,6,1,86,38.238182457237826,-109.355378
55838,32,25,11,14,6,1,89,38.238182457237826,-109.3551086
55839,35,22,11,14,8,1,91,38.238182457237826,-109.3548391
55840,33,18,10,17,11,2,91,38.238182457237826,-109.3545696
55841,31,17,11,18,11,2,90,38.238182457237826,-109.3543001
55842,30,18,11,18,9,1,87,38.238182457237826,-109.3540306
55843,26,22,11,19,9,2,89,38.238182457237826,-109.3537611
55844,6,22,11,14,13,11,77,38.238182457237826,-109.3534916
55845,2,20,11,9,12,8,62,38.238182457237826,-109.3532221
55846,2,23,10,8,12,6,61,38.238182457237826,-109.3529526
55847,3,29,10,7,13,6,68,38.238182457237826,-109.3526831
55848,2,30,11,3,12,10,68,38.238182457237826,-109.3524136
55849,0,29,12,0,12,15,68,38.238182457237826,-109.3521441
55850,1,30,12,1,12,14,70,38.238182457237826,-109.3518746
55851,2,32,13,0,11,15,73,38.238182457237826,-109.3516051
55852,2,36,13,0,11,16,78,38.238182457237826,-109.3513356
55853,20,35,14,11,13,0,93,38.23791296265259,-109.4068515
55854,17,36,14,12,14,0,93,38.23791296265259,-109.406582
55855,18,37,14,11,12,0,92,38.23791296265259,-109.4063125
55856,18,37,14,11,13,0,93,38.23791296265259,-109.406043
55857,17,36,14,13,13,0,93,38.23791296265259,-109.4057735
55858,17,36,14,13,13,0,93,38.23791296265259,-109.405504
55859,16,37,14,13,12,0,92,38.23791296265259,-109.4052345
55860,15,38,15,13,13,0,94,38.23791296265259,-109.4049651
55861,14,39,14,13,13,0,93,38.23791296265259,-109.4046956
55862,14,39,14,13,13,0,93,38.23791296265259,-109.4044261
55863,15,38,14,12,13,0,92,38.23791296265259,-109.4041566
55864,15,37,13,13,13,0,91,38.23791296265259,-109.4038871
55865,16,35,14,13,13,0,91,38.23791296265259,-109.4036176
55866,18,35,13,12,13,0,91,38.23791296265259,-109.4033481
55867,20,34,13,11,13,0,91,38.23791296265259,-109.4030786
55868,20,34,14,12,12,0,92,38.23791296265259,-109.4028091
55869,15,37,14,13,13,0,92,38.23791296265259,-109.4025396
55870,11,41,14,13,13,0,92,38.23791296265259,-109.4022701
55871,9,43,14,13,13,1,93,38.23791296265259,-109.4020006
55872,11,42,14,13,13,0,93,38.23791296265259,-109.4017311
55873,12,40,15,13,14,0,94,38.23791296265259,-109.4014616
55874,11,41,14,13,14,0,93,38.23791296265259,-109.4011921
55875,11,42,14,12,13,0,92,38.23791296265259,-109.4009226
55876,12,42,14,12,13,0,93,38.23791296265259,-109.4006531
55877,11,41,14,12,14,0,92,38.23791296265259,-109.4003836
55878,11,42,14,11,14,0,92,38.23791296265259,-109.4001142
55879,12,40,14,12,14,0,92,38.23791296265259,-109.3998447
55880,12,39,14,13,14,0,92,38.23791296265259,-109.3995752
55881,11,39,15,13,15,0,93,38.23791296265259,-109.3993057
55882,9,39,15,13,15,0,91,38.23791296265259,-109.3990362
55883,9,41,14,11,15,0,90,38.23791296265259,-109.3987667
55884,9,44,13,10,15,0,91,38.23791296265259,-109.3984972
55885,8,45,13,10,15,0,91,38.23791296265259,-109.3982277
55886,6,44,14,10,16,1,91,38.23791296265259,-109.3979582
55887,6,43,14,10,15,1,89,38.23791296265259,-109.3976887
55888,5,43,14,10,14,2,88,38.23791296265259,-109.3974192
55889,7,44,14,12,15,1,93,38.23791296265259,-109.3971497
55890,11,42,14,13,15,0,95,38.23791296265259,-109.3968802
55891,12,41,14,13,15,0,95,38.23791296265259,-109.3966107
55892,8,44,13,13,15,0,93,38.23791296265259,-109.3963412
55893,5,46,13,11,14,1,90,38.23791296265259,-109.3960717
55894,5,49,12,11,14,1,92,38.23791296265259,-109.3958022
55895,7,47,12,11,15,1,93,38.23791296265259,-109.3955327
55896,12,42,13,11,15,0,93,38.23791296265259,-109.3952632
55897,11,42,14,12,15,0,94,38.23791296265259,-109.3949938
55898,9,42,14,13,15,1,94,38.23791296265259,-109.3947243
55899,7,42,13,12,14,1,89,38.23791296265259,-109.3944548
55900,6,44,13,11,13,2,89,38.23791296265259,-109.3941853
55901,6,43,13,11,14,2,89,38.23791296265259,-109.3939158
55902,9,41,14,13,14,1,92,38.23791296265259,-109.3936463
55903,10,41,14,14,14,1,94,38.23791296265259,-109.3933768
55904,10,41,14,14,14,1,94,38.23791296265259,-109.3931073
55905,12,38,14,13,13,1,91,38.23791296265259,-109.3928378
55906,13,37,14,13,13,0,90,38.23791296265259,-109.3925683
55907,13,39,14,13,12,0,91,38.23791296265259,-109.3922988
55908,12,40,15,14,12,0,93,38.23791296265259,-109.3920293
55909,14,38,15,14,12,0,93,38.23791296265259,-109.3917598
55910,16,36,14,13,12,0,91,38.23791296265259,-109.3914903
55911,13,37,14,14,13,0,91,38.23791296265259,-109.3912208
55912,13,36,13,13,13,0,88,38.23791296265259,-109.3909513
55913,15,35,13,12,13,0,88,38.23791296265259,-109.3906818
55914,14,37,14,13,13,0,91,38.23791296265259,-109.3904123
55915,12,39,15,13,13,0,92,38.23791296265259,-109.3901429
55916,8,40,14,11,13,2,88,38.23791296265259,-109.3898734
55917,8,39,14,10,13,2,86,38.23791296265259,-109.3896039
55918,9,38,15,12,14,2,90,38.23791296265259,-109.3893344
55919,9,40,15,13,13,1,91,38.23791296265259,-109.3890649
55920,8,42,15,12,11,2,90,38.23791296265259,-109.3887954
55921,11,42,14,12,11,2,92,38.23791296265259,-109.3885259
55922,16,37,13,9,9,1,85,38.23791296265259,-109.3882564
55923,21,32,11,9,7,0,80,38.23791296265259,-109.3879869
55924,20,30,11,8,7,1,77,38.23791296265259,-109.3877174
55925,25,29,13,12,7,1,87,38.23791296265259,-109.3874479
55926,30,28,12,12,5,0,87,38.23791296265259,-109.3871784
55927,28,30,11,10,4,0,83,38.23791296265259,-109.3869089
55928,24,31,11,11,6,1,84,38.23791296265259,-109.3866394
55929,18,35,14,12,8,1,88,38.23791296265259,-109.3863699
55930,17,36,15,12,9,2,91,38.23791296265259,-109.3861004
55931,19,37,15,11,8,1,91,38.23791296265259,-109.3858309
55932,18,38,15,11,9,1,92,38.23791296265259,-109.3855614
55933,14,41,14,11,11,1,92,38.23791296265259,-109.3852919
55934,12,36,14,9,12,4,87,38.23791296265259,-109.3850225
55935,10,35,13,7,13,4,82,38.23791296265259,-109.384753
55936,7,38,12,4,14,5,80,38.23791296265259,-109.3844835
55937,3,43,11,1,15,6,79,38.23791296265259,-109.384214
55938,3,44,11,3,16,4,81,38.23791296265259,-109.3839445
55939,2,41,11,1,12,9,76,38.23791296265259,-109.383675
55940,3,28,11,2,8,14,66,38.23791296265259,-109.3834055
55941,5,26,12,2,8,12,65,38.23791296265259,-109.383136
55942,7,33,11,5,13,4,73,38.23791296265259,-109.3828665
55943,6,36,11,3,12,6,74,38.23791296265259,-109.382597
55944,6,30,10,5,12,6,69,38.23791296265259,-109.3823275
55945,9,30,11,6,12,5,73,38.23791296265259,-109.382058
55946,13,36,11,6,11,3,80,38.23791296265259,-109.3817885
55947,12,45,10,6,10,2,85,38.23791296265259,-109.381519
55948,11,46,9,4,9,1,80,38.23791296265259,-109.3812495
55949,14,41,10,5,9,1,80,38.23791296265259,-109.38098
55950,17,39,11,5,9,1,82,38.23791296265259,-109.3807105
55951,18,39,12,6,10,1,86,38.23791296265259,-109.380441
55952,20,37,12,7,11,0,87,38.23791296265259,-109.3801716
55953,14,32,10,7,10,1,74,38.23791296265259,-109.3799021
55954,8,23,9,11,8,2,61,38.23791296265259,-109.3796326
55955,7,25,10,8,8,4,62,38.23791296265259,-109.3793631
55956,8,39,11,5,10,4,77,38.23791296265259,-109.3790936
55957,8,36,10,6,9,3,72,38.23791296265259,-109.3788241
55958,8,33,11,7,9,4,72,38.23791296265259,-109.3785546
55959,8,35,11,7,9,4,74,38.23791296265259,-109.3782851
55960,8,41,13,8,9,3,82,38.23791296265259,-109.3780156
55961,8,39,15,10,9,3,84,38.23791296265259,-109.3777461
55962,8,41,15,11,9,3,87,38.23791296265259,-109.3774766
55963,8,43,15,12,10,2,90,38.23791296265259,-109.3772071
55964,7,45,14,12,9,2,89,38.23791296265259,-109.3769376
55965,6,46,13,11,10,2,88,38.23791296265259,-109.3766681
55966,5,47,13,10,11,1,87,38.23791296265259,-109.3763986
55967,3,51,10,4,13,2,83,38.23791296265259,-109.3761291
55968,2,47,9,3,13,5,79,38.23791296265259,-109.3758596
55969,2,41,10,4,12,6,75,38.23791296265259,-109.3755901
55970,3,42,10,3,12,6,76,38.23791296265259,-109.3753206
55971,2,31,9,0,9,9,60,38.23791296265259,-109.3750512
55972,3,32,12,0,8,14,69,38.23791296265259,-109.3747817
55973,1,37,10,0,12,7,67,38.23791296265259,-109.3745122
55974,1,44,9,2,12,5,73,38.23791296265259,-109.3742427
55975,1,41,10,3,11,5,71,38.23791296265259,-109.3739732
55976,2,41,11,0,11,9,74,38.23791296265259,-109.3737037
55977,1,37,10,1,10,11,70,38.23791296265259,-109.3734342
55978,2,41,10,1,11,9,74,38.23791296265259,-109.3731647
55979,3,43,11,0,12,10,79,38.23791296265259,-109.3728952
55980,3,42,11,1,13,8,78,38.23791296265259,-109.3726257
55981,2,38,11,2,14,8,75,38.23791296265259,-109.3723562
55982,2,39,11,1,13,10,76,38.23791296265259,-109.3720867
55983,3,44,11,1,13,9,81,38.23791296265259,-109.3718172
55984,4,48,12,4,14,4,86,38.23791296265259,-109.3715477
55985,4,47,11,4,13,4,83,38.23791296265259,-109.3712782
55986,4,43,12,3,12,8,82,38.23791296265259,-109.3710087
55987,4,39,12,2,11,11,79,38.23791296265259,-109.3707392
55988,3,34,12,1,10,12,72,38.23791296265259,-109.3704697
55989,2,32,12,0,10,16,72,38.23791296265259,-109.3702003
55990,1,31,11,0,11,16,70,38.23791296265259,-109.3699308
55991,2,32,12,0,14,15,75,38.23791296265259,-109.3696613
55992,2,31,14,5,16,12,80,38.23791296265259,-109.3693918
55993,0,32,12,6,18,7,75,38.23791296265259,-109.3691223
55994,1,28,8,8,15,0,60,38.23791296265259,-109.3688528
55995,1,51,6,4,8,2,72,38.23791296265259,-109.3685833
55996,0,50,6,1,8,4,69,38.23791296265259,-109.3683138
55997,1,49,6,2,8,4,70,38.23791296265259,-109.3680443
55998,1,47,6,3,9,5,71,38.23791296265259,-109.3677748
55999,1,46,6,2,8,6,69,38.23791296265259,-109.3675053
56000,1,46,7,3,8,5,70,38.23791296265259,-109.3672358
56001,1,43,7,3,9,5,68,38.23791296265259,-109.3669663
56002,1,41,8,3,10,6,69,38.23791296265259,-109.3666968
56003,3,42,9,4,11,6,75,38.23791296265259,-109.3664273
56004,4,42,11,0,11,10,78,38.23791296265259,-109.3661578
56005,5,39,11,0,9,11,75,38.23791296265259,-109.3658883
56006,5,48,13,3,13,6,88,38.23791296265259,-109.3656188
56007,5,49,12,3,12,4,85,38.23791296265259,-109.3653493
56008,5,44,12,4,10,7,82,38.23791296265259,-109.3650799
56009,4,42,12,1,10,9,78,38.23791296265259,-109.3648104
56010,4,41,11,1,10,10,77,38.23791296265259,-109.3645409
56011,4,44,11,1,12,9,81,38.23791296265259,-109.3642714
56012,4,43,12,1,12,9,81,38.23791296265259,-109.3640019
56013,6,32,13,3,7,12,73,38.23791296265259,-109.3637324
56014,3,26,12,1,5,15,62,38.23791296265259,-109.3634629
56015,3,27,10,2,6,12,60,38.23791296265259,-109.3631934
56016,6,33,11,11,10,7,78,38.23791296265259,-109.3629239
56017,2,42,9,4,10,6,73,38.23791296265259,-109.3626544
56018,2,56,6,5,10,1,80,38.23791296265259,-109.3623849
56019,1,35,8,3,9,4,60,38.23791296265259,-109.3621154
56020,3,43,8,6,9,3,72,38.23791296265259,-109.3618459
56021,1,40,6,4,8,3,62,38.23791296265259,-109.3615764
56022,3,39,6,5,10,2,65,38.23791296265259,-109.3613069
56023,3,41,6,3,9,4,66,38.23791296265259,-109.3610374
56024,4,43,8,2,8,5,70,38.23791296265259,-109.3607679
56025,4,36,9,4,8,8,69,38.23791296265259,-109.3604984
56026,3,32,10,3,7,10,65,38.23791296265259,-109.360229
56027,4,30,10,4,7,9,64,38.23791296265259,-109.3599595
56028,3,31,9,4,7,9,63,38.23791296265259,-109.35969
56029,2,34,10,2,8,12,68,38.23791296265259,-109.3594205
56030,1,34,10,1,6,13,65,38.23791296265259,-109.359151
56031,1,36,10,0,6,14,67,38.23791296265259,-109.3588815
56032,1,41,10,0,10,11,73,38.23791296265259,-109.358612
56033,1,35,8,3,8,6,61,38.23791296265259,-109.3583425
56034,2,33,7,3,7,6,58,38.23791296265259,-109.358073
56035,2,34,8,2,7,8,61,38.23791296265259,-109.3578035
56036,2,28,9,4,7,11,61,38.23791296265259,-109.357534
56037,1,29,9,4,8,10,61,38.23791296265259,-109.3572645
56038,1,35,8,2,10,8,64,38.23791296265259,-109.356995
56039,2,34,10,3,9,10,68,38.23791296265259,-109.3567255
56040,5,31,12,8,8,11,75,38.23791296265259,-109.356456
56041,35,24,12,12,7,1,91,38.23791296265259,-109.3561865
56042,36,21,10,16,6,2,91,38.23791296265259,-109.355917
56043,34,22,9,15,4,1,85,38.23791296265259,-109.3556475
56044,32,22,8,9,3,0,74,38.23791296265259,-109.355378
56045,33,25,9,8,4,0,79,38.23791296265259,-109.3551086
56046,37,22,10,14,7,2,92,38.23791296265259,-109.3548391
56047,35,19,10,17,8,2,91,38.23791296265259,-109.3545696
56048,29,19,10,15,9,1,83,38.23791296265259,-109.3543001
56049,26,23,10,16,8,1,84,38.23791296265259,-109.3540306
56050,22,24,12,15,10,4,87,38.23791296265259,-109.3537611
56051,3,18,12,10,9,12,64,38.23791296265259,-109.3534916
56052,2,27,9,6,10,7,61,38.23791296265259,-109.3532221
56053,2,34,8,5,10,4,63,38.23791296265259,-109.3529526
56054,3,29,8,6,10,5,61,38.23791296265259,-109.3526831
56055,3,27,10,7,13,6,66,38.23791296265259,-109.3524136
56056,1,27,11,3,13,10,65,38.23791296265259,-109.3521441
56057,1,29,11,1,10,14,66,38.23791296265259,-109.3518746
56058,2,32,12,1,11,14,72,38.23791296265259,-109.3516051
56059,3,40,13,1,13,12,82,38.23791296265259,-109.3513356
56060,18,35,14,12,14,0,93,38.237643468067354,-109.4068515
56061,16,37,14,12,14,0,93,38.237643468067354,-109.406582
56062,16,36,14,13,13,0,92,38.237643468067354,-109.4063125
56063,17,36,14,12,13,0,92,38.237643468067354,-109.406043
56064,16,36,14,13,13,0,92,38.237643468067354,-109.4057735
56065,14,36,14,15,13,0,92,38.237643468067354,-109.405504
56066,14,37,14,13,13,0,91,38.237643468067354,-109.4052345
56067,12,39,14,13,14,0,92,38.237643468067354,-109.4049651
56068,12,39,14,14,14,0,93,38.237643468067354,-109.4046956
56069,14,38,14,13,14,0,93,38.237643468067354,-109.4044261
56070,17,35,14,12,14,0,92,38.237643468067354,-109.4041566
56071,17,36,13,12,13,0,91,38.237643468067354,-109.4038871
56072,18,35,13,12,13,0,91,38.237643468067354,-109.4036176
56073,19,34,14,12,13,0,92,38.237643468067354,-109.4033481
56074,19,34,14,12,13,0,92,38.237643468067354,-109.4030786
56075,12,38,15,13,14,0,92,38.237643468067354,-109.4028091
56076,8,44,14,13,15,0,94,38.237643468067354,-109.4025396
56077,7,45,14,12,15,1,94,38.237643468067354,-109.4022701
56078,8,44,14,12,14,0,92,38.237643468067354,-109.4020006
56079,11,43,14,12,14,0,94,38.237643468067354,-109.4017311
56080,11,42,14,13,14,0,94,38.237643468067354,-109.4014616
56081,10,42,14,13,15,0,94,38.237643468067354,-109.4011921
56082,12,41,14,11,13,0,91,38.237643468067354,-109.4009226
56083,15,40,14,11,12,0,92,38.237643468067354,-109.4006531
56084,15,40,15,12,13,0,95,38.237643468067354,-109.4003836
56085,13,40,15,12,14,0,94,38.237643468067354,-109.4001142
56086,12,40,15,13,14,0,94,38.237643468067354,-109.3998447
56087,10,40,14,12,15,0,91,38.237643468067354,-109.3995752
56088,9,41,14,11,15,0,90,38.237643468067354,-109.3993057
56089,8,39,14,12,15,1,89,38.237643468067354,-109.3990362
56090,9,42,14,12,16,0,93,38.237643468067354,-109.3987667
56091,8,43,14,10,16,0,91,38.237643468067354,-109.3984972
56092,6,44,14,10,16,1,91,38.237643468067354,-109.3982277
56093,5,44,13,9,16,1,88,38.237643468067354,-109.3979582
56094,4,46,13,8,15,1,87,38.237643468067354,-109.3976887
56095,6,45,13,10,16,1,91,38.237643468067354,-109.3974192
56096,9,43,14,12,16,0,94,38.237643468067354,-109.3971497
56097,9,42,14,13,15,0,93,38.237643468067354,-109.3968802
56098,8,43,14,13,15,0,93,38.237643468067354,-109.3966107
56099,6,47,13,11,14,1,92,38.237643468067354,-109.3963412
56100,5,49,12,10,14,1,91,38.237643468067354,-109.3960717
56101,6,48,12,10,14,1,91,38.237643468067354,-109.3958022
56102,10,46,12,11,15,0,94,38.237643468067354,-109.3955327
56103,15,39,13,11,14,0,92,38.237643468067354,-109.3952632
56104,14,40,13,11,14,0,92,38.237643468067354,-109.3949938
56105,12,41,14,12,15,0,94,38.237643468067354,-109.3947243
56106,10,42,14,13,15,0,94,38.237643468067354,-109.3944548
56107,10,43,14,13,14,0,94,38.237643468067354,-109.3941853
56108,10,41,14,13,14,0,92,38.237643468067354,-109.3939158
56109,11,40,14,13,15,0,93,38.237643468067354,-109.3936463
56110,9,43,14,13,15,1,95,38.237643468067354,-109.3933768
56111,8,43,14,12,13,1,91,38.237643468067354,-109.3931073
56112,8,41,14,13,13,1,90,38.237643468067354,-109.3928378
56113,7,43,13,13,14,1,91,38.237643468067354,-109.3925683
56114,8,45,13,12,13,1,92,38.237643468067354,-109.3922988
56115,10,43,14,13,12,1,93,38.237643468067354,-109.3920293
56116,11,40,15,14,12,0,92,38.237643468067354,-109.3917598
56117,13,38,14,14,13,0,92,38.237643468067354,-109.3914903
56118,10,40,14,12,14,1,91,38.237643468067354,-109.3912208
56119,12,35,13,13,14,1,88,38.237643468067354,-109.3909513
56120,14,34,13,12,14,0,87,38.237643468067354,-109.3906818
56121,13,37,14,13,14,0,91,38.237643468067354,-109.3904123
56122,11,40,15,14,14,0,94,38.237643468067354,-109.3901429
56123,10,41,15,12,14,1,93,38.237643468067354,-109.3898734
56124,9,41,14,11,15,1,91,38.237643468067354,-109.3896039
56125,8,41,15,12,15,1,92,38.237643468067354,-109.3893344
56126,7,42,14,13,12,2,90,38.237643468067354,-109.3890649
56127,7,42,14,11,11,3,88,38.237643468067354,-109.3887954
56128,8,43,14,13,11,2,91,38.237643468067354,-109.3885259
56129,12,39,13,9,10,1,84,38.237643468067354,-109.3882564
56130,19,32,10,8,7,0,76,38.237643468067354,-109.3879869
56131,21,31,13,11,7,1,84,38.237643468067354,-109.3877174
56132,28,29,14,14,7,1,93,38.237643468067354,-109.3874479
56133,29,30,12,14,6,1,92,38.237643468067354,-109.3871784
56134,25,30,10,11,6,0,82,38.237643468067354,-109.3869089
56135,22,31,11,11,7,0,82,38.237643468067354,-109.3866394
56136,17,37,14,12,9,1,90,38.237643468067354,-109.3863699
56137,18,35,14,12,9,2,90,38.237643468067354,-109.3861004
56138,20,34,14,11,8,2,89,38.237643468067354,-109.3858309
56139,18,37,14,11,9,1,90,38.237643468067354,-109.3855614
56140,11,42,14,12,12,1,92,38.237643468067354,-109.3852919
56141,10,40,14,9,13,2,88,38.237643468067354,-109.3850225
56142,7,34,12,7,12,7,79,38.237643468067354,-109.384753
56143,3,30,12,3,10,12,70,38.237643468067354,-109.3844835
56144,1,30,12,2,10,13,68,38.237643468067354,-109.384214
56145,1,31,11,1,9,13,66,38.237643468067354,-109.3839445
56146,3,34,11,0,8,14,70,38.237643468067354,-109.383675
56147,4,32,11,1,10,11,69,38.237643468067354,-109.3834055
56148,5,32,11,3,12,7,70,38.237643468067354,-109.383136
56149,7,37,10,4,14,4,76,38.237643468067354,-109.3828665
56150,9,31,11,6,11,5,73,38.237643468067354,-109.382597
56151,11,28,11,5,11,5,71,38.237643468067354,-109.3823275
56152,14,32,11,7,11,3,78,38.237643468067354,-109.382058
56153,14,38,11,7,10,1,81,38.237643468067354,-109.3817885
56154,11,42,10,5,9,1,78,38.237643468067354,-109.381519
56155,7,41,8,5,9,2,72,38.237643468067354,-109.3812495
56156,6,40,8,5,9,2,70,38.237643468067354,-109.38098
56157,9,40,9,5,9,2,74,38.237643468067354,-109.3807105
56158,16,40,11,6,10,1,84,38.237643468067354,-109.380441
56159,17,38,12,7,11,1,86,38.237643468067354,-109.3801716
56160,15,38,11,7,11,1,83,38.237643468067354,-109.3799021
56161,11,26,9,9,8,2,65,38.237643468067354,-109.3796326
56162,10,26,10,9,8,3,66,38.237643468067354,-109.3793631
56163,10,39,11,6,10,4,80,38.237643468067354,-109.3790936
56164,7,36,11,7,10,3,74,38.237643468067354,-109.3788241
56165,9,35,11,7,10,3,75,38.237643468067354,-109.3785546
56166,9,37,11,7,10,3,77,38.237643468067354,-109.3782851
56167,9,40,12,8,10,3,82,38.237643468067354,-109.3780156
56168,8,40,14,10,10,3,85,38.237643468067354,-109.3777461
56169,8,38,14,11,10,3,84,38.237643468067354,-109.3774766
56170,8,40,15,12,9,2,86,38.237643468067354,-109.3772071
56171,7,43,15,11,9,2,87,38.237643468067354,-109.3769376
56172,6,45,13,9,10,2,85,38.237643468067354,-109.3766681
56173,5,47,12,7,12,2,85,38.237643468067354,-109.3763986
56174,3,51,10,4,13,2,83,38.237643468067354,-109.3761291
56175,3,45,10,3,14,5,80,38.237643468067354,-109.3758596
56176,3,38,11,3,12,9,76,38.237643468067354,-109.3755901
56177,3,31,11,6,9,10,70,38.237643468067354,-109.3753206
56178,2,30,9,2,10,8,61,38.237643468067354,-109.3750512
56179,4,37,12,3,12,5,73,38.237643468067354,-109.3747817
56180,1,45,8,0,12,6,72,38.237643468067354,-109.3745122
56181,0,47,7,1,10,5,70,38.237643468067354,-109.3742427
56182,2,46,9,4,11,3,75,38.237643468067354,-109.3739732
56183,1,42,9,1,11,8,72,38.237643468067354,-109.3737037
56184,2,40,10,1,12,9,74,38.237643468067354,-109.3734342
56185,2,42,10,0,12,9,75,38.237643468067354,-109.3731647
56186,2,41,10,0,12,9,74,38.237643468067354,-109.3728952
56187,3,41,11,1,13,8,77,38.237643468067354,-109.3726257
56188,2,34,11,0,10,12,69,38.237643468067354,-109.3723562
56189,2,37,12,0,11,12,74,38.237643468067354,-109.3720867
56190,3,45,12,2,13,8,83,38.237643468067354,-109.3718172
56191,4,47,12,4,14,4,85,38.237643468067354,-109.3715477
56192,4,47,11,3,13,5,83,38.237643468067354,-109.3712782
56193,4,41,13,1,11,11,81,38.237643468067354,-109.3710087
56194,3,41,11,0,11,11,77,38.237643468067354,-109.3707392
56195,3,38,10,0,13,9,73,38.237643468067354,-109.3704697
56196,1,34,11,0,13,12,71,38.237643468067354,-109.3702003
56197,1,33,10,0,16,9,69,38.237643468067354,-109.3699308
56198,3,30,11,10,20,3,77,38.237643468067354,-109.3696613
56199,0,26,10,14,19,2,71,38.237643468067354,-109.3693918
56200,0,25,7,9,9,2,52,38.237643468067354,-109.3691223
56201,2,53,6,4,8,2,75,38.237643468067354,-109.3688528
56202,0,54,5,1,8,4,72,38.237643468067354,-109.3685833
56203,0,52,6,1,9,5,73,38.237643468067354,-109.3683138
56204,0,44,6,2,9,5,66,38.237643468067354,-109.3680443
56205,1,44,7,2,9,6,69,38.237643468067354,-109.3677748
56206,3,41,9,3,8,9,73,38.237643468067354,-109.3675053
56207,3,41,10,1,9,10,74,38.237643468067354,-109.3672358
56208,2,44,10,1,10,10,77,38.237643468067354,-109.3669663
56209,2,45,10,1,11,8,77,38.237643468067354,-109.3666968
56210,3,43,11,3,13,7,80,38.237643468067354,-109.3664273
56211,3,37,12,0,8,12,72,38.237643468067354,-109.3661578
56212,6,39,12,4,11,7,79,38.237643468067354,-109.3658883
56213,6,45,12,6,13,3,85,38.237643468067354,-109.3656188
56214,6,47,13,6,12,3,87,38.237643468067354,-109.3653493
56215,5,45,13,5,12,4,84,38.237643468067354,-109.3650799
56216,5,44,13,3,13,6,84,38.237643468067354,-109.3648104
56217,4,40,12,1,11,10,78,38.237643468067354,-109.3645409
56218,4,44,12,1,12,9,82,38.237643468067354,-109.3642714
56219,4,44,12,1,12,8,81,38.237643468067354,-109.3640019
56220,5,34,13,2,6,13,73,38.237643468067354,-109.3637324
56221,3,32,11,0,5,15,66,38.237643468067354,-109.3634629
56222,2,32,10,1,8,11,64,38.237643468067354,-109.3631934
56223,1,38,9,0,13,7,68,38.237643468067354,-109.3629239
56224,2,49,7,3,13,2,76,38.237643468067354,-109.3626544
56225,2,30,6,6,12,0,56,38.237643468067354,-109.3623849
56226,2,25,5,6,10,0,48,38.237643468067354,-109.3621154
56227,3,46,9,5,12,2,77,38.237643468067354,-109.3618459
56228,3,46,7,5,11,2,74,38.237643468067354,-109.3615764
56229,3,39,7,7,10,3,69,38.237643468067354,-109.3613069
56230,2,35,7,5,10,4,63,38.237643468067354,-109.3610374
56231,6,35,8,5,9,3,66,38.237643468067354,-109.3607679
56232,5,31,10,4,8,8,66,38.237643468067354,-109.3604984
56233,3,31,10,3,7,11,65,38.237643468067354,-109.360229
56234,3,26,9,5,7,10,60,38.237643468067354,-109.3599595
56235,4,29,10,5,6,11,65,38.237643468067354,-109.35969
56236,3,33,11,2,6,13,68,38.237643468067354,-109.3594205
56237,2,34,11,1,6,14,68,38.237643468067354,-109.359151
56238,2,34,10,1,7,14,68,38.237643468067354,-109.3588815
56239,2,38,10,1,8,11,70,38.237643468067354,-109.358612
56240,2,36,8,2,7,7,62,38.237643468067354,-109.3583425
56241,3,33,7,4,9,5,61,38.237643468067354,-109.358073
56242,4,29,9,5,11,5,63,38.237643468067354,-109.3578035
56243,2,24,10,6,7,12,61,38.237643468067354,-109.357534
56244,2,25,11,6,7,13,64,38.237643468067354,-109.3572645
56245,2,33,10,4,10,10,69,38.237643468067354,-109.356995
56246,2,40,10,3,11,8,74,38.237643468067354,-109.3567255
56247,4,36,11,6,10,8,75,38.237643468067354,-109.356456
56248,21,28,15,10,8,6,88,38.237643468067354,-109.3561865
56249,34,19,11,15,9,2,90,38.237643468067354,-109.355917
56250,35,21,9,16,5,1,87,38.237643468067354,-109.3556475
56251,31,21,7,8,4,0,71,38.237643468067354,-109.355378
56252,31,22,7,9,4,0,73,38.237643468067354,-109.3551086
56253,38,19,10,16,7,1,91,38.237643468067354,-109.3548391
56254,32,19,10,15,9,1,86,38.237643468067354,-109.3545696
56255,23,20,8,13,6,0,70,38.237643468067354,-109.3543001
56256,22,24,9,14,7,0,76,38.237643468067354,-109.3540306
56257,24,24,12,15,11,3,89,38.237643468067354,-109.3537611
56258,7,20,12,11,9,10,69,38.237643468067354,-109.3534916
56259,4,25,9,8,9,7,62,38.237643468067354,-109.3532221
56260,2,31,8,5,9,6,61,38.237643468067354,-109.3529526
56261,2,29,8,6,8,6,59,38.237643468067354,-109.3526831
56262,3,23,10,6,10,7,59,38.237643468067354,-109.3524136
56263,3,23,10,4,11,8,59,38.237643468067354,-109.3521441
56264,2,28,10,3,10,10,63,38.237643468067354,-109.3518746
56265,2,37,11,2,12,10,74,38.237643468067354,-109.3516051
56266,2,42,11,0,13,10,78,38.237643468067354,-109.3513356
56267,15,37,14,12,14,0,92,38.23737397348212,-109.4068515
56268,12,39,14,13,14,0,92,38.23737397348212,-109.406582
56269,14,38,14,13,14,0,93,38.23737397348212,-109.4063125
56270,16,37,14,11,13,0,91,38.23737397348212,-109.406043
56271,16,36,14,12,13,0,91,38.23737397348212,-109.4057735
56272,13,36,14,13,14,0,90,38.23737397348212,-109.405504
56273,11,38,15,14,14,0,92,38.23737397348212,-109.4052345
56274,10,40,14,14,14,0,92,38.23737397348212,-109.4049651
56275,12,39,14,14,14,0,93,38.23737397348212,-109.4046956
56276,13,37,14,14,14,0,92,38.23737397348212,-109.4044261
56277,13,37,14,13,15,0,92,38.23737397348212,-109.4041566
56278,14,36,14,13,15,0,92,38.23737397348212,-109.4038871
56279,14,36,14,13,14,0,91,38.23737397348212,-109.4036176
56280,13,37,14,13,14,0,91,38.23737397348212,-109.4033481
56281,11,38,15,14,14,0,92,38.23737397348212,-109.4030786
56282,7,43,14,14,14,1,93,38.23737397348212,-109.4028091
56283,7,44,14,13,14,1,93,38.23737397348212,-109.4025396
56284,8,43,14,14,15,1,95,38.23737397348212,-109.4022701
56285,10,40,14,13,15,0,92,38.23737397348212,-109.4020006
56286,13,39,14,12,14,0,92,38.23737397348212,-109.4017311
56287,11,40,14,12,15,0,92,38.23737397348212,-109.4014616
56288,12,41,14,12,15,0,94,38.23737397348212,-109.4011921
56289,14,40,14,11,14,0,93,38.23737397348212,-109.4009226
56290,16,39,14,11,13,0,93,38.23737397348212,-109.4006531
56291,15,39,15,12,14,0,95,38.23737397348212,-109.4003836
56292,13,40,14,12,13,0,92,38.23737397348212,-109.4001142
56293,12,40,14,12,15,0,93,38.23737397348212,-109.3998447
56294,9,41,14,12,16,0,92,38.23737397348212,-109.3995752
56295,8,42,14,10,17,0,91,38.23737397348212,-109.3993057
56296,7,44,14,9,17,0,91,38.23737397348212,-109.3990362
56297,10,41,14,11,16,0,92,38.23737397348212,-109.3987667
56298,10,42,14,12,16,0,94,38.23737397348212,-109.3984972
56299,7,43,14,11,17,0,92,38.23737397348212,-109.3982277
56300,6,44,13,10,16,1,90,38.23737397348212,-109.3979582
56301,6,45,13,10,16,1,91,38.23737397348212,-109.3976887
56302,8,44,13,11,16,0,92,38.23737397348212,-109.3974192
56303,10,42,14,11,14,0,91,38.23737397348212,-109.3971497
56304,10,42,14,12,14,0,92,38.23737397348212,-109.3968802
56305,7,43,14,12,14,1,91,38.23737397348212,-109.3966107
56306,6,45,14,12,14,1,92,38.23737397348212,-109.3963412
56307,7,47,13,11,15,0,93,38.23737397348212,-109.3960717
56308,9,46,13,11,15,0,94,38.23737397348212,-109.3958022
56309,11,44,13,10,15,0,93,38.23737397348212,-109.3955327
56310,14,41,14,11,14,0,94,38.23737397348212,-109.3952632
56311,15,40,14,11,14,0,94,38.23737397348212,-109.3949938
56312,14,40,14,12,14,0,94,38.23737397348212,-109.3947243
56313,13,40,14,12,14,0,93,38.23737397348212,-109.3944548
56314,14,39,14,12,14,0,93,38.23737397348212,-109.3941853
56315,14,37,14,14,14,0,93,38.23737397348212,-109.3939158
56316,13,39,14,13,14,0,93,38.23737397348212,-109.3936463
56317,11,42,14,12,14,0,93,38.23737397348212,-109.3933768
56318,8,45,14,11,14,0,92,38.23737397348212,-109.3931073
56319,6,47,13,10,13,1,90,38.23737397348212,-109.3928378
56320,5,49,12,10,13,2,91,38.23737397348212,-109.3925683
56321,6,50,12,10,13,2,93,38.23737397348212,-109.3922988
56322,7,48,13,11,12,1,92,38.23737397348212,-109.3920293
56323,9,44,14,13,12,0,92,38.23737397348212,-109.3917598
56324,10,42,14,13,13,0,92,38.23737397348212,-109.3914903
56325,8,45,13,9,14,1,90,38.23737397348212,-109.3912208
56326,10,40,12,10,14,1,87,38.23737397348212,-109.3909513
56327,12,36,13,12,14,1,88,38.23737397348212,-109.3906818
56328,12,39,14,13,14,0,92,38.23737397348212,-109.3904123
56329,9,41,15,14,14,0,93,38.23737397348212,-109.3901429
56330,10,42,15,12,14,0,93,38.23737397348212,-109.3898734
56331,8,42,14,12,15,0,91,38.23737397348212,-109.3896039
56332,6,44,13,10,15,1,89,38.23737397348212,-109.3893344
56333,5,43,13,9,12,3,85,38.23737397348212,-109.3890649
56334,6,40,13,9,11,4,83,38.23737397348212,-109.3887954
56335,7,41,13,11,11,3,86,38.23737397348212,-109.3885259
56336,11,38,12,9,11,1,82,38.23737397348212,-109.3882564
56337,16,33,11,7,8,1,76,38.23737397348212,-109.3879869
56338,22,32,14,13,8,1,90,38.23737397348212,-109.3877174
56339,25,30,14,15,8,1,93,38.23737397348212,-109.3874479
56340,25,32,12,14,7,1,91,38.23737397348212,-109.3871784
56341,22,31,10,12,6,0,81,38.23737397348212,-109.3869089
56342,21,30,9,10,7,0,77,38.23737397348212,-109.3866394
56343,19,34,13,11,8,1,86,38.23737397348212,-109.3863699
56344,22,33,13,12,7,1,88,38.23737397348212,-109.3861004
56345,22,34,14,11,8,1,90,38.23737397348212,-109.3858309
56346,16,38,14,11,9,1,89,38.23737397348212,-109.3855614
56347,10,41,14,12,11,2,90,38.23737397348212,-109.3852919
56348,11,39,13,8,13,3,87,38.23737397348212,-109.3850225
56349,6,38,13,4,13,9,83,38.23737397348212,-109.384753
56350,4,37,12,3,13,8,77,38.23737397348212,-109.3844835
56351,4,38,12,4,15,6,79,38.23737397348212,-109.384214
56352,4,36,12,4,14,7,77,38.23737397348212,-109.3839445
56353,5,40,11,5,14,4,79,38.23737397348212,-109.383675
56354,8,42,11,6,15,2,84,38.23737397348212,-109.3834055
56355,9,42,11,7,15,1,85,38.23737397348212,-109.383136
56356,10,41,11,7,15,1,85,38.23737397348212,-109.3828665
56357,12,39,12,5,12,3,83,38.23737397348212,-109.382597
56358,15,33,13,8,10,2,81,38.23737397348212,-109.3823275
56359,13,32,12,9,9,2,77,38.23737397348212,-109.382058
56360,13,32,12,10,9,2,78,38.23737397348212,-109.3817885
56361,16,30,12,9,9,1,77,38.23737397348212,-109.381519
56362,17,26,14,10,6,3,76,38.23737397348212,-109.3812495
56363,15,30,11,9,9,2,76,38.23737397348212,-109.38098
56364,14,36,9,5,9,1,74,38.23737397348212,-109.3807105
56365,13,38,9,5,10,1,76,38.23737397348212,-109.380441
56366,13,40,11,6,10,1,81,38.23737397348212,-109.3801716
56367,17,38,12,7,10,1,85,38.23737397348212,-109.3799021
56368,16,23,11,10,9,1,70,38.23737397348212,-109.3796326
56369,10,22,10,13,11,2,68,38.23737397348212,-109.3793631
56370,10,30,13,11,10,3,77,38.23737397348212,-109.3790936
56371,12,39,13,9,11,1,85,38.23737397348212,-109.3788241
56372,12,41,13,7,11,1,85,38.23737397348212,-109.3785546
56373,11,41,12,7,11,2,84,38.23737397348212,-109.3782851
56374,11,41,12,7,10,2,83,38.23737397348212,-109.3780156
56375,9,40,13,9,10,3,84,38.23737397348212,-109.3777461
56376,8,40,14,12,10,2,86,38.23737397348212,-109.3774766
56377,9,42,15,12,11,2,91,38.23737397348212,-109.3772071
56378,8,43,15,10,10,2,88,38.23737397348212,-109.3769376
56379,6,45,14,9,11,3,88,38.23737397348212,-109.3766681
56380,5,45,13,8,12,3,86,38.23737397348212,-109.3763986
56381,4,47,12,6,14,2,85,38.23737397348212,-109.3761291
56382,3,42,12,4,14,7,82,38.23737397348212,-109.3758596
56383,4,36,12,3,11,11,77,38.23737397348212,-109.3755901
56384,5,32,11,5,10,11,74,38.23737397348212,-109.3753206
56385,4,35,10,9,11,5,74,38.23737397348212,-109.3750512
56386,4,45,10,6,13,2,80,38.23737397348212,-109.3747817
56387,1,46,7,2,12,5,73,38.23737397348212,-109.3745122
56388,0,46,7,1,11,5,70,38.23737397348212,-109.3742427
56389,1,47,8,2,12,4,74,38.23737397348212,-109.3739732
56390,1,45,8,1,12,6,73,38.23737397348212,-109.3737037
56391,2,44,9,2,12,6,75,38.23737397348212,-109.3734342
56392,3,42,10,0,12,9,76,38.23737397348212,-109.3731647
56393,2,34,11,0,10,12,69,38.23737397348212,-109.3728952
56394,1,31,12,0,8,16,68,38.23737397348212,-109.3726257
56395,2,29,12,0,6,19,68,38.23737397348212,-109.3723562
56396,4,36,13,0,10,14,77,38.23737397348212,-109.3720867
56397,5,43,13,3,13,8,85,38.23737397348212,-109.3718172
56398,4,46,13,4,14,5,86,38.23737397348212,-109.3715477
56399,5,46,12,2,13,7,85,38.23737397348212,-109.3712782
56400,4,42,12,1,11,10,80,38.23737397348212,-109.3710087
56401,2,43,10,0,12,10,77,38.23737397348212,-109.3707392
56402,1,39,10,0,12,10,72,38.23737397348212,-109.3704697
56403,1,36,10,0,15,8,70,38.23737397348212,-109.3702003
56404,2,34,9,3,15,4,67,38.23737397348212,-109.3699308
56405,1,24,8,8,13,1,55,38.23737397348212,-109.3696613
56406,1,37,8,9,9,2,66,38.23737397348212,-109.3693918
56407,0,47,6,3,8,3,67,38.23737397348212,-109.3691223
56408,0,51,5,1,8,4,69,38.23737397348212,-109.3688528
56409,1,51,6,2,9,5,74,38.23737397348212,-109.3685833
56410,0,44,6,2,9,6,67,38.23737397348212,-109.3683138
56411,1,39,8,2,9,7,66,38.23737397348212,-109.3680443
56412,2,43,10,0,11,9,75,38.23737397348212,-109.3677748
56413,3,43,11,1,10,10,78,38.23737397348212,-109.3675053
56414,2,41,10,0,8,12,73,38.23737397348212,-109.3672358
56415,2,44,10,1,10,10,77,38.23737397348212,-109.3669663
56416,2,44,10,0,11,10,77,38.23737397348212,-109.3666968
56417,3,40,11,0,9,12,75,38.23737397348212,-109.3664273
56418,4,40,12,0,8,12,76,38.23737397348212,-109.3661578
56419,5,43,12,4,13,5,82,38.23737397348212,-109.3658883
56420,7,46,12,6,13,2,86,38.23737397348212,-109.3656188
56421,5,48,13,5,13,3,87,38.23737397348212,-109.3653493
56422,4,46,12,6,13,3,84,38.23737397348212,-109.3650799
56423,5,47,13,3,14,5,87,38.23737397348212,-109.3648104
56424,5,44,11,2,12,6,80,38.23737397348212,-109.3645409
56425,3,43,11,3,13,6,79,38.23737397348212,-109.3642714
56426,3,42,11,3,14,6,79,38.23737397348212,-109.3640019
56427,3,35,11,2,9,12,72,38.23737397348212,-109.3637324
56428,3,32,11,0,7,13,66,38.23737397348212,-109.3634629
56429,1,38,10,0,11,9,69,38.23737397348212,-109.3631934
56430,1,44,9,2,14,4,74,38.23737397348212,-109.3629239
56431,2,46,9,3,15,2,77,38.23737397348212,-109.3626544
56432,4,27,9,6,10,1,57,38.23737397348212,-109.3623849
56433,5,45,9,7,12,1,79,38.23737397348212,-109.3621154
56434,2,42,8,4,12,4,72,38.23737397348212,-109.3618459
56435,2,38,9,4,11,5,69,38.23737397348212,-109.3615764
56436,3,36,9,4,10,5,67,38.23737397348212,-109.3613069
56437,1,29,9,4,8,9,60,38.23737397348212,-109.3610374
56438,4,31,10,4,9,8,66,38.23737397348212,-109.3607679
56439,5,35,10,4,11,7,72,38.23737397348212,-109.3604984
56440,3,37,10,4,11,7,72,38.23737397348212,-109.360229
56441,2,36,10,4,11,7,70,38.23737397348212,-109.3599595
56442,3,29,10,5,6,11,64,38.23737397348212,-109.35969
56443,2,29,10,5,6,11,63,38.23737397348212,-109.3594205
56444,2,34,10,2,8,11,67,38.23737397348212,-109.359151
56445,1,39,10,1,9,10,70,38.23737397348212,-109.3588815
56446,2,44,9,2,12,6,75,38.23737397348212,-109.358612
56447,3,40,8,4,9,4,68,38.23737397348212,-109.3583425
56448,2,33,8,4,10,5,62,38.23737397348212,-109.358073
56449,2,28,9,5,12,6,62,38.23737397348212,-109.3578035
56450,2,24,10,5,7,11,59,38.23737397348212,-109.357534
56451,2,25,12,6,7,13,65,38.23737397348212,-109.3572645
56452,2,33,10,4,9,11,69,38.23737397348212,-109.356995
56453,2,37,9,3,11,8,70,38.23737397348212,-109.3567255
56454,2,34,9,6,11,6,68,38.23737397348212,-109.356456
56455,9,23,12,12,8,8,72,38.23737397348212,-109.3561865
56456,31,17,14,16,9,3,90,38.23737397348212,-109.355917
56457,37,18,10,17,6,2,90,38.23737397348212,-109.3556475
56458,34,19,8,12,4,0,77,38.23737397348212,-109.355378
56459,29,19,6,10,4,0,68,38.23737397348212,-109.3551086
56460,34,17,10,18,7,1,87,38.23737397348212,-109.3548391
56461,25,18,10,15,9,1,78,38.23737397348212,-109.3545696
56462,21,21,9,14,7,1,73,38.23737397348212,-109.3543001
56463,23,20,9,15,7,1,75,38.23737397348212,-109.3540306
56464,29,19,11,19,11,3,92,38.23737397348212,-109.3537611
56465,20,21,13,19,12,5,90,38.23737397348212,-109.3534916
56466,11,18,14,13,9,9,74,38.23737397348212,-109.3532221
56467,4,19,11,7,8,10,59,38.23737397348212,-109.3529526
56468,1,25,9,4,8,8,55,38.23737397348212,-109.3526831
56469,2,23,8,6,9,7,55,38.23737397348212,-109.3524136
56470,3,24,9,4,10,7,57,38.23737397348212,-109.3521441
56471,2,26,9,3,9,9,58,38.23737397348212,-109.3518746
56472,2,33,9,2,9,10,65,38.23737397348212,-109.3516051
56473,2,36,9,1,10,9,67,38.23737397348212,-109.3513356
56474,12,40,14,12,14,1,93,38.23710447889688,-109.4068515
56475,12,39,14,14,15,0,94,38.23710447889688,-109.406582
56476,15,37,14,12,14,0,92,38.23710447889688,-109.4063125
56477,14,37,14,13,14,0,92,38.23710447889688,-109.406043
56478,14,36,14,13,14,0,91,38.23710447889688,-109.4057735
56479,15,36,14,13,14,0,92,38.23710447889688,-109.405504
56480,11,39,14,14,15,0,93,38.23710447889688,-109.4052345
56481,10,40,14,14,15,0,93,38.23710447889688,-109.4049651
56482,10,39,14,14,15,0,92,38.23710447889688,-109.4046956
56483,11,38,14,14,15,0,92,38.23710447889688,-109.4044261
56484,12,37,14,14,15,0,92,38.23710447889688,-109.4041566
56485,11,38,14,13,15,0,91,38.23710447889688,-109.4038871
56486,13,37,14,13,15,0,92,38.23710447889688,-109.4036176
56487,12,37,14,13,15,0,91,38.23710447889688,-109.4033481
56488,10,39,14,13,15,0,91,38.23710447889688,-109.4030786
56489,8,43,14,12,14,1,92,38.23710447889688,-109.4028091
56490,8,43,14,12,15,1,93,38.23710447889688,-109.4025396
56491,8,42,14,14,15,0,93,38.23710447889688,-109.4022701
56492,10,40,14,14,15,0,93,38.23710447889688,-109.4020006
56493,12,39,14,13,15,0,93,38.23710447889688,-109.4017311
56494,11,39,14,13,15,0,92,38.23710447889688,-109.4014616
56495,9,41,14,13,16,0,93,38.23710447889688,-109.4011921
56496,11,41,14,12,15,0,93,38.23710447889688,-109.4009226
56497,13,40,14,11,14,0,92,38.23710447889688,-109.4006531
56498,13,40,14,11,15,0,93,38.23710447889688,-109.4003836
56499,13,40,14,12,14,0,93,38.23710447889688,-109.4001142
56500,12,40,14,12,15,0,93,38.23710447889688,-109.3998447
56501,10,42,14,11,16,0,93,38.23710447889688,-109.3995752
56502,8,44,14,11,17,0,94,38.23710447889688,-109.3993057
56503,8,45,14,10,17,0,94,38.23710447889688,-109.3990362
56504,9,42,14,11,16,0,92,38.23710447889688,-109.3987667
56505,10,41,14,11,16,0,92,38.23710447889688,-109.3984972
56506,9,42,14,11,16,0,92,38.23710447889688,-109.3982277
56507,9,43,14,11,16,0,93,38.23710447889688,-109.3979582
56508,9,43,14,11,15,0,92,38.23710447889688,-109.3976887
56509,10,42,14,11,15,0,92,38.23710447889688,-109.3974192
56510,9,42,14,11,15,0,91,38.23710447889688,-109.3971497
56511,8,44,14,12,15,1,94,38.23710447889688,-109.3968802
56512,6,43,14,12,14,1,90,38.23710447889688,-109.3966107
56513,8,44,14,12,14,1,93,38.23710447889688,-109.3963412
56514,10,43,13,12,15,0,93,38.23710447889688,-109.3960717
56515,11,45,12,10,15,0,93,38.23710447889688,-109.3958022
56516,11,46,12,9,14,0,92,38.23710447889688,-109.3955327
56517,13,42,13,10,13,0,91,38.23710447889688,-109.3952632
56518,14,41,14,11,13,0,93,38.23710447889688,-109.3949938
56519,14,43,14,11,13,0,95,38.23710447889688,-109.3947243
56520,14,42,14,12,13,0,95,38.23710447889688,-109.3944548
56521,14,39,14,12,13,0,92,38.23710447889688,-109.3941853
56522,13,39,14,12,15,0,93,38.23710447889688,-109.3939158
56523,12,41,14,12,14,0,93,38.23710447889688,-109.3936463
56524,10,43,14,12,14,0,93,38.23710447889688,-109.3933768
56525,8,45,14,11,14,1,93,38.23710447889688,-109.3931073
56526,6,45,13,10,13,2,89,38.23710447889688,-109.3928378
56527,5,48,13,9,13,2,90,38.23710447889688,-109.3925683
56528,5,50,12,8,13,2,90,38.23710447889688,-109.3922988
56529,7,49,13,10,12,1,92,38.23710447889688,-109.3920293
56530,9,45,14,12,12,0,92,38.23710447889688,-109.3917598
56531,8,45,14,13,13,0,93,38.23710447889688,-109.3914903
56532,7,47,14,11,14,0,93,38.23710447889688,-109.3912208
56533,9,43,13,11,14,0,90,38.23710447889688,-109.3909513
56534,12,40,13,11,14,0,90,38.23710447889688,-109.3906818
56535,13,39,14,12,13,0,91,38.23710447889688,-109.3904123
56536,12,42,14,11,14,0,93,38.23710447889688,-109.3901429
56537,11,42,14,11,14,0,92,38.23710447889688,-109.3898734
56538,7,46,13,9,16,0,91,38.23710447889688,-109.3896039
56539,5,49,12,8,15,1,90,38.23710447889688,-109.3893344
56540,5,49,12,7,14,2,89,38.23710447889688,-109.3890649
56541,5,45,12,9,12,2,85,38.23710447889688,-109.3887954
56542,7,42,13,10,11,3,86,38.23710447889688,-109.3885259
56543,11,35,10,7,9,1,73,38.23710447889688,-109.3882564
56544,15,33,10,6,7,0,71,38.23710447889688,-109.3879869
56545,19,36,14,13,9,1,92,38.23710447889688,-109.3877174
56546,20,37,15,13,10,1,96,38.23710447889688,-109.3874479
56547,22,35,13,13,8,1,92,38.23710447889688,-109.3871784
56548,22,32,10,12,7,0,83,38.23710447889688,-109.3869089
56549,20,31,9,9,6,0,75,38.23710447889688,-109.3866394
56550,20,32,12,9,7,1,81,38.23710447889688,-109.3863699
56551,22,33,13,11,8,1,88,38.23710447889688,-109.3861004
56552,20,35,14,11,8,1,89,38.23710447889688,-109.3858309
56553,15,39,14,11,10,2,91,38.23710447889688,-109.3855614
56554,11,40,14,11,11,2,89,38.23710447889688,-109.3852919
56555,13,38,13,8,14,1,87,38.23710447889688,-109.3850225
56556,4,38,12,4,14,7,79,38.23710447889688,-109.384753
56557,3,37,11,4,14,7,76,38.23710447889688,-109.3844835
56558,3,37,11,4,15,5,75,38.23710447889688,-109.384214
56559,3,43,10,4,17,2,79,38.23710447889688,-109.3839445
56560,4,44,10,5,16,2,81,38.23710447889688,-109.383675
56561,4,42,10,6,15,3,80,38.23710447889688,-109.3834055
56562,5,40,11,7,14,3,80,38.23710447889688,-109.383136
56563,7,40,11,8,14,2,82,38.23710447889688,-109.3828665
56564,13,38,12,9,14,1,87,38.23710447889688,-109.382597
56565,17,32,12,11,12,1,85,38.23710447889688,-109.3823275
56566,15,31,13,10,11,1,81,38.23710447889688,-109.382058
56567,15,30,13,10,9,2,79,38.23710447889688,-109.3817885
56568,16,30,13,10,9,1,79,38.23710447889688,-109.381519
56569,14,35,14,10,8,3,84,38.23710447889688,-109.3812495
56570,12,36,12,8,9,2,79,38.23710447889688,-109.38098
56571,11,39,10,7,11,1,79,38.23710447889688,-109.3807105
56572,11,41,9,7,10,1,79,38.23710447889688,-109.380441
56573,15,42,10,6,11,0,84,38.23710447889688,-109.3801716
56574,17,40,11,7,11,0,86,38.23710447889688,-109.3799021
56575,18,28,11,8,10,1,76,38.23710447889688,-109.3796326
56576,9,19,10,14,11,2,65,38.23710447889688,-109.3793631
56577,8,24,10,15,11,2,70,38.23710447889688,-109.3790936
56578,10,41,12,9,12,1,85,38.23710447889688,-109.3788241
56579,6,45,10,7,11,2,81,38.23710447889688,-109.3785546
56580,7,43,10,7,11,2,80,38.23710447889688,-109.3782851
56581,8,41,11,7,11,2,80,38.23710447889688,-109.3780156
56582,8,40,12,7,11,3,81,38.23710447889688,-109.3777461
56583,7,44,13,8,10,3,85,38.23710447889688,-109.3774766
56584,7,44,13,9,11,2,86,38.23710447889688,-109.3772071
56585,7,45,13,9,11,2,87,38.23710447889688,-109.3769376
56586,6,44,14,10,11,2,87,38.23710447889688,-109.3766681
56587,6,42,14,10,11,3,86,38.23710447889688,-109.3763986
56588,6,43,14,10,13,2,88,38.23710447889688,-109.3761291
56589,4,48,13,7,14,4,90,38.23710447889688,-109.3758596
56590,3,48,11,4,13,7,86,38.23710447889688,-109.3755901
56591,5,43,11,5,12,7,83,38.23710447889688,-109.3753206
56592,8,35,11,10,12,5,81,38.23710447889688,-109.3750512
56593,6,43,11,10,13,2,85,38.23710447889688,-109.3747817
56594,2,45,9,5,14,3,78,38.23710447889688,-109.3745122
56595,2,44,9,3,13,4,75,38.23710447889688,-109.3742427
56596,2,43,10,3,13,5,76,38.23710447889688,-109.3739732
56597,2,42,10,3,12,6,75,38.23710447889688,-109.3737037
56598,2,44,10,1,12,7,76,38.23710447889688,-109.3734342
56599,3,38,11,0,12,10,74,38.23710447889688,-109.3731647
56600,2,33,12,0,9,17,73,38.23710447889688,-109.3728952
56601,1,31,12,0,7,20,71,38.23710447889688,-109.3726257
56602,4,36,12,0,11,13,76,38.23710447889688,-109.3723562
56603,5,41,13,3,13,8,83,38.23710447889688,-109.3720867
56604,5,45,13,4,13,6,86,38.23710447889688,-109.3718172
56605,4,46,12,3,13,6,84,38.23710447889688,-109.3715477
56606,3,43,10,1,11,8,76,38.23710447889688,-109.3712782
56607,3,41,10,1,11,8,74,38.23710447889688,-109.3710087
56608,2,40,10,0,10,11,73,38.23710447889688,-109.3707392
56609,2,40,10,0,10,11,73,38.23710447889688,-109.3704697
56610,1,40,9,0,11,9,70,38.23710447889688,-109.3702003
56611,1,44,8,2,10,5,70,38.23710447889688,-109.3699308
56612,2,47,8,4,10,1,72,38.23710447889688,-109.3696613
56613,1,46,6,3,9,3,68,38.23710447889688,-109.3693918
56614,0,50,6,2,9,4,71,38.23710447889688,-109.3691223
56615,1,54,6,3,10,3,77,38.23710447889688,-109.3688528
56616,1,44,7,2,9,6,69,38.23710447889688,-109.3685833
56617,2,42,9,4,11,6,74,38.23710447889688,-109.3683138
56618,3,44,11,4,13,5,80,38.23710447889688,-109.3680443
56619,3,45,10,0,13,7,78,38.23710447889688,-109.3677748
56620,3,48,10,1,13,6,81,38.23710447889688,-109.3675053
56621,2,45,10,2,12,7,78,38.23710447889688,-109.3672358
56622,2,43,10,1,12,9,77,38.23710447889688,-109.3669663
56623,1,38,10,0,9,13,71,38.23710447889688,-109.3666968
56624,3,33,11,0,7,14,68,38.23710447889688,-109.3664273
56625,4,43,11,0,11,9,78,38.23710447889688,-109.3661578
56626,6,47,12,5,14,3,87,38.23710447889688,-109.3658883
56627,9,49,13,6,14,1,92,38.23710447889688,-109.3656188
56628,6,49,13,4,14,2,88,38.23710447889688,-109.3653493
56629,4,48,12,4,13,4,85,38.23710447889688,-109.3650799
56630,5,46,13,3,13,6,86,38.23710447889688,-109.3648104
56631,4,36,12,3,10,10,75,38.23710447889688,-109.3645409
56632,4,35,11,3,10,9,72,38.23710447889688,-109.3642714
56633,4,38,11,3,11,7,74,38.23710447889688,-109.3640019
56634,2,34,10,0,8,13,67,38.23710447889688,-109.3637324
56635,1,31,11,0,7,14,64,38.23710447889688,-109.3634629
56636,1,39,10,0,10,11,71,38.23710447889688,-109.3631934
56637,2,42,9,1,10,9,73,38.23710447889688,-109.3629239
56638,2,40,9,3,9,7,70,38.23710447889688,-109.3626544
56639,6,42,10,6,10,2,76,38.23710447889688,-109.3623849
56640,2,42,7,4,11,4,70,38.23710447889688,-109.3621154
56641,1,38,7,2,10,5,63,38.23710447889688,-109.3618459
56642,1,38,7,2,10,4,62,38.23710447889688,-109.3615764
56643,2,34,8,4,11,3,62,38.23710447889688,-109.3613069
56644,3,30,9,4,10,6,62,38.23710447889688,-109.3610374
56645,3,33,9,5,11,6,67,38.23710447889688,-109.3607679
56646,3,38,9,3,12,6,71,38.23710447889688,-109.3604984
56647,3,43,10,3,12,6,77,38.23710447889688,-109.360229
56648,3,44,10,3,11,7,78,38.23710447889688,-109.3599595
56649,3,32,10,4,9,10,68,38.23710447889688,-109.35969
56650,2,31,10,4,8,11,66,38.23710447889688,-109.3594205
56651,1,36,9,3,9,10,68,38.23710447889688,-109.359151
56652,1,44,9,1,10,7,72,38.23710447889688,-109.3588815
56653,1,47,8,2,10,5,73,38.23710447889688,-109.358612
56654,2,41,8,4,10,3,68,38.23710447889688,-109.3583425
56655,2,35,8,4,10,4,63,38.23710447889688,-109.358073
56656,5,28,9,4,12,5,63,38.23710447889688,-109.3578035
56657,2,26,11,4,6,13,62,38.23710447889688,-109.357534
56658,1,28,11,4,8,13,65,38.23710447889688,-109.3572645
56659,1,35,9,2,11,9,67,38.23710447889688,-109.356995
56660,2,36,8,4,11,6,67,38.23710447889688,-109.3567255
56661,3,32,9,5,9,7,65,38.23710447889688,-109.356456
56662,7,23,11,8,8,9,66,38.23710447889688,-109.3561865
56663,25,19,16,13,9,4,86,38.23710447889688,-109.355917
56664,34,16,11,18,8,2,89,38.23710447889688,-109.3556475
56665,35,13,9,16,5,1,79,38.23710447889688,-109.355378
56666,32,12,8,14,6,1,73,38.23710447889688,-109.3551086
56667,34,12,10,17,8,3,84,38.23710447889688,-109.3548391
56668,24,15,10,16,8,2,75,38.23710447889688,-109.3545696
56669,23,20,9,15,7,1,75,38.23710447889688,-109.3543001
56670,28,18,9,16,7,1,79,38.23710447889688,-109.3540306
56671,32,15,11,22,10,3,93,38.23710447889688,-109.3537611
56672,28,15,11,28,10,2,94,38.23710447889688,-109.3534916
56673,16,17,13,21,13,8,88,38.23710447889688,-109.3532221
56674,4,17,13,9,8,15,66,38.23710447889688,-109.3529526
56675,2,24,10,5,9,11,61,38.23710447889688,-109.3526831
56676,2,26,9,5,11,6,59,38.23710447889688,-109.3524136
56677,2,23,9,4,10,8,56,38.23710447889688,-109.3521441
56678,1,25,10,3,10,9,58,38.23710447889688,-109.3518746
56679,1,30,9,1,8,10,59,38.23710447889688,-109.3516051
56680,3,33,8,2,8,8,62,38.23710447889688,-109.3513356
56681,13,39,13,12,14,0,91,38.23683498431165,-109.4068515
56682,15,37,14,12,14,0,92,38.23683498431165,-109.406582
56683,17,36,14,12,14,0,93,38.23683498431165,-109.4063125
56684,16,36,14,12,14,0,92,38.23683498431165,-109.406043
56685,14,36,14,13,14,0,91,38.23683498431165,-109.4057735
56686,13,36,14,13,14,1,91,38.23683498431165,-109.405504
56687,10,39,14,14,14,1,92,38.23683498431165,-109.4052345
56688,10,39,14,14,15,0,92,38.23683498431165,-109.4049651
56689,11,38,14,14,15,0,92,38.23683498431165,-109.4046956
56690,11,38,14,14,15,0,92,38.23683498431165,-109.4044261
56691,11,37,14,14,15,0,91,38.23683498431165,-109.4041566
56692,10,39,14,13,16,0,92,38.23683498431165,-109.4038871
56693,10,39,14,13,16,0,92,38.23683498431165,-109.4036176
56694,9,39,14,13,16,0,91,38.23683498431165,-109.4033481
56695,8,40,14,13,16,1,92,38.23683498431165,-109.4030786
56696,10,40,14,12,15,1,92,38.23683498431165,-109.4028091
56697,8,42,14,12,15,1,92,38.23683498431165,-109.4025396
56698,7,42,14,13,16,0,92,38.23683498431165,-109.4022701
56699,9,41,14,13,16,0,93,38.23683498431165,-109.4020006
56700,11,39,14,13,15,0,92,38.23683498431165,-109.4017311
56701,12,38,14,13,15,0,92,38.23683498431165,-109.4014616
56702,12,39,14,13,14,0,92,38.23683498431165,-109.4011921
56703,11,39,14,13,15,0,92,38.23683498431165,-109.4009226
56704,12,40,15,12,15,0,94,38.23683498431165,-109.4006531
56705,13,39,15,12,15,0,94,38.23683498431165,-109.4003836
56706,15,38,14,11,13,0,91,38.23683498431165,-109.4001142
56707,13,39,14,11,14,0,91,38.23683498431165,-109.3998447
56708,10,42,14,11,16,0,93,38.23683498431165,-109.3995752
56709,8,43,14,11,16,0,92,38.23683498431165,-109.3993057
56710,9,43,15,11,16,0,94,38.23683498431165,-109.3990362
56711,8,43,14,10,16,0,91,38.23683498431165,-109.3987667
56712,10,41,14,11,16,0,92,38.23683498431165,-109.3984972
56713,12,40,14,11,15,0,92,38.23683498431165,-109.3982277
56714,12,40,14,11,15,0,92,38.23683498431165,-109.3979582
56715,12,42,14,11,14,0,93,38.23683498431165,-109.3976887
56716,11,41,14,11,15,0,92,38.23683498431165,-109.3974192
56717,8,43,14,11,16,0,92,38.23683498431165,-109.3971497
56718,6,44,14,12,15,1,92,38.23683498431165,-109.3968802
56719,6,45,14,12,13,1,91,38.23683498431165,-109.3966107
56720,10,43,14,12,13,0,92,38.23683498431165,-109.3963412
56721,12,44,13,11,14,0,94,38.23683498431165,-109.3960717
56722,12,44,12,9,14,0,91,38.23683498431165,-109.3958022
56723,14,44,12,9,13,0,92,38.23683498431165,-109.3955327
56724,14,41,13,11,13,0,92,38.23683498431165,-109.3952632
56725,12,42,13,11,14,0,92,38.23683498431165,-109.3949938
56726,12,43,13,11,13,0,92,38.23683498431165,-109.3947243
56727,13,43,14,11,13,0,94,38.23683498431165,-109.3944548
56728,12,42,14,12,13,0,93,38.23683498431165,-109.3941853
56729,10,43,14,10,16,0,93,38.23683498431165,-109.3939158
56730,11,43,14,11,15,0,94,38.23683498431165,-109.3936463
56731,10,44,14,10,14,0,92,38.23683498431165,-109.3933768
56732,8,45,14,11,14,1,93,38.23683498431165,-109.3931073
56733,8,43,14,10,13,1,89,38.23683498431165,-109.3928378
56734,6,46,13,9,13,2,89,38.23683498431165,-109.3925683
56735,5,48,13,8,13,2,89,38.23683498431165,-109.3922988
56736,6,49,13,8,13,1,90,38.23683498431165,-109.3920293
56737,6,47,14,10,13,1,91,38.23683498431165,-109.3917598
56738,6,46,14,11,14,0,91,38.23683498431165,-109.3914903
56739,5,48,13,10,14,1,91,38.23683498431165,-109.3912208
56740,7,46,12,10,14,0,89,38.23683498431165,-109.3909513
56741,11,43,13,10,14,0,91,38.23683498431165,-109.3906818
56742,14,39,14,12,14,0,93,38.23683498431165,-109.3904123
56743,14,40,14,11,13,0,92,38.23683498431165,-109.3901429
56744,12,41,14,11,15,0,93,38.23683498431165,-109.3898734
56745,9,45,14,10,16,0,94,38.23683498431165,-109.3896039
56746,7,50,13,8,16,0,94,38.23683498431165,-109.3893344
56747,6,50,12,8,15,0,91,38.23683498431165,-109.3890649
56748,6,46,13,9,14,1,89,38.23683498431165,-109.3887954
56749,7,45,13,10,12,3,90,38.23683498431165,-109.3885259
56750,11,33,8,4,8,0,64,38.23683498431165,-109.3882564
56751,17,29,7,4,6,0,63,38.23683498431165,-109.3879869
56752,20,33,10,7,7,0,77,38.23683498431165,-109.3877174
56753,18,38,13,12,9,1,91,38.23683498431165,-109.3874479
56754,20,36,13,12,9,1,91,38.23683498431165,-109.3871784
56755,20,34,13,11,8,1,87,38.23683498431165,-109.3869089
56756,18,34,12,10,8,1,83,38.23683498431165,-109.3866394
56757,16,37,14,10,10,1,88,38.23683498431165,-109.3863699
56758,13,38,14,12,11,2,90,38.23683498431165,-109.3861004
56759,14,40,14,11,11,2,92,38.23683498431165,-109.3858309
56760,11,41,14,11,11,2,90,38.23683498431165,-109.3855614
56761,8,40,13,11,12,2,86,38.23683498431165,-109.3852919
56762,12,38,13,11,14,1,89,38.23683498431165,-109.3850225
56763,5,36,12,7,15,4,79,38.23683498431165,-109.384753
56764,5,37,12,5,14,6,79,38.23683498431165,-109.3844835
56765,6,35,12,7,15,5,80,38.23683498431165,-109.384214
56766,5,35,11,8,14,4,77,38.23683498431165,-109.3839445
56767,5,39,10,5,14,4,77,38.23683498431165,-109.383675
56768,5,40,10,5,14,4,78,38.23683498431165,-109.3834055
56769,6,40,10,5,13,4,78,38.23683498431165,-109.383136
56770,10,39,11,6,14,2,82,38.23683498431165,-109.3828665
56771,13,41,12,10,14,0,90,38.23683498431165,-109.382597
56772,14,38,12,9,13,1,87,38.23683498431165,-109.3823275
56773,15,34,12,9,12,1,83,38.23683498431165,-109.382058
56774,15,31,12,11,12,1,82,38.23683498431165,-109.3817885
56775,15,34,13,12,10,1,85,38.23683498431165,-109.381519
56776,12,33,12,10,11,2,80,38.23683498431165,-109.3812495
56777,12,35,12,10,12,2,83,38.23683498431165,-109.38098
56778,13,38,12,10,12,1,86,38.23683498431165,-109.3807105
56779,14,41,12,9,12,0,88,38.23683498431165,-109.380441
56780,13,43,12,9,11,0,88,38.23683498431165,-109.3801716
56781,13,40,11,9,11,1,85,38.23683498431165,-109.3799021
56782,12,32,11,12,12,1,80,38.23683498431165,-109.3796326
56783,10,21,10,15,10,2,68,38.23683498431165,-109.3793631
56784,8,22,10,15,10,2,67,38.23683498431165,-109.3790936
56785,7,40,11,9,12,1,80,38.23683498431165,-109.3788241
56786,5,49,10,7,11,2,84,38.23683498431165,-109.3785546
56787,4,49,10,6,11,2,82,38.23683498431165,-109.3782851
56788,5,44,10,7,12,2,80,38.23683498431165,-109.3780156
56789,6,40,12,8,12,3,81,38.23683498431165,-109.3777461
56790,7,42,13,8,11,3,84,38.23683498431165,-109.3774766
56791,7,46,13,9,11,1,87,38.23683498431165,-109.3772071
56792,6,46,13,9,11,2,87,38.23683498431165,-109.3769376
56793,6,44,13,9,10,2,84,38.23683498431165,-109.3766681
56794,6,43,13,9,10,3,84,38.23683498431165,-109.3763986
56795,3,45,10,6,11,3,78,38.23683498431165,-109.3761291
56796,3,49,9,5,12,3,81,38.23683498431165,-109.3758596
56797,2,50,9,5,12,3,81,38.23683498431165,-109.3755901
56798,3,50,10,5,12,4,84,38.23683498431165,-109.3753206
56799,4,44,11,4,12,6,81,38.23683498431165,-109.3750512
56800,4,48,11,6,13,4,86,38.23683498431165,-109.3747817
56801,3,47,10,4,13,4,81,38.23683498431165,-109.3745122
56802,4,43,11,5,13,5,81,38.23683498431165,-109.3742427
56803,6,41,12,7,12,5,83,38.23683498431165,-109.3739732
56804,4,42,11,3,13,6,79,38.23683498431165,-109.3737037
56805,4,44,12,2,14,7,83,38.23683498431165,-109.3734342
56806,4,40,12,2,13,9,80,38.23683498431165,-109.3731647
56807,4,38,12,2,12,12,80,38.23683498431165,-109.3728952
56808,4,39,12,2,14,10,81,38.23683498431165,-109.3726257
56809,4,47,12,3,15,6,87,38.23683498431165,-109.3723562
56810,5,45,12,4,13,4,83,38.23683498431165,-109.3720867
56811,4,45,10,4,11,5,79,38.23683498431165,-109.3718172
56812,3,46,9,2,11,6,77,38.23683498431165,-109.3715477
56813,2,41,10,3,12,7,75,38.23683498431165,-109.3712782
56814,2,37,10,0,11,9,69,38.23683498431165,-109.3710087
56815,3,33,11,0,9,13,69,38.23683498431165,-109.3707392
56816,2,33,11,1,8,14,69,38.23683498431165,-109.3704697
56817,2,36,10,1,10,11,70,38.23683498431165,-109.3702003
56818,3,42,11,4,12,6,78,38.23683498431165,-109.3699308
56819,1,46,8,3,11,3,72,38.23683498431165,-109.3696613
56820,0,45,7,2,10,3,67,38.23683498431165,-109.3693918
56821,1,47,7,3,10,3,71,38.23683498431165,-109.3691223
56822,1,44,7,2,10,5,69,38.23683498431165,-109.3688528
56823,2,38,9,3,9,9,70,38.23683498431165,-109.3685833
56824,3,44,11,2,11,8,79,38.23683498431165,-109.3683138
56825,4,47,10,1,12,7,81,38.23683498431165,-109.3680443
56826,3,49,9,1,14,5,81,38.23683498431165,-109.3677748
56827,3,45,10,1,12,8,79,38.23683498431165,-109.3675053
56828,3,41,11,2,12,8,77,38.23683498431165,-109.3672358
56829,2,39,11,2,12,8,74,38.23683498431165,-109.3669663
56830,1,35,11,1,10,11,69,38.23683498431165,-109.3666968
56831,1,33,10,0,9,12,65,38.23683498431165,-109.3664273
56832,4,44,10,1,15,5,79,38.23683498431165,-109.3661578
56833,6,45,12,6,15,2,86,38.23683498431165,-109.3658883
56834,7,46,13,7,15,1,89,38.23683498431165,-109.3656188
56835,7,47,13,6,15,1,89,38.23683498431165,-109.3653493
56836,5,48,13,4,14,3,87,38.23683498431165,-109.3650799
56837,5,46,14,5,14,3,87,38.23683498431165,-109.3648104
56838,4,43,12,2,13,7,81,38.23683498431165,-109.3645409
56839,4,37,11,1,9,12,74,38.23683498431165,-109.3642714
56840,3,32,11,1,7,14,68,38.23683498431165,-109.3640019
56841,2,34,10,1,7,13,67,38.23683498431165,-109.3637324
56842,2,41,10,1,13,7,74,38.23683498431165,-109.3634629
56843,2,45,10,1,12,8,78,38.23683498431165,-109.3631934
56844,2,41,11,0,11,11,76,38.23683498431165,-109.3629239
56845,3,33,12,1,7,15,71,38.23683498431165,-109.3626544
56846,4,38,11,2,10,9,74,38.23683498431165,-109.3623849
56847,3,39,9,5,10,3,69,38.23683498431165,-109.3621154
56848,1,47,7,3,10,2,70,38.23683498431165,-109.3618459
56849,2,48,7,3,10,2,72,38.23683498431165,-109.3615764
56850,1,42,8,3,10,3,67,38.23683498431165,-109.3613069
56851,1,39,8,2,9,6,65,38.23683498431165,-109.3610374
56852,2,38,8,3,10,6,67,38.23683498431165,-109.3607679
56853,2,39,10,4,12,6,73,38.23683498431165,-109.3604984
56854,3,41,11,2,12,9,78,38.23683498431165,-109.360229
56855,4,41,11,3,10,8,77,38.23683498431165,-109.3599595
56856,3,28,11,4,8,12,66,38.23683498431165,-109.35969
56857,3,33,10,4,9,9,68,38.23683498431165,-109.3594205
56858,1,40,9,3,11,6,70,38.23683498431165,-109.359151
56859,2,44,9,4,10,5,74,38.23683498431165,-109.3588815
56860,2,46,9,4,10,4,75,38.23683498431165,-109.358612
56861,2,41,8,4,9,3,67,38.23683498431165,-109.3583425
56862,2,34,7,3,11,4,61,38.23683498431165,-109.358073
56863,6,29,9,5,12,4,65,38.23683498431165,-109.3578035
56864,3,23,13,6,9,13,67,38.23683498431165,-109.357534
56865,2,34,10,4,8,11,69,38.23683498431165,-109.3572645
56866,3,37,8,5,11,5,69,38.23683498431165,-109.356995
56867,4,33,9,5,11,5,67,38.23683498431165,-109.3567255
56868,6,26,10,8,9,7,66,38.23683498431165,-109.356456
56869,16,20,12,12,9,5,74,38.23683498431165,-109.3561865
56870,33,19,14,15,9,1,91,38.23683498431165,-109.355917
56871,34,16,10,20,6,1,87,38.23683498431165,-109.3556475
56872,33,11,9,17,6,2,78,38.23683498431165,-109.355378
56873,33,8,11,17,7,6,82,38.23683498431165,-109.3551086
56874,32,8,11,19,8,7,85,38.23683498431165,-109.3548391
56875,23,11,11,18,11,3,77,38.23683498431165,-109.3545696
56876,29,15,10,15,8,1,78,38.23683498431165,-109.3543001
56877,34,15,10,16,7,1,83,38.23683498431165,-109.3540306
56878,35,13,10,20,11,2,91,38.23683498431165,-109.3537611
56879,30,12,11,23,12,6,94,38.23683498431165,-109.3534916
56880,8,20,15,15,12,15,85,38.23683498431165,-109.3532221
56881,2,20,13,6,6,20,67,38.23683498431165,-109.3529526
56882,1,27,11,3,12,11,65,38.23683498431165,-109.3526831
56883,1,30,11,4,14,7,67,38.23683498431165,-109.3524136
56884,1,24,11,5,10,10,61,38.23683498431165,-109.3521441
56885,2,24,11,3,10,9,59,38.23683498431165,-109.3518746
56886,3,34,9,4,8,7,65,38.23683498431165,-109.3516051
56887,3,37,7,3,9,4,63,38.23683498431165,-109.3513356
56888,14,38,14,13,14,0,93,38.23656548972641,-109.4068515
56889,13,36,14,13,14,0,90,38.23656548972641,-109.406582
56890,16,35,14,13,13,1,92,38.23656548972641,-109.4063125
56891,15,36,14,13,13,1,92,38.23656548972641,-109.406043
56892,13,36,14,13,14,1,91,38.23656548972641,-109.4057735
56893,13,36,14,13,14,1,91,38.23656548972641,-109.405504
56894,13,36,14,14,15,0,92,38.23656548972641,-109.4052345
56895,11,38,14,14,15,1,93,38.23656548972641,-109.4049651
56896,11,38,14,14,15,1,93,38.23656548972641,-109.4046956
56897,11,37,14,14,14,1,91,38.23656548972641,-109.4044261
56898,10,37,14,14,14,1,90,38.23656548972641,-109.4041566
56899,10,38,14,15,15,0,92,38.23656548972641,-109.4038871
56900,10,39,14,14,15,0,92,38.23656548972641,-109.4036176
56901,9,39,14,13,16,1,92,38.23656548972641,-109.4033481
56902,8,40,14,13,16,1,92,38.23656548972641,-109.4030786
56903,9,40,14,13,16,0,92,38.23656548972641,-109.4028091
56904,10,41,14,13,15,0,93,38.23656548972641,-109.4025396
56905,11,40,14,13,15,0,93,38.23656548972641,-109.4022701
56906,12,38,14,14,15,0,93,38.23656548972641,-109.4020006
56907,12,37,14,15,15,0,93,38.23656548972641,-109.4017311
56908,13,36,14,14,14,0,91,38.23656548972641,-109.4014616
56909,13,36,15,14,14,0,92,38.23656548972641,-109.4011921
56910,14,38,15,12,14,0,93,38.23656548972641,-109.4009226
56911,14,38,15,12,15,0,94,38.23656548972641,-109.4006531
56912,16,36,14,12,14,0,92,38.23656548972641,-109.4003836
56913,22,34,14,11,12,0,93,38.23656548972641,-109.4001142
56914,17,36,14,11,14,0,92,38.23656548972641,-109.3998447
56915,12,40,14,11,15,0,92,38.23656548972641,-109.3995752
56916,9,42,14,11,15,0,91,38.23656548972641,-109.3993057
56917,8,41,14,12,15,1,91,38.23656548972641,-109.3990362
56918,7,42,14,11,15,1,90,38.23656548972641,-109.3987667
56919,9,42,14,11,15,0,91,38.23656548972641,-109.3984972
56920,12,40,14,11,14,0,91,38.23656548972641,-109.3982277
56921,14,39,14,12,13,0,92,38.23656548972641,-109.3979582
56922,13,40,14,11,14,0,92,38.23656548972641,-109.3976887
56923,9,42,14,12,15,0,92,38.23656548972641,-109.3974192
56924,7,44,14,12,15,1,93,38.23656548972641,-109.3971497
56925,6,43,14,12,14,1,90,38.23656548972641,-109.3968802
56926,8,43,14,13,13,1,92,38.23656548972641,-109.3966107
56927,12,43,14,11,13,0,93,38.23656548972641,-109.3963412
56928,11,44,13,10,14,0,92,38.23656548972641,-109.3960717
56929,13,44,12,10,14,0,93,38.23656548972641,-109.3958022
56930,16,41,13,9,13,0,92,38.23656548972641,-109.3955327
56931,16,39,14,11,13,0,93,38.23656548972641,-109.3952632
56932,13,40,14,12,14,0,93,38.23656548972641,-109.3949938
56933,12,41,14,12,14,0,93,38.23656548972641,-109.3947243
56934,11,43,14,11,13,0,92,38.23656548972641,-109.3944548
56935,10,44,14,11,14,0,93,38.23656548972641,-109.3941853
56936,8,44,14,11,16,0,93,38.23656548972641,-109.3939158
56937,11,43,14,11,15,0,94,38.23656548972641,-109.3936463
56938,11,43,14,11,14,0,93,38.23656548972641,-109.3933768
56939,9,43,14,11,13,1,91,38.23656548972641,-109.3931073
56940,8,45,14,10,13,1,91,38.23656548972641,-109.3928378
56941,7,45,14,11,13,1,91,38.23656548972641,-109.3925683
56942,5,47,13,9,14,1,89,38.23656548972641,-109.3922988
56943,5,46,13,8,14,2,88,38.23656548972641,-109.3920293
56944,5,46,13,8,14,2,88,38.23656548972641,-109.3917598
56945,5,47,14,10,14,1,91,38.23656548972641,-109.3914903
56946,4,48,12,8,13,2,87,38.23656548972641,-109.3912208
56947,5,46,11,8,14,1,85,38.23656548972641,-109.3909513
56948,9,42,12,9,15,1,88,38.23656548972641,-109.3906818
56949,13,38,14,12,14,0,91,38.23656548972641,-109.3904123
56950,14,38,14,12,13,0,91,38.23656548972641,-109.3901429
56951,11,40,14,12,14,0,91,38.23656548972641,-109.3898734
56952,9,45,14,10,15,0,93,38.23656548972641,-109.3896039
56953,8,50,13,8,16,0,95,38.23656548972641,-109.3893344
56954,7,50,12,7,15,0,91,38.23656548972641,-109.3890649
56955,10,41,13,9,14,1,88,38.23656548972641,-109.3887954
56956,7,45,13,9,12,3,89,38.23656548972641,-109.3885259
56957,8,41,12,9,12,1,83,38.23656548972641,-109.3882564
56958,14,33,9,6,8,0,70,38.23656548972641,-109.3879869
56959,18,31,8,5,6,0,68,38.23656548972641,-109.3877174
56960,20,36,12,11,8,1,88,38.23656548972641,-109.3874479
56961,18,39,14,12,10,1,94,38.23656548972641,-109.3871784
56962,14,41,15,12,10,1,93,38.23656548972641,-109.3869089
56963,11,42,15,13,11,1,93,38.23656548972641,-109.3866394
56964,12,41,15,13,11,1,93,38.23656548972641,-109.3863699
56965,11,42,15,13,11,1,93,38.23656548972641,-109.3861004
56966,13,42,14,12,11,1,93,38.23656548972641,-109.3858309
56967,11,42,12,10,12,2,89,38.23656548972641,-109.3855614
56968,8,40,12,10,12,3,85,38.23656548972641,-109.3852919
56969,8,34,13,12,15,2,84,38.23656548972641,-109.3850225
56970,8,35,13,10,13,4,83,38.23656548972641,-109.384753
56971,9,37,12,9,12,4,83,38.23656548972641,-109.3844835
56972,8,37,12,10,12,3,82,38.23656548972641,-109.384214
56973,6,38,12,10,13,3,82,38.23656548972641,-109.3839445
56974,5,40,12,7,15,3,82,38.23656548972641,-109.383675
56975,5,38,11,5,14,4,77,38.23656548972641,-109.3834055
56976,5,39,10,6,13,4,77,38.23656548972641,-109.383136
56977,7,40,11,7,14,2,81,38.23656548972641,-109.3828665
56978,11,39,12,10,14,1,87,38.23656548972641,-109.382597
56979,13,41,13,10,13,0,90,38.23656548972641,-109.3823275
56980,14,39,12,8,13,1,87,38.23656548972641,-109.382058
56981,12,38,12,8,13,2,85,38.23656548972641,-109.3817885
56982,9,40,11,9,11,2,82,38.23656548972641,-109.381519
56983,12,36,11,6,13,2,80,38.23656548972641,-109.3812495
56984,13,36,12,8,12,2,83,38.23656548972641,-109.38098
56985,14,39,13,10,12,1,89,38.23656548972641,-109.3807105
56986,14,40,14,11,12,1,92,38.23656548972641,-109.380441
56987,14,41,14,11,12,0,92,38.23656548972641,-109.3801716
56988,15,41,14,11,11,0,92,38.23656548972641,-109.3799021
56989,14,36,13,13,11,1,88,38.23656548972641,-109.3796326
56990,13,24,11,16,11,1,76,38.23656548972641,-109.3793631
56991,11,21,10,18,11,1,72,38.23656548972641,-109.3790936
56992,10,35,12,13,12,1,83,38.23656548972641,-109.3788241
56993,7,44,12,10,12,2,87,38.23656548972641,-109.3785546
56994,6,46,11,7,11,2,83,38.23656548972641,-109.3782851
56995,5,45,10,7,12,2,81,38.23656548972641,-109.3780156
56996,6,41,12,9,12,2,82,38.23656548972641,-109.3777461
56997,6,41,14,10,12,2,85,38.23656548972641,-109.3774766
56998,6,44,14,10,12,2,88,38.23656548972641,-109.3772071
56999,6,45,13,9,11,3,87,38.23656548972641,-109.3769376
57000,5,43,12,7,10,4,81,38.23656548972641,-109.3766681
57001,4,43,12,6,10,4,79,38.23656548972641,-109.3763986
57002,2,46,10,4,11,4,77,38.23656548972641,-109.3761291
57003,3,47,9,4,12,3,78,38.23656548972641,-109.3758596
57004,3,49,9,5,12,3,81,38.23656548972641,-109.3755901
57005,3,50,9,5,11,3,81,38.23656548972641,-109.3753206
57006,3,49,9,4,10,5,80,38.23656548972641,-109.3750512
57007,3,49,10,4,12,5,83,38.23656548972641,-109.3747817
57008,4,45,11,6,12,5,83,38.23656548972641,-109.3745122
57009,10,41,13,9,9,5,87,38.23656548972641,-109.3742427
57010,18,35,14,11,9,3,90,38.23656548972641,-109.3739732
57011,8,41,13,7,13,5,87,38.23656548972641,-109.3737037
57012,4,43,12,2,14,8,83,38.23656548972641,-109.3734342
57013,4,43,12,3,14,7,83,38.23656548972641,-109.3731647
57014,4,47,12,4,15,4,86,38.23656548972641,-109.3728952
57015,4,50,11,4,15,3,87,38.23656548972641,-109.3726257
57016,4,50,10,5,12,2,83,38.23656548972641,-109.3723562
57017,2,51,8,4,11,3,79,38.23656548972641,-109.3720867
57018,2,50,8,3,11,4,78,38.23656548972641,-109.3718172
57019,2,48,9,2,12,5,78,38.23656548972641,-109.3715477
57020,2,45,9,1,14,5,76,38.23656548972641,-109.3712782
57021,1,36,9,0,9,10,65,38.23656548972641,-109.3710087
57022,2,32,10,2,9,11,66,38.23656548972641,-109.3707392
57023,3,36,11,3,11,9,73,38.23656548972641,-109.3704697
57024,3,40,11,2,13,7,76,38.23656548972641,-109.3702003
57025,6,41,14,5,13,3,82,38.23656548972641,-109.3699308
57026,2,44,9,0,12,6,73,38.23656548972641,-109.3696613
57027,1,49,9,3,12,2,76,38.23656548972641,-109.3693918
57028,1,47,9,3,12,3,75,38.23656548972641,-109.3691223
57029,3,39,8,3,9,7,69,38.23656548972641,-109.3688528
57030,4,37,12,2,8,13,76,38.23656548972641,-109.3685833
57031,3,40,11,2,11,9,76,38.23656548972641,-109.3683138
57032,3,42,10,2,13,6,76,38.23656548972641,-109.3680443
57033,3,44,10,1,13,6,77,38.23656548972641,-109.3677748
57034,3,41,11,1,12,8,76,38.23656548972641,-109.3675053
57035,3,42,11,3,14,5,78,38.23656548972641,-109.3672358
57036,2,40,11,2,15,6,76,38.23656548972641,-109.3669663
57037,2,39,10,1,13,7,72,38.23656548972641,-109.3666968
57038,2,37,11,0,11,10,71,38.23656548972641,-109.3664273
57039,3,38,10,1,13,7,72,38.23656548972641,-109.3661578
57040,8,43,12,6,13,3,85,38.23656548972641,-109.3658883
57041,11,44,13,8,13,1,90,38.23656548972641,-109.3656188
57042,10,46,14,8,13,1,92,38.23656548972641,-109.3653493
57043,8,48,13,5,14,1,89,38.23656548972641,-109.3650799
57044,5,49,12,4,15,3,88,38.23656548972641,-109.3648104
57045,4,48,12,2,15,5,86,38.23656548972641,-109.3645409
57046,3,43,11,1,13,9,80,38.23656548972641,-109.3642714
57047,3,39,12,0,10,12,76,38.23656548972641,-109.3640019
57048,3,38,11,0,8,11,71,38.23656548972641,-109.3637324
57049,2,40,10,2,12,7,73,38.23656548972641,-109.3634629
57050,2,46,10,1,12,7,78,38.23656548972641,-109.3631934
57051,2,47,10,0,12,9,80,38.23656548972641,-109.3629239
57052,2,42,10,0,11,11,76,38.23656548972641,-109.3626544
57053,4,45,10,1,11,8,79,38.23656548972641,-109.3623849
57054,8,35,11,6,9,1,70,38.23656548972641,-109.3621154
57055,1,47,7,3,9,3,70,38.23656548972641,-109.3618459
57056,0,48,7,2,10,3,70,38.23656548972641,-109.3615764
57057,1,48,9,3,11,3,75,38.23656548972641,-109.3613069
57058,1,43,8,2,11,6,71,38.23656548972641,-109.3610374
57059,1,34,10,3,8,10,66,38.23656548972641,-109.3607679
57060,2,35,10,2,8,12,69,38.23656548972641,-109.3604984
57061,4,39,11,3,10,11,78,38.23656548972641,-109.360229
57062,4,43,12,3,11,9,82,38.23656548972641,-109.3599595
57063,3,29,11,4,7,13,67,38.23656548972641,-109.35969
57064,3,35,10,4,10,8,70,38.23656548972641,-109.3594205
57065,2,41,9,4,12,4,72,38.23656548972641,-109.359151
57066,2,45,9,4,11,4,75,38.23656548972641,-109.3588815
57067,3,42,9,4,11,4,73,38.23656548972641,-109.358612
57068,2,36,7,3,9,4,61,38.23656548972641,-109.3583425
57069,2,28,7,3,11,5,56,38.23656548972641,-109.358073
57070,5,23,10,8,13,6,65,38.23656548972641,-109.3578035
57071,14,22,14,10,12,8,80,38.23656548972641,-109.357534
57072,2,35,10,6,7,9,69,38.23656548972641,-109.3572645
57073,3,36,9,5,10,5,68,38.23656548972641,-109.356995
57074,6,30,10,8,10,5,69,38.23656548972641,-109.3567255
57075,15,26,12,12,10,4,79,38.23656548972641,-109.356456
57076,36,21,13,13,8,1,92,38.23656548972641,-109.3561865
57077,37,22,11,16,6,0,92,38.23656548972641,-109.355917
57078,29,19,8,14,4,0,74,38.23656548972641,-109.3556475
57079,28,16,8,14,5,0,71,38.23656548972641,-109.355378
57080,31,11,11,17,8,5,83,38.23656548972641,-109.3551086
57081,28,9,10,22,10,7,86,38.23656548972641,-109.3548391
57082,25,10,11,22,13,4,85,38.23656548972641,-109.3545696
57083,30,10,11,21,13,3,88,38.23656548972641,-109.3543001
57084,33,11,12,20,12,3,91,38.23656548972641,-109.3540306
57085,34,12,11,14,14,4,89,38.23656548972641,-109.3537611
57086,12,19,14,13,14,16,88,38.23656548972641,-109.3534916
57087,2,23,15,7,7,21,75,38.23656548972641,-109.3532221
57088,0,26,11,3,8,16,64,38.23656548972641,-109.3529526
57089,0,26,10,4,12,10,62,38.23656548972641,-109.3526831
57090,1,26,10,4,11,10,62,38.23656548972641,-109.3524136
57091,1,25,10,6,9,7,58,38.23656548972641,-109.3521441
57092,3,32,8,5,9,5,62,38.23656548972641,-109.3518746
57093,5,42,7,5,8,2,69,38.23656548972641,-109.3516051
57094,3,42,6,5,9,3,68,38.23656548972641,-109.3513356
57095,12,38,14,13,15,1,93,38.23629599514118,-109.4068515
57096,12,38,15,14,15,0,94,38.23629599514118,-109.406582
57097,16,34,15,13,14,0,92,38.23629599514118,-109.4063125
57098,17,34,14,13,13,0,91,38.23629599514118,-109.406043
57099,16,35,14,13,13,1,92,38.23629599514118,-109.4057735
57100,14,35,14,13,13,1,90,38.23629599514118,-109.405504
57101,11,36,14,14,13,1,89,38.23629599514118,-109.4052345
57102,11,38,14,14,14,1,92,38.23629599514118,-109.4049651
57103,10,38,14,13,14,1,90,38.23629599514118,-109.4046956
57104,10,38,14,13,14,1,90,38.23629599514118,-109.4044261
57105,10,38,14,13,14,1,90,38.23629599514118,-109.4041566
57106,9,39,14,14,14,1,91,38.23629599514118,-109.4038871
57107,8,38,14,13,14,1,88,38.23629599514118,-109.4036176
57108,8,38,14,13,15,1,89,38.23629599514118,-109.4033481
57109,9,39,14,14,15,1,92,38.23629599514118,-109.4030786
57110,11,37,14,14,15,0,91,38.23629599514118,-109.4028091
57111,12,37,14,13,14,0,90,38.23629599514118,-109.4025396
57112,15,37,14,13,15,0,94,38.23629599514118,-109.4022701
57113,16,35,14,13,14,0,92,38.23629599514118,-109.4020006
57114,17,33,14,14,13,0,91,38.23629599514118,-109.4017311
57115,22,31,15,12,12,0,92,38.23629599514118,-109.4014616
57116,19,32,15,13,13,0,92,38.23629599514118,-109.4011921
57117,16,35,14,13,14,0,92,38.23629599514118,-109.4009226
57118,15,36,14,13,14,0,92,38.23629599514118,-109.4006531
57119,16,34,15,13,13,0,91,38.23629599514118,-109.4003836
57120,21,33,14,12,12,0,92,38.23629599514118,-109.4001142
57121,17,35,14,13,14,0,93,38.23629599514118,-109.3998447
57122,12,37,14,13,15,0,91,38.23629599514118,-109.3995752
57123,9,39,14,13,14,1,90,38.23629599514118,-109.3993057
57124,7,39,14,13,15,1,89,38.23629599514118,-109.3990362
57125,6,39,14,12,15,1,87,38.23629599514118,-109.3987667
57126,7,41,14,12,16,1,91,38.23629599514118,-109.3984972
57127,11,40,14,12,15,0,92,38.23629599514118,-109.3982277
57128,15,38,14,12,14,0,93,38.23629599514118,-109.3979582
57129,14,39,14,12,14,0,93,38.23629599514118,-109.3976887
57130,8,42,14,13,15,1,93,38.23629599514118,-109.3974192
57131,8,43,14,13,14,1,93,38.23629599514118,-109.3971497
57132,8,43,14,13,14,1,93,38.23629599514118,-109.3968802
57133,9,41,14,13,14,0,91,38.23629599514118,-109.3966107
57134,13,40,14,11,14,0,92,38.23629599514118,-109.3963412
57135,11,43,13,11,14,0,92,38.23629599514118,-109.3960717
57136,14,42,13,10,14,0,93,38.23629599514118,-109.3958022
57137,16,40,13,10,13,0,92,38.23629599514118,-109.3955327
57138,17,38,14,11,13,0,93,38.23629599514118,-109.3952632
57139,13,39,14,12,14,0,92,38.23629599514118,-109.3949938
57140,11,41,14,12,14,0,92,38.23629599514118,-109.3947243
57141,11,43,14,11,14,0,93,38.23629599514118,-109.3944548
57142,10,43,14,11,14,0,92,38.23629599514118,-109.3941853
57143,10,43,14,12,15,0,94,38.23629599514118,-109.3939158
57144,11,42,14,11,14,0,92,38.23629599514118,-109.3936463
57145,12,41,14,11,14,0,92,38.23629599514118,-109.3933768
57146,11,42,14,12,14,0,93,38.23629599514118,-109.3931073
57147,9,44,14,12,13,1,93,38.23629599514118,-109.3928378
57148,8,47,14,11,14,0,94,38.23629599514118,-109.3925683
57149,6,46,13,9,13,1,88,38.23629599514118,-109.3922988
57150,5,45,13,9,14,2,88,38.23629599514118,-109.3920293
57151,5,46,13,9,14,2,89,38.23629599514118,-109.3917598
57152,5,48,13,7,13,2,88,38.23629599514118,-109.3914903
57153,5,47,12,8,13,1,86,38.23629599514118,-109.3912208
57154,7,44,12,9,15,1,88,38.23629599514118,-109.3909513
57155,9,41,13,11,15,0,89,38.23629599514118,-109.3906818
57156,13,39,14,12,14,0,92,38.23629599514118,-109.3904123
57157,12,40,14,12,13,0,91,38.23629599514118,-109.3901429
57158,10,41,14,12,14,1,92,38.23629599514118,-109.3898734
57159,10,42,13,10,15,0,90,38.23629599514118,-109.3896039
57160,9,44,12,9,15,0,89,38.23629599514118,-109.3893344
57161,9,45,12,8,14,1,89,38.23629599514118,-109.3890649
57162,12,38,13,8,13,1,85,38.23629599514118,-109.3887954
57163,7,44,13,8,13,2,87,38.23629599514118,-109.3885259
57164,8,44,13,11,12,2,90,38.23629599514118,-109.3882564
57165,11,33,9,5,8,0,66,38.23629599514118,-109.3879869
57166,16,30,6,4,6,0,62,38.23629599514118,-109.3877174
57167,17,35,10,9,7,0,78,38.23629599514118,-109.3874479
57168,15,40,13,12,10,1,91,38.23629599514118,-109.3871784
57169,10,42,14,12,12,1,91,38.23629599514118,-109.3869089
57170,9,43,15,12,12,1,92,38.23629599514118,-109.3866394
57171,12,42,14,12,11,1,92,38.23629599514118,-109.3863699
57172,12,43,15,12,10,1,93,38.23629599514118,-109.3861004
57173,13,45,14,11,10,1,94,38.23629599514118,-109.3858309
57174,14,44,13,9,11,1,92,38.23629599514118,-109.3855614
57175,13,41,12,9,11,2,88,38.23629599514118,-109.3852919
57176,14,41,13,9,12,1,90,38.23629599514118,-109.3850225
57177,11,42,14,11,12,1,91,38.23629599514118,-109.384753
57178,10,42,14,12,12,1,91,38.23629599514118,-109.3844835
57179,9,41,14,13,13,1,91,38.23629599514118,-109.384214
57180,9,37,13,13,13,2,87,38.23629599514118,-109.3839445
57181,12,31,13,11,12,3,82,38.23629599514118,-109.383675
57182,16,32,12,9,13,2,84,38.23629599514118,-109.3834055
57183,13,36,12,8,14,1,84,38.23629599514118,-109.383136
57184,7,43,11,7,14,1,83,38.23629599514118,-109.3828665
57185,7,43,12,8,13,2,85,38.23629599514118,-109.382597
57186,10,39,12,9,13,1,84,38.23629599514118,-109.3823275
57187,13,37,12,10,13,1,86,38.23629599514118,-109.382058
57188,11,39,12,9,14,1,86,38.23629599514118,-109.3817885
57189,7,43,11,8,13,2,84,38.23629599514118,-109.381519
57190,10,40,11,8,13,1,83,38.23629599514118,-109.3812495
57191,11,39,12,9,14,1,86,38.23629599514118,-109.38098
57192,11,41,13,10,14,1,90,38.23629599514118,-109.3807105
57193,10,40,14,11,12,2,89,38.23629599514118,-109.380441
57194,10,42,14,12,12,1,91,38.23629599514118,-109.3801716
57195,11,43,14,12,13,0,93,38.23629599514118,-109.3799021
57196,11,41,14,13,13,0,92,38.23629599514118,-109.3796326
57197,12,28,12,15,10,1,78,38.23629599514118,-109.3793631
57198,8,20,10,18,11,2,69,38.23629599514118,-109.3790936
57199,14,30,13,13,12,1,83,38.23629599514118,-109.3788241
57200,8,43,13,11,12,1,88,38.23629599514118,-109.3785546
57201,7,43,12,9,12,2,85,38.23629599514118,-109.3782851
57202,6,45,11,8,12,2,84,38.23629599514118,-109.3780156
57203,5,44,11,8,12,2,82,38.23629599514118,-109.3777461
57204,6,40,13,9,10,3,81,38.23629599514118,-109.3774766
57205,6,41,14,10,10,3,84,38.23629599514118,-109.3772071
57206,6,42,14,10,10,3,85,38.23629599514118,-109.3769376
57207,6,42,13,9,10,3,83,38.23629599514118,-109.3766681
57208,5,40,12,8,10,4,79,38.23629599514118,-109.3763986
57209,3,44,11,6,11,5,80,38.23629599514118,-109.3761291
57210,3,48,10,5,12,4,82,38.23629599514118,-109.3758596
57211,3,48,9,6,12,3,81,38.23629599514118,-109.3755901
57212,3,47,9,6,11,3,79,38.23629599514118,-109.3753206
57213,3,46,10,6,10,4,79,38.23629599514118,-109.3750512
57214,3,50,9,6,11,4,83,38.23629599514118,-109.3747817
57215,5,45,11,9,11,3,84,38.23629599514118,-109.3745122
57216,10,41,13,11,10,3,88,38.23629599514118,-109.3742427
57217,15,38,13,11,9,2,88,38.23629599514118,-109.3739732
57218,4,38,11,4,11,7,75,38.23629599514118,-109.3737037
57219,3,45,11,2,14,5,80,38.23629599514118,-109.3734342
57220,3,49,10,3,13,4,82,38.23629599514118,-109.3731647
57221,3,50,9,3,11,4,80,38.23629599514118,-109.3728952
57222,2,51,8,3,11,3,78,38.23629599514118,-109.3726257
57223,2,53,9,5,11,3,83,38.23629599514118,-109.3723562
57224,1,53,8,3,11,3,79,38.23629599514118,-109.3720867
57225,2,51,8,4,12,2,79,38.23629599514118,-109.3718172
57226,3,49,10,4,15,2,83,38.23629599514118,-109.3715477
57227,3,45,11,2,13,7,81,38.23629599514118,-109.3712782
57228,2,40,9,0,11,9,71,38.23629599514118,-109.3710087
57229,2,38,10,2,14,6,72,38.23629599514118,-109.3707392
57230,2,41,10,2,14,6,75,38.23629599514118,-109.3704697
57231,3,45,10,0,13,7,78,38.23629599514118,-109.3702003
57232,7,38,14,5,11,5,80,38.23629599514118,-109.3699308
57233,2,36,9,1,10,7,65,38.23629599514118,-109.3696613
57234,1,47,8,3,12,3,74,38.23629599514118,-109.3693918
57235,2,45,9,4,12,3,75,38.23629599514118,-109.3691223
57236,3,38,10,4,9,8,72,38.23629599514118,-109.3688528
57237,3,35,11,1,7,14,71,38.23629599514118,-109.3685833
57238,3,36,11,3,10,11,74,38.23629599514118,-109.3683138
57239,3,37,11,2,11,10,74,38.23629599514118,-109.3680443
57240,3,37,11,0,11,10,72,38.23629599514118,-109.3677748
57241,2,38,12,2,12,9,75,38.23629599514118,-109.3675053
57242,2,38,10,1,13,8,72,38.23629599514118,-109.3672358
57243,1,38,10,0,12,8,69,38.23629599514118,-109.3669663
57244,1,38,10,0,12,10,71,38.23629599514118,-109.3666968
57245,1,37,10,0,11,12,71,38.23629599514118,-109.3664273
57246,3,38,10,0,11,11,73,38.23629599514118,-109.3661578
57247,5,39,11,3,13,7,78,38.23629599514118,-109.3658883
57248,11,41,13,8,12,3,88,38.23629599514118,-109.3656188
57249,13,42,14,9,12,1,91,38.23629599514118,-109.3653493
57250,10,44,14,8,13,1,90,38.23629599514118,-109.3650799
57251,5,48,12,3,15,3,86,38.23629599514118,-109.3648104
57252,4,49,12,4,16,1,86,38.23629599514118,-109.3645409
57253,4,47,13,5,16,2,87,38.23629599514118,-109.3642714
57254,4,44,13,5,14,4,84,38.23629599514118,-109.3640019
57255,5,39,11,5,12,6,78,38.23629599514118,-109.3637324
57256,4,32,11,7,11,7,72,38.23629599514118,-109.3634629
57257,3,39,10,3,12,6,73,38.23629599514118,-109.3631934
57258,2,42,9,1,12,7,73,38.23629599514118,-109.3629239
57259,1,41,9,1,11,8,71,38.23629599514118,-109.3626544
57260,2,42,10,1,12,6,73,38.23629599514118,-109.3623849
57261,4,51,9,3,15,1,83,38.23629599514118,-109.3621154
57262,0,51,6,2,10,4,73,38.23629599514118,-109.3618459
57263,0,55,6,2,9,4,76,38.23629599514118,-109.3615764
57264,3,56,8,4,11,2,84,38.23629599514118,-109.3613069
57265,4,45,11,3,13,5,81,38.23629599514118,-109.3610374
57266,4,40,11,3,12,7,77,38.23629599514118,-109.3607679
57267,5,42,12,3,13,7,82,38.23629599514118,-109.3604984
57268,5,45,12,3,13,6,84,38.23629599514118,-109.360229
57269,5,46,12,3,12,6,84,38.23629599514118,-109.3599595
57270,3,36,11,3,9,9,71,38.23629599514118,-109.35969
57271,3,41,9,3,12,6,74,38.23629599514118,-109.3594205
57272,2,43,9,3,12,6,75,38.23629599514118,-109.359151
57273,2,43,9,3,12,6,75,38.23629599514118,-109.3588815
57274,2,39,9,2,10,6,68,38.23629599514118,-109.358612
57275,3,34,8,3,10,4,62,38.23629599514118,-109.3583425
57276,4,26,10,8,11,5,64,38.23629599514118,-109.358073
57277,9,17,12,15,12,7,72,38.23629599514118,-109.3578035
57278,16,15,13,13,15,6,78,38.23629599514118,-109.357534
57279,5,34,9,6,9,5,68,38.23629599514118,-109.3572645
57280,5,29,10,7,9,6,66,38.23629599514118,-109.356995
57281,12,27,11,13,10,4,77,38.23629599514118,-109.3567255
57282,30,27,13,14,8,1,93,38.23629599514118,-109.356456
57283,37,21,11,16,6,1,92,38.23629599514118,-109.3561865
57284,33,23,9,16,5,1,87,38.23629599514118,-109.355917
57285,32,22,9,15,4,0,82,38.23629599514118,-109.3556475
57286,29,20,9,14,5,1,78,38.23629599514118,-109.355378
57287,29,15,11,18,9,3,85,38.23629599514118,-109.3551086
57288,27,10,10,24,13,4,88,38.23629599514118,-109.3548391
57289,26,9,10,24,13,4,86,38.23629599514118,-109.3545696
57290,23,8,11,24,17,6,89,38.23629599514118,-109.3543001
57291,21,12,13,19,20,6,91,38.23629599514118,-109.3540306
57292,14,19,13,15,16,9,86,38.23629599514118,-109.3537611
57293,3,26,14,7,10,17,77,38.23629599514118,-109.3534916
57294,0,29,11,4,9,14,67,38.23629599514118,-109.3532221
57295,1,25,10,6,10,9,61,38.23629599514118,-109.3529526
57296,1,26,10,6,9,8,60,38.23629599514118,-109.3526831
57297,2,32,8,5,9,6,62,38.23629599514118,-109.3524136
57298,2,33,7,5,9,4,60,38.23629599514118,-109.3521441
57299,2,33,7,3,9,5,59,38.23629599514118,-109.3518746
57300,3,40,6,5,9,4,67,38.23629599514118,-109.3516051
57301,3,38,7,5,9,5,67,38.23629599514118,-109.3513356
57302,6,42,13,12,14,2,89,38.23602650055594,-109.4068515
57303,7,40,14,12,14,2,89,38.23602650055594,-109.406582
57304,14,37,14,12,14,1,92,38.23602650055594,-109.4063125
57305,20,33,14,11,13,1,92,38.23602650055594,-109.406043
57306,21,31,14,11,13,1,91,38.23602650055594,-109.4057735
57307,17,32,14,13,13,1,90,38.23602650055594,-109.405504
57308,14,34,15,13,13,1,90,38.23602650055594,-109.4052345
57309,13,36,14,13,13,1,90,38.23602650055594,-109.4049651
57310,13,37,14,14,13,1,92,38.23602650055594,-109.4046956
57311,12,37,14,14,13,1,91,38.23602650055594,-109.4044261
57312,11,38,14,13,14,1,91,38.23602650055594,-109.4041566
57313,11,38,14,13,14,1,91,38.23602650055594,-109.4038871
57314,9,39,14,12,14,1,89,38.23602650055594,-109.4036176
57315,8,40,14,11,15,1,89,38.23602650055594,-109.4033481
57316,8,40,14,12,15,1,90,38.23602650055594,-109.4030786
57317,13,37,13,12,14,1,90,38.23602650055594,-109.4028091
57318,12,37,14,13,14,1,91,38.23602650055594,-109.4025396
57319,12,37,14,15,14,0,92,38.23602650055594,-109.4022701
57320,12,37,14,15,14,0,92,38.23602650055594,-109.4020006
57321,14,35,14,14,13,1,91,38.23602650055594,-109.4017311
57322,16,34,14,14,13,0,91,38.23602650055594,-109.4014616
57323,18,34,14,13,13,0,92,38.23602650055594,-109.4011921
57324,17,34,14,13,14,0,92,38.23602650055594,-109.4009226
57325,15,35,14,14,14,0,92,38.23602650055594,-109.4006531
57326,14,35,15,15,14,0,93,38.23602650055594,-109.4003836
57327,16,34,15,14,14,0,93,38.23602650055594,-109.4001142
57328,14,35,15,15,14,0,93,38.23602650055594,-109.3998447
57329,10,39,14,14,15,0,92,38.23602650055594,-109.3995752
57330,8,42,14,12,15,0,91,38.23602650055594,-109.3993057
57331,7,41,14,11,16,1,90,38.23602650055594,-109.3990362
57332,7,41,14,11,16,1,90,38.23602650055594,-109.3987667
57333,8,42,14,12,15,1,92,38.23602650055594,-109.3984972
57334,10,41,14,13,14,1,93,38.23602650055594,-109.3982277
57335,12,39,14,13,14,0,92,38.23602650055594,-109.3979582
57336,12,39,14,12,15,0,92,38.23602650055594,-109.3976887
57337,10,41,14,13,15,0,93,38.23602650055594,-109.3974192
57338,10,41,14,13,14,1,93,38.23602650055594,-109.3971497
57339,11,41,14,13,14,0,93,38.23602650055594,-109.3968802
57340,13,39,14,13,14,0,93,38.23602650055594,-109.3966107
57341,15,38,14,12,14,0,93,38.23602650055594,-109.3963412
57342,13,41,13,11,14,0,92,38.23602650055594,-109.3960717
57343,13,41,13,11,14,0,92,38.23602650055594,-109.3958022
57344,15,39,14,11,13,0,92,38.23602650055594,-109.3955327
57345,14,39,15,12,13,0,93,38.23602650055594,-109.3952632
57346,11,40,14,13,14,0,92,38.23602650055594,-109.3949938
57347,10,40,14,13,15,1,93,38.23602650055594,-109.3947243
57348,10,40,14,13,15,1,93,38.23602650055594,-109.3944548
57349,11,39,14,12,14,1,91,38.23602650055594,-109.3941853
57350,10,40,15,13,16,0,94,38.23602650055594,-109.3939158
57351,10,39,15,13,15,1,93,38.23602650055594,-109.3936463
57352,12,38,15,13,14,1,93,38.23602650055594,-109.3933768
57353,12,39,15,13,14,0,93,38.23602650055594,-109.3931073
57354,11,42,14,12,13,1,93,38.23602650055594,-109.3928378
57355,8,45,14,11,13,1,92,38.23602650055594,-109.3925683
57356,7,45,13,10,13,2,90,38.23602650055594,-109.3922988
57357,6,45,13,9,14,2,89,38.23602650055594,-109.3920293
57358,5,45,13,9,14,2,88,38.23602650055594,-109.3917598
57359,5,46,12,7,13,2,85,38.23602650055594,-109.3914903
57360,7,43,13,9,14,1,87,38.23602650055594,-109.3912208
57361,8,43,12,10,15,1,89,38.23602650055594,-109.3909513
57362,10,42,13,11,15,0,91,38.23602650055594,-109.3906818
57363,12,40,14,12,15,0,93,38.23602650055594,-109.3904123
57364,13,40,14,12,14,0,93,38.23602650055594,-109.3901429
57365,11,40,14,12,15,0,92,38.23602650055594,-109.3898734
57366,10,42,13,10,16,0,91,38.23602650055594,-109.3896039
57367,9,43,12,9,15,1,89,38.23602650055594,-109.3893344
57368,8,44,11,9,13,1,86,38.23602650055594,-109.3890649
57369,9,43,12,7,13,1,85,38.23602650055594,-109.3887954
57370,7,45,12,8,13,1,86,38.23602650055594,-109.3885259
57371,6,45,13,9,11,2,86,38.23602650055594,-109.3882564
57372,8,40,11,9,11,2,81,38.23602650055594,-109.3879869
57373,12,31,8,4,7,0,62,38.23602650055594,-109.3877174
57374,17,32,8,7,6,0,70,38.23602650055594,-109.3874479
57375,17,39,13,12,9,1,91,38.23602650055594,-109.3871784
57376,10,43,14,12,12,1,92,38.23602650055594,-109.3869089
57377,8,45,14,12,12,1,92,38.23602650055594,-109.3866394
57378,8,46,14,12,11,1,92,38.23602650055594,-109.3863699
57379,9,46,14,12,10,1,92,38.23602650055594,-109.3861004
57380,11,46,13,10,10,1,91,38.23602650055594,-109.3858309
57381,13,46,13,9,11,1,93,38.23602650055594,-109.3855614
57382,11,44,13,10,11,1,90,38.23602650055594,-109.3852919
57383,11,43,14,12,12,0,92,38.23602650055594,-109.3850225
57384,10,43,14,12,13,1,93,38.23602650055594,-109.384753
57385,11,42,14,12,13,1,93,38.23602650055594,-109.3844835
57386,12,40,14,12,12,1,91,38.23602650055594,-109.384214
57387,13,39,14,12,12,0,90,38.23602650055594,-109.3839445
57388,20,36,13,11,11,0,91,38.23602650055594,-109.383675
57389,19,36,13,10,12,0,90,38.23602650055594,-109.3834055
57390,14,40,13,9,13,0,89,38.23602650055594,-109.383136
57391,10,44,12,9,14,0,89,38.23602650055594,-109.3828665
57392,8,47,12,7,12,2,88,38.23602650055594,-109.382597
57393,14,36,12,9,12,2,85,38.23602650055594,-109.3823275
57394,16,33,12,9,12,1,83,38.23602650055594,-109.382058
57395,11,38,12,10,13,1,85,38.23602650055594,-109.3817885
57396,6,43,11,8,13,1,82,38.23602650055594,-109.381519
57397,15,36,12,9,14,0,86,38.23602650055594,-109.3812495
57398,8,42,11,8,14,1,84,38.23602650055594,-109.38098
57399,6,44,12,9,13,2,86,38.23602650055594,-109.3807105
57400,7,43,13,11,12,1,87,38.23602650055594,-109.380441
57401,7,42,14,12,12,2,89,38.23602650055594,-109.3801716
57402,5,43,13,11,13,2,87,38.23602650055594,-109.3799021
57403,5,45,13,11,14,1,89,38.23602650055594,-109.3796326
57404,7,36,12,13,12,1,81,38.23602650055594,-109.3793631
57405,7,21,10,19,11,1,69,38.23602650055594,-109.3790936
57406,7,21,10,22,12,1,73,38.23602650055594,-109.3788241
57407,10,42,13,12,13,1,91,38.23602650055594,-109.3785546
57408,7,45,13,10,13,1,89,38.23602650055594,-109.3782851
57409,6,46,12,9,13,2,88,38.23602650055594,-109.3780156
57410,5,46,11,9,13,1,85,38.23602650055594,-109.3777461
57411,6,42,12,10,11,3,84,38.23602650055594,-109.3774766
57412,6,43,14,12,11,2,88,38.23602650055594,-109.3772071
57413,7,41,15,12,11,2,88,38.23602650055594,-109.3769376
57414,7,42,14,11,10,3,87,38.23602650055594,-109.3766681
57415,6,42,14,8,11,3,84,38.23602650055594,-109.3763986
57416,3,43,10,5,11,5,77,38.23602650055594,-109.3761291
57417,3,46,10,5,12,4,80,38.23602650055594,-109.3758596
57418,4,47,10,8,11,3,83,38.23602650055594,-109.3755901
57419,6,48,11,10,11,2,88,38.23602650055594,-109.3753206
57420,5,50,11,9,11,2,88,38.23602650055594,-109.3750512
57421,3,54,9,7,11,1,85,38.23602650055594,-109.3747817
57422,4,50,10,8,12,1,85,38.23602650055594,-109.3745122
57423,6,45,12,10,12,3,88,38.23602650055594,-109.3742427
57424,6,46,12,7,13,3,87,38.23602650055594,-109.3739732
57425,2,51,9,3,13,3,81,38.23602650055594,-109.3737037
57426,1,55,8,3,12,2,81,38.23602650055594,-109.3734342
57427,2,52,8,3,11,3,79,38.23602650055594,-109.3731647
57428,3,47,9,5,11,4,79,38.23602650055594,-109.3728952
57429,4,46,9,5,11,4,79,38.23602650055594,-109.3726257
57430,6,49,11,9,11,1,87,38.23602650055594,-109.3723562
57431,3,48,9,6,13,2,81,38.23602650055594,-109.3720867
57432,3,47,10,4,15,2,81,38.23602650055594,-109.3718172
57433,5,44,12,6,16,2,85,38.23602650055594,-109.3715477
57434,7,41,12,7,14,4,85,38.23602650055594,-109.3712782
57435,4,39,11,5,13,6,78,38.23602650055594,-109.3710087
57436,4,39,11,5,14,5,78,38.23602650055594,-109.3707392
57437,3,41,11,3,14,6,78,38.23602650055594,-109.3704697
57438,3,41,11,1,13,9,78,38.23602650055594,-109.3702003
57439,6,32,14,4,9,10,75,38.23602650055594,-109.3699308
57440,2,32,10,4,8,9,65,38.23602650055594,-109.3696613
57441,2,38,9,4,10,6,69,38.23602650055594,-109.3693918
57442,3,35,10,5,10,6,69,38.23602650055594,-109.3691223
57443,4,31,12,3,9,14,73,38.23602650055594,-109.3688528
57444,4,34,13,5,10,10,76,38.23602650055594,-109.3685833
57445,3,33,12,3,11,12,74,38.23602650055594,-109.3683138
57446,2,30,12,1,7,17,69,38.23602650055594,-109.3680443
57447,2,29,13,0,4,21,69,38.23602650055594,-109.3677748
57448,2,32,12,0,6,18,70,38.23602650055594,-109.3675053
57449,2,35,12,0,10,15,74,38.23602650055594,-109.3672358
57450,1,35,11,0,12,11,70,38.23602650055594,-109.3669663
57451,0,33,10,0,13,10,66,38.23602650055594,-109.3666968
57452,0,34,10,0,14,12,70,38.23602650055594,-109.3664273
57453,0,33,11,0,8,19,71,38.23602650055594,-109.3661578
57454,3,36,12,0,9,15,75,38.23602650055594,-109.3658883
57455,4,41,12,1,13,9,80,38.23602650055594,-109.3656188
57456,5,44,13,5,15,4,86,38.23602650055594,-109.3653493
57457,5,46,13,7,16,2,89,38.23602650055594,-109.3650799
57458,4,48,12,4,15,2,85,38.23602650055594,-109.3648104
57459,5,49,12,4,15,1,86,38.23602650055594,-109.3645409
57460,5,46,12,6,15,2,86,38.23602650055594,-109.3642714
57461,6,45,14,8,15,1,89,38.23602650055594,-109.3640019
57462,10,42,14,11,14,1,92,38.23602650055594,-109.3637324
57463,10,40,13,8,13,3,87,38.23602650055594,-109.3634629
57464,6,41,10,4,12,4,77,38.23602650055594,-109.3631934
57465,2,44,9,2,12,5,74,38.23602650055594,-109.3629239
57466,1,49,8,0,13,5,76,38.23602650055594,-109.3626544
57467,2,54,9,1,15,3,84,38.23602650055594,-109.3623849
57468,2,54,8,1,14,4,83,38.23602650055594,-109.3621154
57469,2,47,9,3,13,4,78,38.23602650055594,-109.3618459
57470,3,46,10,6,13,3,81,38.23602650055594,-109.3615764
57471,5,49,12,4,15,2,87,38.23602650055594,-109.3613069
57472,5,45,12,5,13,4,84,38.23602650055594,-109.3610374
57473,5,46,13,6,14,2,86,38.23602650055594,-109.3607679
57474,8,46,13,7,14,1,89,38.23602650055594,-109.3604984
57475,8,46,13,7,13,2,89,38.23602650055594,-109.360229
57476,6,46,12,4,13,4,85,38.23602650055594,-109.3599595
57477,3,44,10,3,13,6,79,38.23602650055594,-109.35969
57478,3,42,10,4,14,4,77,38.23602650055594,-109.3594205
57479,3,39,10,5,12,6,75,38.23602650055594,-109.359151
57480,2,37,9,4,10,8,70,38.23602650055594,-109.3588815
57481,1,35,8,1,8,7,60,38.23602650055594,-109.358612
57482,5,34,9,5,10,4,67,38.23602650055594,-109.3583425
57483,7,22,12,16,10,4,71,38.23602650055594,-109.358073
57484,17,19,15,19,14,3,87,38.23602650055594,-109.3578035
57485,22,17,14,16,13,3,85,38.23602650055594,-109.357534
57486,8,28,10,10,12,3,71,38.23602650055594,-109.3572645
57487,14,25,11,16,11,2,79,38.23602650055594,-109.356995
57488,32,25,13,16,8,0,94,38.23602650055594,-109.3567255
57489,36,22,11,18,6,0,93,38.23602650055594,-109.356456
57490,34,20,10,19,4,1,88,38.23602650055594,-109.3561865
57491,33,21,10,20,5,1,90,38.23602650055594,-109.355917
57492,35,18,11,20,5,1,90,38.23602650055594,-109.3556475
57493,35,15,11,22,8,1,92,38.23602650055594,-109.355378
57494,32,13,11,25,10,2,93,38.23602650055594,-109.3551086
57495,31,11,11,23,12,2,90,38.23602650055594,-109.3548391
57496,34,9,11,20,12,3,89,38.23602650055594,-109.3545696
57497,23,11,12,21,17,4,88,38.23602650055594,-109.3543001
57498,12,19,13,15,17,7,83,38.23602650055594,-109.3540306
57499,1,23,12,7,11,15,69,38.23602650055594,-109.3537611
57500,2,27,11,5,10,10,65,38.23602650055594,-109.3534916
57501,3,28,11,5,12,7,66,38.23602650055594,-109.3532221
57502,2,30,9,4,9,7,61,38.23602650055594,-109.3529526
57503,2,29,8,4,9,5,57,38.23602650055594,-109.3526831
57504,2,29,7,4,10,5,57,38.23602650055594,-109.3524136
57505,2,27,7,4,10,6,56,38.23602650055594,-109.3521441
57506,3,27,9,4,9,7,59,38.23602650055594,-109.3518746
57507,2,24,9,5,8,9,57,38.23602650055594,-109.3516051
57508,2,25,9,5,9,9,59,38.23602650055594,-109.3513356
57509,6,48,12,10,13,1,90,38.235757005970704,-109.4068515
57510,6,45,13,11,13,2,90,38.235757005970704,-109.406582
57511,9,40,13,12,14,2,90,38.235757005970704,-109.4063125
57512,15,37,14,12,14,1,93,38.235757005970704,-109.406043
57513,18,34,14,11,13,1,91,38.235757005970704,-109.4057735
57514,16,36,13,11,13,1,90,38.235757005970704,-109.405504
57515,11,38,14,11,13,1,88,38.235757005970704,-109.4052345
57516,11,39,13,10,12,1,86,38.235757005970704,-109.4049651
57517,11,42,13,10,13,1,90,38.235757005970704,-109.4046956
57518,10,45,13,9,14,1,92,38.235757005970704,-109.4044261
57519,10,44,13,9,14,1,91,38.235757005970704,-109.4041566
57520,10,42,13,9,14,1,89,38.235757005970704,-109.4038871
57521,8,39,14,11,15,1,88,38.235757005970704,-109.4036176
57522,7,39,14,12,15,1,88,38.235757005970704,-109.4033481
57523,9,40,14,12,15,1,91,38.235757005970704,-109.4030786
57524,12,38,13,13,14,1,91,38.235757005970704,-109.4028091
57525,11,39,13,12,14,1,90,38.235757005970704,-109.4025396
57526,14,36,13,12,14,0,89,38.235757005970704,-109.4022701
57527,15,35,14,13,13,0,90,38.235757005970704,-109.4020006
57528,16,34,14,14,13,0,91,38.235757005970704,-109.4017311
57529,15,35,13,14,14,0,91,38.235757005970704,-109.4014616
57530,17,34,13,13,13,0,90,38.235757005970704,-109.4011921
57531,17,35,14,12,13,0,91,38.235757005970704,-109.4009226
57532,16,35,14,13,13,0,91,38.235757005970704,-109.4006531
57533,15,35,14,15,14,0,93,38.235757005970704,-109.4003836
57534,17,34,14,14,14,0,93,38.235757005970704,-109.4001142
57535,12,37,14,13,15,0,91,38.235757005970704,-109.3998447
57536,8,40,14,12,16,1,91,38.235757005970704,-109.3995752
57537,6,41,13,10,15,1,86,38.235757005970704,-109.3993057
57538,6,41,14,10,16,1,88,38.235757005970704,-109.3990362
57539,8,43,14,11,16,0,92,38.235757005970704,-109.3987667
57540,9,43,14,11,15,0,92,38.235757005970704,-109.3984972
57541,11,42,14,12,14,0,93,38.235757005970704,-109.3982277
57542,13,40,14,12,14,0,93,38.235757005970704,-109.3979582
57543,12,39,14,12,15,0,92,38.235757005970704,-109.3976887
57544,12,40,14,12,15,0,93,38.235757005970704,-109.3974192
57545,11,40,14,13,14,0,92,38.235757005970704,-109.3971497
57546,13,40,13,12,13,0,91,38.235757005970704,-109.3968802
57547,15,39,14,11,13,0,92,38.235757005970704,-109.3966107
57548,15,38,13,11,14,0,91,38.235757005970704,-109.3963412
57549,11,44,13,10,14,0,92,38.235757005970704,-109.3960717
57550,10,43,13,11,14,0,91,38.235757005970704,-109.3958022
57551,10,40,14,13,15,0,92,38.235757005970704,-109.3955327
57552,10,40,14,13,15,0,92,38.235757005970704,-109.3952632
57553,11,40,14,14,14,0,93,38.235757005970704,-109.3949938
57554,10,39,14,14,15,0,92,38.235757005970704,-109.3947243
57555,9,39,14,13,16,0,91,38.235757005970704,-109.3944548
57556,9,38,14,12,15,1,89,38.235757005970704,-109.3941853
57557,8,39,14,12,16,1,90,38.235757005970704,-109.3939158
57558,10,40,15,13,15,1,94,38.235757005970704,-109.3936463
57559,12,38,15,13,15,1,94,38.235757005970704,-109.3933768
57560,12,38,15,13,14,1,93,38.235757005970704,-109.3931073
57561,12,40,15,12,13,1,93,38.235757005970704,-109.3928378
57562,10,43,14,12,12,1,92,38.235757005970704,-109.3925683
57563,10,43,14,12,13,1,93,38.235757005970704,-109.3922988
57564,8,45,14,12,13,1,93,38.235757005970704,-109.3920293
57565,7,44,14,11,14,1,91,38.235757005970704,-109.3917598
57566,8,41,13,11,14,1,88,38.235757005970704,-109.3914903
57567,7,41,13,11,15,1,88,38.235757005970704,-109.3912208
57568,8,41,13,11,16,1,90,38.235757005970704,-109.3909513
57569,8,40,13,11,16,1,89,38.235757005970704,-109.3906818
57570,9,40,14,11,16,1,91,38.235757005970704,-109.3904123
57571,10,40,14,12,17,0,93,38.235757005970704,-109.3901429
57572,10,40,14,12,16,0,92,38.235757005970704,-109.3898734
57573,10,41,14,10,16,0,91,38.235757005970704,-109.3896039
57574,7,44,13,9,16,1,90,38.235757005970704,-109.3893344
57575,5,48,11,7,14,1,86,38.235757005970704,-109.3890649
57576,4,49,10,5,13,2,83,38.235757005970704,-109.3887954
57577,4,48,11,6,13,2,84,38.235757005970704,-109.3885259
57578,5,45,12,8,11,3,84,38.235757005970704,-109.3882564
57579,8,42,13,10,12,2,87,38.235757005970704,-109.3879869
57580,11,31,8,5,8,0,63,38.235757005970704,-109.3877174
57581,17,31,8,6,6,0,68,38.235757005970704,-109.3874479
57582,18,36,12,10,8,0,84,38.235757005970704,-109.3871784
57583,12,42,14,12,12,1,93,38.235757005970704,-109.3869089
57584,8,45,14,12,11,1,91,38.235757005970704,-109.3866394
57585,8,46,14,11,11,1,91,38.235757005970704,-109.3863699
57586,8,46,14,12,11,1,92,38.235757005970704,-109.3861004
57587,9,45,13,11,11,1,90,38.235757005970704,-109.3858309
57588,11,45,13,10,11,1,91,38.235757005970704,-109.3855614
57589,11,43,13,11,11,1,90,38.235757005970704,-109.3852919
57590,11,42,15,14,12,0,94,38.235757005970704,-109.3850225
57591,9,44,14,12,12,1,92,38.235757005970704,-109.384753
57592,10,43,14,11,12,1,91,38.235757005970704,-109.3844835
57593,10,42,14,12,12,1,91,38.235757005970704,-109.384214
57594,10,40,13,11,12,1,87,38.235757005970704,-109.3839445
57595,13,41,13,10,12,1,90,38.235757005970704,-109.383675
57596,12,38,13,9,13,2,87,38.235757005970704,-109.3834055
57597,9,40,13,10,14,1,87,38.235757005970704,-109.383136
57598,9,44,13,10,14,0,90,38.235757005970704,-109.3828665
57599,10,45,12,7,13,1,88,38.235757005970704,-109.382597
57600,10,40,12,8,14,2,86,38.235757005970704,-109.3823275
57601,14,39,12,9,13,1,88,38.235757005970704,-109.382058
57602,11,41,11,8,14,1,86,38.235757005970704,-109.3817885
57603,5,45,10,7,14,1,82,38.235757005970704,-109.381519
57604,13,35,12,10,14,1,85,38.235757005970704,-109.3812495
57605,14,39,13,10,14,0,90,38.235757005970704,-109.38098
57606,11,43,13,11,13,0,91,38.235757005970704,-109.3807105
57607,8,45,13,11,13,1,91,38.235757005970704,-109.380441
57608,6,47,14,9,13,2,91,38.235757005970704,-109.3801716
57609,4,46,12,7,12,3,84,38.235757005970704,-109.3799021
57610,4,44,13,9,14,2,86,38.235757005970704,-109.3796326
57611,5,38,12,12,14,1,82,38.235757005970704,-109.3793631
57612,7,21,11,16,12,2,69,38.235757005970704,-109.3790936
57613,6,18,10,22,13,2,71,38.235757005970704,-109.3788241
57614,11,32,12,14,14,1,84,38.235757005970704,-109.3785546
57615,7,43,14,11,15,1,91,38.235757005970704,-109.3782851
57616,6,46,13,10,13,1,89,38.235757005970704,-109.3780156
57617,5,48,12,10,13,1,89,38.235757005970704,-109.3777461
57618,6,45,12,11,12,2,88,38.235757005970704,-109.3774766
57619,8,44,14,13,11,2,92,38.235757005970704,-109.3772071
57620,9,42,15,14,11,2,93,38.235757005970704,-109.3769376
57621,9,41,15,13,11,2,91,38.235757005970704,-109.3766681
57622,7,43,14,10,11,3,88,38.235757005970704,-109.3763986
57623,3,38,11,4,13,5,74,38.235757005970704,-109.3761291
57624,4,40,11,6,14,4,79,38.235757005970704,-109.3758596
57625,5,44,12,9,11,3,84,38.235757005970704,-109.3755901
57626,7,49,11,10,11,3,91,38.235757005970704,-109.3753206
57627,5,53,10,10,11,2,91,38.235757005970704,-109.3750512
57628,3,53,9,8,12,1,86,38.235757005970704,-109.3747817
57629,4,49,11,8,13,1,86,38.235757005970704,-109.3745122
57630,7,45,12,9,13,2,88,38.235757005970704,-109.3742427
57631,5,43,12,6,13,5,84,38.235757005970704,-109.3739732
57632,2,53,9,3,14,4,85,38.235757005970704,-109.3737037
57633,1,53,8,4,11,3,80,38.235757005970704,-109.3734342
57634,2,46,8,5,11,3,75,38.235757005970704,-109.3731647
57635,5,42,10,8,11,3,79,38.235757005970704,-109.3728952
57636,6,43,11,8,13,3,84,38.235757005970704,-109.3726257
57637,8,40,12,10,14,2,86,38.235757005970704,-109.3723562
57638,4,40,10,4,13,6,77,38.235757005970704,-109.3720867
57639,3,40,11,2,15,7,78,38.235757005970704,-109.3718172
57640,5,42,12,6,16,3,84,38.235757005970704,-109.3715477
57641,5,38,12,9,13,4,81,38.235757005970704,-109.3712782
57642,6,39,13,10,14,3,85,38.235757005970704,-109.3710087
57643,6,42,13,9,14,3,87,38.235757005970704,-109.3707392
57644,7,42,13,8,14,3,87,38.235757005970704,-109.3704697
57645,8,41,13,8,14,4,88,38.235757005970704,-109.3702003
57646,5,39,13,3,12,11,83,38.235757005970704,-109.3699308
57647,4,31,13,5,8,11,72,38.235757005970704,-109.3696613
57648,2,30,11,5,11,8,67,38.235757005970704,-109.3693918
57649,2,32,11,3,10,10,68,38.235757005970704,-109.3691223
57650,5,31,14,4,7,15,76,38.235757005970704,-109.3688528
57651,5,32,14,3,8,16,78,38.235757005970704,-109.3685833
57652,3,30,13,1,6,19,72,38.235757005970704,-109.3683138
57653,1,28,13,0,4,21,67,38.235757005970704,-109.3680443
57654,1,30,12,0,4,19,66,38.235757005970704,-109.3677748
57655,1,35,11,0,8,15,70,38.235757005970704,-109.3675053
57656,1,35,11,0,11,12,70,38.235757005970704,-109.3672358
57657,1,34,10,0,13,10,68,38.235757005970704,-109.3669663
57658,0,32,10,0,12,12,66,38.235757005970704,-109.3666968
57659,1,33,11,0,10,16,71,38.235757005970704,-109.3664273
57660,1,32,11,0,7,18,69,38.235757005970704,-109.3661578
57661,3,37,12,0,9,14,75,38.235757005970704,-109.3658883
57662,3,42,11,0,13,10,79,38.235757005970704,-109.3656188
57663,3,46,12,1,15,7,84,38.235757005970704,-109.3653493
57664,4,49,13,2,16,4,88,38.235757005970704,-109.3650799
57665,3,49,13,3,16,3,87,38.235757005970704,-109.3648104
57666,4,50,13,4,17,1,89,38.235757005970704,-109.3645409
57667,5,49,13,5,17,1,90,38.235757005970704,-109.3642714
57668,5,48,13,6,16,1,89,38.235757005970704,-109.3640019
57669,6,48,13,6,14,2,89,38.235757005970704,-109.3637324
57670,5,46,13,6,14,2,86,38.235757005970704,-109.3634629
57671,4,45,12,4,14,4,83,38.235757005970704,-109.3631934
57672,3,42,10,2,12,7,76,38.235757005970704,-109.3629239
57673,3,41,10,2,12,8,76,38.235757005970704,-109.3626544
57674,3,48,10,2,14,5,82,38.235757005970704,-109.3623849
57675,4,44,11,3,13,7,82,38.235757005970704,-109.3621154
57676,5,39,12,5,12,7,80,38.235757005970704,-109.3618459
57677,10,39,12,7,13,3,84,38.235757005970704,-109.3615764
57678,9,44,12,8,14,1,88,38.235757005970704,-109.3613069
57679,6,45,13,10,13,1,88,38.235757005970704,-109.3610374
57680,5,46,13,8,13,2,87,38.235757005970704,-109.3607679
57681,6,46,13,6,13,2,86,38.235757005970704,-109.3604984
57682,5,48,12,4,13,4,86,38.235757005970704,-109.360229
57683,4,49,11,2,12,6,84,38.235757005970704,-109.3599595
57684,3,46,10,1,12,7,79,38.235757005970704,-109.35969
57685,3,41,10,4,12,6,76,38.235757005970704,-109.3594205
57686,3,37,10,6,11,6,73,38.235757005970704,-109.359151
57687,3,35,9,4,9,7,67,38.235757005970704,-109.3588815
57688,2,31,9,2,9,7,60,38.235757005970704,-109.358612
57689,6,33,11,8,10,4,72,38.235757005970704,-109.3583425
57690,12,25,13,16,12,3,81,38.235757005970704,-109.358073
57691,28,21,13,18,10,1,91,38.235757005970704,-109.3578035
57692,30,21,12,19,7,1,90,38.235757005970704,-109.357534
57693,27,24,13,19,7,0,90,38.235757005970704,-109.3572645
57694,31,20,11,19,6,1,88,38.235757005970704,-109.356995
57695,33,18,10,23,5,1,90,38.235757005970704,-109.3567255
57696,33,18,10,25,3,1,90,38.235757005970704,-109.356456
57697,31,18,10,24,4,1,88,38.235757005970704,-109.3561865
57698,30,15,10,22,5,2,84,38.235757005970704,-109.355917
57699,33,12,11,22,9,2,89,38.235757005970704,-109.3556475
57700,34,11,10,25,10,1,91,38.235757005970704,-109.355378
57701,34,12,11,24,11,1,93,38.235757005970704,-109.3551086
57702,39,13,11,18,8,1,90,38.235757005970704,-109.3548391
57703,34,14,11,15,11,2,87,38.235757005970704,-109.3545696
57704,17,20,11,19,16,3,86,38.235757005970704,-109.3543001
57705,3,23,12,11,13,10,72,38.235757005970704,-109.3540306
57706,1,25,11,5,9,12,63,38.235757005970704,-109.3537611
57707,3,26,11,4,10,9,63,38.235757005970704,-109.3534916
57708,5,30,9,4,9,7,64,38.235757005970704,-109.3532221
57709,3,32,9,4,9,6,63,38.235757005970704,-109.3529526
57710,3,29,9,4,11,5,61,38.235757005970704,-109.3526831
57711,3,25,10,5,11,7,61,38.235757005970704,-109.3524136
57712,3,20,13,8,5,16,65,38.235757005970704,-109.3521441
57713,1,20,14,4,4,21,64,38.235757005970704,-109.3518746
57714,2,18,14,3,3,22,62,38.235757005970704,-109.3516051
57715,2,20,14,4,4,21,65,38.235757005970704,-109.3513356
57716,8,44,12,10,15,1,90,38.235487511385465,-109.4068515
57717,7,43,13,12,14,2,91,38.235487511385465,-109.406582
57718,7,40,14,12,14,2,89,38.235487511385465,-109.4063125
57719,12,36,14,12,14,1,89,38.235487511385465,-109.406043
57720,16,35,14,12,12,1,90,38.235487511385465,-109.4057735
57721,15,37,13,10,12,1,88,38.235487511385465,-109.405504
57722,11,42,13,10,13,1,90,38.235487511385465,-109.4052345
57723,8,43,13,10,13,2,89,38.235487511385465,-109.4049651
57724,9,44,12,9,13,1,88,38.235487511385465,-109.4046956
57725,9,45,12,9,14,1,90,38.235487511385465,-109.4044261
57726,8,44,12,9,14,1,88,38.235487511385465,-109.4041566
57727,7,44,12,9,13,2,87,38.235487511385465,-109.4038871
57728,6,43,12,8,14,2,85,38.235487511385465,-109.4036176
57729,7,44,13,9,15,2,90,38.235487511385465,-109.4033481
57730,9,44,13,9,14,1,90,38.235487511385465,-109.4030786
57731,11,43,13,9,14,1,91,38.235487511385465,-109.4028091
57732,13,41,12,10,14,0,90,38.235487511385465,-109.4025396
57733,14,39,13,10,14,0,90,38.235487511385465,-109.4022701
57734,13,39,13,11,14,0,90,38.235487511385465,-109.4020006
57735,12,39,13,11,15,0,90,38.235487511385465,-109.4017311
57736,10,41,13,10,15,1,90,38.235487511385465,-109.4014616
57737,12,39,13,11,15,0,90,38.235487511385465,-109.4011921
57738,13,37,14,12,14,0,90,38.235487511385465,-109.4009226
57739,15,35,14,13,14,0,91,38.235487511385465,-109.4006531
57740,15,35,14,14,14,0,92,38.235487511385465,-109.4003836
57741,16,35,14,13,14,0,92,38.235487511385465,-109.4001142
57742,10,38,14,13,15,0,90,38.235487511385465,-109.3998447
57743,8,39,14,12,15,1,89,38.235487511385465,-109.3995752
57744,7,40,14,11,15,1,88,38.235487511385465,-109.3993057
57745,7,41,14,10,16,1,89,38.235487511385465,-109.3990362
57746,8,44,14,11,15,0,92,38.235487511385465,-109.3987667
57747,10,44,13,11,15,0,93,38.235487511385465,-109.3984972
57748,11,43,13,11,14,0,92,38.235487511385465,-109.3982277
57749,11,42,13,12,14,0,92,38.235487511385465,-109.3979582
57750,10,42,13,12,14,0,91,38.235487511385465,-109.3976887
57751,12,41,13,12,14,0,92,38.235487511385465,-109.3974192
57752,13,40,13,12,13,0,91,38.235487511385465,-109.3971497
57753,14,39,13,11,13,0,90,38.235487511385465,-109.3968802
57754,14,39,13,12,13,0,91,38.235487511385465,-109.3966107
57755,14,41,13,11,13,0,92,38.235487511385465,-109.3963412
57756,10,45,13,10,14,0,92,38.235487511385465,-109.3960717
57757,9,45,13,11,15,0,93,38.235487511385465,-109.3958022
57758,9,43,14,13,15,0,94,38.235487511385465,-109.3955327
57759,9,42,15,13,16,0,95,38.235487511385465,-109.3952632
57760,10,40,14,13,15,0,92,38.235487511385465,-109.3949938
57761,10,40,14,13,16,0,93,38.235487511385465,-109.3947243
57762,9,41,14,12,16,0,92,38.235487511385465,-109.3944548
57763,8,41,14,11,15,1,90,38.235487511385465,-109.3941853
57764,9,40,14,12,15,1,91,38.235487511385465,-109.3939158
57765,11,39,14,13,15,0,92,38.235487511385465,-109.3936463
57766,13,37,15,13,14,0,92,38.235487511385465,-109.3933768
57767,12,37,15,14,14,0,92,38.235487511385465,-109.3931073
57768,12,38,15,14,14,0,93,38.235487511385465,-109.3928378
57769,12,39,15,13,13,0,92,38.235487511385465,-109.3925683
57770,13,40,15,13,13,0,94,38.235487511385465,-109.3922988
57771,10,43,15,13,13,0,94,38.235487511385465,-109.3920293
57772,8,43,14,13,14,1,93,38.235487511385465,-109.3917598
57773,8,41,13,11,14,1,88,38.235487511385465,-109.3914903
57774,7,39,12,11,15,1,85,38.235487511385465,-109.3912208
57775,7,40,12,11,15,1,86,38.235487511385465,-109.3909513
57776,7,41,14,11,16,1,90,38.235487511385465,-109.3906818
57777,7,41,14,11,16,1,90,38.235487511385465,-109.3904123
57778,9,40,14,12,17,1,93,38.235487511385465,-109.3901429
57779,10,40,15,13,16,0,94,38.235487511385465,-109.3898734
57780,9,40,15,12,16,1,93,38.235487511385465,-109.3896039
57781,6,43,14,10,16,1,90,38.235487511385465,-109.3893344
57782,5,49,11,7,14,2,88,38.235487511385465,-109.3890649
57783,4,49,11,5,13,3,85,38.235487511385465,-109.3887954
57784,5,47,11,6,13,3,85,38.235487511385465,-109.3885259
57785,6,43,12,9,11,3,84,38.235487511385465,-109.3882564
57786,8,42,12,10,12,1,85,38.235487511385465,-109.3879869
57787,11,32,9,5,8,0,65,38.235487511385465,-109.3877174
57788,16,33,9,5,7,0,70,38.235487511385465,-109.3874479
57789,16,36,11,8,8,0,79,38.235487511385465,-109.3871784
57790,14,40,14,11,11,1,91,38.235487511385465,-109.3869089
57791,9,43,14,12,12,1,91,38.235487511385465,-109.3866394
57792,8,45,14,12,12,1,92,38.235487511385465,-109.3863699
57793,8,44,14,12,11,1,90,38.235487511385465,-109.3861004
57794,9,43,13,12,12,1,90,38.235487511385465,-109.3858309
57795,11,42,13,12,12,1,91,38.235487511385465,-109.3855614
57796,13,41,14,13,12,1,94,38.235487511385465,-109.3852919
57797,11,41,14,13,11,1,91,38.235487511385465,-109.3850225
57798,11,42,14,13,12,1,93,38.235487511385465,-109.384753
57799,12,43,14,12,11,1,93,38.235487511385465,-109.3844835
57800,10,44,14,12,12,1,93,38.235487511385465,-109.384214
57801,8,41,13,11,12,2,87,38.235487511385465,-109.3839445
57802,9,41,13,9,13,1,86,38.235487511385465,-109.383675
57803,7,41,13,10,14,2,87,38.235487511385465,-109.3834055
57804,7,42,13,11,13,2,88,38.235487511385465,-109.383136
57805,6,44,13,10,13,1,87,38.235487511385465,-109.3828665
57806,8,46,12,8,14,0,88,38.235487511385465,-109.382597
57807,7,48,12,8,15,0,90,38.235487511385465,-109.3823275
57808,9,47,11,7,14,0,88,38.235487511385465,-109.382058
57809,8,46,11,6,15,0,86,38.235487511385465,-109.3817885
57810,6,46,10,6,15,1,84,38.235487511385465,-109.381519
57811,10,42,12,9,15,0,88,38.235487511385465,-109.3812495
57812,10,46,13,9,15,0,93,38.235487511385465,-109.38098
57813,9,47,14,9,14,0,93,38.235487511385465,-109.3807105
57814,8,47,14,10,13,1,93,38.235487511385465,-109.380441
57815,6,47,13,8,13,2,89,38.235487511385465,-109.3801716
57816,5,49,12,8,13,2,89,38.235487511385465,-109.3799021
57817,5,47,13,9,15,1,90,38.235487511385465,-109.3796326
57818,8,41,13,11,14,1,88,38.235487511385465,-109.3793631
57819,12,26,12,12,13,2,77,38.235487511385465,-109.3790936
57820,12,19,9,16,14,1,71,38.235487511385465,-109.3788241
57821,13,26,12,14,13,2,80,38.235487511385465,-109.3785546
57822,8,40,13,11,14,1,87,38.235487511385465,-109.3782851
57823,5,47,13,8,14,2,89,38.235487511385465,-109.3780156
57824,5,51,12,8,12,2,90,38.235487511385465,-109.3777461
57825,6,47,12,9,12,3,89,38.235487511385465,-109.3774766
57826,7,45,13,11,12,2,90,38.235487511385465,-109.3772071
57827,9,44,14,12,11,2,92,38.235487511385465,-109.3769376
57828,10,41,15,13,11,2,92,38.235487511385465,-109.3766681
57829,9,40,15,11,11,3,89,38.235487511385465,-109.3763986
57830,6,41,13,6,13,3,82,38.235487511385465,-109.3761291
57831,3,38,11,7,14,4,77,38.235487511385465,-109.3758596
57832,5,42,12,8,12,4,83,38.235487511385465,-109.3755901
57833,5,47,11,8,12,3,86,38.235487511385465,-109.3753206
57834,3,53,9,9,12,1,87,38.235487511385465,-109.3750512
57835,3,53,9,8,13,1,87,38.235487511385465,-109.3747817
57836,5,48,11,9,13,2,88,38.235487511385465,-109.3745122
57837,7,47,12,10,12,2,90,38.235487511385465,-109.3742427
57838,5,47,11,8,12,4,87,38.235487511385465,-109.3739732
57839,4,47,10,6,12,3,82,38.235487511385465,-109.3737037
57840,4,48,9,6,11,2,80,38.235487511385465,-109.3734342
57841,4,43,9,6,12,2,76,38.235487511385465,-109.3731647
57842,3,42,9,7,13,2,76,38.235487511385465,-109.3728952
57843,2,43,10,3,15,4,77,38.235487511385465,-109.3726257
57844,4,36,11,7,15,4,77,38.235487511385465,-109.3723562
57845,2,36,11,1,14,9,73,38.235487511385465,-109.3720867
57846,3,39,11,1,14,8,76,38.235487511385465,-109.3718172
57847,5,41,12,6,15,4,83,38.235487511385465,-109.3715477
57848,6,40,12,7,14,4,83,38.235487511385465,-109.3712782
57849,7,42,13,9,16,2,89,38.235487511385465,-109.3710087
57850,7,42,14,12,13,2,90,38.235487511385465,-109.3707392
57851,9,42,14,13,12,2,92,38.235487511385465,-109.3704697
57852,11,40,14,13,12,1,91,38.235487511385465,-109.3702003
57853,10,39,13,10,14,2,88,38.235487511385465,-109.3699308
57854,6,37,13,6,13,8,83,38.235487511385465,-109.3696613
57855,5,33,12,5,11,10,76,38.235487511385465,-109.3693918
57856,4,31,12,4,9,12,72,38.235487511385465,-109.3691223
57857,4,33,13,3,9,15,77,38.235487511385465,-109.3688528
57858,5,33,15,3,9,17,82,38.235487511385465,-109.3685833
57859,4,32,14,1,6,19,76,38.235487511385465,-109.3683138
57860,2,30,11,0,5,18,66,38.235487511385465,-109.3680443
57861,0,32,10,0,9,14,65,38.235487511385465,-109.3677748
57862,0,41,9,0,13,7,70,38.235487511385465,-109.3675053
57863,1,45,10,1,15,3,75,38.235487511385465,-109.3672358
57864,1,43,9,0,14,4,71,38.235487511385465,-109.3669663
57865,1,34,8,1,10,7,61,38.235487511385465,-109.3666968
57866,2,27,10,2,7,10,58,38.235487511385465,-109.3664273
57867,1,31,10,0,8,13,63,38.235487511385465,-109.3661578
57868,3,40,11,0,11,10,75,38.235487511385465,-109.3658883
57869,2,40,11,0,12,10,75,38.235487511385465,-109.3656188
57870,2,43,11,0,13,8,77,38.235487511385465,-109.3653493
57871,3,47,11,1,15,6,83,38.235487511385465,-109.3650799
57872,3,49,12,1,15,6,86,38.235487511385465,-109.3648104
57873,4,52,12,3,15,3,89,38.235487511385465,-109.3645409
57874,4,50,12,4,15,3,88,38.235487511385465,-109.3642714
57875,4,49,12,4,14,3,86,38.235487511385465,-109.3640019
57876,4,49,13,5,14,3,88,38.235487511385465,-109.3637324
57877,5,45,13,7,14,3,87,38.235487511385465,-109.3634629
57878,5,45,12,6,14,3,85,38.235487511385465,-109.3631934
57879,4,42,11,3,12,8,80,38.235487511385465,-109.3629239
57880,3,37,11,3,8,13,75,38.235487511385465,-109.3626544
57881,1,36,10,2,7,13,69,38.235487511385465,-109.3623849
57882,3,41,11,3,12,8,78,38.235487511385465,-109.3621154
57883,3,39,11,3,13,7,76,38.235487511385465,-109.3618459
57884,5,41,11,4,14,5,80,38.235487511385465,-109.3615764
57885,6,47,12,5,14,2,86,38.235487511385465,-109.3613069
57886,6,48,13,6,12,2,87,38.235487511385465,-109.3610374
57887,6,46,13,7,12,2,86,38.235487511385465,-109.3607679
57888,5,45,13,8,12,2,85,38.235487511385465,-109.3604984
57889,4,45,12,6,12,3,82,38.235487511385465,-109.360229
57890,4,46,11,4,13,5,83,38.235487511385465,-109.3599595
57891,4,45,11,2,12,7,81,38.235487511385465,-109.35969
57892,5,41,11,5,13,4,79,38.235487511385465,-109.3594205
57893,5,42,10,6,12,3,78,38.235487511385465,-109.359151
57894,3,38,9,4,10,5,69,38.235487511385465,-109.3588815
57895,2,27,9,4,9,6,57,38.235487511385465,-109.358612
57896,7,26,11,9,11,5,69,38.235487511385465,-109.3583425
57897,16,24,14,13,12,5,84,38.235487511385465,-109.358073
57898,29,20,12,17,10,2,90,38.235487511385465,-109.3578035
57899,32,18,10,23,6,1,90,38.235487511385465,-109.357534
57900,33,18,11,23,6,1,92,38.235487511385465,-109.3572645
57901,35,13,11,23,7,1,90,38.235487511385465,-109.356995
57902,32,14,10,25,6,1,88,38.235487511385465,-109.3567255
57903,31,16,10,25,4,1,87,38.235487511385465,-109.356456
57904,31,16,10,24,4,1,86,38.235487511385465,-109.3561865
57905,32,12,10,26,6,1,87,38.235487511385465,-109.355917
57906,35,10,10,26,10,2,93,38.235487511385465,-109.3556475
57907,36,11,10,24,10,1,92,38.235487511385465,-109.355378
57908,39,14,10,18,8,1,90,38.235487511385465,-109.3551086
57909,40,18,11,16,7,1,93,38.235487511385465,-109.3548391
57910,27,19,11,17,13,2,89,38.235487511385465,-109.3545696
57911,7,22,12,13,14,6,74,38.235487511385465,-109.3543001
57912,3,21,11,8,11,8,62,38.235487511385465,-109.3540306
57913,4,27,10,5,10,7,63,38.235487511385465,-109.3537611
57914,3,27,9,4,8,8,59,38.235487511385465,-109.3534916
57915,2,29,8,2,8,8,57,38.235487511385465,-109.3532221
57916,3,31,9,4,10,6,63,38.235487511385465,-109.3529526
57917,3,30,10,6,11,6,66,38.235487511385465,-109.3526831
57918,2,21,12,7,7,15,64,38.235487511385465,-109.3524136
57919,5,12,17,6,8,24,72,38.235487511385465,-109.3521441
57920,6,16,18,4,5,28,77,38.235487511385465,-109.3518746
57921,6,19,18,4,3,28,78,38.235487511385465,-109.3516051
57922,6,20,17,3,3,26,75,38.235487511385465,-109.3513356
57923,7,45,11,10,15,0,88,38.23521801680023,-109.4068515
57924,7,45,12,11,15,1,91,38.23521801680023,-109.406582
57925,6,41,13,12,14,2,88,38.23521801680023,-109.4063125
57926,9,39,14,12,14,1,89,38.23521801680023,-109.406043
57927,12,38,15,13,13,1,92,38.23521801680023,-109.4057735
57928,13,36,15,13,12,1,90,38.23521801680023,-109.405504
57929,14,37,14,12,12,1,90,38.23521801680023,-109.4052345
57930,9,40,13,10,13,2,87,38.23521801680023,-109.4049651
57931,10,42,13,9,13,1,88,38.23521801680023,-109.4046956
57932,11,43,13,9,14,1,91,38.23521801680023,-109.4044261
57933,10,42,13,9,14,1,89,38.23521801680023,-109.4041566
57934,9,44,13,9,15,1,91,38.23521801680023,-109.4038871
57935,6,45,13,8,16,1,89,38.23521801680023,-109.4036176
57936,7,45,13,9,16,1,91,38.23521801680023,-109.4033481
57937,11,43,13,10,15,1,93,38.23521801680023,-109.4030786
57938,12,43,13,9,14,0,91,38.23521801680023,-109.4028091
57939,11,43,13,9,15,1,92,38.23521801680023,-109.4025396
57940,10,43,13,9,15,1,91,38.23521801680023,-109.4022701
57941,8,43,13,9,16,1,90,38.23521801680023,-109.4020006
57942,6,43,13,9,16,1,88,38.23521801680023,-109.4017311
57943,6,44,13,9,16,1,89,38.23521801680023,-109.4014616
57944,8,43,13,10,15,1,90,38.23521801680023,-109.4011921
57945,9,42,13,11,14,1,90,38.23521801680023,-109.4009226
57946,10,41,13,11,15,1,91,38.23521801680023,-109.4006531
57947,12,41,13,10,15,0,91,38.23521801680023,-109.4003836
57948,11,42,13,9,15,0,90,38.23521801680023,-109.4001142
57949,9,42,12,10,15,0,88,38.23521801680023,-109.3998447
57950,9,42,13,10,15,1,90,38.23521801680023,-109.3995752
57951,8,42,13,10,15,1,89,38.23521801680023,-109.3993057
57952,8,43,13,11,15,0,90,38.23521801680023,-109.3990362
57953,8,46,13,9,15,0,91,38.23521801680023,-109.3987667
57954,10,45,13,10,14,0,92,38.23521801680023,-109.3984972
57955,11,45,13,10,13,0,92,38.23521801680023,-109.3982277
57956,11,45,13,11,13,0,93,38.23521801680023,-109.3979582
57957,10,45,13,11,13,0,92,38.23521801680023,-109.3976887
57958,13,41,13,11,13,0,91,38.23521801680023,-109.3974192
57959,14,40,13,11,13,0,91,38.23521801680023,-109.3971497
57960,15,39,13,10,13,1,91,38.23521801680023,-109.3968802
57961,15,40,12,9,12,0,88,38.23521801680023,-109.3966107
57962,13,46,12,8,12,0,91,38.23521801680023,-109.3963412
57963,12,46,12,10,13,0,93,38.23521801680023,-109.3960717
57964,12,44,13,11,13,0,93,38.23521801680023,-109.3958022
57965,10,43,13,12,14,0,92,38.23521801680023,-109.3955327
57966,8,43,14,13,15,0,93,38.23521801680023,-109.3952632
57967,9,42,14,12,15,0,92,38.23521801680023,-109.3949938
57968,9,42,14,12,16,0,93,38.23521801680023,-109.3947243
57969,7,44,14,11,16,0,92,38.23521801680023,-109.3944548
57970,7,44,14,11,16,1,93,38.23521801680023,-109.3941853
57971,9,42,14,13,15,0,93,38.23521801680023,-109.3939158
57972,12,38,14,13,15,0,92,38.23521801680023,-109.3936463
57973,14,37,15,13,14,0,93,38.23521801680023,-109.3933768
57974,13,37,15,13,14,0,92,38.23521801680023,-109.3931073
57975,11,39,15,13,15,0,93,38.23521801680023,-109.3928378
57976,10,40,15,13,15,0,93,38.23521801680023,-109.3925683
57977,11,40,15,13,14,0,93,38.23521801680023,-109.3922988
57978,11,40,15,13,14,0,93,38.23521801680023,-109.3920293
57979,9,43,14,13,14,0,93,38.23521801680023,-109.3917598
57980,7,44,14,12,14,1,92,38.23521801680023,-109.3914903
57981,8,39,13,12,15,1,88,38.23521801680023,-109.3912208
57982,7,41,13,12,15,0,88,38.23521801680023,-109.3909513
57983,8,42,14,12,15,0,91,38.23521801680023,-109.3906818
57984,10,40,14,12,15,1,92,38.23521801680023,-109.3904123
57985,10,39,14,12,16,1,92,38.23521801680023,-109.3901429
57986,9,40,14,12,16,0,91,38.23521801680023,-109.3898734
57987,8,39,14,11,16,1,89,38.23521801680023,-109.3896039
57988,6,42,14,10,16,1,89,38.23521801680023,-109.3893344
57989,5,46,12,8,15,2,88,38.23521801680023,-109.3890649
57990,4,49,11,6,13,3,86,38.23521801680023,-109.3887954
57991,4,47,11,6,12,3,83,38.23521801680023,-109.3885259
57992,5,42,12,8,11,3,81,38.23521801680023,-109.3882564
57993,7,39,13,11,12,3,85,38.23521801680023,-109.3879869
57994,10,38,12,9,11,1,81,38.23521801680023,-109.3877174
57995,13,36,10,7,9,1,76,38.23521801680023,-109.3874479
57996,13,39,12,9,10,1,84,38.23521801680023,-109.3871784
57997,11,42,13,13,13,1,93,38.23521801680023,-109.3869089
57998,8,44,14,13,13,1,93,38.23521801680023,-109.3866394
57999,7,43,14,12,12,2,90,38.23521801680023,-109.3863699
58000,9,42,14,11,11,2,89,38.23521801680023,-109.3861004
58001,14,40,14,10,11,1,90,38.23521801680023,-109.3858309
58002,17,38,13,11,11,1,91,38.23521801680023,-109.3855614
58003,16,35,12,10,10,0,83,38.23521801680023,-109.3852919
58004,19,33,11,10,8,0,81,38.23521801680023,-109.3850225
58005,17,35,12,13,9,1,87,38.23521801680023,-109.384753
58006,15,36,13,14,10,1,89,38.23521801680023,-109.3844835
58007,11,40,14,13,13,1,92,38.23521801680023,-109.384214
58008,7,42,14,13,14,1,91,38.23521801680023,-109.3839445
58009,6,42,13,11,14,1,87,38.23521801680023,-109.383675
58010,6,43,13,10,14,2,88,38.23521801680023,-109.3834055
58011,6,44,13,10,13,2,88,38.23521801680023,-109.383136
58012,5,46,12,8,14,2,87,38.23521801680023,-109.3828665
58013,5,47,12,8,15,1,88,38.23521801680023,-109.382597
58014,7,50,11,8,13,0,89,38.23521801680023,-109.3823275
58015,10,49,11,7,14,0,91,38.23521801680023,-109.382058
58016,8,47,11,7,15,0,88,38.23521801680023,-109.3817885
58017,7,50,11,7,15,0,90,38.23521801680023,-109.381519
58018,11,45,13,10,14,0,93,38.23521801680023,-109.3812495
58019,8,46,14,10,13,1,92,38.23521801680023,-109.38098
58020,9,45,14,10,12,1,91,38.23521801680023,-109.3807105
58021,9,45,14,11,12,1,92,38.23521801680023,-109.380441
58022,8,45,14,11,13,1,92,38.23521801680023,-109.3801716
58023,5,46,13,10,14,1,89,38.23521801680023,-109.3799021
58024,4,47,12,10,15,1,89,38.23521801680023,-109.3796326
58025,6,44,12,9,15,1,87,38.23521801680023,-109.3793631
58026,13,33,11,10,12,1,80,38.23521801680023,-109.3790936
58027,11,19,10,16,12,1,69,38.23521801680023,-109.3788241
58028,9,22,11,14,13,3,72,38.23521801680023,-109.3785546
58029,8,37,13,10,15,2,85,38.23521801680023,-109.3782851
58030,5,47,14,9,17,0,92,38.23521801680023,-109.3780156
58031,5,51,13,8,13,1,91,38.23521801680023,-109.3777461
58032,6,48,13,10,12,1,90,38.23521801680023,-109.3774766
58033,8,47,12,10,12,1,90,38.23521801680023,-109.3772071
58034,11,45,14,11,11,1,93,38.23521801680023,-109.3769376
58035,11,44,15,12,11,1,94,38.23521801680023,-109.3766681
58036,9,42,14,9,13,1,88,38.23521801680023,-109.3763986
58037,6,40,13,8,13,2,82,38.23521801680023,-109.3761291
58038,4,39,12,6,13,4,78,38.23521801680023,-109.3758596
58039,3,40,11,5,13,5,77,38.23521801680023,-109.3755901
58040,2,46,10,5,13,4,80,38.23521801680023,-109.3753206
58041,3,50,9,6,12,2,82,38.23521801680023,-109.3750512
58042,3,53,9,7,12,1,85,38.23521801680023,-109.3747817
58043,4,50,10,7,12,2,85,38.23521801680023,-109.3745122
58044,4,49,10,8,12,2,85,38.23521801680023,-109.3742427
58045,4,49,9,7,12,2,83,38.23521801680023,-109.3739732
58046,4,44,9,6,11,2,76,38.23521801680023,-109.3737037
58047,4,45,9,7,11,2,78,38.23521801680023,-109.3734342
58048,2,42,9,6,13,3,75,38.23521801680023,-109.3731647
58049,2,41,10,5,14,4,76,38.23521801680023,-109.3728952
58050,2,37,10,1,14,6,70,38.23521801680023,-109.3726257
58051,3,35,11,5,16,5,75,38.23521801680023,-109.3723562
58052,4,36,11,4,14,7,76,38.23521801680023,-109.3720867
58053,7,38,12,7,15,4,83,38.23521801680023,-109.3718172
58054,12,38,13,10,15,1,89,38.23521801680023,-109.3715477
58055,13,37,13,11,14,1,89,38.23521801680023,-109.3712782
58056,14,38,13,12,13,0,90,38.23521801680023,-109.3710087
58057,11,39,14,14,13,0,91,38.23521801680023,-109.3707392
58058,11,39,14,15,12,1,92,38.23521801680023,-109.3704697
58059,12,39,15,15,11,1,93,38.23521801680023,-109.3702003
58060,13,37,14,15,11,1,91,38.23521801680023,-109.3699308
58061,12,38,14,15,12,1,92,38.23521801680023,-109.3696613
58062,12,37,14,14,12,1,90,38.23521801680023,-109.3693918
58063,10,37,14,11,13,3,88,38.23521801680023,-109.3691223
58064,5,37,13,7,14,7,83,38.23521801680023,-109.3688528
58065,5,39,13,7,12,7,83,38.23521801680023,-109.3685833
58066,4,36,13,7,13,8,81,38.23521801680023,-109.3683138
58067,4,34,13,5,11,11,78,38.23521801680023,-109.3680443
58068,3,34,12,2,10,12,73,38.23521801680023,-109.3677748
58069,2,36,10,0,12,9,69,38.23521801680023,-109.3675053
58070,2,42,11,2,14,5,76,38.23521801680023,-109.3672358
58071,1,45,8,1,13,4,72,38.23521801680023,-109.3669663
58072,1,40,8,2,12,5,68,38.23521801680023,-109.3666968
58073,1,33,9,3,12,6,64,38.23521801680023,-109.3664273
58074,1,33,10,0,8,11,63,38.23521801680023,-109.3661578
58075,1,35,9,0,8,12,65,38.23521801680023,-109.3658883
58076,1,37,9,0,8,11,66,38.23521801680023,-109.3656188
58077,1,37,9,1,9,9,66,38.23521801680023,-109.3653493
58078,2,40,10,2,12,7,73,38.23521801680023,-109.3650799
58079,3,49,11,1,13,6,83,38.23521801680023,-109.3648104
58080,2,51,10,1,13,6,83,38.23521801680023,-109.3645409
58081,2,50,10,2,13,6,83,38.23521801680023,-109.3642714
58082,3,49,11,3,13,5,84,38.23521801680023,-109.3640019
58083,4,48,11,4,13,4,84,38.23521801680023,-109.3637324
58084,4,47,12,5,12,4,84,38.23521801680023,-109.3634629
58085,4,46,12,5,12,4,83,38.23521801680023,-109.3631934
58086,4,48,12,4,13,5,86,38.23521801680023,-109.3629239
58087,3,46,11,3,14,6,83,38.23521801680023,-109.3626544
58088,2,43,10,2,12,7,76,38.23521801680023,-109.3623849
58089,2,46,10,2,16,5,81,38.23521801680023,-109.3621154
58090,2,45,11,2,17,4,81,38.23521801680023,-109.3618459
58091,3,48,11,4,14,4,84,38.23521801680023,-109.3615764
58092,4,50,11,5,12,4,86,38.23521801680023,-109.3613069
58093,5,47,12,6,12,4,86,38.23521801680023,-109.3610374
58094,6,46,12,7,13,2,86,38.23521801680023,-109.3607679
58095,6,43,13,8,13,3,86,38.23521801680023,-109.3604984
58096,6,43,13,8,12,3,85,38.23521801680023,-109.360229
58097,6,46,13,7,12,3,87,38.23521801680023,-109.3599595
58098,5,44,12,6,13,4,84,38.23521801680023,-109.35969
58099,5,42,12,6,14,3,82,38.23521801680023,-109.3594205
58100,5,42,11,6,13,3,80,38.23521801680023,-109.359151
58101,4,39,10,5,10,4,72,38.23521801680023,-109.3588815
58102,2,31,9,4,9,5,60,38.23521801680023,-109.358612
58103,2,23,10,6,8,7,56,38.23521801680023,-109.3583425
58104,12,22,13,14,12,6,79,38.23521801680023,-109.358073
58105,30,16,12,18,11,3,90,38.23521801680023,-109.3578035
58106,32,13,11,25,7,2,90,38.23521801680023,-109.357534
58107,30,13,10,26,11,3,93,38.23521801680023,-109.3572645
58108,33,9,9,27,12,3,93,38.23521801680023,-109.356995
58109,32,12,10,28,8,1,91,38.23521801680023,-109.3567255
58110,30,14,10,27,4,2,87,38.23521801680023,-109.356456
58111,34,14,9,26,3,1,87,38.23521801680023,-109.3561865
58112,39,13,9,26,4,0,91,38.23521801680023,-109.355917
58113,36,11,10,22,8,2,89,38.23521801680023,-109.3556475
58114,37,12,10,15,7,1,82,38.23521801680023,-109.355378
58115,40,16,11,14,7,1,89,38.23521801680023,-109.3551086
58116,33,20,11,17,10,1,92,38.23521801680023,-109.3548391
58117,16,19,13,14,12,5,79,38.23521801680023,-109.3545696
58118,9,17,13,9,9,9,66,38.23521801680023,-109.3543001
58119,4,19,11,7,11,8,60,38.23521801680023,-109.3540306
58120,4,26,9,5,13,5,62,38.23521801680023,-109.3537611
58121,4,27,9,5,12,4,61,38.23521801680023,-109.3534916
58122,2,27,9,3,8,7,56,38.23521801680023,-109.3532221
58123,3,27,9,5,10,7,61,38.23521801680023,-109.3529526
58124,3,28,11,7,8,10,67,38.23521801680023,-109.3526831
58125,4,21,14,10,8,14,71,38.23521801680023,-109.3524136
58126,14,17,16,11,14,16,88,38.23521801680023,-109.3521441
58127,9,22,17,5,8,24,85,38.23521801680023,-109.3518746
58128,6,26,16,3,5,25,81,38.23521801680023,-109.3516051
58129,3,28,15,2,6,23,77,38.23521801680023,-109.3513356
58130,5,47,10,8,15,0,85,38.23494852221499,-109.4068515
58131,6,46,11,8,15,1,87,38.23494852221499,-109.406582
58132,7,46,12,10,14,1,90,38.23494852221499,-109.4063125
58133,7,44,12,11,13,1,88,38.23494852221499,-109.406043
58134,8,42,13,11,13,1,88,38.23494852221499,-109.4057735
58135,10,40,13,12,13,1,89,38.23494852221499,-109.405504
58136,10,41,12,11,13,1,88,38.23494852221499,-109.4052345
58137,5,47,11,10,14,1,88,38.23494852221499,-109.4049651
58138,6,45,12,11,14,1,89,38.23494852221499,-109.4046956
58139,8,43,12,11,14,1,89,38.23494852221499,-109.4044261
58140,11,43,12,10,14,0,90,38.23494852221499,-109.4041566
58141,13,37,13,13,14,0,90,38.23494852221499,-109.4038871
58142,9,45,13,11,16,0,94,38.23494852221499,-109.4036176
58143,9,43,13,10,15,1,91,38.23494852221499,-109.4033481
58144,14,40,13,10,14,1,92,38.23494852221499,-109.4030786
58145,17,38,13,10,13,0,91,38.23494852221499,-109.4028091
58146,16,39,13,9,13,0,90,38.23494852221499,-109.4025396
58147,15,39,13,10,14,0,91,38.23494852221499,-109.4022701
58148,12,40,13,10,15,1,91,38.23494852221499,-109.4020006
58149,9,41,13,9,16,1,89,38.23494852221499,-109.4017311
58150,10,42,14,9,16,0,91,38.23494852221499,-109.4014616
58151,10,43,13,9,15,0,90,38.23494852221499,-109.4011921
58152,11,41,13,10,15,0,90,38.23494852221499,-109.4009226
58153,14,39,13,11,15,0,92,38.23494852221499,-109.4006531
58154,18,37,13,10,14,0,92,38.23494852221499,-109.4003836
58155,19,36,13,10,13,0,91,38.23494852221499,-109.4001142
58156,12,40,13,10,15,0,90,38.23494852221499,-109.3998447
58157,9,42,13,8,16,1,89,38.23494852221499,-109.3995752
58158,8,44,13,7,15,1,88,38.23494852221499,-109.3993057
58159,9,46,12,7,14,0,88,38.23494852221499,-109.3990362
58160,10,46,12,7,14,1,90,38.23494852221499,-109.3987667
58161,11,46,12,8,14,0,91,38.23494852221499,-109.3984972
58162,11,46,12,8,14,0,91,38.23494852221499,-109.3982277
58163,11,47,12,8,13,0,91,38.23494852221499,-109.3979582
58164,10,48,12,8,13,0,91,38.23494852221499,-109.3976887
58165,11,44,12,10,14,0,91,38.23494852221499,-109.3974192
58166,10,43,12,10,14,1,90,38.23494852221499,-109.3971497
58167,13,41,13,10,14,1,92,38.23494852221499,-109.3968802
58168,16,41,12,9,13,0,91,38.23494852221499,-109.3966107
58169,13,50,11,8,12,0,94,38.23494852221499,-109.3963412
58170,11,50,10,8,12,0,91,38.23494852221499,-109.3960717
58171,11,47,11,9,12,0,90,38.23494852221499,-109.3958022
58172,10,47,12,10,13,1,93,38.23494852221499,-109.3955327
58173,7,49,12,10,14,1,93,38.23494852221499,-109.3952632
58174,7,48,13,10,15,1,94,38.23494852221499,-109.3949938
58175,7,45,13,10,15,1,91,38.23494852221499,-109.3947243
58176,7,45,13,11,15,1,92,38.23494852221499,-109.3944548
58177,7,45,14,11,16,1,94,38.23494852221499,-109.3941853
58178,8,44,14,13,15,0,94,38.23494852221499,-109.3939158
58179,10,41,14,13,15,0,93,38.23494852221499,-109.3936463
58180,11,41,14,12,14,0,92,38.23494852221499,-109.3933768
58181,11,42,14,12,14,0,93,38.23494852221499,-109.3931073
58182,10,42,14,12,14,0,92,38.23494852221499,-109.3928378
58183,8,42,14,12,14,1,91,38.23494852221499,-109.3925683
58184,9,41,14,13,14,0,91,38.23494852221499,-109.3922988
58185,9,42,14,13,14,0,92,38.23494852221499,-109.3920293
58186,9,43,14,13,14,0,93,38.23494852221499,-109.3917598
58187,8,44,14,13,15,0,94,38.23494852221499,-109.3914903
58188,9,41,13,13,15,0,91,38.23494852221499,-109.3912208
58189,10,42,13,12,15,0,92,38.23494852221499,-109.3909513
58190,11,41,13,11,14,1,91,38.23494852221499,-109.3906818
58191,11,40,14,11,14,1,91,38.23494852221499,-109.3904123
58192,10,40,14,11,15,1,91,38.23494852221499,-109.3901429
58193,9,41,14,11,15,1,91,38.23494852221499,-109.3898734
58194,8,40,14,10,17,1,90,38.23494852221499,-109.3896039
58195,6,41,13,9,17,1,87,38.23494852221499,-109.3893344
58196,5,43,13,9,15,2,87,38.23494852221499,-109.3890649
58197,3,48,11,6,13,3,84,38.23494852221499,-109.3887954
58198,3,46,10,7,12,3,81,38.23494852221499,-109.3885259
58199,5,41,12,8,11,4,81,38.23494852221499,-109.3882564
58200,6,39,13,11,11,3,83,38.23494852221499,-109.3879869
58201,8,42,13,12,12,2,89,38.23494852221499,-109.3877174
58202,10,42,12,11,11,1,87,38.23494852221499,-109.3874479
58203,8,44,13,13,12,1,91,38.23494852221499,-109.3871784
58204,7,45,13,13,13,1,92,38.23494852221499,-109.3869089
58205,7,46,13,12,13,1,92,38.23494852221499,-109.3866394
58206,7,43,14,12,13,2,91,38.23494852221499,-109.3863699
58207,10,41,15,13,12,2,93,38.23494852221499,-109.3861004
58208,14,38,14,11,11,1,89,38.23494852221499,-109.3858309
58209,16,36,14,11,11,1,89,38.23494852221499,-109.3855614
58210,17,35,13,11,11,0,87,38.23494852221499,-109.3852919
58211,18,32,11,11,8,0,80,38.23494852221499,-109.3850225
58212,19,33,12,14,8,0,86,38.23494852221499,-109.384753
58213,17,34,14,13,11,1,90,38.23494852221499,-109.3844835
58214,11,39,14,14,13,1,92,38.23494852221499,-109.384214
58215,7,43,14,13,13,1,91,38.23494852221499,-109.3839445
58216,6,44,13,11,13,2,89,38.23494852221499,-109.383675
58217,7,43,13,10,14,1,88,38.23494852221499,-109.3834055
58218,5,44,12,9,14,2,86,38.23494852221499,-109.383136
58219,4,47,11,8,14,2,86,38.23494852221499,-109.3828665
58220,5,47,11,9,14,1,87,38.23494852221499,-109.382597
58221,8,46,12,10,13,1,90,38.23494852221499,-109.3823275
58222,12,40,11,9,14,1,87,38.23494852221499,-109.382058
58223,11,38,12,10,14,1,86,38.23494852221499,-109.3817885
58224,10,43,13,10,13,1,90,38.23494852221499,-109.381519
58225,12,43,14,11,14,0,94,38.23494852221499,-109.3812495
58226,8,43,14,11,13,1,90,38.23494852221499,-109.38098
58227,9,44,14,11,13,1,92,38.23494852221499,-109.3807105
58228,10,45,14,11,12,1,93,38.23494852221499,-109.380441
58229,10,44,14,10,13,1,92,38.23494852221499,-109.3801716
58230,9,42,13,11,15,0,90,38.23494852221499,-109.3799021
58231,6,46,12,11,15,0,90,38.23494852221499,-109.3796326
58232,7,46,12,9,15,0,89,38.23494852221499,-109.3793631
58233,13,36,12,11,13,1,86,38.23494852221499,-109.3790936
58234,13,24,11,16,11,0,75,38.23494852221499,-109.3788241
58235,9,19,9,16,13,1,67,38.23494852221499,-109.3785546
58236,11,33,12,9,14,1,80,38.23494852221499,-109.3782851
58237,7,46,14,8,16,1,92,38.23494852221499,-109.3780156
58238,6,50,14,9,13,1,93,38.23494852221499,-109.3777461
58239,8,47,15,12,11,1,94,38.23494852221499,-109.3774766
58240,9,48,13,11,12,1,94,38.23494852221499,-109.3772071
58241,9,47,13,11,12,1,93,38.23494852221499,-109.3769376
58242,8,47,13,10,12,1,91,38.23494852221499,-109.3766681
58243,7,42,13,7,13,2,84,38.23494852221499,-109.3763986
58244,5,39,12,6,12,3,77,38.23494852221499,-109.3761291
58245,3,43,10,3,13,4,76,38.23494852221499,-109.3758596
58246,2,45,9,2,13,6,77,38.23494852221499,-109.3755901
58247,2,49,9,2,13,5,80,38.23494852221499,-109.3753206
58248,3,54,9,4,13,2,85,38.23494852221499,-109.3750512
58249,4,55,9,6,12,1,87,38.23494852221499,-109.3747817
58250,3,49,9,6,12,2,81,38.23494852221499,-109.3745122
58251,3,46,9,6,13,3,80,38.23494852221499,-109.3742427
58252,3,44,9,6,14,3,79,38.23494852221499,-109.3739732
58253,3,41,9,6,13,3,75,38.23494852221499,-109.3737037
58254,5,41,10,6,14,3,79,38.23494852221499,-109.3734342
58255,2,37,10,3,14,6,72,38.23494852221499,-109.3731647
58256,2,34,10,2,14,8,70,38.23494852221499,-109.3728952
58257,2,34,10,2,15,6,69,38.23494852221499,-109.3726257
58258,5,36,11,5,13,6,76,38.23494852221499,-109.3723562
58259,11,36,12,10,15,2,86,38.23494852221499,-109.3720867
58260,14,37,13,11,15,0,90,38.23494852221499,-109.3718172
58261,16,36,14,13,13,0,92,38.23494852221499,-109.3715477
58262,16,36,14,14,13,0,93,38.23494852221499,-109.3712782
58263,15,36,14,14,12,0,91,38.23494852221499,-109.3710087
58264,13,38,14,14,13,0,92,38.23494852221499,-109.3707392
58265,13,38,14,13,12,1,91,38.23494852221499,-109.3704697
58266,14,37,14,14,12,1,92,38.23494852221499,-109.3702003
58267,15,36,14,16,11,1,93,38.23494852221499,-109.3699308
58268,15,36,14,15,11,1,92,38.23494852221499,-109.3696613
58269,14,38,14,15,11,1,93,38.23494852221499,-109.3693918
58270,11,40,14,14,12,1,92,38.23494852221499,-109.3691223
58271,9,41,14,13,12,2,91,38.23494852221499,-109.3688528
58272,11,41,14,14,11,1,92,38.23494852221499,-109.3685833
58273,14,38,14,13,11,1,91,38.23494852221499,-109.3683138
58274,13,36,14,14,11,2,90,38.23494852221499,-109.3680443
58275,8,35,13,10,11,8,85,38.23494852221499,-109.3677748
58276,2,33,14,2,10,17,78,38.23494852221499,-109.3675053
58277,2,33,13,0,9,19,76,38.23494852221499,-109.3672358
58278,1,35,10,0,12,12,70,38.23494852221499,-109.3669663
58279,1,32,10,2,11,10,66,38.23494852221499,-109.3666968
58280,2,30,11,3,13,8,67,38.23494852221499,-109.3664273
58281,0,27,11,1,6,16,61,38.23494852221499,-109.3661578
58282,0,38,9,1,10,11,69,38.23494852221499,-109.3658883
58283,1,38,8,2,10,7,66,38.23494852221499,-109.3656188
58284,1,39,8,1,10,7,66,38.23494852221499,-109.3653493
58285,1,42,9,1,11,9,73,38.23494852221499,-109.3650799
58286,2,50,10,1,11,9,83,38.23494852221499,-109.3648104
58287,2,51,10,1,13,7,84,38.23494852221499,-109.3645409
58288,2,47,10,1,13,7,80,38.23494852221499,-109.3642714
58289,2,44,10,3,13,6,78,38.23494852221499,-109.3640019
58290,2,44,9,2,12,6,75,38.23494852221499,-109.3637324
58291,2,48,10,2,13,5,80,38.23494852221499,-109.3634629
58292,3,50,11,4,12,4,84,38.23494852221499,-109.3631934
58293,4,49,12,4,12,4,85,38.23494852221499,-109.3629239
58294,3,49,11,2,13,6,84,38.23494852221499,-109.3626544
58295,2,44,10,2,12,7,77,38.23494852221499,-109.3623849
58296,4,45,11,2,15,6,83,38.23494852221499,-109.3621154
58297,3,49,10,2,14,6,84,38.23494852221499,-109.3618459
58298,3,49,10,4,13,5,84,38.23494852221499,-109.3615764
58299,4,48,11,5,14,3,85,38.23494852221499,-109.3613069
58300,4,46,12,6,12,4,84,38.23494852221499,-109.3610374
58301,5,47,13,6,13,3,87,38.23494852221499,-109.3607679
58302,6,44,13,8,13,3,87,38.23494852221499,-109.3604984
58303,6,42,13,9,12,3,85,38.23494852221499,-109.360229
58304,7,43,13,8,12,3,86,38.23494852221499,-109.3599595
58305,7,42,12,7,13,3,84,38.23494852221499,-109.35969
58306,4,40,11,5,13,5,78,38.23494852221499,-109.3594205
58307,4,40,11,5,13,5,78,38.23494852221499,-109.359151
58308,4,38,10,5,11,6,74,38.23494852221499,-109.3588815
58309,3,35,9,4,9,5,65,38.23494852221499,-109.358612
58310,2,25,9,5,9,6,56,38.23494852221499,-109.3583425
58311,7,20,12,13,12,6,70,38.23494852221499,-109.358073
58312,23,16,14,16,15,5,89,38.23494852221499,-109.3578035
58313,31,7,9,25,13,5,90,38.23494852221499,-109.357534
58314,31,6,8,26,13,7,91,38.23494852221499,-109.3572645
58315,37,7,9,26,10,5,94,38.23494852221499,-109.356995
58316,35,11,10,29,6,1,92,38.23494852221499,-109.3567255
58317,34,13,10,27,3,1,88,38.23494852221499,-109.356456
58318,38,14,10,23,3,1,89,38.23494852221499,-109.3561865
58319,42,15,9,19,2,1,88,38.23494852221499,-109.355917
58320,34,13,9,14,5,0,75,38.23494852221499,-109.3556475
58321,38,15,9,9,5,0,76,38.23494852221499,-109.355378
58322,40,19,10,12,7,1,89,38.23494852221499,-109.3551086
58323,28,19,12,19,12,2,92,38.23494852221499,-109.3548391
58324,24,22,14,18,10,1,89,38.23494852221499,-109.3545696
58325,20,21,13,17,10,3,84,38.23494852221499,-109.3543001
58326,11,21,11,15,11,5,74,38.23494852221499,-109.3540306
58327,9,23,11,14,14,3,74,38.23494852221499,-109.3537611
58328,9,23,11,14,13,3,73,38.23494852221499,-109.3534916
58329,7,22,12,15,10,6,72,38.23494852221499,-109.3532221
58330,9,22,13,13,10,9,76,38.23494852221499,-109.3529526
58331,12,23,15,10,8,12,80,38.23494852221499,-109.3526831
58332,10,20,14,14,10,12,80,38.23494852221499,-109.3524136
58333,10,21,14,16,15,11,87,38.23494852221499,-109.3521441
58334,4,27,14,3,9,18,75,38.23494852221499,-109.3518746
58335,1,33,12,0,9,18,73,38.23494852221499,-109.3516051
58336,1,33,12,0,10,17,73,38.23494852221499,-109.3513356
58337,10,48,10,9,13,0,90,38.23467902762976,-109.4068515
58338,5,51,9,6,15,0,86,38.23467902762976,-109.406582
58339,7,50,10,8,13,0,88,38.23467902762976,-109.4063125
58340,6,49,10,9,13,1,88,38.23467902762976,-109.406043
58341,7,47,11,9,13,1,88,38.23467902762976,-109.4057735
58342,6,48,11,9,13,1,88,38.23467902762976,-109.405504
58343,5,51,10,8,13,1,88,38.23467902762976,-109.4052345
58344,3,56,9,7,13,1,89,38.23467902762976,-109.4049651
58345,3,54,9,6,14,0,86,38.23467902762976,-109.4046956
58346,3,51,10,7,15,0,86,38.23467902762976,-109.4044261
58347,6,48,11,8,16,0,89,38.23467902762976,-109.4041566
58348,10,44,13,11,15,0,93,38.23467902762976,-109.4038871
58349,11,43,13,11,15,0,93,38.23467902762976,-109.4036176
58350,13,41,13,10,14,0,91,38.23467902762976,-109.4033481
58351,16,40,13,10,13,0,92,38.23467902762976,-109.4030786
58352,17,38,13,9,13,0,90,38.23467902762976,-109.4028091
58353,17,38,13,9,13,0,90,38.23467902762976,-109.4025396
58354,14,39,13,10,14,0,90,38.23467902762976,-109.4022701
58355,14,39,13,11,14,0,91,38.23467902762976,-109.4020006
58356,13,39,13,11,14,0,90,38.23467902762976,-109.4017311
58357,12,40,13,11,15,0,91,38.23467902762976,-109.4014616
58358,14,39,13,11,14,0,91,38.23467902762976,-109.4011921
58359,15,38,14,11,14,0,92,38.23467902762976,-109.4009226
58360,17,38,13,10,13,0,91,38.23467902762976,-109.4006531
58361,19,37,13,10,13,0,92,38.23467902762976,-109.4003836
58362,20,35,13,10,12,0,90,38.23467902762976,-109.4001142
58363,17,37,14,10,14,0,92,38.23467902762976,-109.3998447
58364,14,39,14,9,15,0,91,38.23467902762976,-109.3995752
58365,12,42,14,9,15,0,92,38.23467902762976,-109.3993057
58366,13,42,13,9,15,0,92,38.23467902762976,-109.3990362
58367,16,42,13,8,13,0,92,38.23467902762976,-109.3987667
58368,15,43,13,8,13,0,92,38.23467902762976,-109.3984972
58369,15,44,12,8,13,0,92,38.23467902762976,-109.3982277
58370,15,45,12,8,12,0,92,38.23467902762976,-109.3979582
58371,16,44,12,8,12,0,92,38.23467902762976,-109.3976887
58372,14,43,12,9,13,0,91,38.23467902762976,-109.3974192
58373,16,40,12,9,13,0,90,38.23467902762976,-109.3971497
58374,20,38,12,8,13,0,91,38.23467902762976,-109.3968802
58375,20,39,11,8,13,0,91,38.23467902762976,-109.3966107
58376,15,48,10,8,12,0,93,38.23467902762976,-109.3963412
58377,13,50,10,8,13,0,94,38.23467902762976,-109.3960717
58378,12,49,11,8,12,0,92,38.23467902762976,-109.3958022
58379,9,52,11,7,13,0,92,38.23467902762976,-109.3955327
58380,5,52,11,6,14,1,89,38.23467902762976,-109.3952632
58381,6,53,10,6,13,1,89,38.23467902762976,-109.3949938
58382,6,49,11,8,14,1,89,38.23467902762976,-109.3947243
58383,6,49,12,9,14,1,91,38.23467902762976,-109.3944548
58384,6,50,12,9,15,1,93,38.23467902762976,-109.3941853
58385,7,49,12,10,15,1,94,38.23467902762976,-109.3939158
58386,8,46,12,11,15,0,92,38.23467902762976,-109.3936463
58387,8,45,13,11,14,0,91,38.23467902762976,-109.3933768
58388,9,45,13,11,14,1,93,38.23467902762976,-109.3931073
58389,8,44,13,11,13,1,90,38.23467902762976,-109.3928378
58390,7,44,13,10,13,1,88,38.23467902762976,-109.3925683
58391,8,44,13,11,14,1,91,38.23467902762976,-109.3922988
58392,9,45,13,11,14,1,93,38.23467902762976,-109.3920293
58393,9,46,13,11,14,0,93,38.23467902762976,-109.3917598
58394,9,46,13,11,15,0,94,38.23467902762976,-109.3914903
58395,10,43,13,11,15,0,92,38.23467902762976,-109.3912208
58396,12,42,13,11,14,0,92,38.23467902762976,-109.3909513
58397,13,41,13,11,13,0,91,38.23467902762976,-109.3906818
58398,12,40,14,11,14,1,92,38.23467902762976,-109.3904123
58399,10,41,14,11,15,1,92,38.23467902762976,-109.3901429
58400,10,42,14,10,16,0,92,38.23467902762976,-109.3898734
58401,9,41,14,11,16,0,91,38.23467902762976,-109.3896039
58402,10,40,13,11,16,1,91,38.23467902762976,-109.3893344
58403,9,41,13,11,15,1,90,38.23467902762976,-109.3890649
58404,6,43,12,9,14,2,86,38.23467902762976,-109.3887954
58405,4,41,12,8,12,3,80,38.23467902762976,-109.3885259
58406,5,38,12,9,11,4,79,38.23467902762976,-109.3882564
58407,7,39,13,11,12,3,85,38.23467902762976,-109.3879869
58408,9,37,11,9,11,1,78,38.23467902762976,-109.3877174
58409,9,39,11,9,10,1,79,38.23467902762976,-109.3874479
58410,7,45,13,11,12,2,90,38.23467902762976,-109.3871784
58411,6,46,13,10,12,2,89,38.23467902762976,-109.3869089
58412,6,45,13,11,13,2,90,38.23467902762976,-109.3866394
58413,7,44,14,12,12,2,91,38.23467902762976,-109.3863699
58414,8,43,15,13,12,1,92,38.23467902762976,-109.3861004
58415,8,42,15,14,13,1,93,38.23467902762976,-109.3858309
58416,9,41,14,14,13,1,92,38.23467902762976,-109.3855614
58417,11,40,14,14,14,1,94,38.23467902762976,-109.3852919
58418,16,37,13,13,11,0,90,38.23467902762976,-109.3850225
58419,20,33,12,13,9,1,88,38.23467902762976,-109.384753
58420,16,36,14,13,13,1,93,38.23467902762976,-109.3844835
58421,10,40,15,14,14,1,94,38.23467902762976,-109.384214
58422,8,41,15,14,14,1,93,38.23467902762976,-109.3839445
58423,6,43,14,11,14,2,90,38.23467902762976,-109.383675
58424,6,42,13,11,15,1,88,38.23467902762976,-109.3834055
58425,5,44,12,10,15,1,87,38.23467902762976,-109.383136
58426,6,46,12,11,14,1,90,38.23467902762976,-109.3828665
58427,9,43,12,11,15,0,90,38.23467902762976,-109.382597
58428,9,45,11,9,14,1,89,38.23467902762976,-109.3823275
58429,16,36,12,9,14,1,88,38.23467902762976,-109.382058
58430,19,35,12,9,14,0,89,38.23467902762976,-109.3817885
58431,14,39,13,9,13,1,89,38.23467902762976,-109.381519
58432,13,43,14,10,13,1,94,38.23467902762976,-109.3812495
58433,11,44,14,9,13,1,92,38.23467902762976,-109.38098
58434,11,44,14,10,13,0,92,38.23467902762976,-109.3807105
58435,10,44,14,11,13,0,92,38.23467902762976,-109.380441
58436,9,43,13,10,14,1,90,38.23467902762976,-109.3801716
58437,10,43,13,10,15,0,91,38.23467902762976,-109.3799021
58438,6,46,12,9,16,1,90,38.23467902762976,-109.3796326
58439,7,45,13,9,16,0,90,38.23467902762976,-109.3793631
58440,11,40,13,11,14,0,89,38.23467902762976,-109.3790936
58441,13,27,12,14,12,1,79,38.23467902762976,-109.3788241
58442,9,21,10,18,11,1,70,38.23467902762976,-109.3785546
58443,14,30,12,10,12,1,79,38.23467902762976,-109.3782851
58444,10,44,13,8,14,1,90,38.23467902762976,-109.3780156
58445,8,46,15,11,12,1,93,38.23467902762976,-109.3777461
58446,11,44,15,12,11,1,94,38.23467902762976,-109.3774766
58447,9,46,14,11,12,1,93,38.23467902762976,-109.3772071
58448,8,49,13,11,13,0,94,38.23467902762976,-109.3769376
58449,6,49,12,8,13,1,89,38.23467902762976,-109.3766681
58450,4,46,11,5,14,2,82,38.23467902762976,-109.3763986
58451,3,41,10,3,13,4,74,38.23467902762976,-109.3761291
58452,2,47,9,1,13,4,76,38.23467902762976,-109.3758596
58453,2,50,9,1,13,4,79,38.23467902762976,-109.3755901
58454,2,53,9,3,14,3,84,38.23467902762976,-109.3753206
58455,4,58,9,4,13,2,90,38.23467902762976,-109.3750512
58456,3,58,9,4,13,1,88,38.23467902762976,-109.3747817
58457,4,49,9,5,13,2,82,38.23467902762976,-109.3745122
58458,4,44,10,4,12,6,80,38.23467902762976,-109.3742427
58459,6,40,11,5,11,8,81,38.23467902762976,-109.3739732
58460,8,41,12,8,14,3,86,38.23467902762976,-109.3737037
58461,12,39,12,9,15,1,88,38.23467902762976,-109.3734342
58462,4,38,11,4,15,5,77,38.23467902762976,-109.3731647
58463,3,37,10,0,14,7,71,38.23467902762976,-109.3728952
58464,5,37,11,6,17,3,79,38.23467902762976,-109.3726257
58465,10,40,12,9,14,1,86,38.23467902762976,-109.3723562
58466,15,37,13,11,13,1,90,38.23467902762976,-109.3720867
58467,15,37,13,11,12,1,89,38.23467902762976,-109.3718172
58468,14,38,13,12,12,1,90,38.23467902762976,-109.3715477
58469,13,39,14,14,12,0,92,38.23467902762976,-109.3712782
58470,13,38,14,15,12,0,92,38.23467902762976,-109.3710087
58471,11,40,14,14,13,0,92,38.23467902762976,-109.3707392
58472,10,40,14,14,13,1,92,38.23467902762976,-109.3704697
58473,9,39,14,15,13,1,91,38.23467902762976,-109.3702003
58474,10,39,15,16,13,1,94,38.23467902762976,-109.3699308
58475,11,39,15,16,12,1,94,38.23467902762976,-109.3696613
58476,12,39,15,16,12,1,95,38.23467902762976,-109.3693918
58477,13,40,15,15,12,0,95,38.23467902762976,-109.3691223
58478,14,40,15,15,11,0,95,38.23467902762976,-109.3688528
58479,18,38,14,14,11,0,95,38.23467902762976,-109.3685833
58480,25,33,13,13,9,0,93,38.23467902762976,-109.3683138
58481,23,32,13,14,9,0,91,38.23467902762976,-109.3680443
58482,17,34,13,15,11,1,91,38.23467902762976,-109.3677748
58483,10,35,13,13,12,4,87,38.23467902762976,-109.3675053
58484,6,38,14,7,13,8,86,38.23467902762976,-109.3672358
58485,2,38,12,2,14,10,78,38.23467902762976,-109.3669663
58486,0,32,12,0,11,16,71,38.23467902762976,-109.3666968
58487,0,27,12,0,8,17,64,38.23467902762976,-109.3664273
58488,0,31,10,2,9,13,65,38.23467902762976,-109.3661578
58489,1,40,8,2,10,7,68,38.23467902762976,-109.3658883
58490,1,40,8,3,11,4,67,38.23467902762976,-109.3656188
58491,0,43,8,1,11,5,68,38.23467902762976,-109.3653493
58492,1,45,9,2,12,6,75,38.23467902762976,-109.3650799
58493,2,46,10,3,13,6,80,38.23467902762976,-109.3648104
58494,2,48,10,2,14,6,82,38.23467902762976,-109.3645409
58495,2,47,10,3,13,6,81,38.23467902762976,-109.3642714
58496,2,46,9,3,13,5,78,38.23467902762976,-109.3640019
58497,1,44,9,3,13,5,75,38.23467902762976,-109.3637324
58498,1,46,9,1,12,7,76,38.23467902762976,-109.3634629
58499,2,49,10,4,13,5,83,38.23467902762976,-109.3631934
58500,3,48,11,5,12,5,84,38.23467902762976,-109.3629239
58501,4,44,11,4,12,6,81,38.23467902762976,-109.3626544
58502,4,31,12,5,9,12,73,38.23467902762976,-109.3623849
58503,6,30,13,5,10,12,76,38.23467902762976,-109.3621154
58504,3,44,11,3,13,8,82,38.23467902762976,-109.3618459
58505,3,48,11,5,15,3,85,38.23467902762976,-109.3615764
58506,4,45,12,5,16,2,84,38.23467902762976,-109.3613069
58507,5,42,13,8,11,4,83,38.23467902762976,-109.3610374
58508,8,44,13,9,11,2,87,38.23467902762976,-109.3607679
58509,9,43,13,10,12,2,89,38.23467902762976,-109.3604984
58510,9,42,13,11,12,2,89,38.23467902762976,-109.360229
58511,9,43,13,10,12,2,89,38.23467902762976,-109.3599595
58512,6,41,12,6,13,4,82,38.23467902762976,-109.35969
58513,4,40,11,4,12,7,78,38.23467902762976,-109.3594205
58514,3,37,10,5,11,7,73,38.23467902762976,-109.359151
58515,3,34,9,4,10,7,67,38.23467902762976,-109.3588815
58516,3,30,9,4,10,6,62,38.23467902762976,-109.358612
58517,3,25,8,5,10,4,55,38.23467902762976,-109.3583425
58518,6,18,11,12,10,6,63,38.23467902762976,-109.358073
58519,16,19,15,12,19,6,87,38.23467902762976,-109.3578035
58520,22,7,9,29,12,8,87,38.23467902762976,-109.357534
58521,34,6,9,27,8,8,92,38.23467902762976,-109.3572645
58522,37,9,9,30,7,2,94,38.23467902762976,-109.356995
58523,33,13,10,28,5,1,90,38.23467902762976,-109.3567255
58524,36,15,10,24,4,1,90,38.23467902762976,-109.356456
58525,39,14,9,16,3,0,81,38.23467902762976,-109.3561865
58526,36,17,8,11,2,0,74,38.23467902762976,-109.355917
58527,37,15,7,9,3,0,71,38.23467902762976,-109.3556475
58528,42,18,9,11,3,0,83,38.23467902762976,-109.355378
58529,39,19,10,16,5,0,89,38.23467902762976,-109.3551086
58530,30,20,12,23,6,1,92,38.23467902762976,-109.3548391
58531,32,20,11,22,5,1,91,38.23467902762976,-109.3545696
58532,31,19,10,23,5,1,89,38.23467902762976,-109.3543001
58533,30,19,10,22,6,1,88,38.23467902762976,-109.3540306
58534,30,19,10,21,6,1,87,38.23467902762976,-109.3537611
58535,31,16,12,20,8,1,88,38.23467902762976,-109.3534916
58536,36,13,13,21,9,2,94,38.23467902762976,-109.3532221
58537,34,14,12,21,10,3,94,38.23467902762976,-109.3529526
58538,22,18,13,20,12,7,92,38.23467902762976,-109.3526831
58539,8,21,14,19,13,11,86,38.23467902762976,-109.3524136
58540,4,29,13,13,15,8,82,38.23467902762976,-109.3521441
58541,1,31,11,0,11,16,70,38.23467902762976,-109.3518746
58542,0,34,11,0,10,15,70,38.23467902762976,-109.3516051
58543,1,31,11,1,10,13,67,38.23467902762976,-109.3513356
58544,16,45,11,8,11,0,91,38.23440953304453,-109.4068515
58545,5,53,9,7,12,1,87,38.23440953304453,-109.406582
58546,5,52,10,8,12,1,88,38.23440953304453,-109.4063125
58547,5,52,9,7,12,1,86,38.23440953304453,-109.406043
58548,4,54,9,6,12,1,86,38.23440953304453,-109.4057735
58549,3,57,9,6,12,1,88,38.23440953304453,-109.405504
58550,3,59,10,7,12,0,91,38.23440953304453,-109.4052345
58551,5,55,11,9,12,0,92,38.23440953304453,-109.4049651
58552,5,52,11,8,14,0,90,38.23440953304453,-109.4046956
58553,5,49,11,8,16,0,89,38.23440953304453,-109.4044261
58554,7,47,11,9,16,0,90,38.23440953304453,-109.4041566
58555,12,43,13,10,14,0,92,38.23440953304453,-109.4038871
58556,13,42,13,11,13,0,92,38.23440953304453,-109.4036176
58557,15,40,13,11,13,0,92,38.23440953304453,-109.4033481
58558,15,41,13,10,13,0,92,38.23440953304453,-109.4030786
58559,12,42,13,10,14,0,91,38.23440953304453,-109.4028091
58560,12,42,13,9,14,1,91,38.23440953304453,-109.4025396
58561,14,41,13,9,14,1,92,38.23440953304453,-109.4022701
58562,16,40,13,9,14,0,92,38.23440953304453,-109.4020006
58563,17,39,13,9,13,0,91,38.23440953304453,-109.4017311
58564,16,39,13,10,13,0,91,38.23440953304453,-109.4014616
58565,16,39,13,10,14,0,92,38.23440953304453,-109.4011921
58566,17,39,13,10,13,0,92,38.23440953304453,-109.4009226
58567,16,38,13,10,13,0,90,38.23440953304453,-109.4006531
58568,16,38,13,10,14,0,91,38.23440953304453,-109.4003836
58569,16,38,14,9,14,0,91,38.23440953304453,-109.4001142
58570,17,37,14,10,13,0,91,38.23440953304453,-109.3998447
58571,16,39,14,10,14,0,93,38.23440953304453,-109.3995752
58572,16,39,13,9,14,0,91,38.23440953304453,-109.3993057
58573,17,39,13,9,13,0,91,38.23440953304453,-109.3990362
58574,18,40,13,9,12,0,92,38.23440953304453,-109.3987667
58575,17,40,13,9,12,0,91,38.23440953304453,-109.3984972
58576,16,41,13,9,12,0,91,38.23440953304453,-109.3982277
58577,16,42,12,9,12,0,91,38.23440953304453,-109.3979582
58578,17,43,13,8,12,0,93,38.23440953304453,-109.3976887
58579,19,39,13,10,11,0,92,38.23440953304453,-109.3974192
58580,25,34,13,9,11,0,92,38.23440953304453,-109.3971497
58581,28,31,12,7,11,0,89,38.23440953304453,-109.3968802
58582,26,34,11,6,12,0,89,38.23440953304453,-109.3966107
58583,22,39,11,7,12,0,91,38.23440953304453,-109.3963412
58584,19,40,12,8,13,0,92,38.23440953304453,-109.3960717
58585,13,46,12,8,13,0,92,38.23440953304453,-109.3958022
58586,10,50,12,7,13,0,92,38.23440953304453,-109.3955327
58587,9,52,12,7,13,0,93,38.23440953304453,-109.3952632
58588,10,51,11,8,13,0,93,38.23440953304453,-109.3949938
58589,9,49,12,8,14,1,93,38.23440953304453,-109.3947243
58590,7,50,12,8,14,1,92,38.23440953304453,-109.3944548
58591,7,52,11,7,14,1,92,38.23440953304453,-109.3941853
58592,8,51,11,7,13,0,90,38.23440953304453,-109.3939158
58593,9,50,11,8,14,0,92,38.23440953304453,-109.3936463
58594,8,48,11,8,13,1,89,38.23440953304453,-109.3933768
58595,7,47,12,8,14,1,89,38.23440953304453,-109.3931073
58596,7,46,12,8,14,2,89,38.23440953304453,-109.3928378
58597,6,46,12,8,13,2,87,38.23440953304453,-109.3925683
58598,7,46,13,9,14,1,90,38.23440953304453,-109.3922988
58599,7,47,13,10,15,1,93,38.23440953304453,-109.3920293
58600,8,49,12,10,14,1,94,38.23440953304453,-109.3917598
58601,8,49,12,10,14,0,93,38.23440953304453,-109.3914903
58602,9,45,13,11,14,0,92,38.23440953304453,-109.3912208
58603,10,45,13,11,14,0,93,38.23440953304453,-109.3909513
58604,11,43,13,11,13,1,92,38.23440953304453,-109.3906818
58605,10,43,13,11,13,1,91,38.23440953304453,-109.3904123
58606,10,43,13,11,14,1,92,38.23440953304453,-109.3901429
58607,11,43,13,10,15,0,92,38.23440953304453,-109.3898734
58608,9,44,13,10,15,0,91,38.23440953304453,-109.3896039
58609,8,42,13,11,15,1,90,38.23440953304453,-109.3893344
58610,7,42,13,10,15,1,88,38.23440953304453,-109.3890649
58611,7,40,13,11,14,1,86,38.23440953304453,-109.3887954
58612,7,35,14,11,11,3,81,38.23440953304453,-109.3885259
58613,9,31,15,12,11,3,81,38.23440953304453,-109.3882564
58614,12,33,15,12,12,1,85,38.23440953304453,-109.3879869
58615,14,35,13,10,12,1,85,38.23440953304453,-109.3877174
58616,12,39,13,10,11,1,86,38.23440953304453,-109.3874479
58617,7,44,14,10,12,2,89,38.23440953304453,-109.3871784
58618,6,46,12,9,14,1,88,38.23440953304453,-109.3869089
58619,6,45,12,10,14,1,88,38.23440953304453,-109.3866394
58620,6,44,13,12,13,1,89,38.23440953304453,-109.3863699
58621,7,45,14,12,13,1,92,38.23440953304453,-109.3861004
58622,6,43,14,13,13,1,90,38.23440953304453,-109.3858309
58623,6,43,14,13,13,1,90,38.23440953304453,-109.3855614
58624,8,43,14,13,13,1,92,38.23440953304453,-109.3852919
58625,12,39,14,13,12,1,91,38.23440953304453,-109.3850225
58626,16,36,14,13,12,0,91,38.23440953304453,-109.384753
58627,12,38,14,14,13,1,92,38.23440953304453,-109.3844835
58628,8,38,15,14,14,1,90,38.23440953304453,-109.384214
58629,7,40,14,12,14,2,89,38.23440953304453,-109.3839445
58630,6,41,14,10,14,2,87,38.23440953304453,-109.383675
58631,6,42,13,11,15,1,88,38.23440953304453,-109.3834055
58632,7,42,12,11,15,1,88,38.23440953304453,-109.383136
58633,6,45,12,10,15,1,89,38.23440953304453,-109.3828665
58634,5,50,11,9,14,1,90,38.23440953304453,-109.382597
58635,5,51,11,8,14,1,90,38.23440953304453,-109.3823275
58636,8,46,12,9,15,0,90,38.23440953304453,-109.382058
58637,10,41,13,12,14,0,90,38.23440953304453,-109.3817885
58638,10,40,14,13,14,1,92,38.23440953304453,-109.381519
58639,13,38,14,12,13,1,91,38.23440953304453,-109.3812495
58640,18,38,14,10,12,0,92,38.23440953304453,-109.38098
58641,15,41,13,10,13,0,92,38.23440953304453,-109.3807105
58642,11,44,13,10,14,0,92,38.23440953304453,-109.380441
58643,8,43,13,10,14,1,89,38.23440953304453,-109.3801716
58644,7,43,13,10,14,1,88,38.23440953304453,-109.3799021
58645,7,45,13,10,15,1,91,38.23440953304453,-109.3796326
58646,8,46,13,9,15,0,91,38.23440953304453,-109.3793631
58647,11,42,13,10,14,0,90,38.23440953304453,-109.3790936
58648,15,31,13,11,13,1,84,38.23440953304453,-109.3788241
58649,13,22,9,18,12,0,74,38.23440953304453,-109.3785546
58650,14,24,12,13,12,1,76,38.23440953304453,-109.3782851
58651,14,39,13,10,13,1,90,38.23440953304453,-109.3780156
58652,10,45,14,11,13,1,94,38.23440953304453,-109.3777461
58653,12,42,15,12,10,1,92,38.23440953304453,-109.3774766
58654,11,44,14,11,11,1,92,38.23440953304453,-109.3772071
58655,8,47,13,9,12,1,90,38.23440953304453,-109.3769376
58656,5,47,11,6,13,2,84,38.23440953304453,-109.3766681
58657,4,46,11,5,14,2,82,38.23440953304453,-109.3763986
58658,3,43,10,2,14,5,77,38.23440953304453,-109.3761291
58659,3,49,9,2,14,3,80,38.23440953304453,-109.3758596
58660,5,50,11,3,14,3,86,38.23440953304453,-109.3755901
58661,7,50,11,6,13,2,89,38.23440953304453,-109.3753206
58662,5,57,10,6,12,2,92,38.23440953304453,-109.3750512
58663,3,56,9,5,13,2,88,38.23440953304453,-109.3747817
58664,4,48,9,6,14,2,83,38.23440953304453,-109.3745122
58665,5,42,10,5,13,5,80,38.23440953304453,-109.3742427
58666,7,40,11,6,13,5,82,38.23440953304453,-109.3739732
58667,12,40,12,9,14,1,88,38.23440953304453,-109.3737037
58668,8,41,12,8,16,1,86,38.23440953304453,-109.3734342
58669,4,37,10,3,16,4,74,38.23440953304453,-109.3731647
58670,4,39,10,1,15,5,74,38.23440953304453,-109.3728952
58671,7,42,11,6,17,1,84,38.23440953304453,-109.3726257
58672,9,44,13,8,16,0,90,38.23440953304453,-109.3723562
58673,12,40,13,11,13,0,89,38.23440953304453,-109.3720867
58674,14,39,14,11,12,1,91,38.23440953304453,-109.3718172
58675,14,40,14,11,11,0,90,38.23440953304453,-109.3715477
58676,13,40,14,13,12,0,92,38.23440953304453,-109.3712782
58677,10,42,14,13,13,0,92,38.23440953304453,-109.3710087
58678,7,44,14,12,14,0,91,38.23440953304453,-109.3707392
58679,6,44,14,12,15,1,92,38.23440953304453,-109.3704697
58680,5,44,14,12,14,1,90,38.23440953304453,-109.3702003
58681,7,45,14,14,13,1,94,38.23440953304453,-109.3699308
58682,8,42,15,15,12,1,93,38.23440953304453,-109.3696613
58683,11,40,15,15,11,1,93,38.23440953304453,-109.3693918
58684,12,40,15,15,11,1,94,38.23440953304453,-109.3691223
58685,17,38,15,15,11,0,96,38.23440953304453,-109.3688528
58686,26,32,13,13,8,0,92,38.23440953304453,-109.3685833
58687,29,26,11,12,7,1,86,38.23440953304453,-109.3683138
58688,29,27,12,13,7,1,89,38.23440953304453,-109.3680443
58689,23,31,12,15,9,1,91,38.23440953304453,-109.3677748
58690,14,35,13,14,10,2,88,38.23440953304453,-109.3675053
58691,7,40,12,8,13,4,84,38.23440953304453,-109.3672358
58692,5,38,11,5,14,6,79,38.23440953304453,-109.3669663
58693,4,35,11,5,13,8,76,38.23440953304453,-109.3666968
58694,2,32,10,4,12,10,70,38.23440953304453,-109.3664273
58695,1,36,9,1,11,9,67,38.23440953304453,-109.3661578
58696,1,42,7,2,9,4,65,38.23440953304453,-109.3658883
58697,0,44,7,1,10,4,66,38.23440953304453,-109.3656188
58698,0,45,8,1,10,5,69,38.23440953304453,-109.3653493
58699,1,46,8,2,11,6,74,38.23440953304453,-109.3650799
58700,1,49,9,2,13,5,79,38.23440953304453,-109.3648104
58701,1,51,8,2,13,5,80,38.23440953304453,-109.3645409
58702,1,49,8,2,12,5,77,38.23440953304453,-109.3642714
58703,1,45,9,3,12,6,76,38.23440953304453,-109.3640019
58704,2,41,9,3,13,6,74,38.23440953304453,-109.3637324
58705,2,40,10,2,10,10,74,38.23440953304453,-109.3634629
58706,3,45,10,3,12,6,79,38.23440953304453,-109.3631934
58707,3,44,11,4,13,6,81,38.23440953304453,-109.3629239
58708,3,38,11,5,12,8,77,38.23440953304453,-109.3626544
58709,3,30,11,7,10,10,71,38.23440953304453,-109.3623849
58710,5,31,11,9,11,6,73,38.23440953304453,-109.3621154
58711,3,35,10,6,11,6,71,38.23440953304453,-109.3618459
58712,4,40,11,6,15,3,79,38.23440953304453,-109.3615764
58713,5,43,12,6,15,3,84,38.23440953304453,-109.3613069
58714,6,42,13,9,11,3,84,38.23440953304453,-109.3610374
58715,9,43,14,11,12,1,90,38.23440953304453,-109.3607679
58716,9,43,13,10,12,1,88,38.23440953304453,-109.3604984
58717,9,41,12,10,13,1,86,38.23440953304453,-109.360229
58718,10,38,12,10,13,1,84,38.23440953304453,-109.3599595
58719,5,38,10,6,11,5,75,38.23440953304453,-109.35969
58720,3,34,9,4,12,5,67,38.23440953304453,-109.3594205
58721,3,32,8,4,12,5,64,38.23440953304453,-109.359151
58722,2,29,8,4,11,6,60,38.23440953304453,-109.3588815
58723,2,28,8,4,10,6,58,38.23440953304453,-109.358612
58724,4,27,9,6,11,4,61,38.23440953304453,-109.3583425
58725,7,21,12,13,11,6,70,38.23440953304453,-109.358073
58726,17,15,15,14,20,6,87,38.23440953304453,-109.3578035
58727,24,6,9,30,12,8,89,38.23440953304453,-109.357534
58728,37,7,9,26,9,5,93,38.23440953304453,-109.3572645
58729,34,12,10,28,6,1,91,38.23440953304453,-109.356995
58730,35,15,10,26,4,1,91,38.23440953304453,-109.3567255
58731,37,17,8,14,3,0,79,38.23440953304453,-109.356456
58732,33,16,6,8,2,0,65,38.23440953304453,-109.3561865
58733,38,17,7,8,3,0,73,38.23440953304453,-109.355917
58734,43,16,7,9,2,0,77,38.23440953304453,-109.3556475
58735,42,15,8,12,2,0,79,38.23440953304453,-109.355378
58736,35,14,10,18,4,1,82,38.23440953304453,-109.3551086
58737,30,18,10,19,4,1,82,38.23440953304453,-109.3548391
58738,33,17,10,19,4,1,84,38.23440953304453,-109.3545696
58739,34,15,10,19,3,2,83,38.23440953304453,-109.3543001
58740,34,13,10,21,6,1,85,38.23440953304453,-109.3540306
58741,35,13,11,21,9,1,90,38.23440953304453,-109.3537611
58742,38,13,11,20,9,2,93,38.23440953304453,-109.3534916
58743,24,15,11,27,12,3,92,38.23440953304453,-109.3532221
58744,14,18,11,26,14,8,91,38.23440953304453,-109.3529526
58745,6,21,14,20,13,12,86,38.23440953304453,-109.3526831
58746,2,26,14,10,11,14,77,38.23440953304453,-109.3524136
58747,2,32,11,2,11,11,69,38.23440953304453,-109.3521441
58748,1,32,10,2,10,11,66,38.23440953304453,-109.3518746
58749,1,36,10,2,11,9,69,38.23440953304453,-109.3516051
58750,1,34,10,3,11,9,68,38.23440953304453,-109.3513356
58751,5,45,9,9,11,1,80,38.23414003845929,-109.4068515
58752,5,50,9,9,11,1,85,38.23414003845929,-109.406582
58753,7,50,10,9,12,1,89,38.23414003845929,-109.4063125
58754,9,48,11,9,13,1,91,38.23414003845929,-109.406043
58755,5,55,10,7,12,1,90,38.23414003845929,-109.4057735
58756,3,59,10,7,11,0,90,38.23414003845929,-109.405504
58757,4,57,10,8,13,0,92,38.23414003845929,-109.4052345
58758,6,50,12,9,15,0,92,38.23414003845929,-109.4049651
58759,7,48,13,9,15,0,92,38.23414003845929,-109.4046956
58760,8,47,12,9,15,0,91,38.23414003845929,-109.4044261
58761,10,45,12,9,15,0,91,38.23414003845929,-109.4041566
58762,9,45,13,10,15,1,93,38.23414003845929,-109.4038871
58763,12,41,14,10,13,1,91,38.23414003845929,-109.4036176
58764,14,41,14,10,12,1,92,38.23414003845929,-109.4033481
58765,14,42,13,10,13,1,93,38.23414003845929,-109.4030786
58766,13,43,13,10,13,0,92,38.23414003845929,-109.4028091
58767,12,43,13,10,14,0,92,38.23414003845929,-109.4025396
58768,17,40,13,10,12,0,92,38.23414003845929,-109.4022701
58769,19,38,13,10,12,0,92,38.23414003845929,-109.4020006
58770,18,38,13,10,13,0,92,38.23414003845929,-109.4017311
58771,14,40,14,11,14,0,93,38.23414003845929,-109.4014616
58772,13,39,14,11,14,0,91,38.23414003845929,-109.4011921
58773,13,40,14,11,14,0,92,38.23414003845929,-109.4009226
58774,16,39,14,11,13,0,93,38.23414003845929,-109.4006531
58775,17,38,14,10,13,0,92,38.23414003845929,-109.4003836
58776,15,39,14,10,14,0,92,38.23414003845929,-109.4001142
58777,14,40,14,10,13,0,91,38.23414003845929,-109.3998447
58778,15,41,14,10,13,0,93,38.23414003845929,-109.3995752
58779,16,41,13,10,12,0,92,38.23414003845929,-109.3993057
58780,16,39,13,10,13,0,91,38.23414003845929,-109.3990362
58781,15,38,13,9,13,0,88,38.23414003845929,-109.3987667
58782,17,38,12,9,13,0,89,38.23414003845929,-109.3984972
58783,18,38,13,10,12,0,91,38.23414003845929,-109.3982277
58784,18,39,13,10,12,0,92,38.23414003845929,-109.3979582
58785,19,40,13,9,11,0,92,38.23414003845929,-109.3976887
58786,22,36,13,10,10,0,91,38.23414003845929,-109.3974192
58787,25,33,13,9,10,0,90,38.23414003845929,-109.3971497
58788,28,31,13,8,11,0,91,38.23414003845929,-109.3968802
58789,29,31,12,7,11,0,90,38.23414003845929,-109.3966107
58790,28,33,12,7,11,0,91,38.23414003845929,-109.3963412
58791,27,35,13,7,10,0,92,38.23414003845929,-109.3960717
58792,19,41,13,8,11,0,92,38.23414003845929,-109.3958022
58793,15,45,12,8,12,0,92,38.23414003845929,-109.3955327
58794,15,46,13,9,12,0,95,38.23414003845929,-109.3952632
58795,16,44,13,9,12,0,94,38.23414003845929,-109.3949938
58796,12,45,13,9,13,0,92,38.23414003845929,-109.3947243
58797,10,48,12,9,13,1,93,38.23414003845929,-109.3944548
58798,10,49,12,9,13,1,94,38.23414003845929,-109.3941853
58799,13,46,12,8,12,0,91,38.23414003845929,-109.3939158
58800,13,46,12,8,13,0,92,38.23414003845929,-109.3936463
58801,10,49,12,8,13,1,93,38.23414003845929,-109.3933768
58802,9,49,12,7,13,1,91,38.23414003845929,-109.3931073
58803,8,48,12,7,13,1,89,38.23414003845929,-109.3928378
58804,9,46,12,8,13,1,89,38.23414003845929,-109.3925683
58805,10,47,12,8,14,0,91,38.23414003845929,-109.3922988
58806,10,48,12,8,13,0,91,38.23414003845929,-109.3920293
58807,9,48,12,8,14,1,92,38.23414003845929,-109.3917598
58808,8,47,12,9,14,1,91,38.23414003845929,-109.3914903
58809,9,44,12,10,15,0,90,38.23414003845929,-109.3912208
58810,10,44,13,11,15,0,93,38.23414003845929,-109.3909513
58811,10,44,13,10,14,0,91,38.23414003845929,-109.3906818
58812,10,45,13,10,14,0,92,38.23414003845929,-109.3904123
58813,9,44,13,10,14,1,91,38.23414003845929,-109.3901429
58814,8,44,13,11,14,1,91,38.23414003845929,-109.3898734
58815,8,43,13,10,15,1,90,38.23414003845929,-109.3896039
58816,8,41,12,10,14,1,86,38.23414003845929,-109.3893344
58817,7,41,12,10,14,2,86,38.23414003845929,-109.3890649
58818,7,41,13,10,13,1,85,38.23414003845929,-109.3887954
58819,8,37,14,11,11,2,83,38.23414003845929,-109.3885259
58820,11,30,16,12,12,2,83,38.23414003845929,-109.3882564
58821,12,30,16,13,12,1,84,38.23414003845929,-109.3879869
58822,11,34,16,13,12,1,87,38.23414003845929,-109.3877174
58823,9,38,15,13,13,1,89,38.23414003845929,-109.3874479
58824,10,39,15,12,14,1,91,38.23414003845929,-109.3871784
58825,8,46,13,8,14,1,90,38.23414003845929,-109.3869089
58826,5,48,11,9,14,1,88,38.23414003845929,-109.3866394
58827,5,49,11,10,13,1,89,38.23414003845929,-109.3863699
58828,7,47,14,11,13,1,93,38.23414003845929,-109.3861004
58829,7,44,14,12,13,1,91,38.23414003845929,-109.3858309
58830,7,43,14,13,13,1,91,38.23414003845929,-109.3855614
58831,7,41,14,13,13,1,89,38.23414003845929,-109.3852919
58832,10,39,14,14,14,1,92,38.23414003845929,-109.3850225
58833,10,40,14,13,13,1,91,38.23414003845929,-109.384753
58834,11,38,14,14,14,1,92,38.23414003845929,-109.3844835
58835,11,37,14,14,14,1,91,38.23414003845929,-109.384214
58836,8,38,14,12,14,2,88,38.23414003845929,-109.3839445
58837,5,42,13,10,15,1,86,38.23414003845929,-109.383675
58838,5,44,12,10,15,1,87,38.23414003845929,-109.3834055
58839,5,46,12,10,14,1,88,38.23414003845929,-109.383136
58840,5,48,11,9,14,1,88,38.23414003845929,-109.3828665
58841,5,49,11,8,14,1,88,38.23414003845929,-109.382597
58842,7,46,12,10,15,0,90,38.23414003845929,-109.3823275
58843,10,43,13,11,15,0,92,38.23414003845929,-109.382058
58844,12,40,14,13,14,0,93,38.23414003845929,-109.3817885
58845,13,38,14,13,14,0,92,38.23414003845929,-109.381519
58846,15,38,14,12,14,0,93,38.23414003845929,-109.3812495
58847,15,39,14,11,14,0,93,38.23414003845929,-109.38098
58848,12,42,14,11,13,0,92,38.23414003845929,-109.3807105
58849,11,42,13,11,13,1,91,38.23414003845929,-109.380441
58850,10,43,13,11,13,1,91,38.23414003845929,-109.3801716
58851,8,45,14,11,14,0,92,38.23414003845929,-109.3799021
58852,9,45,13,11,14,1,93,38.23414003845929,-109.3796326
58853,9,44,14,11,15,0,93,38.23414003845929,-109.3793631
58854,10,41,14,13,15,0,93,38.23414003845929,-109.3790936
58855,12,36,13,13,13,0,87,38.23414003845929,-109.3788241
58856,11,21,10,19,12,0,73,38.23414003845929,-109.3785546
58857,10,21,11,19,13,1,75,38.23414003845929,-109.3782851
58858,16,31,13,12,13,1,86,38.23414003845929,-109.3780156
58859,13,41,14,13,12,0,93,38.23414003845929,-109.3777461
58860,12,42,15,13,11,1,94,38.23414003845929,-109.3774766
58861,12,43,14,12,11,1,93,38.23414003845929,-109.3772071
58862,9,45,13,9,13,1,90,38.23414003845929,-109.3769376
58863,6,45,12,8,13,1,85,38.23414003845929,-109.3766681
58864,4,46,10,6,13,2,81,38.23414003845929,-109.3763986
58865,3,45,10,4,14,3,79,38.23414003845929,-109.3761291
58866,3,45,10,3,14,4,79,38.23414003845929,-109.3758596
58867,7,46,12,6,13,3,87,38.23414003845929,-109.3755901
58868,9,48,12,10,12,1,92,38.23414003845929,-109.3753206
58869,8,50,11,9,12,1,91,38.23414003845929,-109.3750512
58870,3,51,10,5,13,3,85,38.23414003845929,-109.3747817
58871,5,47,10,7,13,3,85,38.23414003845929,-109.3745122
58872,5,42,11,8,15,3,84,38.23414003845929,-109.3742427
58873,6,43,11,6,15,3,84,38.23414003845929,-109.3739732
58874,8,41,12,6,16,2,85,38.23414003845929,-109.3737037
58875,3,41,10,2,17,2,75,38.23414003845929,-109.3734342
58876,2,36,10,2,15,4,69,38.23414003845929,-109.3731647
58877,3,38,10,2,13,6,72,38.23414003845929,-109.3728952
58878,5,40,11,5,15,3,79,38.23414003845929,-109.3726257
58879,9,42,12,9,16,1,89,38.23414003845929,-109.3723562
58880,13,40,13,12,13,0,91,38.23414003845929,-109.3720867
58881,15,39,13,11,12,0,90,38.23414003845929,-109.3718172
58882,15,40,14,11,12,0,92,38.23414003845929,-109.3715477
58883,12,41,14,12,13,0,92,38.23414003845929,-109.3712782
58884,9,44,14,12,13,0,92,38.23414003845929,-109.3710087
58885,7,46,14,11,14,0,92,38.23414003845929,-109.3707392
58886,6,48,14,9,15,0,92,38.23414003845929,-109.3704697
58887,5,47,13,10,15,0,90,38.23414003845929,-109.3702003
58888,6,46,14,12,14,0,92,38.23414003845929,-109.3699308
58889,8,44,15,13,13,0,93,38.23414003845929,-109.3696613
58890,11,42,15,13,12,0,93,38.23414003845929,-109.3693918
58891,13,40,15,14,12,0,94,38.23414003845929,-109.3691223
58892,15,38,15,15,11,0,94,38.23414003845929,-109.3688528
58893,25,34,14,13,10,0,96,38.23414003845929,-109.3685833
58894,30,30,12,13,8,0,93,38.23414003845929,-109.3683138
58895,26,31,12,14,8,1,92,38.23414003845929,-109.3680443
58896,18,35,13,15,10,1,92,38.23414003845929,-109.3677748
58897,9,37,13,13,11,2,85,38.23414003845929,-109.3675053
58898,4,43,10,6,14,3,80,38.23414003845929,-109.3672358
58899,3,39,9,6,12,4,73,38.23414003845929,-109.3669663
58900,2,38,8,3,11,5,67,38.23414003845929,-109.3666968
58901,1,38,7,2,11,5,64,38.23414003845929,-109.3664273
58902,1,43,7,4,9,3,67,38.23414003845929,-109.3661578
58903,0,51,6,2,8,2,69,38.23414003845929,-109.3658883
58904,0,56,6,1,10,2,75,38.23414003845929,-109.3656188
58905,0,50,8,2,10,4,74,38.23414003845929,-109.3653493
58906,1,45,8,1,11,6,72,38.23414003845929,-109.3650799
58907,1,40,10,1,10,11,73,38.23414003845929,-109.3648104
58908,2,43,10,3,13,6,77,38.23414003845929,-109.3645409
58909,1,44,9,3,13,6,76,38.23414003845929,-109.3642714
58910,2,44,9,4,13,5,77,38.23414003845929,-109.3640019
58911,2,43,10,4,14,4,77,38.23414003845929,-109.3637324
58912,3,38,10,3,13,8,75,38.23414003845929,-109.3634629
58913,2,39,10,4,13,6,74,38.23414003845929,-109.3631934
58914,2,38,10,5,13,5,73,38.23414003845929,-109.3629239
58915,3,35,9,6,13,4,70,38.23414003845929,-109.3626544
58916,3,31,9,5,11,5,64,38.23414003845929,-109.3623849
58917,4,27,10,7,10,7,65,38.23414003845929,-109.3621154
58918,4,28,11,6,11,8,68,38.23414003845929,-109.3618459
58919,6,35,12,8,15,4,80,38.23414003845929,-109.3615764
58920,8,41,13,11,15,1,89,38.23414003845929,-109.3613069
58921,6,42,13,12,13,2,88,38.23414003845929,-109.3610374
58922,8,42,13,12,13,1,89,38.23414003845929,-109.3607679
58923,8,40,12,10,13,1,84,38.23414003845929,-109.3604984
58924,5,36,10,8,13,2,74,38.23414003845929,-109.360229
58925,4,33,9,6,13,3,68,38.23414003845929,-109.3599595
58926,2,31,9,5,11,5,63,38.23414003845929,-109.35969
58927,2,34,7,3,10,5,61,38.23414003845929,-109.3594205
58928,2,33,7,3,9,5,59,38.23414003845929,-109.359151
58929,2,31,7,3,10,5,58,38.23414003845929,-109.3588815
58930,2,29,8,5,11,5,60,38.23414003845929,-109.358612
58931,6,26,10,10,15,3,70,38.23414003845929,-109.3583425
58932,11,22,12,16,17,3,81,38.23414003845929,-109.358073
58933,25,10,12,21,17,3,88,38.23414003845929,-109.3578035
58934,40,7,9,24,11,4,95,38.23414003845929,-109.357534
58935,40,10,9,25,7,1,92,38.23414003845929,-109.3572645
58936,38,15,10,25,4,1,93,38.23414003845929,-109.356995
58937,43,16,9,21,4,1,94,38.23414003845929,-109.3567255
58938,40,18,7,12,3,0,80,38.23414003845929,-109.356456
58939,35,19,6,8,2,0,70,38.23414003845929,-109.3561865
58940,44,16,7,10,3,0,80,38.23414003845929,-109.355917
58941,44,13,7,13,1,0,78,38.23414003845929,-109.3556475
58942,41,12,8,17,2,1,81,38.23414003845929,-109.355378
58943,34,13,10,20,4,2,83,38.23414003845929,-109.3551086
58944,34,15,11,22,5,2,89,38.23414003845929,-109.3548391
58945,35,14,10,22,9,1,91,38.23414003845929,-109.3545696
58946,30,14,11,20,13,2,90,38.23414003845929,-109.3543001
58947,19,17,11,21,18,3,89,38.23414003845929,-109.3540306
58948,13,20,12,19,18,4,86,38.23414003845929,-109.3537611
58949,7,22,13,15,11,10,78,38.23414003845929,-109.3534916
58950,4,25,13,9,11,13,75,38.23414003845929,-109.3532221
58951,3,27,14,7,11,16,78,38.23414003845929,-109.3529526
58952,1,24,14,4,9,18,70,38.23414003845929,-109.3526831
58953,1,23,11,2,7,15,59,38.23414003845929,-109.3524136
58954,2,36,11,2,11,8,70,38.23414003845929,-109.3521441
58955,1,35,9,3,10,8,66,38.23414003845929,-109.3518746
58956,1,33,9,3,9,8,63,38.23414003845929,-109.3516051
58957,2,29,9,4,8,8,60,38.23414003845929,-109.3513356
58958,3,45,8,5,10,2,73,38.233870543874055,-109.4068515
58959,4,48,9,7,11,1,80,38.233870543874055,-109.406582
58960,6,51,11,9,13,1,91,38.233870543874055,-109.4063125
58961,6,52,11,8,13,1,91,38.233870543874055,-109.406043
58962,6,53,11,7,12,1,90,38.233870543874055,-109.4057735
58963,5,54,11,6,14,1,91,38.233870543874055,-109.405504
58964,5,53,12,8,16,0,94,38.233870543874055,-109.4052345
58965,5,52,12,8,15,1,93,38.233870543874055,-109.4049651
58966,5,51,11,7,15,0,89,38.233870543874055,-109.4046956
58967,5,51,11,7,15,0,89,38.233870543874055,-109.4044261
58968,7,49,11,9,15,0,91,38.233870543874055,-109.4041566
58969,8,46,12,10,13,1,90,38.233870543874055,-109.4038871
58970,9,42,14,10,13,2,90,38.233870543874055,-109.4036176
58971,11,41,14,9,13,1,89,38.233870543874055,-109.4033481
58972,12,42,13,7,12,1,87,38.233870543874055,-109.4030786
58973,12,43,13,8,13,1,90,38.233870543874055,-109.4028091
58974,13,42,13,8,12,0,88,38.233870543874055,-109.4025396
58975,14,42,13,9,12,1,91,38.233870543874055,-109.4022701
58976,15,41,13,10,13,0,92,38.233870543874055,-109.4020006
58977,15,41,14,10,13,0,93,38.233870543874055,-109.4017311
58978,14,42,14,10,14,0,94,38.233870543874055,-109.4014616
58979,14,42,14,10,14,0,94,38.233870543874055,-109.4011921
58980,11,43,14,10,15,0,93,38.233870543874055,-109.4009226
58981,13,41,14,10,14,0,92,38.233870543874055,-109.4006531
58982,17,39,14,10,13,0,93,38.233870543874055,-109.4003836
58983,16,40,14,10,13,0,93,38.233870543874055,-109.4001142
58984,15,41,14,10,13,0,93,38.233870543874055,-109.3998447
58985,16,41,14,10,13,0,94,38.233870543874055,-109.3995752
58986,18,40,13,10,12,0,93,38.233870543874055,-109.3993057
58987,19,39,13,10,11,0,92,38.233870543874055,-109.3990362
58988,18,38,13,11,11,0,91,38.233870543874055,-109.3987667
58989,18,39,13,10,12,0,92,38.233870543874055,-109.3984972
58990,18,39,13,10,11,0,91,38.233870543874055,-109.3982277
58991,19,39,12,9,11,0,90,38.233870543874055,-109.3979582
58992,20,38,12,9,11,0,90,38.233870543874055,-109.3976887
58993,21,37,12,9,11,0,90,38.233870543874055,-109.3974192
58994,23,35,13,9,11,0,91,38.233870543874055,-109.3971497
58995,23,34,13,9,12,0,91,38.233870543874055,-109.3968802
58996,23,34,13,9,12,0,91,38.233870543874055,-109.3966107
58997,27,33,13,8,11,0,92,38.233870543874055,-109.3963412
58998,28,33,13,8,9,0,91,38.233870543874055,-109.3960717
58999,22,37,13,9,11,0,92,38.233870543874055,-109.3958022
59000,19,40,13,9,11,0,92,38.233870543874055,-109.3955327
59001,17,42,13,9,12,0,93,38.233870543874055,-109.3952632
59002,16,44,13,9,11,0,93,38.233870543874055,-109.3949938
59003,13,45,13,9,12,0,92,38.233870543874055,-109.3947243
59004,12,46,13,9,13,0,93,38.233870543874055,-109.3944548
59005,14,45,13,9,12,0,93,38.233870543874055,-109.3941853
59006,17,42,13,9,11,0,92,38.233870543874055,-109.3939158
59007,16,41,13,10,12,0,92,38.233870543874055,-109.3936463
59008,13,44,13,10,12,0,92,38.233870543874055,-109.3933768
59009,12,46,13,9,12,0,92,38.233870543874055,-109.3931073
59010,11,47,13,8,13,0,92,38.233870543874055,-109.3928378
59011,12,46,13,8,13,0,92,38.233870543874055,-109.3925683
59012,13,45,13,9,12,0,92,38.233870543874055,-109.3922988
59013,14,45,13,9,12,0,93,38.233870543874055,-109.3920293
59014,15,45,13,9,12,0,94,38.233870543874055,-109.3917598
59015,13,44,12,8,13,0,90,38.233870543874055,-109.3914903
59016,12,42,12,9,13,1,89,38.233870543874055,-109.3912208
59017,13,42,13,9,13,1,91,38.233870543874055,-109.3909513
59018,12,44,13,9,13,0,91,38.233870543874055,-109.3906818
59019,10,46,13,8,14,1,92,38.233870543874055,-109.3904123
59020,7,45,13,9,14,2,90,38.233870543874055,-109.3901429
59021,6,43,13,9,13,2,86,38.233870543874055,-109.3898734
59022,6,44,12,8,13,2,85,38.233870543874055,-109.3896039
59023,6,42,12,9,13,2,84,38.233870543874055,-109.3893344
59024,7,40,12,10,14,2,85,38.233870543874055,-109.3890649
59025,8,40,13,11,13,1,86,38.233870543874055,-109.3887954
59026,7,40,14,11,12,1,85,38.233870543874055,-109.3885259
59027,9,37,15,12,13,1,87,38.233870543874055,-109.3882564
59028,10,36,15,12,12,1,86,38.233870543874055,-109.3879869
59029,10,35,15,12,12,1,85,38.233870543874055,-109.3877174
59030,11,35,15,12,13,2,88,38.233870543874055,-109.3874479
59031,15,36,15,12,12,1,91,38.233870543874055,-109.3871784
59032,12,42,14,10,13,1,92,38.233870543874055,-109.3869089
59033,8,48,12,9,14,1,92,38.233870543874055,-109.3866394
59034,6,52,11,10,13,0,92,38.233870543874055,-109.3863699
59035,8,49,13,11,12,1,94,38.233870543874055,-109.3861004
59036,8,45,14,13,12,1,93,38.233870543874055,-109.3858309
59037,8,43,14,13,12,1,91,38.233870543874055,-109.3855614
59038,8,43,14,13,13,1,92,38.233870543874055,-109.3852919
59039,9,43,14,13,13,1,93,38.233870543874055,-109.3850225
59040,7,45,13,12,14,1,92,38.233870543874055,-109.384753
59041,9,41,14,13,15,1,93,38.233870543874055,-109.3844835
59042,11,38,14,14,15,0,92,38.233870543874055,-109.384214
59043,12,40,13,12,15,0,92,38.233870543874055,-109.3839445
59044,6,46,12,10,15,1,90,38.233870543874055,-109.383675
59045,5,46,12,10,15,1,89,38.233870543874055,-109.3834055
59046,5,48,12,9,15,1,90,38.233870543874055,-109.383136
59047,5,45,12,11,15,1,89,38.233870543874055,-109.3828665
59048,6,43,12,12,14,1,88,38.233870543874055,-109.382597
59049,9,45,13,11,14,0,92,38.233870543874055,-109.3823275
59050,10,41,14,13,14,0,92,38.233870543874055,-109.382058
59051,13,38,14,13,14,0,92,38.233870543874055,-109.3817885
59052,13,38,14,13,14,0,92,38.233870543874055,-109.381519
59053,11,39,14,13,14,0,91,38.233870543874055,-109.3812495
59054,8,43,14,12,14,1,92,38.233870543874055,-109.38098
59055,7,43,13,12,13,1,89,38.233870543874055,-109.3807105
59056,8,41,14,13,13,1,90,38.233870543874055,-109.380441
59057,10,41,14,13,13,1,92,38.233870543874055,-109.3801716
59058,11,43,14,12,13,1,94,38.233870543874055,-109.3799021
59059,8,45,14,12,14,1,94,38.233870543874055,-109.3796326
59060,7,45,14,12,15,0,93,38.233870543874055,-109.3793631
59061,6,44,14,13,14,0,91,38.233870543874055,-109.3790936
59062,6,43,13,14,13,0,89,38.233870543874055,-109.3788241
59063,11,28,12,14,11,1,77,38.233870543874055,-109.3785546
59064,9,21,10,21,13,0,74,38.233870543874055,-109.3782851
59065,13,27,13,17,13,1,84,38.233870543874055,-109.3780156
59066,13,38,14,12,13,0,90,38.233870543874055,-109.3777461
59067,13,41,15,12,12,0,93,38.233870543874055,-109.3774766
59068,12,41,14,12,12,1,92,38.233870543874055,-109.3772071
59069,9,43,14,10,13,1,90,38.233870543874055,-109.3769376
59070,6,42,12,9,14,1,84,38.233870543874055,-109.3766681
59071,4,46,10,7,12,2,81,38.233870543874055,-109.3763986
59072,3,47,9,6,12,2,79,38.233870543874055,-109.3761291
59073,4,45,11,6,13,3,82,38.233870543874055,-109.3758596
59074,6,45,11,8,13,2,85,38.233870543874055,-109.3755901
59075,7,48,11,10,12,1,89,38.233870543874055,-109.3753206
59076,8,49,11,11,12,1,92,38.233870543874055,-109.3750512
59077,5,46,11,8,13,3,86,38.233870543874055,-109.3747817
59078,8,45,12,8,11,5,89,38.233870543874055,-109.3745122
59079,9,42,13,11,14,1,90,38.233870543874055,-109.3742427
59080,8,42,13,9,16,2,90,38.233870543874055,-109.3739732
59081,7,39,12,5,15,4,82,38.233870543874055,-109.3737037
59082,3,40,10,2,17,4,76,38.233870543874055,-109.3734342
59083,3,38,11,3,16,4,75,38.233870543874055,-109.3731647
59084,5,36,10,3,13,6,73,38.233870543874055,-109.3728952
59085,9,36,11,6,14,3,79,38.233870543874055,-109.3726257
59086,14,38,12,11,14,0,89,38.233870543874055,-109.3723562
59087,17,38,13,10,12,0,90,38.233870543874055,-109.3720867
59088,16,39,14,12,12,0,93,38.233870543874055,-109.3718172
59089,13,40,14,13,13,0,93,38.233870543874055,-109.3715477
59090,9,43,14,12,14,0,92,38.233870543874055,-109.3712782
59091,7,46,13,9,15,0,90,38.233870543874055,-109.3710087
59092,9,44,14,11,14,0,92,38.233870543874055,-109.3707392
59093,7,45,14,11,14,0,91,38.233870543874055,-109.3704697
59094,6,44,14,11,15,0,90,38.233870543874055,-109.3702003
59095,6,43,14,12,15,0,90,38.233870543874055,-109.3699308
59096,7,43,14,12,15,0,91,38.233870543874055,-109.3696613
59097,9,42,14,12,14,0,91,38.233870543874055,-109.3693918
59098,10,41,15,12,13,1,92,38.233870543874055,-109.3691223
59099,10,40,14,13,12,1,90,38.233870543874055,-109.3688528
59100,10,41,13,12,12,1,89,38.233870543874055,-109.3685833
59101,12,40,13,13,11,1,90,38.233870543874055,-109.3683138
59102,14,38,13,12,10,2,89,38.233870543874055,-109.3680443
59103,12,39,12,12,11,1,87,38.233870543874055,-109.3677748
59104,9,40,11,8,11,2,81,38.233870543874055,-109.3675053
59105,4,40,9,4,11,3,71,38.233870543874055,-109.3672358
59106,1,40,7,1,10,5,64,38.233870543874055,-109.3669663
59107,0,41,7,1,10,6,65,38.233870543874055,-109.3666968
59108,0,44,7,1,10,5,67,38.233870543874055,-109.3664273
59109,1,46,6,3,9,3,68,38.233870543874055,-109.3661578
59110,0,54,6,2,9,2,73,38.233870543874055,-109.3658883
59111,0,54,7,2,10,2,75,38.233870543874055,-109.3656188
59112,1,48,8,2,11,4,74,38.233870543874055,-109.3653493
59113,1,39,9,2,11,8,70,38.233870543874055,-109.3650799
59114,1,36,11,2,8,12,70,38.233870543874055,-109.3648104
59115,1,39,9,2,9,9,69,38.233870543874055,-109.3645409
59116,1,43,9,3,12,6,74,38.233870543874055,-109.3642714
59117,2,44,9,5,13,4,77,38.233870543874055,-109.3640019
59118,3,41,11,7,14,4,80,38.233870543874055,-109.3637324
59119,3,36,10,5,12,6,72,38.233870543874055,-109.3634629
59120,2,32,9,4,10,7,64,38.233870543874055,-109.3631934
59121,2,32,9,4,11,7,65,38.233870543874055,-109.3629239
59122,3,33,9,5,11,6,67,38.233870543874055,-109.3626544
59123,2,31,10,6,11,7,67,38.233870543874055,-109.3623849
59124,3,28,12,6,10,9,68,38.233870543874055,-109.3621154
59125,3,29,11,6,13,7,69,38.233870543874055,-109.3618459
59126,6,38,12,7,16,3,82,38.233870543874055,-109.3615764
59127,6,43,13,9,16,1,88,38.233870543874055,-109.3613069
59128,7,45,13,10,14,1,90,38.233870543874055,-109.3610374
59129,8,42,13,11,13,1,88,38.233870543874055,-109.3607679
59130,6,34,10,7,14,3,74,38.233870543874055,-109.3604984
59131,2,31,8,5,12,4,62,38.233870543874055,-109.360229
59132,2,32,7,3,10,4,58,38.233870543874055,-109.3599595
59133,3,42,6,6,9,3,69,38.233870543874055,-109.35969
59134,4,38,8,8,9,4,71,38.233870543874055,-109.3594205
59135,5,38,8,9,9,4,73,38.233870543874055,-109.359151
59136,3,30,9,7,13,4,66,38.233870543874055,-109.3588815
59137,7,26,11,15,15,2,76,38.233870543874055,-109.358612
59138,17,22,14,18,12,1,84,38.233870543874055,-109.3583425
59139,25,12,12,21,16,2,88,38.233870543874055,-109.358073
59140,32,8,10,26,13,3,92,38.233870543874055,-109.3578035
59141,40,9,9,23,10,2,93,38.233870543874055,-109.357534
59142,39,12,9,21,6,1,88,38.233870543874055,-109.3572645
59143,38,14,9,20,5,1,87,38.233870543874055,-109.356995
59144,39,14,9,17,4,1,84,38.233870543874055,-109.3567255
59145,38,17,8,13,2,1,79,38.233870543874055,-109.356456
59146,42,18,6,9,1,0,76,38.233870543874055,-109.3561865
59147,46,15,7,12,2,0,82,38.233870543874055,-109.355917
59148,39,10,8,19,2,1,79,38.233870543874055,-109.3556475
59149,39,11,10,25,3,2,90,38.233870543874055,-109.355378
59150,42,11,9,20,8,2,92,38.233870543874055,-109.3551086
59151,36,13,10,18,13,2,92,38.233870543874055,-109.3548391
59152,18,21,13,15,14,7,88,38.233870543874055,-109.3545696
59153,6,22,13,10,11,13,75,38.233870543874055,-109.3543001
59154,2,19,13,8,9,14,65,38.233870543874055,-109.3540306
59155,1,20,12,6,8,15,62,38.233870543874055,-109.3537611
59156,1,27,11,2,8,14,63,38.233870543874055,-109.3534916
59157,2,37,11,2,11,10,73,38.233870543874055,-109.3532221
59158,2,36,11,2,11,11,73,38.233870543874055,-109.3529526
59159,2,34,10,2,10,11,69,38.233870543874055,-109.3526831
59160,1,32,10,2,9,11,65,38.233870543874055,-109.3524136
59161,2,33,10,3,8,10,66,38.233870543874055,-109.3521441
59162,1,28,10,3,7,13,62,38.233870543874055,-109.3518746
59163,1,29,9,3,7,11,60,38.233870543874055,-109.3516051
59164,2,31,9,4,8,9,63,38.233870543874055,-109.3513356
59165,3,40,7,5,9,2,66,38.233601049288815,-109.4068515
59166,3,43,7,5,9,2,69,38.233601049288815,-109.406582
59167,4,48,9,7,11,1,80,38.233601049288815,-109.4063125
59168,4,55,10,6,12,1,88,38.233601049288815,-109.406043
59169,5,53,11,8,13,1,91,38.233601049288815,-109.4057735
59170,6,51,12,9,15,1,94,38.233601049288815,-109.405504
59171,5,52,13,8,15,1,94,38.233601049288815,-109.4052345
59172,5,53,12,8,15,0,93,38.233601049288815,-109.4049651
59173,5,54,10,6,15,0,90,38.233601049288815,-109.4046956
59174,4,54,10,6,14,0,88,38.233601049288815,-109.4044261
59175,4,54,9,7,13,0,87,38.233601049288815,-109.4041566
59176,5,55,10,7,13,1,91,38.233601049288815,-109.4038871
59177,6,50,11,8,13,1,89,38.233601049288815,-109.4036176
59178,8,46,13,10,14,1,92,38.233601049288815,-109.4033481
59179,10,44,14,11,14,1,94,38.233601049288815,-109.4030786
59180,12,43,14,11,14,0,94,38.233601049288815,-109.4028091
59181,12,42,13,10,14,0,91,38.233601049288815,-109.4025396
59182,12,43,13,10,13,0,91,38.233601049288815,-109.4022701
59183,11,44,14,10,14,0,93,38.233601049288815,-109.4020006
59184,9,44,14,10,15,0,92,38.233601049288815,-109.4017311
59185,10,44,14,10,14,0,92,38.233601049288815,-109.4014616
59186,13,43,14,10,14,0,94,38.233601049288815,-109.4011921
59187,13,43,14,10,13,0,93,38.233601049288815,-109.4009226
59188,14,40,14,10,13,0,91,38.233601049288815,-109.4006531
59189,16,39,14,10,13,0,92,38.233601049288815,-109.4003836
59190,15,42,14,9,14,0,94,38.233601049288815,-109.4001142
59191,15,42,14,10,13,0,94,38.233601049288815,-109.3998447
59192,18,40,14,9,12,0,93,38.233601049288815,-109.3995752
59193,21,39,14,9,11,0,94,38.233601049288815,-109.3993057
59194,21,37,13,10,11,0,92,38.233601049288815,-109.3990362
59195,20,37,13,11,11,0,92,38.233601049288815,-109.3987667
59196,18,39,13,11,11,0,92,38.233601049288815,-109.3984972
59197,16,40,13,11,12,0,92,38.233601049288815,-109.3982277
59198,17,40,13,10,12,0,92,38.233601049288815,-109.3979582
59199,19,39,13,10,11,0,92,38.233601049288815,-109.3976887
59200,21,38,13,10,11,0,93,38.233601049288815,-109.3974192
59201,24,35,13,9,11,0,92,38.233601049288815,-109.3971497
59202,21,37,13,9,11,0,91,38.233601049288815,-109.3968802
59203,20,37,13,9,12,0,91,38.233601049288815,-109.3966107
59204,26,33,13,9,11,0,92,38.233601049288815,-109.3963412
59205,27,33,13,9,10,0,92,38.233601049288815,-109.3960717
59206,23,36,13,9,11,0,92,38.233601049288815,-109.3958022
59207,21,38,13,9,11,0,92,38.233601049288815,-109.3955327
59208,19,41,13,9,11,0,93,38.233601049288815,-109.3952632
59209,16,44,13,9,11,0,93,38.233601049288815,-109.3949938
59210,14,45,13,9,12,0,93,38.233601049288815,-109.3947243
59211,14,45,13,9,12,0,93,38.233601049288815,-109.3944548
59212,15,44,13,9,12,0,93,38.233601049288815,-109.3941853
59213,16,43,13,9,11,0,92,38.233601049288815,-109.3939158
59214,16,43,13,10,12,0,94,38.233601049288815,-109.3936463
59215,16,43,13,10,12,0,94,38.233601049288815,-109.3933768
59216,14,44,13,9,12,0,92,38.233601049288815,-109.3931073
59217,13,45,13,9,12,0,92,38.233601049288815,-109.3928378
59218,12,46,13,9,13,1,94,38.233601049288815,-109.3925683
59219,11,46,13,9,13,1,93,38.233601049288815,-109.3922988
59220,13,45,13,10,12,0,93,38.233601049288815,-109.3920293
59221,15,44,13,9,12,0,93,38.233601049288815,-109.3917598
59222,15,44,12,8,13,0,92,38.233601049288815,-109.3914903
59223,14,41,12,9,13,1,90,38.233601049288815,-109.3912208
59224,15,41,13,9,12,1,91,38.233601049288815,-109.3909513
59225,12,43,13,9,13,1,91,38.233601049288815,-109.3906818
59226,10,44,13,9,13,1,90,38.233601049288815,-109.3904123
59227,7,43,13,8,14,2,87,38.233601049288815,-109.3901429
59228,7,43,13,8,12,2,85,38.233601049288815,-109.3898734
59229,8,46,13,7,13,2,89,38.233601049288815,-109.3896039
59230,8,45,13,7,13,2,88,38.233601049288815,-109.3893344
59231,10,43,13,8,12,2,88,38.233601049288815,-109.3890649
59232,11,42,14,9,11,1,88,38.233601049288815,-109.3887954
59233,10,40,13,11,13,1,88,38.233601049288815,-109.3885259
59234,9,39,13,11,14,1,87,38.233601049288815,-109.3882564
59235,8,40,14,11,14,1,88,38.233601049288815,-109.3879869
59236,8,37,14,11,12,2,84,38.233601049288815,-109.3877174
59237,10,37,14,12,12,2,87,38.233601049288815,-109.3874479
59238,12,38,14,11,12,1,88,38.233601049288815,-109.3871784
59239,9,43,13,8,13,1,87,38.233601049288815,-109.3869089
59240,6,49,11,8,13,1,88,38.233601049288815,-109.3866394
59241,4,51,10,8,13,1,87,38.233601049288815,-109.3863699
59242,6,53,11,9,12,1,92,38.233601049288815,-109.3861004
59243,7,47,13,12,12,1,92,38.233601049288815,-109.3858309
59244,7,45,13,13,12,1,91,38.233601049288815,-109.3855614
59245,7,47,13,11,13,1,92,38.233601049288815,-109.3852919
59246,5,51,11,9,13,1,90,38.233601049288815,-109.3850225
59247,7,48,13,11,15,1,95,38.233601049288815,-109.384753
59248,10,42,13,12,14,1,92,38.233601049288815,-109.3844835
59249,10,42,13,13,13,1,92,38.233601049288815,-109.384214
59250,8,44,13,11,14,1,91,38.233601049288815,-109.3839445
59251,6,46,13,10,15,1,91,38.233601049288815,-109.383675
59252,6,45,13,12,15,1,92,38.233601049288815,-109.3834055
59253,6,42,13,12,15,1,89,38.233601049288815,-109.383136
59254,6,42,13,13,14,1,89,38.233601049288815,-109.3828665
59255,8,42,14,13,14,1,92,38.233601049288815,-109.382597
59256,10,42,14,12,13,1,92,38.233601049288815,-109.3823275
59257,9,41,14,13,14,1,92,38.233601049288815,-109.382058
59258,10,41,14,13,14,0,92,38.233601049288815,-109.3817885
59259,12,39,14,13,14,0,92,38.233601049288815,-109.381519
59260,12,40,14,13,14,0,93,38.233601049288815,-109.3812495
59261,8,43,14,12,14,1,92,38.233601049288815,-109.38098
59262,6,41,13,12,13,1,86,38.233601049288815,-109.3807105
59263,7,41,14,12,13,1,88,38.233601049288815,-109.380441
59264,8,41,14,13,13,1,90,38.233601049288815,-109.3801716
59265,8,42,14,13,13,1,91,38.233601049288815,-109.3799021
59266,9,44,13,12,14,1,93,38.233601049288815,-109.3796326
59267,7,44,13,12,14,1,91,38.233601049288815,-109.3793631
59268,5,45,13,11,14,1,89,38.233601049288815,-109.3790936
59269,4,44,13,12,13,1,87,38.233601049288815,-109.3788241
59270,6,34,13,16,11,1,81,38.233601049288815,-109.3785546
59271,10,20,11,18,12,0,71,38.233601049288815,-109.3782851
59272,11,23,12,18,13,1,78,38.233601049288815,-109.3780156
59273,13,34,13,13,15,0,88,38.233601049288815,-109.3777461
59274,11,40,14,12,14,0,91,38.233601049288815,-109.3774766
59275,10,42,15,12,13,1,93,38.233601049288815,-109.3772071
59276,7,41,14,11,14,1,88,38.233601049288815,-109.3769376
59277,4,40,12,8,13,2,79,38.233601049288815,-109.3766681
59278,3,45,10,6,12,2,78,38.233601049288815,-109.3763986
59279,3,52,9,6,13,1,84,38.233601049288815,-109.3761291
59280,5,50,10,7,13,2,87,38.233601049288815,-109.3758596
59281,6,50,11,8,13,2,90,38.233601049288815,-109.3755901
59282,5,53,10,8,12,2,90,38.233601049288815,-109.3753206
59283,6,51,11,9,12,1,90,38.233601049288815,-109.3750512
59284,7,46,12,10,14,2,91,38.233601049288815,-109.3747817
59285,9,45,12,9,13,3,91,38.233601049288815,-109.3745122
59286,9,43,13,10,16,1,92,38.233601049288815,-109.3742427
59287,9,41,13,9,17,1,90,38.233601049288815,-109.3739732
59288,7,39,12,6,16,4,84,38.233601049288815,-109.3737037
59289,3,38,11,2,16,7,77,38.233601049288815,-109.3734342
59290,4,40,11,3,16,4,78,38.233601049288815,-109.3731647
59291,6,40,11,5,16,3,81,38.233601049288815,-109.3728952
59292,9,39,12,9,16,1,86,38.233601049288815,-109.3726257
59293,13,41,12,10,14,0,90,38.233601049288815,-109.3723562
59294,11,43,13,10,14,0,91,38.233601049288815,-109.3720867
59295,11,42,14,11,14,0,92,38.233601049288815,-109.3718172
59296,10,43,15,12,14,0,94,38.233601049288815,-109.3715477
59297,8,44,14,12,14,0,92,38.233601049288815,-109.3712782
59298,7,46,13,9,15,1,91,38.233601049288815,-109.3710087
59299,9,43,14,12,13,0,91,38.233601049288815,-109.3707392
59300,7,43,14,12,13,1,90,38.233601049288815,-109.3704697
59301,6,42,13,11,13,1,86,38.233601049288815,-109.3702003
59302,7,43,13,12,14,0,89,38.233601049288815,-109.3699308
59303,7,43,14,12,15,0,91,38.233601049288815,-109.3696613
59304,6,45,13,9,15,1,89,38.233601049288815,-109.3693918
59305,6,44,13,9,16,2,90,38.233601049288815,-109.3691223
59306,7,44,13,9,15,2,90,38.233601049288815,-109.3688528
59307,6,45,12,7,15,2,87,38.233601049288815,-109.3685833
59308,6,45,11,6,13,3,84,38.233601049288815,-109.3683138
59309,10,41,12,7,12,2,84,38.233601049288815,-109.3680443
59310,12,37,11,8,11,2,81,38.233601049288815,-109.3677748
59311,7,38,10,5,10,3,73,38.233601049288815,-109.3675053
59312,2,43,8,1,10,4,68,38.233601049288815,-109.3672358
59313,1,50,7,4,12,2,76,38.233601049288815,-109.3669663
59314,2,51,9,3,10,4,79,38.233601049288815,-109.3666968
59315,1,47,9,1,11,6,75,38.233601049288815,-109.3664273
59316,1,44,7,3,11,3,69,38.233601049288815,-109.3661578
59317,1,45,6,4,9,2,67,38.233601049288815,-109.3658883
59318,1,49,8,3,11,2,74,38.233601049288815,-109.3656188
59319,1,44,9,4,12,4,74,38.233601049288815,-109.3653493
59320,1,38,10,2,10,10,71,38.233601049288815,-109.3650799
59321,2,39,10,1,9,11,72,38.233601049288815,-109.3648104
59322,1,43,9,0,11,9,73,38.233601049288815,-109.3645409
59323,2,41,9,2,12,8,74,38.233601049288815,-109.3642714
59324,2,40,9,5,13,5,74,38.233601049288815,-109.3640019
59325,3,39,10,8,12,3,75,38.233601049288815,-109.3637324
59326,2,38,9,4,11,5,69,38.233601049288815,-109.3634629
59327,2,37,9,4,12,5,69,38.233601049288815,-109.3631934
59328,4,34,10,6,11,6,71,38.233601049288815,-109.3629239
59329,4,31,11,8,10,7,71,38.233601049288815,-109.3626544
59330,3,26,11,8,10,9,67,38.233601049288815,-109.3623849
59331,3,24,12,7,9,10,65,38.233601049288815,-109.3621154
59332,1,28,9,6,10,7,61,38.233601049288815,-109.3618459
59333,3,35,9,7,13,4,71,38.233601049288815,-109.3615764
59334,5,39,10,8,15,2,79,38.233601049288815,-109.3613069
59335,6,42,11,9,14,1,83,38.233601049288815,-109.3610374
59336,8,34,10,8,13,2,75,38.233601049288815,-109.3607679
59337,3,28,8,4,11,5,59,38.233601049288815,-109.3604984
59338,2,30,8,3,10,5,58,38.233601049288815,-109.360229
59339,2,30,8,4,11,5,60,38.233601049288815,-109.3599595
59340,6,31,9,9,9,6,70,38.233601049288815,-109.35969
59341,10,25,11,11,9,7,73,38.233601049288815,-109.3594205
59342,10,25,13,11,8,8,75,38.233601049288815,-109.359151
59343,8,25,13,16,13,4,79,38.233601049288815,-109.3588815
59344,14,26,13,15,13,2,83,38.233601049288815,-109.358612
59345,37,9,10,17,8,2,83,38.233601049288815,-109.3583425
59346,34,7,9,27,9,4,90,38.233601049288815,-109.358073
59347,36,8,9,25,8,3,89,38.233601049288815,-109.3578035
59348,38,9,9,20,7,3,86,38.233601049288815,-109.357534
59349,40,9,9,17,4,3,82,38.233601049288815,-109.3572645
59350,36,10,10,19,5,3,83,38.233601049288815,-109.356995
59351,35,12,10,18,5,3,83,38.233601049288815,-109.3567255
59352,37,14,8,16,3,2,80,38.233601049288815,-109.356456
59353,35,14,7,12,3,1,72,38.233601049288815,-109.3561865
59354,37,11,8,16,4,2,78,38.233601049288815,-109.355917
59355,36,11,10,21,8,1,87,38.233601049288815,-109.3556475
59356,34,15,10,18,13,2,92,38.233601049288815,-109.355378
59357,20,19,11,18,14,5,87,38.233601049288815,-109.3551086
59358,9,21,13,13,11,10,77,38.233601049288815,-109.3548391
59359,6,25,12,10,12,8,73,38.233601049288815,-109.3545696
59360,2,28,10,4,11,10,65,38.233601049288815,-109.3543001
59361,2,34,10,3,12,8,69,38.233601049288815,-109.3540306
59362,1,36,10,2,12,8,69,38.233601049288815,-109.3537611
59363,1,36,10,2,11,9,69,38.233601049288815,-109.3534916
59364,1,36,10,2,11,10,70,38.233601049288815,-109.3532221
59365,2,39,9,1,10,9,70,38.233601049288815,-109.3529526
59366,2,33,10,4,9,8,66,38.233601049288815,-109.3526831
59367,2,27,10,4,8,9,60,38.233601049288815,-109.3524136
59368,3,33,10,2,7,13,68,38.233601049288815,-109.3521441
59369,1,29,10,2,6,15,63,38.233601049288815,-109.3518746
59370,3,31,10,4,7,11,66,38.233601049288815,-109.3516051
59371,7,34,12,9,10,5,77,38.233601049288815,-109.3513356
59372,8,37,10,8,12,1,76,38.23333155470358,-109.4068515
59373,5,40,9,7,11,2,74,38.23333155470358,-109.406582
59374,6,45,9,7,10,1,78,38.23333155470358,-109.4063125
59375,5,48,10,8,12,1,84,38.23333155470358,-109.406043
59376,5,49,12,9,13,1,89,38.23333155470358,-109.4057735
59377,6,48,12,9,14,2,91,38.23333155470358,-109.405504
59378,6,49,12,8,14,1,90,38.23333155470358,-109.4052345
59379,7,53,11,8,14,1,94,38.23333155470358,-109.4049651
59380,6,53,11,8,14,1,93,38.23333155470358,-109.4046956
59381,5,53,10,7,14,1,90,38.23333155470358,-109.4044261
59382,5,54,10,6,13,1,89,38.23333155470358,-109.4041566
59383,4,55,10,6,13,0,88,38.23333155470358,-109.4038871
59384,4,56,10,6,14,0,90,38.23333155470358,-109.4036176
59385,5,54,11,6,15,0,91,38.23333155470358,-109.4033481
59386,8,50,12,9,15,0,94,38.23333155470358,-109.4030786
59387,9,46,13,10,14,0,92,38.23333155470358,-109.4028091
59388,11,44,14,10,14,0,93,38.23333155470358,-109.4025396
59389,14,42,14,11,13,0,94,38.23333155470358,-109.4022701
59390,13,43,14,10,14,0,94,38.23333155470358,-109.4020006
59391,11,44,14,10,15,0,94,38.23333155470358,-109.4017311
59392,10,43,14,11,15,0,93,38.23333155470358,-109.4014616
59393,11,43,14,10,15,0,93,38.23333155470358,-109.4011921
59394,13,42,14,11,13,0,93,38.23333155470358,-109.4009226
59395,12,42,14,11,13,0,92,38.23333155470358,-109.4006531
59396,12,42,14,10,14,0,92,38.23333155470358,-109.4003836
59397,14,42,13,9,14,0,92,38.23333155470358,-109.4001142
59398,15,43,13,9,13,0,93,38.23333155470358,-109.3998447
59399,19,41,13,9,12,0,94,38.23333155470358,-109.3995752
59400,20,40,14,10,11,0,95,38.23333155470358,-109.3993057
59401,19,39,13,11,11,0,93,38.23333155470358,-109.3990362
59402,19,40,13,9,11,0,92,38.23333155470358,-109.3987667
59403,16,40,13,10,12,0,91,38.23333155470358,-109.3984972
59404,17,41,13,10,12,0,93,38.23333155470358,-109.3982277
59405,17,40,13,10,12,0,92,38.23333155470358,-109.3979582
59406,17,40,13,11,12,0,93,38.23333155470358,-109.3976887
59407,20,39,13,10,11,0,93,38.23333155470358,-109.3974192
59408,20,39,14,10,11,0,94,38.23333155470358,-109.3971497
59409,18,41,13,9,12,0,93,38.23333155470358,-109.3968802
59410,19,40,13,9,12,0,93,38.23333155470358,-109.3966107
59411,23,35,13,9,11,0,91,38.23333155470358,-109.3963412
59412,22,36,13,10,11,0,92,38.23333155470358,-109.3960717
59413,19,39,13,10,12,0,93,38.23333155470358,-109.3958022
59414,18,42,13,9,12,0,94,38.23333155470358,-109.3955327
59415,18,43,13,8,11,0,93,38.23333155470358,-109.3952632
59416,17,44,13,9,11,0,94,38.23333155470358,-109.3949938
59417,15,44,13,9,11,0,92,38.23333155470358,-109.3947243
59418,16,44,13,9,12,0,94,38.23333155470358,-109.3944548
59419,15,44,13,9,12,0,93,38.23333155470358,-109.3941853
59420,14,44,13,10,12,0,93,38.23333155470358,-109.3939158
59421,13,46,14,10,12,0,95,38.23333155470358,-109.3936463
59422,15,45,13,9,12,0,94,38.23333155470358,-109.3933768
59423,15,44,13,10,12,0,94,38.23333155470358,-109.3931073
59424,13,45,13,9,13,0,93,38.23333155470358,-109.3928378
59425,11,47,13,8,13,1,93,38.23333155470358,-109.3925683
59426,8,47,13,9,12,2,91,38.23333155470358,-109.3922988
59427,12,45,13,10,12,1,93,38.23333155470358,-109.3920293
59428,13,45,13,9,12,0,92,38.23333155470358,-109.3917598
59429,13,43,12,9,13,0,90,38.23333155470358,-109.3914903
59430,13,41,11,9,14,0,88,38.23333155470358,-109.3912208
59431,13,44,13,8,13,1,92,38.23333155470358,-109.3909513
59432,11,45,13,9,13,1,92,38.23333155470358,-109.3906818
59433,10,44,13,8,13,1,89,38.23333155470358,-109.3904123
59434,8,42,13,8,14,2,87,38.23333155470358,-109.3901429
59435,7,42,13,8,12,2,84,38.23333155470358,-109.3898734
59436,8,44,14,8,12,2,88,38.23333155470358,-109.3896039
59437,9,42,14,9,12,2,88,38.23333155470358,-109.3893344
59438,9,41,14,9,12,2,87,38.23333155470358,-109.3890649
59439,10,41,14,9,11,2,87,38.23333155470358,-109.3887954
59440,10,41,14,9,11,1,86,38.23333155470358,-109.3885259
59441,9,41,14,9,11,2,86,38.23333155470358,-109.3882564
59442,10,40,14,9,11,2,86,38.23333155470358,-109.3879869
59443,11,41,14,9,11,1,87,38.23333155470358,-109.3877174
59444,12,41,14,9,12,1,89,38.23333155470358,-109.3874479
59445,11,42,14,9,13,1,90,38.23333155470358,-109.3871784
59446,9,47,11,7,14,1,89,38.23333155470358,-109.3869089
59447,5,50,10,7,12,1,85,38.23333155470358,-109.3866394
59448,4,52,9,7,12,1,85,38.23333155470358,-109.3863699
59449,6,51,11,9,12,1,90,38.23333155470358,-109.3861004
59450,7,47,12,13,12,1,92,38.23333155470358,-109.3858309
59451,7,46,12,13,12,1,91,38.23333155470358,-109.3855614
59452,7,47,12,12,13,0,91,38.23333155470358,-109.3852919
59453,8,46,11,11,14,0,90,38.23333155470358,-109.3850225
59454,7,44,13,11,16,1,92,38.23333155470358,-109.384753
59455,9,43,13,11,15,1,92,38.23333155470358,-109.3844835
59456,8,43,13,11,14,1,90,38.23333155470358,-109.384214
59457,7,44,13,10,15,1,90,38.23333155470358,-109.3839445
59458,8,42,13,11,14,1,89,38.23333155470358,-109.383675
59459,8,42,14,12,14,1,91,38.23333155470358,-109.3834055
59460,7,42,14,13,14,1,91,38.23333155470358,-109.383136
59461,7,40,14,12,14,2,89,38.23333155470358,-109.3828665
59462,7,38,14,12,13,2,86,38.23333155470358,-109.382597
59463,10,38,14,13,12,1,88,38.23333155470358,-109.3823275
59464,8,39,14,13,13,1,88,38.23333155470358,-109.382058
59465,8,39,14,13,14,1,89,38.23333155470358,-109.3817885
59466,8,40,14,13,14,1,90,38.23333155470358,-109.381519
59467,7,41,14,13,14,1,90,38.23333155470358,-109.3812495
59468,6,44,13,12,13,1,89,38.23333155470358,-109.38098
59469,5,41,13,11,12,2,84,38.23333155470358,-109.3807105
59470,6,40,13,11,12,1,83,38.23333155470358,-109.380441
59471,6,40,13,12,12,1,84,38.23333155470358,-109.3801716
59472,8,40,13,13,13,1,88,38.23333155470358,-109.3799021
59473,7,43,13,13,14,1,91,38.23333155470358,-109.3796326
59474,6,44,13,12,14,1,90,38.23333155470358,-109.3793631
59475,5,44,13,12,13,1,88,38.23333155470358,-109.3790936
59476,5,43,13,14,13,1,89,38.23333155470358,-109.3788241
59477,7,35,13,18,13,1,87,38.23333155470358,-109.3785546
59478,10,19,11,18,14,1,73,38.23333155470358,-109.3782851
59479,12,20,12,18,14,1,77,38.23333155470358,-109.3780156
59480,14,30,13,13,13,1,84,38.23333155470358,-109.3777461
59481,11,39,14,11,15,0,90,38.23333155470358,-109.3774766
59482,8,42,15,11,15,1,92,38.23333155470358,-109.3772071
59483,6,43,13,9,15,1,87,38.23333155470358,-109.3769376
59484,3,41,11,6,13,3,77,38.23333155470358,-109.3766681
59485,2,44,9,5,12,3,75,38.23333155470358,-109.3763986
59486,2,51,9,5,13,2,82,38.23333155470358,-109.3761291
59487,4,53,9,7,12,2,87,38.23333155470358,-109.3758596
59488,4,55,10,7,12,2,90,38.23333155470358,-109.3755901
59489,6,53,11,9,12,2,93,38.23333155470358,-109.3753206
59490,8,49,11,10,12,2,92,38.23333155470358,-109.3750512
59491,6,48,12,10,14,1,91,38.23333155470358,-109.3747817
59492,8,46,13,11,14,1,93,38.23333155470358,-109.3745122
59493,8,43,13,9,17,1,91,38.23333155470358,-109.3742427
59494,8,42,13,6,18,3,90,38.23333155470358,-109.3739732
59495,3,41,11,2,17,5,79,38.23333155470358,-109.3737037
59496,2,36,11,2,16,6,73,38.23333155470358,-109.3734342
59497,2,41,10,1,16,5,75,38.23333155470358,-109.3731647
59498,3,44,10,3,17,3,80,38.23333155470358,-109.3728952
59499,4,44,11,5,17,2,83,38.23333155470358,-109.3726257
59500,5,42,11,8,16,1,83,38.23333155470358,-109.3723562
59501,6,44,12,7,16,1,86,38.23333155470358,-109.3720867
59502,7,43,13,9,15,2,89,38.23333155470358,-109.3718172
59503,9,43,14,11,15,0,92,38.23333155470358,-109.3715477
59504,9,42,14,12,15,0,92,38.23333155470358,-109.3712782
59505,8,42,14,12,15,1,92,38.23333155470358,-109.3710087
59506,10,41,14,13,13,0,91,38.23333155470358,-109.3707392
59507,8,41,14,13,14,1,91,38.23333155470358,-109.3704697
59508,7,41,13,12,14,1,88,38.23333155470358,-109.3702003
59509,8,43,13,11,14,1,90,38.23333155470358,-109.3699308
59510,8,44,13,10,13,1,89,38.23333155470358,-109.3696613
59511,6,46,13,9,14,1,89,38.23333155470358,-109.3693918
59512,6,47,13,8,15,1,90,38.23333155470358,-109.3691223
59513,6,48,12,8,15,1,90,38.23333155470358,-109.3688528
59514,6,48,12,7,15,1,89,38.23333155470358,-109.3685833
59515,7,49,11,5,13,1,86,38.23333155470358,-109.3683138
59516,8,43,11,6,12,2,82,38.23333155470358,-109.3680443
59517,7,40,11,6,11,2,77,38.23333155470358,-109.3677748
59518,5,42,10,4,10,3,74,38.23333155470358,-109.3675053
59519,1,45,8,2,10,4,70,38.23333155470358,-109.3672358
59520,2,51,9,5,12,2,81,38.23333155470358,-109.3669663
59521,3,44,10,1,12,7,77,38.23333155470358,-109.3666968
59522,2,39,10,0,10,11,72,38.23333155470358,-109.3664273
59523,0,43,8,0,13,5,69,38.23333155470358,-109.3661578
59524,1,50,6,3,9,2,71,38.23333155470358,-109.3658883
59525,1,53,7,3,10,1,75,38.23333155470358,-109.3656188
59526,1,51,8,2,11,3,76,38.23333155470358,-109.3653493
59527,2,45,9,3,11,5,75,38.23333155470358,-109.3650799
59528,3,39,9,3,10,7,71,38.23333155470358,-109.3648104
59529,1,42,9,3,11,6,72,38.23333155470358,-109.3645409
59530,2,46,9,2,13,4,76,38.23333155470358,-109.3642714
59531,3,42,9,6,12,2,74,38.23333155470358,-109.3640019
59532,3,37,9,6,11,3,69,38.23333155470358,-109.3637324
59533,1,39,9,3,10,5,67,38.23333155470358,-109.3634629
59534,5,38,10,8,11,3,75,38.23333155470358,-109.3631934
59535,7,38,12,9,10,4,80,38.23333155470358,-109.3629239
59536,7,34,13,10,10,5,79,38.23333155470358,-109.3626544
59537,7,29,12,10,12,7,77,38.23333155470358,-109.3623849
59538,6,24,13,11,11,8,73,38.23333155470358,-109.3621154
59539,1,30,8,5,9,7,60,38.23333155470358,-109.3618459
59540,2,33,7,5,11,4,62,38.23333155470358,-109.3615764
59541,2,33,8,5,11,4,63,38.23333155470358,-109.3613069
59542,2,33,8,5,11,4,63,38.23333155470358,-109.3610374
59543,3,37,8,4,10,3,65,38.23333155470358,-109.3607679
59544,2,34,8,3,10,4,61,38.23333155470358,-109.3604984
59545,2,28,9,4,10,6,59,38.23333155470358,-109.360229
59546,3,29,10,7,10,7,66,38.23333155470358,-109.3599595
59547,3,29,11,8,10,8,69,38.23333155470358,-109.35969
59548,10,29,13,14,12,5,83,38.23333155470358,-109.3594205
59549,21,24,13,14,14,1,87,38.23333155470358,-109.359151
59550,21,18,11,15,11,1,77,38.23333155470358,-109.3588815
59551,20,16,10,16,9,2,73,38.23333155470358,-109.358612
59552,32,9,9,16,5,3,74,38.23333155470358,-109.3583425
59553,32,8,9,21,6,3,79,38.23333155470358,-109.358073
59554,36,9,9,19,6,2,81,38.23333155470358,-109.3578035
59555,34,9,8,16,4,2,73,38.23333155470358,-109.357534
59556,31,9,7,14,3,2,66,38.23333155470358,-109.3572645
59557,32,11,9,19,6,2,79,38.23333155470358,-109.356995
59558,35,12,10,20,7,2,86,38.23333155470358,-109.3567255
59559,32,12,10,19,8,2,83,38.23333155470358,-109.356456
59560,29,12,11,18,11,3,84,38.23333155470358,-109.3561865
59561,29,12,12,20,14,2,89,38.23333155470358,-109.355917
59562,19,18,13,17,14,7,88,38.23333155470358,-109.3556475
59563,5,20,13,8,8,16,70,38.23333155470358,-109.355378
59564,4,21,12,10,9,10,66,38.23333155470358,-109.3551086
59565,3,27,11,9,12,7,69,38.23333155470358,-109.3548391
59566,4,31,10,7,13,4,69,38.23333155470358,-109.3545696
59567,3,30,10,5,12,6,66,38.23333155470358,-109.3543001
59568,2,29,10,6,10,8,65,38.23333155470358,-109.3540306
59569,2,30,10,4,9,10,65,38.23333155470358,-109.3537611
59570,1,34,9,2,9,11,66,38.23333155470358,-109.3534916
59571,1,36,10,4,11,7,69,38.23333155470358,-109.3532221
59572,2,36,9,4,11,6,68,38.23333155470358,-109.3529526
59573,3,26,10,5,10,7,61,38.23333155470358,-109.3526831
59574,4,21,10,7,8,9,59,38.23333155470358,-109.3524136
59575,5,35,12,7,9,9,77,38.23333155470358,-109.3521441
59576,2,32,11,5,9,10,69,38.23333155470358,-109.3518746
59577,6,34,12,9,11,6,78,38.23333155470358,-109.3516051
59578,23,28,14,13,12,1,91,38.23333155470358,-109.3513356
59579,12,41,13,11,13,0,90,38.23306206011834,-109.4068515
59580,9,41,13,12,13,0,88,38.23306206011834,-109.406582
59581,8,44,13,11,13,0,89,38.23306206011834,-109.4063125
59582,7,48,13,11,13,1,93,38.23306206011834,-109.406043
59583,7,48,13,11,13,1,93,38.23306206011834,-109.4057735
59584,8,47,13,11,14,1,94,38.23306206011834,-109.405504
59585,9,47,12,10,13,1,92,38.23306206011834,-109.4052345
59586,9,48,12,10,13,1,93,38.23306206011834,-109.4049651
59587,7,49,12,10,13,1,92,38.23306206011834,-109.4046956
59588,6,50,12,8,13,1,90,38.23306206011834,-109.4044261
59589,5,49,11,7,13,2,87,38.23306206011834,-109.4041566
59590,5,50,11,7,13,2,88,38.23306206011834,-109.4038871
59591,4,53,9,6,13,1,86,38.23306206011834,-109.4036176
59592,4,52,10,6,15,0,87,38.23306206011834,-109.4033481
59593,4,52,10,6,15,0,87,38.23306206011834,-109.4030786
59594,4,52,10,6,14,1,87,38.23306206011834,-109.4028091
59595,5,51,11,8,14,1,90,38.23306206011834,-109.4025396
59596,8,51,12,8,14,0,93,38.23306206011834,-109.4022701
59597,8,48,13,9,14,0,92,38.23306206011834,-109.4020006
59598,10,44,14,10,15,0,93,38.23306206011834,-109.4017311
59599,10,43,14,11,15,0,93,38.23306206011834,-109.4014616
59600,11,44,14,10,14,0,93,38.23306206011834,-109.4011921
59601,13,42,15,12,12,0,94,38.23306206011834,-109.4009226
59602,12,43,14,12,13,0,94,38.23306206011834,-109.4006531
59603,14,42,14,11,14,0,95,38.23306206011834,-109.4003836
59604,20,40,14,9,12,0,95,38.23306206011834,-109.4001142
59605,20,39,14,9,12,0,94,38.23306206011834,-109.3998447
59606,23,38,14,9,11,0,95,38.23306206011834,-109.3995752
59607,21,38,14,10,12,0,95,38.23306206011834,-109.3993057
59608,18,39,14,10,12,0,93,38.23306206011834,-109.3990362
59609,17,39,13,11,13,0,93,38.23306206011834,-109.3987667
59610,17,39,13,10,13,0,92,38.23306206011834,-109.3984972
59611,16,40,13,10,13,0,92,38.23306206011834,-109.3982277
59612,14,41,13,10,13,0,91,38.23306206011834,-109.3979582
59613,13,43,13,10,13,0,92,38.23306206011834,-109.3976887
59614,13,44,13,9,13,0,92,38.23306206011834,-109.3974192
59615,13,46,13,9,13,0,94,38.23306206011834,-109.3971497
59616,13,45,13,10,13,0,94,38.23306206011834,-109.3968802
59617,17,42,13,9,12,0,93,38.23306206011834,-109.3966107
59618,22,38,13,9,11,0,93,38.23306206011834,-109.3963412
59619,19,40,13,9,12,0,93,38.23306206011834,-109.3960717
59620,17,42,13,9,12,0,93,38.23306206011834,-109.3958022
59621,16,44,13,9,11,0,93,38.23306206011834,-109.3955327
59622,16,45,13,9,11,0,94,38.23306206011834,-109.3952632
59623,16,43,14,10,11,0,94,38.23306206011834,-109.3949938
59624,15,44,13,10,12,0,94,38.23306206011834,-109.3947243
59625,14,45,13,9,12,0,93,38.23306206011834,-109.3944548
59626,14,45,13,9,12,0,93,38.23306206011834,-109.3941853
59627,13,45,14,10,12,0,94,38.23306206011834,-109.3939158
59628,12,46,14,10,12,0,94,38.23306206011834,-109.3936463
59629,16,43,13,10,12,0,94,38.23306206011834,-109.3933768
59630,16,41,13,10,12,0,92,38.23306206011834,-109.3931073
59631,14,44,13,10,12,0,93,38.23306206011834,-109.3928378
59632,9,50,13,8,12,1,93,38.23306206011834,-109.3925683
59633,6,49,12,8,12,2,89,38.23306206011834,-109.3922988
59634,9,47,13,9,12,1,91,38.23306206011834,-109.3920293
59635,11,46,13,9,12,1,92,38.23306206011834,-109.3917598
59636,12,42,12,10,13,0,89,38.23306206011834,-109.3914903
59637,11,42,12,9,14,1,89,38.23306206011834,-109.3912208
59638,10,48,12,8,14,1,93,38.23306206011834,-109.3909513
59639,8,46,13,9,13,1,90,38.23306206011834,-109.3906818
59640,7,43,13,9,14,2,88,38.23306206011834,-109.3904123
59641,7,41,13,9,14,2,86,38.23306206011834,-109.3901429
59642,7,42,14,9,13,2,87,38.23306206011834,-109.3898734
59643,10,41,14,10,12,1,88,38.23306206011834,-109.3896039
59644,12,42,14,9,12,1,90,38.23306206011834,-109.3893344
59645,12,41,14,9,12,1,89,38.23306206011834,-109.3890649
59646,10,38,14,10,11,2,85,38.23306206011834,-109.3887954
59647,14,37,15,11,11,1,89,38.23306206011834,-109.3885259
59648,14,37,14,10,11,2,88,38.23306206011834,-109.3882564
59649,13,40,14,9,11,1,88,38.23306206011834,-109.3879869
59650,13,41,14,9,12,1,90,38.23306206011834,-109.3877174
59651,11,40,14,9,13,1,88,38.23306206011834,-109.3874479
59652,11,44,13,8,13,1,90,38.23306206011834,-109.3871784
59653,7,50,12,6,14,1,90,38.23306206011834,-109.3869089
59654,4,53,10,4,13,1,85,38.23306206011834,-109.3866394
59655,3,50,9,5,12,2,81,38.23306206011834,-109.3863699
59656,4,47,10,7,12,3,83,38.23306206011834,-109.3861004
59657,5,51,10,7,12,1,86,38.23306206011834,-109.3858309
59658,5,51,10,8,13,1,88,38.23306206011834,-109.3855614
59659,5,49,11,7,14,1,87,38.23306206011834,-109.3852919
59660,7,47,12,7,16,0,89,38.23306206011834,-109.3850225
59661,9,44,12,10,14,1,90,38.23306206011834,-109.384753
59662,13,39,12,11,15,0,90,38.23306206011834,-109.3844835
59663,15,36,13,11,15,1,91,38.23306206011834,-109.384214
59664,15,36,13,12,15,1,92,38.23306206011834,-109.3839445
59665,11,37,13,14,14,1,90,38.23306206011834,-109.383675
59666,9,42,14,14,14,1,94,38.23306206011834,-109.3834055
59667,8,42,14,13,14,1,92,38.23306206011834,-109.383136
59668,8,41,14,13,14,1,91,38.23306206011834,-109.3828665
59669,7,38,14,12,13,2,86,38.23306206011834,-109.382597
59670,8,37,14,11,12,3,85,38.23306206011834,-109.3823275
59671,9,38,14,12,13,2,88,38.23306206011834,-109.382058
59672,9,40,14,12,13,1,89,38.23306206011834,-109.3817885
59673,8,41,13,12,13,1,88,38.23306206011834,-109.381519
59674,8,41,13,12,13,1,88,38.23306206011834,-109.3812495
59675,6,40,13,12,12,2,85,38.23306206011834,-109.38098
59676,6,41,13,10,11,2,83,38.23306206011834,-109.3807105
59677,6,41,13,11,12,2,85,38.23306206011834,-109.380441
59678,6,41,13,12,12,2,86,38.23306206011834,-109.3801716
59679,7,41,14,13,13,1,89,38.23306206011834,-109.3799021
59680,9,43,14,13,13,1,93,38.23306206011834,-109.3796326
59681,7,44,13,12,13,1,90,38.23306206011834,-109.3793631
59682,6,43,13,12,13,1,88,38.23306206011834,-109.3790936
59683,5,42,14,14,14,1,90,38.23306206011834,-109.3788241
59684,8,37,14,17,14,0,90,38.23306206011834,-109.3785546
59685,9,21,11,19,13,1,74,38.23306206011834,-109.3782851
59686,12,20,11,19,15,0,77,38.23306206011834,-109.3780156
59687,15,26,13,15,14,1,84,38.23306206011834,-109.3777461
59688,12,35,14,12,16,0,89,38.23306206011834,-109.3774766
59689,9,41,14,12,16,0,92,38.23306206011834,-109.3772071
59690,6,44,13,10,14,1,88,38.23306206011834,-109.3769376
59691,3,43,11,5,13,3,78,38.23306206011834,-109.3766681
59692,1,43,9,3,12,5,73,38.23306206011834,-109.3763986
59693,2,45,9,4,13,3,76,38.23306206011834,-109.3761291
59694,4,50,9,7,12,1,83,38.23306206011834,-109.3758596
59695,6,50,10,10,12,1,89,38.23306206011834,-109.3755901
59696,10,47,11,12,12,1,93,38.23306206011834,-109.3753206
59697,16,39,12,11,12,1,91,38.23306206011834,-109.3750512
59698,10,43,13,13,14,1,94,38.23306206011834,-109.3747817
59699,9,43,14,12,15,1,94,38.23306206011834,-109.3745122
59700,9,43,14,9,17,1,93,38.23306206011834,-109.3742427
59701,5,45,12,4,18,3,87,38.23306206011834,-109.3739732
59702,2,44,10,1,16,5,78,38.23306206011834,-109.3737037
59703,1,43,10,2,16,4,76,38.23306206011834,-109.3734342
59704,1,38,10,1,15,6,71,38.23306206011834,-109.3731647
59705,2,35,10,3,15,7,72,38.23306206011834,-109.3728952
59706,3,34,11,4,15,6,73,38.23306206011834,-109.3726257
59707,6,35,12,6,16,4,79,38.23306206011834,-109.3723562
59708,8,40,13,8,16,2,87,38.23306206011834,-109.3720867
59709,8,41,14,9,16,1,89,38.23306206011834,-109.3718172
59710,9,41,14,10,17,1,92,38.23306206011834,-109.3715477
59711,8,42,13,10,17,1,91,38.23306206011834,-109.3712782
59712,8,43,13,9,16,1,90,38.23306206011834,-109.3710087
59713,9,42,13,10,15,1,90,38.23306206011834,-109.3707392
59714,8,40,13,11,14,1,87,38.23306206011834,-109.3704697
59715,7,42,13,11,14,1,88,38.23306206011834,-109.3702003
59716,7,45,13,10,14,0,89,38.23306206011834,-109.3699308
59717,8,45,12,8,15,1,89,38.23306206011834,-109.3696613
59718,6,45,13,10,15,1,90,38.23306206011834,-109.3693918
59719,6,46,13,8,15,1,89,38.23306206011834,-109.3691223
59720,6,48,12,7,15,1,89,38.23306206011834,-109.3688528
59721,7,49,12,7,14,0,89,38.23306206011834,-109.3685833
59722,6,48,10,7,12,1,84,38.23306206011834,-109.3683138
59723,3,47,9,5,12,3,79,38.23306206011834,-109.3680443
59724,2,50,8,2,11,3,76,38.23306206011834,-109.3677748
59725,1,54,7,1,9,3,75,38.23306206011834,-109.3675053
59726,0,53,6,1,9,3,72,38.23306206011834,-109.3672358
59727,3,52,10,6,13,1,85,38.23306206011834,-109.3669663
59728,3,45,11,2,14,6,81,38.23306206011834,-109.3666968
59729,3,38,11,0,10,12,74,38.23306206011834,-109.3664273
59730,1,43,9,0,11,9,73,38.23306206011834,-109.3661578
59731,1,49,8,2,11,4,75,38.23306206011834,-109.3658883
59732,1,59,7,2,10,2,81,38.23306206011834,-109.3656188
59733,1,52,8,2,11,4,78,38.23306206011834,-109.3653493
59734,2,42,9,4,11,5,73,38.23306206011834,-109.3650799
59735,6,27,10,6,10,6,65,38.23306206011834,-109.3648104
59736,4,31,10,7,9,7,68,38.23306206011834,-109.3645409
59737,2,38,9,3,10,7,69,38.23306206011834,-109.3642714
59738,3,36,9,5,12,5,70,38.23306206011834,-109.3640019
59739,4,33,9,5,11,5,67,38.23306206011834,-109.3637324
59740,4,35,9,5,9,6,68,38.23306206011834,-109.3634629
59741,10,35,12,11,12,4,84,38.23306206011834,-109.3631934
59742,17,34,11,8,10,1,81,38.23306206011834,-109.3629239
59743,18,34,11,6,9,1,79,38.23306206011834,-109.3626544
59744,15,35,13,10,12,3,88,38.23306206011834,-109.3623849
59745,13,26,13,13,13,4,82,38.23306206011834,-109.3621154
59746,7,20,12,8,8,10,65,38.23306206011834,-109.3618459
59747,5,25,10,8,11,7,66,38.23306206011834,-109.3615764
59748,2,30,8,5,11,6,62,38.23306206011834,-109.3613069
59749,2,34,7,4,10,4,61,38.23306206011834,-109.3610374
59750,3,39,8,4,10,3,67,38.23306206011834,-109.3607679
59751,3,35,9,4,11,4,66,38.23306206011834,-109.3604984
59752,3,29,10,7,9,7,65,38.23306206011834,-109.360229
59753,3,29,11,8,9,8,68,38.23306206011834,-109.3599595
59754,4,29,10,8,9,8,68,38.23306206011834,-109.35969
59755,16,30,13,13,12,2,86,38.23306206011834,-109.3594205
59756,19,16,9,16,6,1,67,38.23306206011834,-109.359151
59757,23,12,8,15,4,2,64,38.23306206011834,-109.3588815
59758,25,13,8,14,4,2,66,38.23306206011834,-109.358612
59759,29,11,7,13,3,1,64,38.23306206011834,-109.3583425
59760,30,10,8,16,4,1,69,38.23306206011834,-109.358073
59761,33,11,7,16,3,0,70,38.23306206011834,-109.3578035
59762,33,11,6,13,2,0,65,38.23306206011834,-109.357534
59763,28,11,6,12,2,0,59,38.23306206011834,-109.3572645
59764,31,13,7,16,3,1,71,38.23306206011834,-109.356995
59765,39,15,9,19,8,0,90,38.23306206011834,-109.3567255
59766,26,19,10,22,13,1,91,38.23306206011834,-109.356456
59767,10,22,12,20,14,6,84,38.23306206011834,-109.3561865
59768,4,20,12,10,9,14,69,38.23306206011834,-109.355917
59769,2,24,12,7,8,13,66,38.23306206011834,-109.3556475
59770,3,29,11,7,10,9,69,38.23306206011834,-109.355378
59771,4,27,11,9,11,7,69,38.23306206011834,-109.3551086
59772,6,26,11,10,13,6,72,38.23306206011834,-109.3548391
59773,5,27,11,9,10,7,69,38.23306206011834,-109.3545696
59774,5,31,11,10,10,6,73,38.23306206011834,-109.3543001
59775,6,29,12,11,10,7,75,38.23306206011834,-109.3540306
59776,3,29,11,8,8,10,69,38.23306206011834,-109.3537611
59777,1,36,10,1,6,14,68,38.23306206011834,-109.3534916
59778,2,35,10,6,11,5,69,38.23306206011834,-109.3532221
59779,4,29,10,7,11,6,67,38.23306206011834,-109.3529526
59780,7,24,11,11,13,5,71,38.23306206011834,-109.3526831
59781,14,23,12,15,13,4,81,38.23306206011834,-109.3524136
59782,21,29,14,16,12,1,93,38.23306206011834,-109.3521441
59783,14,32,13,14,13,2,88,38.23306206011834,-109.3518746
59784,17,30,14,15,14,2,92,38.23306206011834,-109.3516051
59785,27,21,11,19,13,1,92,38.23306206011834,-109.3513356
59786,13,44,14,10,12,0,93,38.23279256553311,-109.4068515
59787,12,43,14,12,12,0,93,38.23279256553311,-109.406582
59788,11,43,15,13,13,0,95,38.23279256553311,-109.4063125
59789,8,45,14,12,14,1,94,38.23279256553311,-109.406043
59790,8,45,14,12,14,1,94,38.23279256553311,-109.4057735
59791,11,44,13,10,13,1,92,38.23279256553311,-109.405504
59792,13,44,13,9,12,1,92,38.23279256553311,-109.4052345
59793,9,45,12,10,12,1,89,38.23279256553311,-109.4049651
59794,9,47,12,10,11,1,90,38.23279256553311,-109.4046956
59795,8,46,12,9,12,2,89,38.23279256553311,-109.4044261
59796,7,45,12,9,12,2,87,38.23279256553311,-109.4041566
59797,6,45,12,10,13,1,87,38.23279256553311,-109.4038871
59798,6,50,12,8,14,1,91,38.23279256553311,-109.4036176
59799,6,52,11,8,15,0,92,38.23279256553311,-109.4033481
59800,4,54,10,6,14,0,88,38.23279256553311,-109.4030786
59801,4,54,10,6,13,1,88,38.23279256553311,-109.4028091
59802,4,53,10,6,13,1,87,38.23279256553311,-109.4025396
59803,4,53,10,7,14,0,88,38.23279256553311,-109.4022701
59804,5,52,10,7,14,0,88,38.23279256553311,-109.4020006
59805,6,50,12,7,15,0,90,38.23279256553311,-109.4017311
59806,7,48,13,9,16,0,93,38.23279256553311,-109.4014616
59807,10,45,14,11,14,0,94,38.23279256553311,-109.4011921
59808,10,45,15,12,13,0,95,38.23279256553311,-109.4009226
59809,11,45,14,11,13,0,94,38.23279256553311,-109.4006531
59810,13,44,14,11,13,0,95,38.23279256553311,-109.4003836
59811,16,42,14,10,13,0,95,38.23279256553311,-109.4001142
59812,18,40,14,10,13,0,95,38.23279256553311,-109.3998447
59813,19,40,14,10,12,0,95,38.23279256553311,-109.3995752
59814,20,39,14,10,12,0,95,38.23279256553311,-109.3993057
59815,20,38,14,10,12,0,94,38.23279256553311,-109.3990362
59816,22,36,14,11,12,0,95,38.23279256553311,-109.3987667
59817,19,37,14,12,12,0,94,38.23279256553311,-109.3984972
59818,17,38,14,12,12,0,93,38.23279256553311,-109.3982277
59819,12,43,13,11,13,0,92,38.23279256553311,-109.3979582
59820,10,48,13,9,14,0,94,38.23279256553311,-109.3976887
59821,8,49,13,9,15,0,94,38.23279256553311,-109.3974192
59822,11,45,13,10,15,0,94,38.23279256553311,-109.3971497
59823,14,43,13,10,14,0,94,38.23279256553311,-109.3968802
59824,17,40,13,10,13,0,93,38.23279256553311,-109.3966107
59825,20,39,13,9,12,0,93,38.23279256553311,-109.3963412
59826,15,43,13,9,13,0,93,38.23279256553311,-109.3960717
59827,14,45,13,9,12,0,93,38.23279256553311,-109.3958022
59828,14,45,13,10,12,0,94,38.23279256553311,-109.3955327
59829,15,45,13,9,12,0,94,38.23279256553311,-109.3952632
59830,14,45,13,10,12,0,94,38.23279256553311,-109.3949938
59831,13,44,13,10,12,0,92,38.23279256553311,-109.3947243
59832,13,45,14,10,12,0,94,38.23279256553311,-109.3944548
59833,12,46,14,10,12,0,94,38.23279256553311,-109.3941853
59834,11,46,14,10,12,0,93,38.23279256553311,-109.3939158
59835,12,46,14,10,12,0,94,38.23279256553311,-109.3936463
59836,18,40,14,10,11,0,93,38.23279256553311,-109.3933768
59837,20,35,14,11,11,0,91,38.23279256553311,-109.3931073
59838,16,39,14,11,11,1,92,38.23279256553311,-109.3928378
59839,10,47,13,9,12,1,92,38.23279256553311,-109.3925683
59840,6,50,12,7,12,2,89,38.23279256553311,-109.3922988
59841,7,49,13,8,11,2,90,38.23279256553311,-109.3920293
59842,9,47,12,8,12,1,89,38.23279256553311,-109.3917598
59843,10,45,12,9,13,1,90,38.23279256553311,-109.3914903
59844,9,46,12,9,13,1,90,38.23279256553311,-109.3912208
59845,8,48,12,9,13,1,91,38.23279256553311,-109.3909513
59846,7,46,12,9,13,2,89,38.23279256553311,-109.3906818
59847,6,44,13,9,13,2,87,38.23279256553311,-109.3904123
59848,7,43,13,9,13,2,87,38.23279256553311,-109.3901429
59849,7,42,13,9,13,2,86,38.23279256553311,-109.3898734
59850,11,42,14,11,12,1,91,38.23279256553311,-109.3896039
59851,13,42,14,10,12,1,92,38.23279256553311,-109.3893344
59852,12,42,14,10,12,1,91,38.23279256553311,-109.3890649
59853,10,36,14,10,11,2,83,38.23279256553311,-109.3887954
59854,15,33,15,12,10,1,86,38.23279256553311,-109.3885259
59855,14,33,14,10,11,2,84,38.23279256553311,-109.3882564
59856,15,38,14,10,11,1,89,38.23279256553311,-109.3879869
59857,15,40,14,9,12,1,91,38.23279256553311,-109.3877174
59858,12,41,14,9,13,1,90,38.23279256553311,-109.3874479
59859,13,43,13,8,12,1,90,38.23279256553311,-109.3871784
59860,8,49,12,6,14,1,90,38.23279256553311,-109.3869089
59861,5,52,11,5,14,1,88,38.23279256553311,-109.3866394
59862,4,53,10,5,13,2,87,38.23279256553311,-109.3863699
59863,5,49,12,8,13,2,89,38.23279256553311,-109.3861004
59864,7,52,10,7,14,0,90,38.23279256553311,-109.3858309
59865,4,51,10,6,15,1,87,38.23279256553311,-109.3855614
59866,5,49,11,5,16,1,87,38.23279256553311,-109.3852919
59867,6,48,11,6,16,1,88,38.23279256553311,-109.3850225
59868,5,48,10,8,12,2,85,38.23279256553311,-109.384753
59869,8,42,12,9,16,0,87,38.23279256553311,-109.3844835
59870,12,39,13,10,15,1,90,38.23279256553311,-109.384214
59871,12,40,13,11,14,1,91,38.23279256553311,-109.3839445
59872,8,43,13,11,13,1,89,38.23279256553311,-109.383675
59873,7,41,13,9,13,3,86,38.23279256553311,-109.3834055
59874,5,43,13,8,12,4,85,38.23279256553311,-109.383136
59875,5,45,13,8,12,3,86,38.23279256553311,-109.3828665
59876,6,44,13,10,11,2,86,38.23279256553311,-109.382597
59877,8,42,13,10,11,2,86,38.23279256553311,-109.3823275
59878,13,40,13,11,11,1,89,38.23279256553311,-109.382058
59879,13,40,13,11,12,1,90,38.23279256553311,-109.3817885
59880,11,40,13,11,13,1,89,38.23279256553311,-109.381519
59881,11,40,13,12,13,1,90,38.23279256553311,-109.3812495
59882,11,39,14,12,12,1,89,38.23279256553311,-109.38098
59883,10,40,14,11,11,2,88,38.23279256553311,-109.3807105
59884,8,43,13,11,11,2,88,38.23279256553311,-109.380441
59885,7,44,14,12,12,1,90,38.23279256553311,-109.3801716
59886,8,42,14,13,13,1,91,38.23279256553311,-109.3799021
59887,10,42,14,13,13,1,93,38.23279256553311,-109.3796326
59888,9,41,14,13,13,1,91,38.23279256553311,-109.3793631
59889,9,41,14,13,13,1,91,38.23279256553311,-109.3790936
59890,8,42,14,13,14,1,92,38.23279256553311,-109.3788241
59891,8,40,14,16,14,0,92,38.23279256553311,-109.3785546
59892,8,25,13,22,13,0,81,38.23279256553311,-109.3782851
59893,7,20,10,22,15,0,74,38.23279256553311,-109.3780156
59894,9,24,11,20,14,0,78,38.23279256553311,-109.3777461
59895,12,36,13,13,15,0,89,38.23279256553311,-109.3774766
59896,9,42,13,12,15,0,91,38.23279256553311,-109.3772071
59897,7,43,12,9,14,1,86,38.23279256553311,-109.3769376
59898,4,43,10,6,12,3,78,38.23279256553311,-109.3766681
59899,2,42,10,4,12,4,74,38.23279256553311,-109.3763986
59900,3,43,10,5,12,4,77,38.23279256553311,-109.3761291
59901,4,44,10,8,12,2,80,38.23279256553311,-109.3758596
59902,11,41,11,13,13,1,90,38.23279256553311,-109.3755901
59903,18,39,12,13,12,1,95,38.23279256553311,-109.3753206
59904,19,38,12,12,13,1,95,38.23279256553311,-109.3750512
59905,12,40,14,13,14,1,94,38.23279256553311,-109.3747817
59906,10,41,14,11,16,1,93,38.23279256553311,-109.3745122
59907,9,39,13,7,16,3,87,38.23279256553311,-109.3742427
59908,4,41,11,3,18,4,81,38.23279256553311,-109.3739732
59909,2,45,10,1,17,3,78,38.23279256553311,-109.3737037
59910,1,43,9,0,16,4,73,38.23279256553311,-109.3734342
59911,1,32,10,1,12,9,65,38.23279256553311,-109.3731647
59912,2,29,11,3,13,9,67,38.23279256553311,-109.3728952
59913,3,33,12,5,15,6,74,38.23279256553311,-109.3726257
59914,7,39,12,7,17,2,84,38.23279256553311,-109.3723562
59915,9,42,14,9,17,1,92,38.23279256553311,-109.3720867
59916,8,43,14,10,17,1,93,38.23279256553311,-109.3718172
59917,7,43,13,9,17,1,90,38.23279256553311,-109.3715477
59918,6,45,12,7,17,1,88,38.23279256553311,-109.3712782
59919,3,47,11,5,16,2,84,38.23279256553311,-109.3710087
59920,4,48,12,6,16,1,87,38.23279256553311,-109.3707392
59921,6,47,13,7,16,1,90,38.23279256553311,-109.3704697
59922,6,46,13,8,15,1,89,38.23279256553311,-109.3702003
59923,6,46,13,7,15,1,88,38.23279256553311,-109.3699308
59924,6,48,12,6,15,1,88,38.23279256553311,-109.3696613
59925,5,46,12,6,16,2,87,38.23279256553311,-109.3693918
59926,4,47,12,6,15,2,86,38.23279256553311,-109.3691223
59927,5,47,12,6,14,2,86,38.23279256553311,-109.3688528
59928,7,46,11,7,13,1,85,38.23279256553311,-109.3685833
59929,6,47,11,7,12,2,85,38.23279256553311,-109.3683138
59930,2,48,9,5,13,3,80,38.23279256553311,-109.3680443
59931,0,55,7,2,11,3,78,38.23279256553311,-109.3677748
59932,0,58,6,2,10,2,78,38.23279256553311,-109.3675053
59933,0,55,7,2,10,3,77,38.23279256553311,-109.3672358
59934,2,51,10,2,14,4,83,38.23279256553311,-109.3669663
59935,2,45,11,0,13,9,80,38.23279256553311,-109.3666968
59936,1,43,10,0,12,10,76,38.23279256553311,-109.3664273
59937,1,44,9,0,13,8,75,38.23279256553311,-109.3661578
59938,2,49,9,2,13,4,79,38.23279256553311,-109.3658883
59939,0,51,7,1,10,5,74,38.23279256553311,-109.3656188
59940,1,48,9,3,12,4,77,38.23279256553311,-109.3653493
59941,3,42,10,7,11,4,77,38.23279256553311,-109.3650799
59942,2,30,10,5,8,10,65,38.23279256553311,-109.3648104
59943,3,32,10,6,9,8,68,38.23279256553311,-109.3645409
59944,3,38,9,4,9,7,70,38.23279256553311,-109.3642714
59945,3,34,9,5,11,5,67,38.23279256553311,-109.3640019
59946,5,33,9,6,12,4,69,38.23279256553311,-109.3637324
59947,8,36,11,9,11,5,80,38.23279256553311,-109.3634629
59948,24,32,13,10,11,2,92,38.23279256553311,-109.3631934
59949,33,29,11,10,8,1,92,38.23279256553311,-109.3629239
59950,30,29,12,10,10,1,92,38.23279256553311,-109.3626544
59951,22,30,13,11,11,3,90,38.23279256553311,-109.3623849
59952,26,27,11,15,11,1,91,38.23279256553311,-109.3621154
59953,14,30,13,14,12,2,85,38.23279256553311,-109.3618459
59954,9,31,12,8,10,6,76,38.23279256553311,-109.3615764
59955,4,32,10,5,9,8,68,38.23279256553311,-109.3613069
59956,1,33,8,3,10,7,62,38.23279256553311,-109.3610374
59957,2,37,8,4,11,4,66,38.23279256553311,-109.3607679
59958,2,36,9,3,10,6,66,38.23279256553311,-109.3604984
59959,6,29,10,11,13,4,73,38.23279256553311,-109.360229
59960,11,26,13,16,15,3,84,38.23279256553311,-109.3599595
59961,17,26,13,14,13,2,85,38.23279256553311,-109.35969
59962,19,18,10,18,7,2,74,38.23279256553311,-109.3594205
59963,21,11,9,18,5,3,67,38.23279256553311,-109.359151
59964,26,11,6,13,3,3,62,38.23279256553311,-109.3588815
59965,32,11,6,11,2,1,63,38.23279256553311,-109.358612
59966,33,12,5,10,2,0,62,38.23279256553311,-109.3583425
59967,35,11,6,12,1,0,65,38.23279256553311,-109.358073
59968,36,11,6,15,1,0,69,38.23279256553311,-109.3578035
59969,35,12,8,18,4,2,79,38.23279256553311,-109.357534
59970,32,11,10,18,9,1,81,38.23279256553311,-109.3572645
59971,29,11,10,23,13,1,87,38.23279256553311,-109.356995
59972,14,20,11,28,14,3,90,38.23279256553311,-109.3567255
59973,5,23,12,15,11,9,75,38.23279256553311,-109.356456
59974,2,26,11,7,11,10,67,38.23279256553311,-109.3561865
59975,2,33,10,4,8,10,67,38.23279256553311,-109.355917
59976,5,34,12,9,10,7,77,38.23279256553311,-109.3556475
59977,6,35,13,12,11,4,81,38.23279256553311,-109.355378
59978,10,35,14,14,12,3,88,38.23279256553311,-109.3551086
59979,13,34,14,12,12,3,88,38.23279256553311,-109.3548391
59980,12,34,13,12,11,5,87,38.23279256553311,-109.3545696
59981,16,34,14,13,12,2,91,38.23279256553311,-109.3543001
59982,20,28,14,14,10,1,87,38.23279256553311,-109.3540306
59983,15,32,14,12,11,4,88,38.23279256553311,-109.3537611
59984,3,31,11,6,8,12,71,38.23279256553311,-109.3534916
59985,5,35,12,10,11,5,78,38.23279256553311,-109.3532221
59986,11,28,13,15,12,3,82,38.23279256553311,-109.3529526
59987,25,24,15,17,12,1,94,38.23279256553311,-109.3526831
59988,36,17,12,18,8,1,92,38.23279256553311,-109.3524136
59989,36,16,10,19,9,1,91,38.23279256553311,-109.3521441
59990,32,19,10,18,10,1,90,38.23279256553311,-109.3518746
59991,26,20,11,19,13,2,91,38.23279256553311,-109.3516051
59992,20,19,10,25,18,2,94,38.23279256553311,-109.3513356
59993,16,38,15,12,12,0,93,38.23252307094787,-109.4068515
59994,16,39,15,12,12,0,94,38.23252307094787,-109.406582
59995,10,43,14,12,14,0,93,38.23252307094787,-109.4063125
59996,8,46,13,9,14,1,91,38.23252307094787,-109.406043
59997,9,44,14,10,14,1,92,38.23252307094787,-109.4057735
59998,13,41,14,11,13,0,92,38.23252307094787,-109.405504
59999,16,40,14,10,13,0,93,38.23252307094787,-109.4052345
60000,12,43,13,10,12,1,91,38.23252307094787,-109.4049651
60001,13,43,12,10,12,1,91,38.23252307094787,-109.4046956
60002,13,42,13,11,12,1,92,38.23252307094787,-109.4044261
60003,12,42,13,11,13,1,92,38.23252307094787,-109.4041566
60004,10,44,13,12,13,1,93,38.23252307094787,-109.4038871
60005,9,46,13,11,14,1,94,38.23252307094787,-109.4036176
60006,7,46,12,10,13,1,89,38.23252307094787,-109.4033481
60007,6,46,11,9,12,1,85,38.23252307094787,-109.4030786
60008,6,48,11,7,11,2,85,38.23252307094787,-109.4028091
60009,7,50,11,7,12,1,88,38.23252307094787,-109.4025396
60010,6,51,10,7,13,0,87,38.23252307094787,-109.4022701
60011,5,51,10,6,14,0,86,38.23252307094787,-109.4020006
60012,4,51,10,6,15,0,86,38.23252307094787,-109.4017311
60013,4,50,11,8,15,0,88,38.23252307094787,-109.4014616
60014,7,48,13,10,15,0,93,38.23252307094787,-109.4011921
60015,9,47,14,10,14,0,94,38.23252307094787,-109.4009226
60016,8,46,14,11,14,0,93,38.23252307094787,-109.4006531
60017,10,45,14,11,15,0,95,38.23252307094787,-109.4003836
60018,12,43,14,11,14,0,94,38.23252307094787,-109.4001142
60019,15,42,14,11,13,0,95,38.23252307094787,-109.3998447
60020,16,41,14,10,14,0,95,38.23252307094787,-109.3995752
60021,20,39,14,10,13,0,96,38.23252307094787,-109.3993057
60022,23,36,14,10,12,0,95,38.23252307094787,-109.3990362
60023,23,35,14,11,11,0,94,38.23252307094787,-109.3987667
60024,17,37,14,13,12,0,93,38.23252307094787,-109.3984972
60025,15,42,14,11,12,0,94,38.23252307094787,-109.3982277
60026,12,47,13,10,13,0,95,38.23252307094787,-109.3979582
60027,10,50,13,8,14,0,95,38.23252307094787,-109.3976887
60028,10,48,13,9,14,0,94,38.23252307094787,-109.3974192
60029,13,42,13,11,14,0,93,38.23252307094787,-109.3971497
60030,17,40,13,10,14,0,94,38.23252307094787,-109.3968802
60031,18,39,14,10,13,0,94,38.23252307094787,-109.3966107
60032,19,39,14,10,12,0,94,38.23252307094787,-109.3963412
60033,18,41,13,10,12,0,94,38.23252307094787,-109.3960717
60034,16,42,14,11,12,0,95,38.23252307094787,-109.3958022
60035,14,43,14,11,12,0,94,38.23252307094787,-109.3955327
60036,14,43,14,11,12,0,94,38.23252307094787,-109.3952632
60037,13,44,14,11,13,0,95,38.23252307094787,-109.3949938
60038,13,44,14,11,12,0,94,38.23252307094787,-109.3947243
60039,14,45,14,10,12,0,95,38.23252307094787,-109.3944548
60040,12,46,14,11,12,0,95,38.23252307094787,-109.3941853
60041,10,46,14,11,13,0,94,38.23252307094787,-109.3939158
60042,11,46,13,10,13,0,93,38.23252307094787,-109.3936463
60043,17,40,14,10,12,0,93,38.23252307094787,-109.3933768
60044,18,37,14,11,11,0,91,38.23252307094787,-109.3931073
60045,14,40,14,11,12,1,92,38.23252307094787,-109.3928378
60046,8,45,13,9,12,1,88,38.23252307094787,-109.3925683
60047,6,49,13,7,12,2,89,38.23252307094787,-109.3922988
60048,7,49,12,8,12,2,90,38.23252307094787,-109.3920293
60049,8,49,12,8,13,1,91,38.23252307094787,-109.3917598
60050,10,47,12,9,13,0,91,38.23252307094787,-109.3914903
60051,11,46,12,10,13,0,92,38.23252307094787,-109.3912208
60052,9,48,13,10,12,1,93,38.23252307094787,-109.3909513
60053,7,45,13,10,13,2,90,38.23252307094787,-109.3906818
60054,6,44,12,9,13,2,86,38.23252307094787,-109.3904123
60055,7,44,12,10,12,2,87,38.23252307094787,-109.3901429
60056,7,43,13,10,12,2,87,38.23252307094787,-109.3898734
60057,8,43,13,11,13,2,90,38.23252307094787,-109.3896039
60058,10,45,13,9,12,1,90,38.23252307094787,-109.3893344
60059,10,44,13,9,11,1,88,38.23252307094787,-109.3890649
60060,10,40,13,10,11,2,86,38.23252307094787,-109.3887954
60061,11,38,14,10,10,2,85,38.23252307094787,-109.3885259
60062,13,39,14,10,11,2,89,38.23252307094787,-109.3882564
60063,14,40,14,10,11,1,90,38.23252307094787,-109.3879869
60064,14,41,14,10,12,1,92,38.23252307094787,-109.3877174
60065,13,42,14,10,12,1,92,38.23252307094787,-109.3874479
60066,12,45,13,9,13,1,93,38.23252307094787,-109.3871784
60067,8,49,12,6,13,1,89,38.23252307094787,-109.3869089
60068,5,51,11,5,13,1,86,38.23252307094787,-109.3866394
60069,4,51,11,6,12,2,86,38.23252307094787,-109.3863699
60070,5,45,12,8,11,4,85,38.23252307094787,-109.3861004
60071,6,50,10,8,13,1,88,38.23252307094787,-109.3858309
60072,5,50,10,6,15,1,87,38.23252307094787,-109.3855614
60073,5,49,10,7,15,1,87,38.23252307094787,-109.3852919
60074,5,48,11,8,15,1,88,38.23252307094787,-109.3850225
60075,4,50,11,5,15,1,86,38.23252307094787,-109.384753
60076,9,43,13,9,16,0,90,38.23252307094787,-109.3844835
60077,13,39,13,11,14,1,91,38.23252307094787,-109.384214
60078,13,39,14,11,14,1,92,38.23252307094787,-109.3839445
60079,12,42,14,11,14,1,94,38.23252307094787,-109.383675
60080,15,38,14,11,12,1,91,38.23252307094787,-109.3834055
60081,11,43,13,10,13,1,91,38.23252307094787,-109.383136
60082,8,44,13,9,12,2,88,38.23252307094787,-109.3828665
60083,8,43,13,9,12,2,87,38.23252307094787,-109.382597
60084,13,43,14,10,12,1,93,38.23252307094787,-109.3823275
60085,16,40,13,10,11,1,91,38.23252307094787,-109.382058
60086,14,40,13,10,12,1,90,38.23252307094787,-109.3817885
60087,13,40,13,10,12,1,89,38.23252307094787,-109.381519
60088,14,40,13,10,12,1,90,38.23252307094787,-109.3812495
60089,15,41,14,10,11,1,92,38.23252307094787,-109.38098
60090,15,40,14,10,11,1,91,38.23252307094787,-109.3807105
60091,12,42,14,10,12,1,91,38.23252307094787,-109.380441
60092,10,45,14,10,13,1,93,38.23252307094787,-109.3801716
60093,10,45,13,10,13,1,92,38.23252307094787,-109.3799021
60094,11,41,13,12,13,1,91,38.23252307094787,-109.3796326
60095,11,39,13,11,13,1,88,38.23252307094787,-109.3793631
60096,11,39,14,12,13,1,90,38.23252307094787,-109.3790936
60097,10,41,14,13,13,1,92,38.23252307094787,-109.3788241
60098,9,40,13,15,13,0,90,38.23252307094787,-109.3785546
60099,11,28,13,18,14,1,85,38.23252307094787,-109.3782851
60100,7,20,10,22,14,0,73,38.23252307094787,-109.3780156
60101,8,24,10,21,14,0,77,38.23252307094787,-109.3777461
60102,11,32,12,14,14,0,83,38.23252307094787,-109.3774766
60103,8,39,12,12,15,1,87,38.23252307094787,-109.3772071
60104,6,41,11,8,13,2,81,38.23252307094787,-109.3769376
60105,3,42,10,7,12,3,77,38.23252307094787,-109.3766681
60106,1,44,9,5,11,4,74,38.23252307094787,-109.3763986
60107,1,45,9,4,11,5,75,38.23252307094787,-109.3761291
60108,4,42,10,8,11,3,78,38.23252307094787,-109.3758596
60109,15,38,11,12,13,2,91,38.23252307094787,-109.3755901
60110,18,40,11,12,12,1,94,38.23252307094787,-109.3753206
60111,13,41,12,12,13,1,92,38.23252307094787,-109.3750512
60112,10,39,14,13,15,1,92,38.23252307094787,-109.3747817
60113,10,39,13,10,16,1,89,38.23252307094787,-109.3745122
60114,9,37,13,7,16,4,86,38.23252307094787,-109.3742427
60115,4,40,11,3,17,5,80,38.23252307094787,-109.3739732
60116,2,46,9,1,17,3,78,38.23252307094787,-109.3737037
60117,1,43,9,2,16,3,74,38.23252307094787,-109.3734342
60118,2,35,10,3,16,6,72,38.23252307094787,-109.3731647
60119,3,36,11,5,16,4,75,38.23252307094787,-109.3728952
60120,4,41,11,7,17,2,82,38.23252307094787,-109.3726257
60121,5,47,12,6,17,1,88,38.23252307094787,-109.3723562
60122,6,45,13,7,18,1,90,38.23252307094787,-109.3720867
60123,6,45,13,8,17,1,90,38.23252307094787,-109.3718172
60124,4,47,12,8,15,1,87,38.23252307094787,-109.3715477
60125,3,49,10,6,14,2,84,38.23252307094787,-109.3712782
60126,2,50,9,4,13,2,80,38.23252307094787,-109.3710087
60127,3,50,10,6,14,1,84,38.23252307094787,-109.3707392
60128,4,51,11,7,15,1,89,38.23252307094787,-109.3704697
60129,5,50,12,7,15,1,90,38.23252307094787,-109.3702003
60130,5,49,12,7,16,1,90,38.23252307094787,-109.3699308
60131,5,50,11,7,15,1,89,38.23252307094787,-109.3696613
60132,5,50,11,7,14,1,88,38.23252307094787,-109.3693918
60133,4,50,11,7,13,2,87,38.23252307094787,-109.3691223
60134,5,48,11,7,13,2,86,38.23252307094787,-109.3688528
60135,8,45,12,8,13,2,88,38.23252307094787,-109.3685833
60136,6,45,12,6,13,3,85,38.23252307094787,-109.3683138
60137,3,48,10,4,14,3,82,38.23252307094787,-109.3680443
60138,1,50,9,4,12,3,79,38.23252307094787,-109.3677748
60139,1,49,9,3,12,4,78,38.23252307094787,-109.3675053
60140,2,46,10,4,13,4,79,38.23252307094787,-109.3672358
60141,2,41,11,1,14,8,77,38.23252307094787,-109.3669663
60142,2,39,11,1,12,10,75,38.23252307094787,-109.3666968
60143,2,43,10,1,14,6,76,38.23252307094787,-109.3664273
60144,2,47,9,2,15,4,79,38.23252307094787,-109.3661578
60145,2,44,10,3,14,4,77,38.23252307094787,-109.3658883
60146,1,42,8,2,10,7,70,38.23252307094787,-109.3656188
60147,2,40,10,4,12,6,74,38.23252307094787,-109.3653493
60148,2,36,10,6,11,7,72,38.23252307094787,-109.3650799
60149,1,34,9,4,9,10,67,38.23252307094787,-109.3648104
60150,0,48,8,2,11,5,74,38.23252307094787,-109.3645409
60151,1,43,8,3,11,5,71,38.23252307094787,-109.3642714
60152,2,37,9,5,11,4,68,38.23252307094787,-109.3640019
60153,7,34,11,11,11,3,77,38.23252307094787,-109.3637324
60154,16,34,11,7,9,2,79,38.23252307094787,-109.3634629
60155,15,31,9,9,9,1,74,38.23252307094787,-109.3631934
60156,25,30,11,13,9,1,89,38.23252307094787,-109.3629239
60157,29,29,12,13,10,1,94,38.23252307094787,-109.3626544
60158,28,29,11,13,10,1,92,38.23252307094787,-109.3623849
60159,34,28,11,11,8,0,92,38.23252307094787,-109.3621154
60160,16,32,12,11,12,2,85,38.23252307094787,-109.3618459
60161,9,32,11,7,11,5,75,38.23252307094787,-109.3615764
60162,2,31,9,4,9,9,64,38.23252307094787,-109.3613069
60163,2,31,9,4,9,7,62,38.23252307094787,-109.3610374
60164,4,33,10,7,12,4,70,38.23252307094787,-109.3607679
60165,6,31,11,10,10,5,73,38.23252307094787,-109.3604984
60166,10,29,12,15,15,2,83,38.23252307094787,-109.360229
60167,17,14,11,20,9,2,73,38.23252307094787,-109.3599595
60168,24,10,10,21,6,3,74,38.23252307094787,-109.35969
60169,20,7,8,19,4,4,62,38.23252307094787,-109.3594205
60170,21,6,8,20,4,6,65,38.23252307094787,-109.359151
60171,24,5,6,18,2,4,59,38.23252307094787,-109.3588815
60172,29,7,5,10,1,2,54,38.23252307094787,-109.358612
60173,30,9,4,7,2,0,52,38.23252307094787,-109.3583425
60174,36,11,7,13,4,2,73,38.23252307094787,-109.358073
60175,40,11,9,19,9,0,88,38.23252307094787,-109.3578035
60176,26,13,10,25,18,0,92,38.23252307094787,-109.357534
60177,10,17,11,26,20,5,89,38.23252307094787,-109.3572645
60178,5,24,14,12,14,15,84,38.23252307094787,-109.356995
60179,5,25,13,7,12,13,75,38.23252307094787,-109.3567255
60180,1,27,12,5,10,13,68,38.23252307094787,-109.356456
60181,2,30,11,5,9,11,68,38.23252307094787,-109.3561865
60182,5,33,12,8,10,7,75,38.23252307094787,-109.355917
60183,15,34,14,15,12,2,92,38.23252307094787,-109.3556475
60184,21,26,12,14,8,0,81,38.23252307094787,-109.355378
60185,20,22,9,13,6,0,70,38.23252307094787,-109.3551086
60186,19,21,8,11,6,0,65,38.23252307094787,-109.3548391
60187,16,21,7,10,6,0,60,38.23252307094787,-109.3545696
60188,19,16,7,9,5,0,56,38.23252307094787,-109.3543001
60189,24,17,8,12,5,0,66,38.23252307094787,-109.3540306
60190,25,20,9,16,6,1,77,38.23252307094787,-109.3537611
60191,19,27,13,15,10,1,85,38.23252307094787,-109.3534916
60192,16,27,12,14,9,1,79,38.23252307094787,-109.3532221
60193,26,19,11,19,8,1,84,38.23252307094787,-109.3529526
60194,33,18,9,14,8,1,83,38.23252307094787,-109.3526831
60195,32,19,9,15,10,2,87,38.23252307094787,-109.3524136
60196,26,20,10,20,14,3,93,38.23252307094787,-109.3521441
60197,11,26,13,12,14,11,87,38.23252307094787,-109.3518746
60198,11,27,13,12,18,7,88,38.23252307094787,-109.3516051
60199,9,26,13,15,20,8,91,38.23252307094787,-109.3513356
60200,18,38,14,11,11,0,92,38.23225357636264,-109.4068515
60201,13,42,14,12,12,0,93,38.23225357636264,-109.406582
60202,8,46,14,11,14,0,93,38.23225357636264,-109.4063125
60203,7,45,14,11,14,1,92,38.23225357636264,-109.406043
60204,9,44,14,10,14,0,91,38.23225357636264,-109.4057735
60205,11,44,14,9,14,0,92,38.23225357636264,-109.405504
60206,11,46,13,9,13,0,92,38.23225357636264,-109.4052345
60207,10,48,13,9,12,1,93,38.23225357636264,-109.4049651
60208,13,43,13,11,13,0,93,38.23225357636264,-109.4046956
60209,16,40,13,11,13,0,93,38.23225357636264,-109.4044261
60210,15,41,13,10,13,0,92,38.23225357636264,-109.4041566
60211,12,44,13,10,13,1,93,38.23225357636264,-109.4038871
60212,11,43,13,10,14,0,91,38.23225357636264,-109.4036176
60213,9,44,13,10,13,1,90,38.23225357636264,-109.4033481
60214,8,46,12,10,13,1,90,38.23225357636264,-109.4030786
60215,6,47,12,8,13,1,87,38.23225357636264,-109.4028091
60216,6,48,12,7,13,1,87,38.23225357636264,-109.4025396
60217,8,47,12,9,13,1,90,38.23225357636264,-109.4022701
60218,6,46,11,8,14,0,85,38.23225357636264,-109.4020006
60219,4,48,11,7,15,1,86,38.23225357636264,-109.4017311
60220,5,49,10,7,15,0,86,38.23225357636264,-109.4014616
60221,9,48,12,9,14,0,92,38.23225357636264,-109.4011921
60222,9,46,14,10,15,0,94,38.23225357636264,-109.4009226
60223,9,45,14,11,15,0,94,38.23225357636264,-109.4006531
60224,10,44,13,10,15,0,92,38.23225357636264,-109.4003836
60225,12,43,14,10,14,0,93,38.23225357636264,-109.4001142
60226,16,43,14,9,12,0,94,38.23225357636264,-109.3998447
60227,16,43,13,9,12,0,93,38.23225357636264,-109.3995752
60228,20,38,14,9,12,0,93,38.23225357636264,-109.3993057
60229,24,36,14,9,12,0,95,38.23225357636264,-109.3990362
60230,23,36,14,10,12,0,95,38.23225357636264,-109.3987667
60231,15,41,14,12,13,0,95,38.23225357636264,-109.3984972
60232,13,44,14,11,13,0,95,38.23225357636264,-109.3982277
60233,13,45,13,10,13,0,94,38.23225357636264,-109.3979582
60234,13,45,13,9,14,0,94,38.23225357636264,-109.3976887
60235,13,44,13,10,14,0,94,38.23225357636264,-109.3974192
60236,15,40,13,11,14,0,93,38.23225357636264,-109.3971497
60237,16,39,13,11,13,0,92,38.23225357636264,-109.3968802
60238,18,39,14,10,12,0,93,38.23225357636264,-109.3966107
60239,20,39,14,10,11,0,94,38.23225357636264,-109.3963412
60240,21,38,14,11,11,0,95,38.23225357636264,-109.3960717
60241,19,39,14,11,11,0,94,38.23225357636264,-109.3958022
60242,15,42,14,11,12,0,94,38.23225357636264,-109.3955327
60243,12,43,14,11,13,0,93,38.23225357636264,-109.3952632
60244,13,43,14,11,12,0,93,38.23225357636264,-109.3949938
60245,14,43,14,11,12,0,94,38.23225357636264,-109.3947243
60246,15,44,14,10,12,0,95,38.23225357636264,-109.3944548
60247,12,45,14,11,12,0,94,38.23225357636264,-109.3941853
60248,9,46,14,11,13,0,93,38.23225357636264,-109.3939158
60249,10,45,14,12,12,0,93,38.23225357636264,-109.3936463
60250,15,42,14,11,12,0,94,38.23225357636264,-109.3933768
60251,14,43,14,10,12,0,93,38.23225357636264,-109.3931073
60252,10,47,13,10,13,1,94,38.23225357636264,-109.3928378
60253,6,49,12,8,14,1,90,38.23225357636264,-109.3925683
60254,6,50,12,7,13,2,90,38.23225357636264,-109.3922988
60255,6,51,12,7,13,2,91,38.23225357636264,-109.3920293
60256,9,51,11,8,13,0,92,38.23225357636264,-109.3917598
60257,12,47,12,9,13,0,93,38.23225357636264,-109.3914903
60258,12,45,13,10,13,0,93,38.23225357636264,-109.3912208
60259,12,45,13,10,12,1,93,38.23225357636264,-109.3909513
60260,8,45,13,10,13,1,90,38.23225357636264,-109.3906818
60261,7,44,13,10,13,2,89,38.23225357636264,-109.3904123
60262,7,45,13,10,12,2,89,38.23225357636264,-109.3901429
60263,7,44,13,10,12,2,88,38.23225357636264,-109.3898734
60264,7,43,13,10,13,2,88,38.23225357636264,-109.3896039
60265,8,44,13,10,12,1,88,38.23225357636264,-109.3893344
60266,9,43,13,10,12,1,88,38.23225357636264,-109.3890649
60267,10,40,14,10,11,1,86,38.23225357636264,-109.3887954
60268,12,39,14,11,11,1,88,38.23225357636264,-109.3885259
60269,16,39,14,11,11,1,92,38.23225357636264,-109.3882564
60270,16,39,14,11,11,1,92,38.23225357636264,-109.3879869
60271,15,40,14,11,12,1,93,38.23225357636264,-109.3877174
60272,15,41,14,11,12,1,94,38.23225357636264,-109.3874479
60273,13,44,13,9,13,1,93,38.23225357636264,-109.3871784
60274,9,49,12,7,13,1,91,38.23225357636264,-109.3869089
60275,6,50,11,6,13,1,87,38.23225357636264,-109.3866394
60276,5,50,11,6,13,2,87,38.23225357636264,-109.3863699
60277,5,50,12,8,12,2,89,38.23225357636264,-109.3861004
60278,5,50,11,8,12,2,88,38.23225357636264,-109.3858309
60279,4,52,10,7,13,2,88,38.23225357636264,-109.3855614
60280,5,50,10,7,15,1,88,38.23225357636264,-109.3852919
60281,7,49,10,7,15,0,88,38.23225357636264,-109.3850225
60282,7,49,12,8,15,0,91,38.23225357636264,-109.384753
60283,12,43,12,9,15,0,91,38.23225357636264,-109.3844835
60284,14,41,13,10,14,0,92,38.23225357636264,-109.384214
60285,16,39,13,11,13,1,93,38.23225357636264,-109.3839445
60286,18,36,13,11,12,1,91,38.23225357636264,-109.383675
60287,21,32,12,7,11,0,83,38.23225357636264,-109.3834055
60288,22,33,12,7,11,0,85,38.23225357636264,-109.383136
60289,20,37,13,10,11,0,91,38.23225357636264,-109.3828665
60290,17,39,13,10,11,1,91,38.23225357636264,-109.382597
60291,17,38,13,10,11,1,90,38.23225357636264,-109.3823275
60292,18,38,13,10,11,1,91,38.23225357636264,-109.382058
60293,16,39,13,10,12,1,91,38.23225357636264,-109.3817885
60294,15,40,13,10,12,1,91,38.23225357636264,-109.381519
60295,14,41,13,10,12,1,91,38.23225357636264,-109.3812495
60296,13,41,14,11,12,1,92,38.23225357636264,-109.38098
60297,17,40,14,10,11,1,93,38.23225357636264,-109.3807105
60298,16,41,13,10,11,1,92,38.23225357636264,-109.380441
60299,13,42,13,10,12,1,91,38.23225357636264,-109.3801716
60300,13,42,13,10,12,1,91,38.23225357636264,-109.3799021
60301,14,37,14,12,13,1,91,38.23225357636264,-109.3796326
60302,21,34,14,11,11,0,91,38.23225357636264,-109.3793631
60303,20,35,14,11,11,0,91,38.23225357636264,-109.3790936
60304,16,38,14,11,12,0,91,38.23225357636264,-109.3788241
60305,15,37,13,12,13,0,90,38.23225357636264,-109.3785546
60306,16,35,12,11,14,0,88,38.23225357636264,-109.3782851
60307,13,25,11,16,13,0,78,38.23225357636264,-109.3780156
60308,10,24,10,16,13,0,73,38.23225357636264,-109.3777461
60309,13,30,11,10,13,1,78,38.23225357636264,-109.3774766
60310,8,40,12,9,16,1,86,38.23225357636264,-109.3772071
60311,3,42,10,6,13,3,77,38.23225357636264,-109.3769376
60312,2,45,9,5,12,3,76,38.23225357636264,-109.3766681
60313,1,44,9,4,11,5,74,38.23225357636264,-109.3763986
60314,2,39,9,5,10,5,70,38.23225357636264,-109.3761291
60315,3,40,9,7,11,3,73,38.23225357636264,-109.3758596
60316,7,42,9,12,13,1,84,38.23225357636264,-109.3755901
60317,9,43,11,12,13,1,89,38.23225357636264,-109.3753206
60318,7,45,12,11,14,1,90,38.23225357636264,-109.3750512
60319,6,43,13,11,15,1,89,38.23225357636264,-109.3747817
60320,8,42,13,12,16,1,92,38.23225357636264,-109.3745122
60321,9,40,13,10,16,1,89,38.23225357636264,-109.3742427
60322,5,43,12,5,17,3,85,38.23225357636264,-109.3739732
60323,2,48,10,2,17,4,83,38.23225357636264,-109.3737037
60324,1,47,9,2,16,2,77,38.23225357636264,-109.3734342
60325,2,41,10,2,16,4,75,38.23225357636264,-109.3731647
60326,3,40,11,6,16,2,78,38.23225357636264,-109.3728952
60327,4,42,11,7,16,2,82,38.23225357636264,-109.3726257
60328,5,46,12,6,16,1,86,38.23225357636264,-109.3723562
60329,5,43,12,6,17,2,85,38.23225357636264,-109.3720867
60330,5,43,12,7,16,2,85,38.23225357636264,-109.3718172
60331,3,46,11,6,15,2,83,38.23225357636264,-109.3715477
60332,2,49,9,4,13,2,79,38.23225357636264,-109.3712782
60333,2,51,9,3,12,2,79,38.23225357636264,-109.3710087
60334,2,53,9,5,13,1,83,38.23225357636264,-109.3707392
60335,3,50,11,6,15,1,86,38.23225357636264,-109.3704697
60336,4,49,12,8,15,1,89,38.23225357636264,-109.3702003
60337,6,49,12,8,15,1,91,38.23225357636264,-109.3699308
60338,7,50,12,9,14,1,93,38.23225357636264,-109.3696613
60339,4,51,11,8,13,1,88,38.23225357636264,-109.3693918
60340,3,49,10,6,12,2,82,38.23225357636264,-109.3691223
60341,3,48,9,6,12,2,80,38.23225357636264,-109.3688528
60342,4,47,10,6,12,2,81,38.23225357636264,-109.3685833
60343,4,48,11,5,13,3,84,38.23225357636264,-109.3683138
60344,3,48,11,5,14,3,84,38.23225357636264,-109.3680443
60345,3,48,10,4,14,4,83,38.23225357636264,-109.3677748
60346,2,45,11,4,14,5,81,38.23225357636264,-109.3675053
60347,3,39,11,3,14,7,77,38.23225357636264,-109.3672358
60348,4,34,12,4,13,8,75,38.23225357636264,-109.3669663
60349,2,32,11,3,11,10,69,38.23225357636264,-109.3666968
60350,2,36,10,3,13,7,71,38.23225357636264,-109.3664273
60351,2,39,10,3,14,6,74,38.23225357636264,-109.3661578
60352,2,37,11,4,15,5,74,38.23225357636264,-109.3658883
60353,2,39,11,4,13,7,76,38.23225357636264,-109.3656188
60354,2,39,10,3,12,8,74,38.23225357636264,-109.3653493
60355,2,40,9,3,12,7,73,38.23225357636264,-109.3650799
60356,1,46,8,2,13,5,75,38.23225357636264,-109.3648104
60357,0,56,7,2,12,3,80,38.23225357636264,-109.3645409
60358,0,45,7,2,11,4,69,38.23225357636264,-109.3642714
60359,2,38,9,5,11,5,70,38.23225357636264,-109.3640019
60360,10,32,13,14,11,2,82,38.23225357636264,-109.3637324
60361,24,23,8,9,6,1,71,38.23225357636264,-109.3634629
60362,20,23,6,5,5,0,59,38.23225357636264,-109.3631934
60363,28,28,10,12,8,1,87,38.23225357636264,-109.3629239
60364,33,27,10,13,8,1,92,38.23225357636264,-109.3626544
60365,36,27,10,13,7,1,94,38.23225357636264,-109.3623849
60366,36,26,10,13,8,0,93,38.23225357636264,-109.3621154
60367,10,32,12,14,12,3,83,38.23225357636264,-109.3618459
60368,6,31,10,6,10,8,71,38.23225357636264,-109.3615764
60369,4,29,9,5,9,7,63,38.23225357636264,-109.3613069
60370,3,35,9,6,10,5,68,38.23225357636264,-109.3610374
60371,6,32,11,10,12,4,75,38.23225357636264,-109.3607679
60372,11,30,13,15,13,2,84,38.23225357636264,-109.3604984
60373,18,16,10,17,8,2,71,38.23225357636264,-109.360229
60374,21,10,8,17,4,2,62,38.23225357636264,-109.3599595
60375,20,7,7,16,3,2,55,38.23225357636264,-109.35969
60376,20,5,7,23,3,6,64,38.23225357636264,-109.3594205
60377,19,5,6,26,3,6,65,38.23225357636264,-109.359151
60378,24,5,6,21,3,5,64,38.23225357636264,-109.3588815
60379,29,7,6,17,5,3,67,38.23225357636264,-109.358612
60380,38,15,7,14,7,0,81,38.23225357636264,-109.3583425
60381,19,22,11,19,14,3,88,38.23225357636264,-109.358073
60382,7,23,12,12,14,9,77,38.23225357636264,-109.3578035
60383,3,22,11,10,11,12,69,38.23225357636264,-109.357534
60384,2,21,12,9,10,12,66,38.23225357636264,-109.3572645
60385,2,26,12,5,8,14,67,38.23225357636264,-109.356995
60386,2,41,11,6,16,4,80,38.23225357636264,-109.3567255
60387,2,36,10,5,13,6,72,38.23225357636264,-109.356456
60388,3,29,11,6,9,8,66,38.23225357636264,-109.3561865
60389,9,31,13,13,11,3,80,38.23225357636264,-109.355917
60390,22,26,9,12,8,1,78,38.23225357636264,-109.3556475
60391,23,17,7,10,4,0,61,38.23225357636264,-109.355378
60392,23,14,7,10,4,0,58,38.23225357636264,-109.3551086
60393,24,14,7,11,4,1,61,38.23225357636264,-109.3548391
60394,23,14,7,11,4,1,60,38.23225357636264,-109.3545696
60395,27,17,9,13,5,1,72,38.23225357636264,-109.3543001
60396,29,16,9,15,5,1,75,38.23225357636264,-109.3540306
60397,29,15,9,16,5,2,76,38.23225357636264,-109.3537611
60398,28,15,9,16,5,2,75,38.23225357636264,-109.3534916
60399,24,16,9,17,6,2,74,38.23225357636264,-109.3532221
60400,33,18,8,17,6,1,83,38.23225357636264,-109.3529526
60401,29,21,9,20,9,2,90,38.23225357636264,-109.3526831
60402,14,28,12,13,9,9,85,38.23225357636264,-109.3524136
60403,3,31,13,5,12,13,77,38.23225357636264,-109.3521441
60404,1,28,13,1,9,20,72,38.23225357636264,-109.3518746
60405,3,31,13,7,16,10,80,38.23225357636264,-109.3516051
60406,2,28,13,8,16,12,79,38.23225357636264,-109.3513356
60407,14,42,14,12,12,0,94,38.23198408,-109.4068515
60408,9,46,13,11,13,0,92,38.23198408,-109.406582
60409,6,48,13,11,13,1,92,38.23198408,-109.4063125
60410,7,47,14,12,13,1,94,38.23198408,-109.406043
60411,11,43,14,12,13,0,93,38.23198408,-109.4057735
60412,11,43,14,11,14,0,93,38.23198408,-109.405504
60413,9,45,13,9,14,0,90,38.23198408,-109.4052345
60414,10,47,13,9,13,1,93,38.23198408,-109.4049651
60415,16,42,13,10,11,0,92,38.23198408,-109.4046956
60416,15,41,13,10,13,0,92,38.23198408,-109.4044261
60417,16,39,13,11,13,0,92,38.23198408,-109.4041566
60418,19,37,14,11,13,0,94,38.23198408,-109.4038871
60419,19,38,14,10,13,0,94,38.23198408,-109.4036176
60420,12,43,13,10,12,1,91,38.23198408,-109.4033481
60421,11,45,13,10,12,1,92,38.23198408,-109.4030786
60422,10,45,13,11,13,1,93,38.23198408,-109.4028091
60423,8,47,13,10,13,1,92,38.23198408,-109.4025396
60424,10,45,13,10,14,0,92,38.23198408,-109.4022701
60425,8,44,13,9,15,0,89,38.23198408,-109.4020006
60426,5,48,12,8,15,0,88,38.23198408,-109.4017311
60427,4,50,10,7,15,0,86,38.23198408,-109.4014616
60428,4,47,10,7,15,0,83,38.23198408,-109.4011921
60429,6,46,12,9,15,0,88,38.23198408,-109.4009226
60430,8,46,13,11,14,0,92,38.23198408,-109.4006531
60431,10,45,14,11,13,0,93,38.23198408,-109.4003836
60432,12,44,14,11,12,0,93,38.23198408,-109.4001142
60433,15,41,14,11,12,0,93,38.23198408,-109.3998447
60434,18,40,13,10,12,0,93,38.23198408,-109.3995752
60435,20,38,13,9,12,0,92,38.23198408,-109.3993057
60436,20,37,14,10,12,0,93,38.23198408,-109.3990362
60437,17,39,14,10,14,0,94,38.23198408,-109.3987667
60438,15,41,14,11,14,0,95,38.23198408,-109.3984972
60439,13,42,14,11,14,0,94,38.23198408,-109.3982277
60440,12,42,13,11,14,0,92,38.23198408,-109.3979582
60441,13,43,13,10,14,0,93,38.23198408,-109.3976887
60442,12,43,13,9,14,0,91,38.23198408,-109.3974192
60443,14,40,13,11,13,0,91,38.23198408,-109.3971497
60444,14,42,13,11,13,0,93,38.23198408,-109.3968802
60445,15,42,13,10,12,0,92,38.23198408,-109.3966107
60446,17,40,14,10,12,0,93,38.23198408,-109.3963412
60447,19,38,14,11,11,0,93,38.23198408,-109.3960717
60448,16,40,14,11,11,0,92,38.23198408,-109.3958022
60449,13,42,14,12,12,0,93,38.23198408,-109.3955327
60450,12,43,14,12,13,0,94,38.23198408,-109.3952632
60451,12,44,14,11,12,0,93,38.23198408,-109.3949938
60452,16,41,14,11,12,0,94,38.23198408,-109.3947243
60453,16,42,14,10,11,0,93,38.23198408,-109.3944548
60454,13,44,14,11,12,0,94,38.23198408,-109.3941853
60455,10,45,15,12,12,0,94,38.23198408,-109.3939158
60456,12,43,15,12,12,0,94,38.23198408,-109.3936463
60457,15,42,14,10,12,0,93,38.23198408,-109.3933768
60458,14,45,13,10,13,0,95,38.23198408,-109.3931073
60459,10,48,13,9,13,0,93,38.23198408,-109.3928378
60460,7,51,13,8,15,0,94,38.23198408,-109.3925683
60461,6,50,12,8,14,1,91,38.23198408,-109.3922988
60462,6,52,12,7,13,1,91,38.23198408,-109.3920293
60463,9,50,12,8,13,0,92,38.23198408,-109.3917598
60464,12,46,12,9,13,0,92,38.23198408,-109.3914903
60465,13,44,13,11,13,0,94,38.23198408,-109.3912208
60466,11,45,13,11,13,0,93,38.23198408,-109.3909513
60467,8,44,13,11,14,1,91,38.23198408,-109.3906818
60468,8,43,13,10,13,2,89,38.23198408,-109.3904123
60469,9,44,13,11,12,1,90,38.23198408,-109.3901429
60470,10,43,14,11,13,1,92,38.23198408,-109.3898734
60471,9,42,13,11,14,1,90,38.23198408,-109.3896039
60472,11,42,13,11,13,1,91,38.23198408,-109.3893344
60473,12,41,14,11,12,1,91,38.23198408,-109.3890649
60474,14,40,14,11,12,1,92,38.23198408,-109.3887954
60475,15,40,14,11,11,1,92,38.23198408,-109.3885259
60476,16,39,14,11,11,1,92,38.23198408,-109.3882564
60477,14,40,14,11,12,1,92,38.23198408,-109.3879869
60478,14,41,14,11,12,1,93,38.23198408,-109.3877174
60479,15,41,14,10,12,1,93,38.23198408,-109.3874479
60480,12,43,13,9,13,1,91,38.23198408,-109.3871784
60481,7,50,11,6,13,1,88,38.23198408,-109.3869089
60482,6,53,10,6,13,1,89,38.23198408,-109.3866394
60483,5,53,10,5,13,1,87,38.23198408,-109.3863699
60484,5,52,11,5,12,2,87,38.23198408,-109.3861004
60485,5,49,10,7,11,3,85,38.23198408,-109.3858309
60486,7,52,11,8,11,2,91,38.23198408,-109.3855614
60487,7,51,10,6,14,0,88,38.23198408,-109.3852919
60488,6,47,10,7,16,0,86,38.23198408,-109.3850225
60489,9,45,12,10,15,0,91,38.23198408,-109.384753
60490,12,43,13,10,14,0,92,38.23198408,-109.3844835
60491,13,42,13,10,13,0,91,38.23198408,-109.384214
60492,15,41,13,10,13,0,92,38.23198408,-109.3839445
60493,18,39,13,10,12,0,92,38.23198408,-109.383675
60494,20,38,13,9,11,0,91,38.23198408,-109.3834055
60495,21,35,13,9,11,0,89,38.23198408,-109.383136
60496,23,35,13,8,11,0,90,38.23198408,-109.3828665
60497,21,36,13,10,11,0,91,38.23198408,-109.382597
60498,17,39,13,11,12,0,92,38.23198408,-109.3823275
60499,17,39,13,11,12,0,92,38.23198408,-109.382058
60500,19,38,13,10,11,0,91,38.23198408,-109.3817885
60501,18,39,13,10,11,1,92,38.23198408,-109.381519
60502,14,41,13,11,11,1,91,38.23198408,-109.3812495
60503,13,40,14,12,12,1,92,38.23198408,-109.38098
60504,19,39,14,10,10,0,92,38.23198408,-109.3807105
60505,18,39,13,10,11,0,91,38.23198408,-109.380441
60506,16,40,14,10,12,1,93,38.23198408,-109.3801716
60507,14,39,13,11,12,1,90,38.23198408,-109.3799021
60508,15,37,14,12,13,1,92,38.23198408,-109.3796326
60509,20,36,14,11,11,0,92,38.23198408,-109.3793631
60510,17,39,14,10,11,0,91,38.23198408,-109.3790936
60511,15,42,14,10,12,0,93,38.23198408,-109.3788241
60512,17,40,13,10,11,0,91,38.23198408,-109.3785546
60513,17,37,13,10,13,0,90,38.23198408,-109.3782851
60514,11,28,11,13,12,1,76,38.23198408,-109.3780156
60515,8,24,10,15,12,1,70,38.23198408,-109.3777461
60516,11,27,11,10,13,1,73,38.23198408,-109.3774766
60517,9,40,12,8,15,1,85,38.23198408,-109.3772071
60518,3,45,10,5,13,3,79,38.23198408,-109.3769376
60519,3,47,9,5,10,3,77,38.23198408,-109.3766681
60520,3,43,10,6,10,3,75,38.23198408,-109.3763986
60521,3,37,10,6,9,4,69,38.23198408,-109.3761291
60522,3,40,8,6,9,3,69,38.23198408,-109.3758596
60523,3,38,8,7,11,2,69,38.23198408,-109.3755901
60524,4,40,9,9,13,1,76,38.23198408,-109.3753206
60525,5,45,11,10,14,1,86,38.23198408,-109.3750512
60526,6,47,12,11,14,1,91,38.23198408,-109.3747817
60527,7,45,12,12,14,1,91,38.23198408,-109.3745122
60528,7,42,12,11,15,1,88,38.23198408,-109.3742427
60529,8,37,13,9,15,4,86,38.23198408,-109.3739732
60530,6,37,12,4,15,6,80,38.23198408,-109.3737037
60531,1,43,10,1,15,5,75,38.23198408,-109.3734342
60532,1,43,10,2,14,5,75,38.23198408,-109.3731647
60533,1,38,10,2,15,6,72,38.23198408,-109.3728952
60534,2,39,10,3,15,5,74,38.23198408,-109.3726257
60535,3,43,11,4,16,3,80,38.23198408,-109.3723562
60536,4,40,12,5,17,3,81,38.23198408,-109.3720867
60537,4,38,12,6,16,4,80,38.23198408,-109.3718172
60538,3,39,12,4,16,5,79,38.23198408,-109.3715477
60539,2,42,10,2,16,5,77,38.23198408,-109.3712782
60540,2,45,10,2,16,4,79,38.23198408,-109.3710087
60541,2,46,10,6,16,2,82,38.23198408,-109.3707392
60542,3,43,12,5,16,3,82,38.23198408,-109.3704697
60543,4,45,12,6,16,2,85,38.23198408,-109.3702003
60544,4,49,12,7,15,1,88,38.23198408,-109.3699308
60545,4,51,11,8,13,1,88,38.23198408,-109.3696613
60546,2,54,9,5,11,2,83,38.23198408,-109.3693918
60547,1,54,8,4,11,2,80,38.23198408,-109.3691223
60548,1,54,8,4,11,2,80,38.23198408,-109.3688528
60549,1,53,8,4,11,2,79,38.23198408,-109.3685833
60550,2,46,10,6,13,3,80,38.23198408,-109.3683138
60551,3,44,10,6,12,3,78,38.23198408,-109.3680443
60552,3,42,10,6,12,4,77,38.23198408,-109.3677748
60553,3,44,11,5,13,4,80,38.23198408,-109.3675053
60554,3,41,11,4,14,6,79,38.23198408,-109.3672358
60555,3,32,11,3,12,9,70,38.23198408,-109.3669663
60556,2,31,11,4,11,9,68,38.23198408,-109.3666968
60557,1,34,10,3,13,8,69,38.23198408,-109.3664273
60558,1,38,10,3,14,6,72,38.23198408,-109.3661578
60559,2,40,9,4,14,4,73,38.23198408,-109.3658883
60560,4,45,12,7,14,2,84,38.23198408,-109.3656188
60561,3,46,11,5,15,4,84,38.23198408,-109.3653493
60562,2,44,10,2,14,6,78,38.23198408,-109.3650799
60563,1,42,9,1,13,7,73,38.23198408,-109.3648104
60564,1,46,8,1,11,6,73,38.23198408,-109.3645409
60565,1,36,9,3,11,6,66,38.23198408,-109.3642714
60566,3,31,10,7,9,7,67,38.23198408,-109.3640019
60567,13,32,14,13,11,3,86,38.23198408,-109.3637324
60568,24,23,8,10,6,0,71,38.23198408,-109.3634629
60569,23,23,7,6,5,0,64,38.23198408,-109.3631934
60570,30,26,10,13,8,1,88,38.23198408,-109.3629239
60571,35,27,10,13,7,0,92,38.23198408,-109.3626544
60572,36,29,9,14,6,0,94,38.23198408,-109.3623849
60573,23,31,13,12,11,1,91,38.23198408,-109.3621154
60574,5,42,11,6,13,5,82,38.23198408,-109.3618459
60575,5,36,9,6,12,4,72,38.23198408,-109.3615764
60576,3,30,9,5,11,6,64,38.23198408,-109.3613069
60577,5,33,10,9,10,5,72,38.23198408,-109.3610374
60578,12,36,13,18,10,1,90,38.23198408,-109.3607679
60579,15,20,8,17,6,1,67,38.23198408,-109.3604984
60580,18,12,7,16,4,1,58,38.23198408,-109.360229
60581,21,8,7,14,3,1,54,38.23198408,-109.3599595
60582,19,5,6,15,3,2,50,38.23198408,-109.35969
60583,17,4,5,21,2,5,54,38.23198408,-109.3594205
60584,21,4,6,23,2,5,61,38.23198408,-109.359151
60585,31,7,8,23,8,6,83,38.23198408,-109.3588815
60586,30,15,10,19,12,4,90,38.23198408,-109.358612
60587,12,26,12,16,15,3,84,38.23198408,-109.3583425
60588,2,26,11,6,11,10,66,38.23198408,-109.358073
60589,1,31,10,2,9,12,65,38.23198408,-109.3578035
60590,1,36,10,3,11,9,70,38.23198408,-109.357534
60591,1,37,9,4,11,7,69,38.23198408,-109.3572645
60592,2,36,9,4,10,6,67,38.23198408,-109.356995
60593,2,37,9,4,12,4,68,38.23198408,-109.3567255
60594,5,27,10,8,10,6,66,38.23198408,-109.356456
60595,8,23,11,12,9,6,69,38.23198408,-109.3561865
60596,21,29,13,16,10,1,90,38.23198408,-109.355917
60597,25,18,8,12,5,1,69,38.23198408,-109.3556475
60598,24,16,7,10,3,0,60,38.23198408,-109.355378
60599,23,14,7,8,3,0,55,38.23198408,-109.3551086
60600,24,16,7,9,4,0,60,38.23198408,-109.3548391
60601,29,22,10,14,6,1,82,38.23198408,-109.3545696
60602,24,29,14,14,11,1,93,38.23198408,-109.3543001
60603,16,28,13,14,13,3,87,38.23198408,-109.3540306
60604,22,24,11,22,11,1,91,38.23198408,-109.3537611
60605,29,21,9,21,8,1,89,38.23198408,-109.3534916
60606,22,24,9,24,9,1,89,38.23198408,-109.3532221
60607,23,28,10,17,10,4,92,38.23198408,-109.3529526
60608,9,30,13,13,14,8,87,38.23198408,-109.3526831
60609,2,31,13,5,16,11,78,38.23198408,-109.3524136
60610,0,30,12,3,15,11,71,38.23198408,-109.3521441
60611,1,28,14,0,10,21,74,38.23198408,-109.3518746
60612,0,26,14,0,10,21,71,38.23198408,-109.3516051
60613,0,25,14,2,11,19,71,38.23198408,-109.3513356
60614,10,44,14,14,13,0,95,38.231714587192165,-109.4068515
60615,7,47,14,13,13,1,95,38.231714587192165,-109.406582
60616,6,47,13,12,12,1,91,38.231714587192165,-109.4063125
60617,9,46,14,11,13,1,94,38.231714587192165,-109.406043
60618,14,42,14,11,12,1,94,38.231714587192165,-109.4057735
60619,14,40,14,12,13,0,93,38.231714587192165,-109.405504
60620,12,40,14,13,13,0,92,38.231714587192165,-109.4052345
60621,10,42,14,12,13,1,92,38.231714587192165,-109.4049651
60622,12,42,14,11,13,0,92,38.231714587192165,-109.4046956
60623,12,41,14,11,13,0,91,38.231714587192165,-109.4044261
60624,14,40,14,11,13,0,92,38.231714587192165,-109.4041566
60625,18,37,14,11,13,0,93,38.231714587192165,-109.4038871
60626,17,38,14,10,14,0,93,38.231714587192165,-109.4036176
60627,12,42,14,10,14,1,93,38.231714587192165,-109.4033481
60628,11,44,14,10,12,1,92,38.231714587192165,-109.4030786
60629,10,45,14,11,12,1,93,38.231714587192165,-109.4028091
60630,10,44,14,12,12,1,93,38.231714587192165,-109.4025396
60631,11,44,14,11,13,1,94,38.231714587192165,-109.4022701
60632,8,45,13,9,14,1,90,38.231714587192165,-109.4020006
60633,5,50,12,7,15,0,89,38.231714587192165,-109.4017311
60634,4,52,11,5,16,0,88,38.231714587192165,-109.4014616
60635,4,51,9,3,16,0,83,38.231714587192165,-109.4011921
60636,5,50,10,6,16,0,87,38.231714587192165,-109.4009226
60637,7,49,12,8,14,0,90,38.231714587192165,-109.4006531
60638,9,47,13,9,13,0,91,38.231714587192165,-109.4003836
60639,12,45,14,9,13,0,93,38.231714587192165,-109.4001142
60640,14,42,14,11,13,0,94,38.231714587192165,-109.3998447
60641,17,41,14,10,12,0,94,38.231714587192165,-109.3995752
60642,18,39,14,10,12,0,93,38.231714587192165,-109.3993057
60643,17,39,14,10,13,0,93,38.231714587192165,-109.3990362
60644,15,41,14,11,13,0,94,38.231714587192165,-109.3987667
60645,14,40,14,11,13,0,92,38.231714587192165,-109.3984972
60646,13,40,14,12,14,0,93,38.231714587192165,-109.3982277
60647,13,40,13,11,14,0,91,38.231714587192165,-109.3979582
60648,13,41,13,10,14,0,91,38.231714587192165,-109.3976887
60649,14,41,13,9,13,0,90,38.231714587192165,-109.3974192
60650,14,40,13,10,14,0,91,38.231714587192165,-109.3971497
60651,14,43,13,9,13,0,92,38.231714587192165,-109.3968802
60652,15,42,13,9,12,0,91,38.231714587192165,-109.3966107
60653,16,40,14,11,12,0,93,38.231714587192165,-109.3963412
60654,17,38,15,12,12,0,94,38.231714587192165,-109.3960717
60655,15,40,14,12,12,0,93,38.231714587192165,-109.3958022
60656,13,42,14,12,12,0,93,38.231714587192165,-109.3955327
60657,11,43,15,12,12,0,93,38.231714587192165,-109.3952632
60658,12,43,15,11,12,0,93,38.231714587192165,-109.3949938
60659,15,41,14,11,12,0,93,38.231714587192165,-109.3947243
60660,13,43,14,11,12,0,93,38.231714587192165,-109.3944548
60661,11,44,14,12,12,0,93,38.231714587192165,-109.3941853
60662,11,43,15,12,12,0,93,38.231714587192165,-109.3939158
60663,12,44,14,11,12,0,93,38.231714587192165,-109.3936463
60664,14,45,14,9,13,0,95,38.231714587192165,-109.3933768
60665,13,46,13,9,13,0,94,38.231714587192165,-109.3931073
60666,11,46,13,10,13,0,93,38.231714587192165,-109.3928378
60667,9,48,14,10,15,0,96,38.231714587192165,-109.3925683
60668,7,48,13,9,14,1,92,38.231714587192165,-109.3922988
60669,8,49,13,8,14,1,93,38.231714587192165,-109.3920293
60670,10,48,12,9,14,0,93,38.231714587192165,-109.3917598
60671,11,46,12,9,14,0,92,38.231714587192165,-109.3914903
60672,12,46,13,10,13,0,94,38.231714587192165,-109.3912208
60673,10,46,13,10,14,1,94,38.231714587192165,-109.3909513
60674,8,45,13,11,14,1,92,38.231714587192165,-109.3906818
60675,9,43,13,11,13,1,90,38.231714587192165,-109.3904123
60676,12,42,14,11,12,1,92,38.231714587192165,-109.3901429
60677,14,40,14,12,13,1,94,38.231714587192165,-109.3898734
60678,12,41,14,12,13,1,93,38.231714587192165,-109.3896039
60679,14,40,14,12,13,1,94,38.231714587192165,-109.3893344
60680,15,39,14,12,12,1,93,38.231714587192165,-109.3890649
60681,16,39,14,12,12,0,93,38.231714587192165,-109.3887954
60682,16,41,14,11,11,0,93,38.231714587192165,-109.3885259
60683,15,40,14,11,12,0,92,38.231714587192165,-109.3882564
60684,15,39,14,11,12,0,91,38.231714587192165,-109.3879869
60685,16,40,14,10,12,0,92,38.231714587192165,-109.3877174
60686,14,42,14,10,12,1,93,38.231714587192165,-109.3874479
60687,9,48,13,8,14,1,93,38.231714587192165,-109.3871784
60688,7,51,11,7,13,1,90,38.231714587192165,-109.3869089
60689,7,53,11,7,13,1,92,38.231714587192165,-109.3866394
60690,6,53,10,6,13,1,89,38.231714587192165,-109.3863699
60691,5,53,10,7,12,1,88,38.231714587192165,-109.3861004
60692,6,50,11,8,12,2,89,38.231714587192165,-109.3858309
60693,9,51,11,8,13,0,92,38.231714587192165,-109.3855614
60694,10,49,11,8,14,0,92,38.231714587192165,-109.3852919
60695,10,46,11,9,14,0,90,38.231714587192165,-109.3850225
60696,11,45,12,9,14,0,91,38.231714587192165,-109.384753
60697,11,45,13,9,13,0,91,38.231714587192165,-109.3844835
60698,14,44,13,9,12,0,92,38.231714587192165,-109.384214
60699,16,42,13,9,12,0,92,38.231714587192165,-109.3839445
60700,16,42,13,9,12,0,92,38.231714587192165,-109.383675
60701,12,43,13,11,14,0,93,38.231714587192165,-109.3834055
60702,13,43,13,10,14,0,93,38.231714587192165,-109.383136
60703,17,41,13,10,12,0,93,38.231714587192165,-109.3828665
60704,18,39,13,11,11,0,92,38.231714587192165,-109.382597
60705,14,41,13,12,12,1,93,38.231714587192165,-109.3823275
60706,16,40,13,11,11,0,91,38.231714587192165,-109.382058
60707,17,39,13,11,12,1,93,38.231714587192165,-109.3817885
60708,14,41,13,11,12,1,92,38.231714587192165,-109.381519
60709,13,41,14,11,12,1,92,38.231714587192165,-109.3812495
60710,14,40,14,11,11,1,91,38.231714587192165,-109.38098
60711,19,38,14,10,10,0,91,38.231714587192165,-109.3807105
60712,18,39,14,10,10,1,92,38.231714587192165,-109.380441
60713,15,40,14,10,11,1,91,38.231714587192165,-109.3801716
60714,13,40,14,11,13,1,92,38.231714587192165,-109.3799021
60715,11,38,13,11,14,1,88,38.231714587192165,-109.3796326
60716,14,40,13,11,13,1,92,38.231714587192165,-109.3793631
60717,15,41,13,10,12,0,91,38.231714587192165,-109.3790936
60718,15,42,13,9,12,0,91,38.231714587192165,-109.3788241
60719,16,40,13,10,12,0,91,38.231714587192165,-109.3785546
60720,17,36,13,9,13,0,88,38.231714587192165,-109.3782851
60721,14,33,12,10,12,1,82,38.231714587192165,-109.3780156
60722,8,23,10,13,11,1,66,38.231714587192165,-109.3777461
60723,9,24,10,11,12,1,67,38.231714587192165,-109.3774766
60724,10,38,12,8,14,2,84,38.231714587192165,-109.3772071
60725,3,47,10,3,15,3,81,38.231714587192165,-109.3769376
60726,3,49,10,6,12,3,83,38.231714587192165,-109.3766681
60727,4,44,10,7,11,3,79,38.231714587192165,-109.3763986
60728,3,38,10,7,10,4,72,38.231714587192165,-109.3761291
60729,3,38,9,4,9,4,67,38.231714587192165,-109.3758596
60730,3,34,9,6,10,5,67,38.231714587192165,-109.3755901
60731,3,33,9,8,13,4,70,38.231714587192165,-109.3753206
60732,5,37,10,10,15,2,79,38.231714587192165,-109.3750512
60733,6,41,11,11,14,1,84,38.231714587192165,-109.3747817
60734,5,39,10,9,12,2,77,38.231714587192165,-109.3745122
60735,5,40,11,8,14,3,81,38.231714587192165,-109.3742427
60736,8,38,12,9,14,3,84,38.231714587192165,-109.3739732
60737,10,36,12,7,14,4,83,38.231714587192165,-109.3737037
60738,4,40,11,5,16,3,79,38.231714587192165,-109.3734342
60739,2,43,10,3,14,4,76,38.231714587192165,-109.3731647
60740,1,35,10,1,13,7,67,38.231714587192165,-109.3728952
60741,2,34,10,1,13,8,68,38.231714587192165,-109.3726257
60742,2,40,10,2,15,6,75,38.231714587192165,-109.3723562
60743,3,39,11,3,15,7,78,38.231714587192165,-109.3720867
60744,4,34,11,4,14,7,74,38.231714587192165,-109.3718172
60745,4,33,12,5,14,7,75,38.231714587192165,-109.3715477
60746,4,35,11,4,14,7,75,38.231714587192165,-109.3712782
60747,2,40,10,2,14,7,75,38.231714587192165,-109.3710087
60748,3,43,10,7,14,2,79,38.231714587192165,-109.3707392
60749,3,39,12,6,16,3,79,38.231714587192165,-109.3704697
60750,3,41,11,4,16,5,80,38.231714587192165,-109.3702003
60751,2,45,10,3,15,4,79,38.231714587192165,-109.3699308
60752,1,52,9,4,12,2,80,38.231714587192165,-109.3696613
60753,1,55,7,4,10,2,79,38.231714587192165,-109.3693918
60754,1,58,7,3,10,1,80,38.231714587192165,-109.3691223
60755,1,58,7,3,10,1,80,38.231714587192165,-109.3688528
60756,1,54,7,3,10,2,77,38.231714587192165,-109.3685833
60757,1,49,9,4,13,3,79,38.231714587192165,-109.3683138
60758,3,45,9,6,12,3,78,38.231714587192165,-109.3680443
60759,3,43,10,6,12,4,78,38.231714587192165,-109.3677748
60760,3,43,11,6,14,4,81,38.231714587192165,-109.3675053
60761,3,39,12,4,15,6,79,38.231714587192165,-109.3672358
60762,1,24,12,4,9,14,64,38.231714587192165,-109.3669663
60763,0,24,11,3,7,16,61,38.231714587192165,-109.3666968
60764,1,29,11,2,9,12,64,38.231714587192165,-109.3664273
60765,2,38,10,3,15,5,73,38.231714587192165,-109.3661578
60766,2,41,10,6,15,2,76,38.231714587192165,-109.3658883
60767,5,44,12,9,13,2,85,38.231714587192165,-109.3656188
60768,5,45,13,7,14,3,87,38.231714587192165,-109.3653493
60769,3,43,11,2,15,7,81,38.231714587192165,-109.3650799
60770,2,37,10,1,13,10,73,38.231714587192165,-109.3648104
60771,2,37,11,3,13,7,73,38.231714587192165,-109.3645409
60772,2,31,10,6,12,6,67,38.231714587192165,-109.3642714
60773,7,20,13,12,10,8,70,38.231714587192165,-109.3640019
60774,25,19,15,17,11,3,90,38.231714587192165,-109.3637324
60775,35,18,10,20,7,1,91,38.231714587192165,-109.3634629
60776,35,24,10,12,7,0,88,38.231714587192165,-109.3631934
60777,35,25,10,12,7,0,89,38.231714587192165,-109.3629239
60778,33,28,10,12,8,0,91,38.231714587192165,-109.3626544
60779,28,31,11,12,9,0,91,38.231714587192165,-109.3623849
60780,9,41,14,12,14,1,91,38.231714587192165,-109.3621154
60781,3,41,10,5,14,4,77,38.231714587192165,-109.3618459
60782,2,36,9,5,11,6,69,38.231714587192165,-109.3615764
60783,3,35,10,6,11,6,71,38.231714587192165,-109.3613069
60784,6,36,11,12,12,3,80,38.231714587192165,-109.3610374
60785,13,25,9,14,7,0,68,38.231714587192165,-109.3607679
60786,21,14,7,14,4,1,61,38.231714587192165,-109.3604984
60787,25,13,7,14,4,1,64,38.231714587192165,-109.360229
60788,25,9,7,15,4,1,61,38.231714587192165,-109.3599595
60789,23,6,8,22,5,3,67,38.231714587192165,-109.35969
60790,17,4,6,20,3,4,54,38.231714587192165,-109.3594205
60791,26,5,6,16,3,3,59,38.231714587192165,-109.359151
60792,35,13,10,18,10,5,91,38.231714587192165,-109.3588815
60793,12,27,12,8,12,12,83,38.231714587192165,-109.358612
60794,1,24,11,6,10,11,63,38.231714587192165,-109.3583425
60795,1,36,9,3,13,7,69,38.231714587192165,-109.358073
60796,1,37,9,4,10,7,68,38.231714587192165,-109.3578035
60797,1,36,9,3,10,7,66,38.231714587192165,-109.357534
60798,2,35,9,4,10,7,67,38.231714587192165,-109.3572645
60799,2,34,9,6,10,6,67,38.231714587192165,-109.356995
60800,9,30,12,13,11,3,78,38.231714587192165,-109.3567255
60801,27,27,13,15,8,1,91,38.231714587192165,-109.356456
60802,34,21,11,16,6,1,89,38.231714587192165,-109.3561865
60803,30,20,9,15,5,1,80,38.231714587192165,-109.355917
60804,23,16,8,10,4,1,62,38.231714587192165,-109.3556475
60805,23,16,8,9,3,0,59,38.231714587192165,-109.355378
60806,24,16,7,8,3,0,58,38.231714587192165,-109.3551086
60807,32,19,8,9,4,0,72,38.231714587192165,-109.3548391
60808,40,24,10,11,7,1,93,38.231714587192165,-109.3545696
60809,10,30,14,12,15,5,86,38.231714587192165,-109.3543001
60810,4,29,12,8,14,8,75,38.231714587192165,-109.3540306
60811,7,31,12,12,15,4,81,38.231714587192165,-109.3537611
60812,9,31,12,17,14,2,85,38.231714587192165,-109.3534916
60813,4,31,12,16,14,4,81,38.231714587192165,-109.3532221
60814,5,31,14,11,16,6,83,38.231714587192165,-109.3529526
60815,1,29,14,3,14,14,75,38.231714587192165,-109.3526831
60816,0,27,13,1,12,17,70,38.231714587192165,-109.3524136
60817,0,31,12,0,14,15,72,38.231714587192165,-109.3521441
60818,0,31,12,0,11,16,70,38.231714587192165,-109.3518746
60819,0,29,12,0,12,16,69,38.231714587192165,-109.3516051
60820,0,30,12,0,11,15,68,38.231714587192165,-109.3513356
60821,8,45,14,15,12,1,95,38.23144509260693,-109.4068515
60822,6,47,14,13,13,1,94,38.23144509260693,-109.406582
60823,9,45,14,13,13,1,95,38.23144509260693,-109.4063125
60824,12,42,14,13,13,1,95,38.23144509260693,-109.406043
60825,16,39,14,13,12,0,94,38.23144509260693,-109.4057735
60826,16,39,14,13,12,0,94,38.23144509260693,-109.405504
60827,12,40,14,14,13,1,94,38.23144509260693,-109.4052345
60828,9,41,14,13,13,1,91,38.23144509260693,-109.4049651
60829,8,40,14,13,13,2,90,38.23144509260693,-109.4046956
60830,8,40,15,14,13,1,91,38.23144509260693,-109.4044261
60831,8,40,15,13,13,1,90,38.23144509260693,-109.4041566
60832,10,41,15,13,14,1,94,38.23144509260693,-109.4038871
60833,13,41,15,12,13,0,94,38.23144509260693,-109.4036176
60834,14,40,14,12,13,0,93,38.23144509260693,-109.4033481
60835,13,40,14,12,12,1,92,38.23144509260693,-109.4030786
60836,12,42,14,12,12,1,93,38.23144509260693,-109.4028091
60837,12,43,14,11,12,1,93,38.23144509260693,-109.4025396
60838,12,43,14,10,12,1,92,38.23144509260693,-109.4022701
60839,9,47,13,9,13,1,92,38.23144509260693,-109.4020006
60840,6,51,12,6,14,1,90,38.23144509260693,-109.4017311
60841,4,52,11,4,16,0,87,38.23144509260693,-109.4014616
60842,4,51,10,4,16,0,85,38.23144509260693,-109.4011921
60843,5,51,10,5,15,0,86,38.23144509260693,-109.4009226
60844,9,50,11,7,15,0,92,38.23144509260693,-109.4006531
60845,12,45,13,8,14,0,92,38.23144509260693,-109.4003836
60846,16,41,13,9,13,0,92,38.23144509260693,-109.4001142
60847,17,41,13,9,13,0,93,38.23144509260693,-109.3998447
60848,16,42,14,9,12,0,93,38.23144509260693,-109.3995752
60849,16,42,14,10,12,0,94,38.23144509260693,-109.3993057
60850,16,41,14,10,12,0,93,38.23144509260693,-109.3990362
60851,15,41,14,10,13,0,93,38.23144509260693,-109.3987667
60852,16,40,14,11,13,0,94,38.23144509260693,-109.3984972
60853,16,40,13,10,13,0,92,38.23144509260693,-109.3982277
60854,15,40,13,10,13,0,91,38.23144509260693,-109.3979582
60855,15,40,13,10,13,0,91,38.23144509260693,-109.3976887
60856,18,38,13,10,13,0,92,38.23144509260693,-109.3974192
60857,15,40,13,11,13,0,92,38.23144509260693,-109.3971497
60858,14,40,13,11,13,0,91,38.23144509260693,-109.3968802
60859,15,40,14,10,12,0,91,38.23144509260693,-109.3966107
60860,15,39,14,12,12,0,92,38.23144509260693,-109.3963412
60861,17,37,15,12,11,0,92,38.23144509260693,-109.3960717
60862,16,37,15,12,11,0,91,38.23144509260693,-109.3958022
60863,13,40,15,12,12,0,92,38.23144509260693,-109.3955327
60864,11,41,15,12,12,1,92,38.23144509260693,-109.3952632
60865,12,42,15,11,12,0,92,38.23144509260693,-109.3949938
60866,13,42,14,11,12,0,92,38.23144509260693,-109.3947243
60867,11,43,14,11,12,0,91,38.23144509260693,-109.3944548
60868,12,42,14,12,12,0,92,38.23144509260693,-109.3941853
60869,12,41,15,12,13,0,93,38.23144509260693,-109.3939158
60870,13,43,14,11,12,0,93,38.23144509260693,-109.3936463
60871,12,45,14,10,12,0,93,38.23144509260693,-109.3933768
60872,12,46,13,11,13,0,95,38.23144509260693,-109.3931073
60873,10,46,14,11,13,0,94,38.23144509260693,-109.3928378
60874,9,46,14,11,14,0,94,38.23144509260693,-109.3925683
60875,8,46,13,11,14,1,93,38.23144509260693,-109.3922988
60876,11,47,13,10,14,0,95,38.23144509260693,-109.3920293
60877,11,45,12,9,14,0,91,38.23144509260693,-109.3917598
60878,10,45,12,10,14,0,91,38.23144509260693,-109.3914903
60879,10,46,13,10,14,0,93,38.23144509260693,-109.3912208
60880,10,45,13,10,13,1,92,38.23144509260693,-109.3909513
60881,10,44,13,11,14,1,93,38.23144509260693,-109.3906818
60882,12,43,14,11,13,0,93,38.23144509260693,-109.3904123
60883,15,41,14,11,13,0,94,38.23144509260693,-109.3901429
60884,15,39,14,12,13,0,93,38.23144509260693,-109.3898734
60885,14,41,14,11,13,0,93,38.23144509260693,-109.3896039
60886,16,40,14,11,12,0,93,38.23144509260693,-109.3893344
60887,17,38,14,11,12,0,92,38.23144509260693,-109.3890649
60888,17,37,14,12,13,0,93,38.23144509260693,-109.3887954
60889,15,41,14,11,12,0,93,38.23144509260693,-109.3885259
60890,15,40,14,12,12,0,93,38.23144509260693,-109.3882564
60891,16,38,14,11,12,0,91,38.23144509260693,-109.3879869
60892,17,38,14,11,12,0,92,38.23144509260693,-109.3877174
60893,16,40,14,10,12,0,92,38.23144509260693,-109.3874479
60894,10,45,13,9,13,1,91,38.23144509260693,-109.3871784
60895,6,51,11,7,13,1,89,38.23144509260693,-109.3869089
60896,5,53,10,7,13,1,89,38.23144509260693,-109.3866394
60897,5,52,10,7,12,1,87,38.23144509260693,-109.3863699
60898,5,51,10,7,12,1,86,38.23144509260693,-109.3861004
60899,7,50,11,9,12,1,90,38.23144509260693,-109.3858309
60900,6,54,10,7,14,0,91,38.23144509260693,-109.3855614
60901,7,51,11,7,15,0,91,38.23144509260693,-109.3852919
60902,10,47,12,9,15,0,93,38.23144509260693,-109.3850225
60903,14,42,13,10,13,0,92,38.23144509260693,-109.384753
60904,15,42,13,10,12,0,92,38.23144509260693,-109.3844835
60905,15,41,13,10,12,0,91,38.23144509260693,-109.384214
60906,15,41,13,10,12,0,91,38.23144509260693,-109.3839445
60907,14,43,13,9,13,0,92,38.23144509260693,-109.383675
60908,12,45,13,9,14,0,93,38.23144509260693,-109.3834055
60909,12,44,13,10,14,0,93,38.23144509260693,-109.383136
60910,15,41,13,11,12,0,92,38.23144509260693,-109.3828665
60911,19,38,13,11,12,0,93,38.23144509260693,-109.382597
60912,19,38,14,11,11,0,93,38.23144509260693,-109.3823275
60913,21,37,13,10,10,0,91,38.23144509260693,-109.382058
60914,20,35,13,10,11,1,90,38.23144509260693,-109.3817885
60915,18,36,14,11,11,1,91,38.23144509260693,-109.381519
60916,18,38,14,10,11,1,92,38.23144509260693,-109.3812495
60917,21,37,14,10,10,0,92,38.23144509260693,-109.38098
60918,19,38,14,10,10,0,91,38.23144509260693,-109.3807105
60919,16,40,14,10,10,1,91,38.23144509260693,-109.380441
60920,14,41,14,11,11,1,92,38.23144509260693,-109.3801716
60921,14,42,14,11,12,0,93,38.23144509260693,-109.3799021
60922,12,40,13,11,13,1,90,38.23144509260693,-109.3796326
60923,13,43,13,10,13,0,92,38.23144509260693,-109.3793631
60924,12,44,13,9,13,1,92,38.23144509260693,-109.3790936
60925,10,45,13,9,13,1,91,38.23144509260693,-109.3788241
60926,9,45,14,10,14,0,92,38.23144509260693,-109.3785546
60927,10,40,13,11,13,1,88,38.23144509260693,-109.3782851
60928,11,38,12,8,13,1,83,38.23144509260693,-109.3780156
60929,7,25,10,11,9,2,64,38.23144509260693,-109.3777461
60930,5,23,9,12,9,2,60,38.23144509260693,-109.3774766
60931,13,33,11,7,13,2,79,38.23144509260693,-109.3772071
60932,3,46,10,3,13,4,79,38.23144509260693,-109.3769376
60933,3,49,10,3,13,3,81,38.23144509260693,-109.3766681
60934,3,47,10,5,13,3,81,38.23144509260693,-109.3763986
60935,4,42,11,5,11,4,77,38.23144509260693,-109.3761291
60936,4,39,10,4,11,5,73,38.23144509260693,-109.3758596
60937,5,36,11,7,10,5,74,38.23144509260693,-109.3755901
60938,4,33,10,8,11,6,72,38.23144509260693,-109.3753206
60939,4,35,10,8,14,4,75,38.23144509260693,-109.3750512
60940,5,37,10,8,14,2,76,38.23144509260693,-109.3747817
60941,5,34,10,8,12,4,73,38.23144509260693,-109.3745122
60942,5,38,10,7,13,3,76,38.23144509260693,-109.3742427
60943,6,44,11,7,13,3,84,38.23144509260693,-109.3739732
60944,7,45,12,8,12,3,87,38.23144509260693,-109.3737037
60945,6,43,12,5,14,4,84,38.23144509260693,-109.3734342
60946,4,43,10,2,14,4,77,38.23144509260693,-109.3731647
60947,3,36,10,2,13,6,70,38.23144509260693,-109.3728952
60948,3,35,10,2,13,7,70,38.23144509260693,-109.3726257
60949,4,40,10,2,15,5,76,38.23144509260693,-109.3723562
60950,5,44,11,3,16,4,83,38.23144509260693,-109.3720867
60951,6,38,11,5,15,4,79,38.23144509260693,-109.3718172
60952,6,36,11,5,14,5,77,38.23144509260693,-109.3715477
60953,6,36,11,6,12,6,77,38.23144509260693,-109.3712782
60954,4,37,11,4,12,7,75,38.23144509260693,-109.3710087
60955,3,41,10,6,13,2,75,38.23144509260693,-109.3707392
60956,3,41,11,5,16,3,79,38.23144509260693,-109.3704697
60957,3,42,11,4,16,4,80,38.23144509260693,-109.3702003
60958,2,42,10,5,13,4,76,38.23144509260693,-109.3699308
60959,1,49,9,4,12,3,78,38.23144509260693,-109.3696613
60960,0,54,7,4,11,1,77,38.23144509260693,-109.3693918
60961,0,59,7,3,10,1,80,38.23144509260693,-109.3691223
60962,0,55,7,3,10,1,76,38.23144509260693,-109.3688528
60963,0,49,8,3,11,3,74,38.23144509260693,-109.3685833
60964,1,45,9,4,12,4,75,38.23144509260693,-109.3683138
60965,2,45,9,5,13,4,78,38.23144509260693,-109.3680443
60966,2,44,10,4,14,4,78,38.23144509260693,-109.3677748
60967,3,42,11,4,14,6,80,38.23144509260693,-109.3675053
60968,2,34,12,3,12,11,74,38.23144509260693,-109.3672358
60969,1,24,12,2,7,17,63,38.23144509260693,-109.3669663
60970,0,25,12,2,8,16,63,38.23144509260693,-109.3666968
60971,1,29,11,2,10,12,65,38.23144509260693,-109.3664273
60972,3,39,11,4,16,5,78,38.23144509260693,-109.3661578
60973,4,43,12,8,16,1,84,38.23144509260693,-109.3658883
60974,7,44,13,11,13,1,89,38.23144509260693,-109.3656188
60975,7,42,14,11,15,1,90,38.23144509260693,-109.3653493
60976,4,42,13,8,16,2,85,38.23144509260693,-109.3650799
60977,2,41,11,4,15,5,78,38.23144509260693,-109.3648104
60978,1,46,9,1,13,5,75,38.23144509260693,-109.3645409
60979,1,35,10,5,12,6,69,38.23144509260693,-109.3642714
60980,6,26,12,9,10,8,71,38.23144509260693,-109.3640019
60981,19,28,14,11,11,5,88,38.23144509260693,-109.3637324
60982,31,22,9,20,9,1,92,38.23144509260693,-109.3634629
60983,38,23,9,15,8,0,93,38.23144509260693,-109.3631934
60984,37,26,10,14,8,0,95,38.23144509260693,-109.3629239
60985,26,34,12,12,11,0,95,38.23144509260693,-109.3626544
60986,11,41,14,12,14,1,93,38.23144509260693,-109.3623849
60987,7,41,13,10,15,1,87,38.23144509260693,-109.3621154
60988,3,32,10,6,11,7,69,38.23144509260693,-109.3618459
60989,3,34,10,5,11,6,69,38.23144509260693,-109.3615764
60990,4,38,10,8,11,4,75,38.23144509260693,-109.3613069
60991,10,38,13,15,12,1,89,38.23144509260693,-109.3610374
60992,18,18,7,13,4,0,60,38.23144509260693,-109.3607679
60993,27,13,8,16,3,1,68,38.23144509260693,-109.3604984
60994,30,11,9,18,5,1,74,38.23144509260693,-109.360229
60995,29,8,9,20,7,1,74,38.23144509260693,-109.3599595
60996,22,7,9,23,8,5,74,38.23144509260693,-109.35969
60997,23,5,8,22,5,6,69,38.23144509260693,-109.3594205
60998,33,10,10,19,7,5,84,38.23144509260693,-109.359151
60999,21,22,12,14,12,5,86,38.23144509260693,-109.3588815
61000,4,27,11,5,10,10,67,38.23144509260693,-109.358612
61001,2,37,9,6,13,4,71,38.23144509260693,-109.3583425
61002,2,41,8,4,11,5,71,38.23144509260693,-109.358073
61003,3,36,10,6,9,7,71,38.23144509260693,-109.3578035
61004,5,34,11,9,10,6,75,38.23144509260693,-109.357534
61005,9,34,12,12,10,4,81,38.23144509260693,-109.3572645
61006,17,31,13,15,10,2,88,38.23144509260693,-109.356995
61007,27,18,9,12,5,0,71,38.23144509260693,-109.3567255
61008,23,13,6,8,4,0,54,38.23144509260693,-109.356456
61009,20,12,5,4,3,0,44,38.23144509260693,-109.3561865
61010,20,13,5,5,3,0,46,38.23144509260693,-109.355917
61011,18,15,5,5,3,0,46,38.23144509260693,-109.3556475
61012,23,15,6,8,2,0,54,38.23144509260693,-109.355378
61013,38,17,8,13,2,0,78,38.23144509260693,-109.3551086
61014,37,17,8,21,8,0,91,38.23144509260693,-109.3548391
61015,19,19,11,30,11,3,93,38.23144509260693,-109.3545696
61016,3,26,13,15,17,7,81,38.23144509260693,-109.3543001
61017,2,27,13,13,16,7,78,38.23144509260693,-109.3540306
61018,2,30,13,7,16,10,78,38.23144509260693,-109.3537611
61019,2,32,13,4,15,11,77,38.23144509260693,-109.3534916
61020,2,31,12,7,15,9,76,38.23144509260693,-109.3532221
61021,1,32,13,3,15,11,75,38.23144509260693,-109.3529526
61022,0,32,12,0,15,13,72,38.23144509260693,-109.3526831
61023,0,31,12,0,12,15,70,38.23144509260693,-109.3524136
61024,0,33,11,0,11,15,70,38.23144509260693,-109.3521441
61025,1,35,10,0,13,12,71,38.23144509260693,-109.3518746
61026,1,36,11,0,14,12,74,38.23144509260693,-109.3516051
61027,1,39,11,0,14,11,76,38.23144509260693,-109.3513356
61028,7,45,14,14,13,1,94,38.23117559802169,-109.4068515
61029,7,45,13,13,13,1,92,38.23117559802169,-109.406582
61030,10,43,14,13,13,0,93,38.23117559802169,-109.4063125
61031,12,44,13,11,13,1,94,38.23117559802169,-109.406043
61032,14,41,14,12,13,0,94,38.23117559802169,-109.4057735
61033,13,40,14,13,13,0,93,38.23117559802169,-109.405504
61034,10,42,14,14,13,1,94,38.23117559802169,-109.4052345
61035,8,42,14,14,13,1,92,38.23117559802169,-109.4049651
61036,7,42,14,14,13,1,91,38.23117559802169,-109.4046956
61037,8,42,15,14,14,1,94,38.23117559802169,-109.4044261
61038,9,42,15,13,14,1,94,38.23117559802169,-109.4041566
61039,11,41,15,13,13,1,94,38.23117559802169,-109.4038871
61040,13,40,15,14,12,1,95,38.23117559802169,-109.4036176
61041,13,40,15,13,12,1,94,38.23117559802169,-109.4033481
61042,13,41,14,13,12,1,94,38.23117559802169,-109.4030786
61043,14,41,14,12,12,1,94,38.23117559802169,-109.4028091
61044,15,40,14,12,12,1,94,38.23117559802169,-109.4025396
61045,13,43,14,12,13,1,96,38.23117559802169,-109.4022701
61046,10,45,13,10,14,0,92,38.23117559802169,-109.4020006
61047,8,46,13,9,15,0,91,38.23117559802169,-109.4017311
61048,7,48,13,8,17,0,93,38.23117559802169,-109.4014616
61049,6,51,12,6,18,0,93,38.23117559802169,-109.4011921
61050,4,49,11,5,17,0,86,38.23117559802169,-109.4009226
61051,8,47,12,8,17,0,92,38.23117559802169,-109.4006531
61052,13,43,13,9,15,0,93,38.23117559802169,-109.4003836
61053,17,39,14,10,13,0,93,38.23117559802169,-109.4001142
61054,17,41,14,9,13,0,94,38.23117559802169,-109.3998447
61055,14,43,14,10,13,0,94,38.23117559802169,-109.3995752
61056,15,42,14,11,12,0,94,38.23117559802169,-109.3993057
61057,17,40,14,10,12,0,93,38.23117559802169,-109.3990362
61058,17,38,15,11,12,0,93,38.23117559802169,-109.3987667
61059,18,39,14,10,12,0,93,38.23117559802169,-109.3984972
61060,18,39,14,10,12,0,93,38.23117559802169,-109.3982277
61061,18,39,14,10,12,0,93,38.23117559802169,-109.3979582
61062,16,40,14,10,13,0,93,38.23117559802169,-109.3976887
61063,14,41,14,11,13,0,93,38.23117559802169,-109.3974192
61064,13,42,14,12,13,0,94,38.23117559802169,-109.3971497
61065,14,41,14,11,13,0,93,38.23117559802169,-109.3968802
61066,17,38,15,12,12,0,94,38.23117559802169,-109.3966107
61067,16,38,15,12,12,0,93,38.23117559802169,-109.3963412
61068,17,37,15,12,11,0,92,38.23117559802169,-109.3960717
61069,16,37,15,12,12,0,92,38.23117559802169,-109.3958022
61070,13,39,15,12,12,0,91,38.23117559802169,-109.3955327
61071,12,41,14,11,12,0,90,38.23117559802169,-109.3952632
61072,12,43,14,10,12,0,91,38.23117559802169,-109.3949938
61073,14,43,13,10,12,0,92,38.23117559802169,-109.3947243
61074,15,41,14,10,11,0,91,38.23117559802169,-109.3944548
61075,14,39,15,11,12,0,91,38.23117559802169,-109.3941853
61076,15,39,15,12,13,0,94,38.23117559802169,-109.3939158
61077,15,41,14,11,12,0,93,38.23117559802169,-109.3936463
61078,13,43,14,10,12,0,92,38.23117559802169,-109.3933768
61079,12,45,13,10,13,0,93,38.23117559802169,-109.3931073
61080,11,44,13,11,13,0,92,38.23117559802169,-109.3928378
61081,11,44,14,10,13,0,92,38.23117559802169,-109.3925683
61082,12,44,13,10,12,0,91,38.23117559802169,-109.3922988
61083,12,46,13,9,13,0,93,38.23117559802169,-109.3920293
61084,11,45,12,9,13,0,90,38.23117559802169,-109.3917598
61085,10,46,12,10,14,0,92,38.23117559802169,-109.3914903
61086,11,45,13,11,14,0,94,38.23117559802169,-109.3912208
61087,11,45,14,11,13,0,94,38.23117559802169,-109.3909513
61088,12,43,14,11,14,0,94,38.23117559802169,-109.3906818
61089,12,43,14,11,14,0,94,38.23117559802169,-109.3904123
61090,12,42,14,12,14,0,94,38.23117559802169,-109.3901429
61091,14,40,14,12,14,0,94,38.23117559802169,-109.3898734
61092,16,39,14,11,13,0,93,38.23117559802169,-109.3896039
61093,16,39,14,11,13,0,93,38.23117559802169,-109.3893344
61094,16,39,14,11,12,0,92,38.23117559802169,-109.3890649
61095,16,39,14,11,12,0,92,38.23117559802169,-109.3887954
61096,15,41,14,10,12,0,92,38.23117559802169,-109.3885259
61097,19,36,14,11,11,0,91,38.23117559802169,-109.3882564
61098,21,36,14,11,11,0,93,38.23117559802169,-109.3879869
61099,21,36,14,10,11,0,92,38.23117559802169,-109.3877174
61100,19,38,14,10,11,0,92,38.23117559802169,-109.3874479
61101,15,42,13,9,13,0,92,38.23117559802169,-109.3871784
61102,9,46,12,9,13,1,90,38.23117559802169,-109.3869089
61103,7,50,11,9,13,1,91,38.23117559802169,-109.3866394
61104,6,50,11,8,12,1,88,38.23117559802169,-109.3863699
61105,5,48,11,9,12,1,86,38.23117559802169,-109.3861004
61106,5,50,11,7,12,2,87,38.23117559802169,-109.3858309
61107,4,53,10,6,15,0,88,38.23117559802169,-109.3855614
61108,6,52,11,8,16,0,93,38.23117559802169,-109.3852919
61109,10,46,13,10,16,0,95,38.23117559802169,-109.3850225
61110,14,43,13,11,13,0,94,38.23117559802169,-109.384753
61111,17,42,13,9,12,0,93,38.23117559802169,-109.3844835
61112,16,42,13,9,12,0,92,38.23117559802169,-109.384214
61113,14,42,13,10,13,0,92,38.23117559802169,-109.3839445
61114,14,43,13,10,13,0,93,38.23117559802169,-109.383675
61115,16,42,13,9,12,0,92,38.23117559802169,-109.3834055
61116,15,42,13,9,12,0,91,38.23117559802169,-109.383136
61117,16,41,13,10,13,0,93,38.23117559802169,-109.3828665
61118,17,39,14,11,12,0,93,38.23117559802169,-109.382597
61119,19,37,13,11,11,0,91,38.23117559802169,-109.3823275
61120,21,35,13,10,11,0,90,38.23117559802169,-109.382058
61121,22,34,14,10,10,0,90,38.23117559802169,-109.3817885
61122,22,34,14,11,10,0,91,38.23117559802169,-109.381519
61123,21,36,14,11,10,0,92,38.23117559802169,-109.3812495
61124,19,38,14,10,10,0,91,38.23117559802169,-109.38098
61125,16,40,14,10,10,1,91,38.23117559802169,-109.3807105
61126,13,42,14,11,12,1,93,38.23117559802169,-109.380441
61127,11,43,13,11,12,1,91,38.23117559802169,-109.3801716
61128,11,44,13,10,12,1,91,38.23117559802169,-109.3799021
61129,11,43,13,11,13,0,91,38.23117559802169,-109.3796326
61130,12,44,13,9,13,1,92,38.23117559802169,-109.3793631
61131,11,46,13,9,13,1,93,38.23117559802169,-109.3790936
61132,8,48,13,8,13,1,91,38.23117559802169,-109.3788241
61133,6,49,13,7,13,1,89,38.23117559802169,-109.3785546
61134,5,46,13,8,13,1,86,38.23117559802169,-109.3782851
61135,7,44,12,8,13,1,85,38.23117559802169,-109.3780156
61136,6,30,9,10,9,2,66,38.23117559802169,-109.3777461
61137,4,26,8,13,8,1,60,38.23117559802169,-109.3774766
61138,9,29,11,11,11,1,72,38.23117559802169,-109.3772071
61139,4,45,10,4,14,2,79,38.23117559802169,-109.3769376
61140,4,45,11,5,13,3,81,38.23117559802169,-109.3766681
61141,5,42,11,6,12,3,79,38.23117559802169,-109.3763986
61142,6,39,11,5,11,4,76,38.23117559802169,-109.3761291
61143,4,35,10,4,9,6,68,38.23117559802169,-109.3758596
61144,7,39,12,7,10,5,80,38.23117559802169,-109.3755901
61145,6,39,11,7,11,5,79,38.23117559802169,-109.3753206
61146,4,39,9,6,12,4,74,38.23117559802169,-109.3750512
61147,4,39,9,6,13,3,74,38.23117559802169,-109.3747817
61148,7,36,10,9,13,3,78,38.23117559802169,-109.3745122
61149,6,39,10,7,13,3,78,38.23117559802169,-109.3742427
61150,6,44,11,7,13,3,84,38.23117559802169,-109.3739732
61151,6,46,12,7,13,4,88,38.23117559802169,-109.3737037
61152,7,44,12,5,13,5,86,38.23117559802169,-109.3734342
61153,3,42,10,2,15,4,76,38.23117559802169,-109.3731647
61154,3,39,10,1,13,5,71,38.23117559802169,-109.3728952
61155,3,41,10,3,13,5,75,38.23117559802169,-109.3726257
61156,5,45,10,3,14,3,80,38.23117559802169,-109.3723562
61157,5,46,11,4,16,3,85,38.23117559802169,-109.3720867
61158,7,43,11,5,15,2,83,38.23117559802169,-109.3718172
61159,9,40,12,7,14,3,85,38.23117559802169,-109.3715477
61160,10,38,12,8,13,3,84,38.23117559802169,-109.3712782
61161,10,37,12,7,13,3,82,38.23117559802169,-109.3710087
61162,4,43,10,3,15,4,79,38.23117559802169,-109.3707392
61163,4,45,10,3,15,3,80,38.23117559802169,-109.3704697
61164,4,45,11,5,15,3,83,38.23117559802169,-109.3702003
61165,4,46,11,6,13,3,83,38.23117559802169,-109.3699308
61166,2,49,9,5,12,3,80,38.23117559802169,-109.3696613
61167,1,49,8,4,12,2,76,38.23117559802169,-109.3693918
61168,1,52,8,4,11,2,78,38.23117559802169,-109.3691223
61169,0,48,8,3,11,3,73,38.23117559802169,-109.3688528
61170,1,43,9,3,12,4,72,38.23117559802169,-109.3685833
61171,2,44,10,5,11,4,76,38.23117559802169,-109.3683138
61172,2,41,10,4,13,5,75,38.23117559802169,-109.3680443
61173,2,43,10,4,13,6,78,38.23117559802169,-109.3677748
61174,2,39,11,4,13,7,76,38.23117559802169,-109.3675053
61175,2,32,11,3,10,12,70,38.23117559802169,-109.3672358
61176,1,26,12,0,6,18,63,38.23117559802169,-109.3669663
61177,1,29,11,2,10,14,67,38.23117559802169,-109.3666968
61178,2,32,11,3,13,10,71,38.23117559802169,-109.3664273
61179,3,37,11,4,15,6,76,38.23117559802169,-109.3661578
61180,3,43,12,6,17,2,83,38.23117559802169,-109.3658883
61181,5,47,13,8,16,1,90,38.23117559802169,-109.3656188
61182,5,45,14,10,16,1,91,38.23117559802169,-109.3653493
61183,4,44,13,7,16,2,86,38.23117559802169,-109.3650799
61184,1,47,9,3,13,4,77,38.23117559802169,-109.3648104
61185,0,57,7,2,10,3,79,38.23117559802169,-109.3645409
61186,1,42,9,3,10,5,70,38.23117559802169,-109.3642714
61187,4,25,11,8,10,8,66,38.23117559802169,-109.3640019
61188,17,29,14,11,11,5,87,38.23117559802169,-109.3637324
61189,31,24,10,17,10,1,93,38.23117559802169,-109.3634629
61190,36,23,10,14,7,1,91,38.23117559802169,-109.3631934
61191,35,24,11,12,11,1,94,38.23117559802169,-109.3629239
61192,15,36,13,11,15,1,91,38.23117559802169,-109.3626544
61193,7,42,13,11,16,1,90,38.23117559802169,-109.3623849
61194,7,40,13,10,16,1,87,38.23117559802169,-109.3621154
61195,5,38,11,8,14,3,79,38.23117559802169,-109.3618459
61196,4,37,10,7,12,5,75,38.23117559802169,-109.3615764
61197,8,36,12,13,11,4,84,38.23117559802169,-109.3613069
61198,14,23,9,14,8,1,69,38.23117559802169,-109.3610374
61199,24,15,7,14,4,1,65,38.23117559802169,-109.3607679
61200,30,12,9,19,5,2,77,38.23117559802169,-109.3604984
61201,30,8,9,20,7,1,75,38.23117559802169,-109.360229
61202,24,7,9,20,6,2,68,38.23117559802169,-109.3599595
61203,21,7,7,16,4,2,57,38.23117559802169,-109.35969
61204,28,6,7,18,3,3,65,38.23117559802169,-109.3594205
61205,26,16,11,16,12,5,86,38.23117559802169,-109.359151
61206,6,23,12,9,9,10,69,38.23117559802169,-109.3588815
61207,5,38,11,7,13,4,78,38.23117559802169,-109.358612
61208,6,38,11,12,12,2,81,38.23117559802169,-109.3583425
61209,10,37,13,15,12,2,89,38.23117559802169,-109.358073
61210,15,31,12,10,10,1,79,38.23117559802169,-109.3578035
61211,18,22,9,10,7,1,67,38.23117559802169,-109.357534
61212,21,16,6,8,4,0,55,38.23117559802169,-109.3572645
61213,21,12,6,8,4,0,51,38.23117559802169,-109.356995
61214,21,12,5,4,3,0,45,38.23117559802169,-109.3567255
61215,17,11,4,3,3,0,38,38.23117559802169,-109.356456
61216,15,11,4,3,3,0,36,38.23117559802169,-109.3561865
61217,17,13,4,3,2,0,39,38.23117559802169,-109.355917
61218,20,14,6,7,2,0,49,38.23117559802169,-109.3556475
61219,37,17,7,16,5,0,82,38.23117559802169,-109.355378
61220,28,15,8,31,11,1,94,38.23117559802169,-109.3551086
61221,18,15,11,32,12,2,90,38.23117559802169,-109.3548391
61222,1,24,13,25,16,3,82,38.23117559802169,-109.3545696
61223,2,28,11,20,18,1,80,38.23117559802169,-109.3543001
61224,1,29,11,7,15,7,70,38.23117559802169,-109.3540306
61225,1,31,12,0,12,15,71,38.23117559802169,-109.3537611
61226,1,33,12,0,12,15,73,38.23117559802169,-109.3534916
61227,3,35,12,2,15,10,77,38.23117559802169,-109.3532221
61228,2,34,12,2,14,11,75,38.23117559802169,-109.3529526
61229,1,34,11,1,14,11,72,38.23117559802169,-109.3526831
61230,1,36,12,0,14,12,75,38.23117559802169,-109.3524136
61231,2,38,12,0,14,11,77,38.23117559802169,-109.3521441
61232,2,40,12,2,17,6,79,38.23117559802169,-109.3518746
61233,4,43,13,2,17,5,84,38.23117559802169,-109.3516051
61234,4,47,12,3,17,4,87,38.23117559802169,-109.3513356
61235,8,43,14,16,13,1,95,38.23090610343646,-109.4068515
61236,9,44,14,14,14,1,96,38.23090610343646,-109.406582
61237,11,43,14,12,14,1,95,38.23090610343646,-109.4063125
61238,11,43,13,12,13,1,93,38.23090610343646,-109.406043
61239,12,43,13,12,13,1,94,38.23090610343646,-109.4057735
61240,9,43,14,13,14,1,94,38.23090610343646,-109.405504
61241,7,43,14,13,14,1,92,38.23090610343646,-109.4052345
61242,7,44,14,13,13,1,92,38.23090610343646,-109.4049651
61243,7,43,14,12,14,1,91,38.23090610343646,-109.4046956
61244,9,42,15,14,13,1,94,38.23090610343646,-109.4044261
61245,11,41,15,14,13,1,95,38.23090610343646,-109.4041566
61246,11,41,15,14,12,1,94,38.23090610343646,-109.4038871
61247,13,40,15,14,12,1,95,38.23090610343646,-109.4036176
61248,10,42,15,14,13,1,95,38.23090610343646,-109.4033481
61249,10,42,14,13,13,1,93,38.23090610343646,-109.4030786
61250,11,43,14,12,13,1,94,38.23090610343646,-109.4028091
61251,10,45,13,12,13,1,94,38.23090610343646,-109.4025396
61252,10,45,13,11,13,0,92,38.23090610343646,-109.4022701
61253,14,41,14,13,13,0,95,38.23090610343646,-109.4020006
61254,14,40,14,11,14,1,94,38.23090610343646,-109.4017311
61255,12,42,14,11,15,0,94,38.23090610343646,-109.4014616
61256,8,46,13,10,16,0,93,38.23090610343646,-109.4011921
61257,5,48,12,9,16,0,90,38.23090610343646,-109.4009226
61258,5,48,12,9,16,0,90,38.23090610343646,-109.4006531
61259,8,47,13,10,15,0,93,38.23090610343646,-109.4003836
61260,11,45,14,10,14,0,94,38.23090610343646,-109.4001142
61261,14,43,14,10,12,0,93,38.23090610343646,-109.3998447
61262,15,43,14,11,11,0,94,38.23090610343646,-109.3995752
61263,15,40,15,12,11,0,93,38.23090610343646,-109.3993057
61264,16,38,15,12,12,0,93,38.23090610343646,-109.3990362
61265,15,39,15,12,12,0,93,38.23090610343646,-109.3987667
61266,17,39,14,11,12,0,93,38.23090610343646,-109.3984972
61267,19,38,14,10,12,0,93,38.23090610343646,-109.3982277
61268,17,38,14,11,12,0,92,38.23090610343646,-109.3979582
61269,15,40,14,11,13,0,93,38.23090610343646,-109.3976887
61270,12,43,14,11,13,0,93,38.23090610343646,-109.3974192
61271,13,44,14,11,12,0,94,38.23090610343646,-109.3971497
61272,14,43,14,11,12,0,94,38.23090610343646,-109.3968802
61273,16,39,15,12,11,0,93,38.23090610343646,-109.3966107
61274,17,38,15,12,11,0,93,38.23090610343646,-109.3963412
61275,15,39,15,12,12,0,93,38.23090610343646,-109.3960717
61276,15,39,15,12,12,0,93,38.23090610343646,-109.3958022
61277,15,40,14,11,12,0,92,38.23090610343646,-109.3955327
61278,13,41,14,11,12,0,91,38.23090610343646,-109.3952632
61279,13,44,13,10,12,0,92,38.23090610343646,-109.3949938
61280,16,43,13,9,12,0,93,38.23090610343646,-109.3947243
61281,17,39,14,10,12,0,92,38.23090610343646,-109.3944548
61282,16,39,15,11,12,0,93,38.23090610343646,-109.3941853
61283,15,41,14,10,13,0,93,38.23090610343646,-109.3939158
61284,14,42,14,10,12,0,92,38.23090610343646,-109.3936463
61285,14,43,14,10,12,0,93,38.23090610343646,-109.3933768
61286,14,43,14,10,12,0,93,38.23090610343646,-109.3931073
61287,15,41,14,10,12,0,92,38.23090610343646,-109.3928378
61288,18,39,14,10,12,0,93,38.23090610343646,-109.3925683
61289,17,38,14,11,12,0,92,38.23090610343646,-109.3922988
61290,11,45,13,10,14,0,93,38.23090610343646,-109.3920293
61291,10,44,12,9,13,0,88,38.23090610343646,-109.3917598
61292,9,45,12,10,14,0,90,38.23090610343646,-109.3914903
61293,10,45,13,11,14,0,93,38.23090610343646,-109.3912208
61294,10,44,14,11,13,0,92,38.23090610343646,-109.3909513
61295,13,42,14,11,13,0,93,38.23090610343646,-109.3906818
61296,10,43,14,12,14,0,93,38.23090610343646,-109.3904123
61297,9,44,13,11,14,1,92,38.23090610343646,-109.3901429
61298,10,43,14,12,14,1,94,38.23090610343646,-109.3898734
61299,16,39,14,11,13,0,93,38.23090610343646,-109.3896039
61300,17,38,14,11,12,0,92,38.23090610343646,-109.3893344
61301,16,39,14,11,12,0,92,38.23090610343646,-109.3890649
61302,17,40,14,10,12,0,93,38.23090610343646,-109.3887954
61303,18,38,14,11,11,0,92,38.23090610343646,-109.3885259
61304,20,36,14,11,11,0,92,38.23090610343646,-109.3882564
61305,21,36,14,11,11,0,93,38.23090610343646,-109.3879869
61306,20,37,14,10,11,0,92,38.23090610343646,-109.3877174
61307,19,38,14,10,12,0,93,38.23090610343646,-109.3874479
61308,14,43,13,9,12,0,91,38.23090610343646,-109.3871784
61309,8,47,11,9,13,1,89,38.23090610343646,-109.3869089
61310,6,50,11,7,13,1,88,38.23090610343646,-109.3866394
61311,5,51,10,7,12,1,86,38.23090610343646,-109.3863699
61312,5,50,11,7,11,2,86,38.23090610343646,-109.3861004
61313,5,50,11,6,11,3,86,38.23090610343646,-109.3858309
61314,4,53,11,5,16,0,89,38.23090610343646,-109.3855614
61315,6,52,11,7,17,0,93,38.23090610343646,-109.3852919
61316,10,46,12,9,15,0,92,38.23090610343646,-109.3850225
61317,12,44,13,11,14,0,94,38.23090610343646,-109.384753
61318,16,42,13,9,13,0,93,38.23090610343646,-109.3844835
61319,15,42,13,10,13,0,93,38.23090610343646,-109.384214
61320,14,42,13,11,14,0,94,38.23090610343646,-109.3839445
61321,15,41,13,10,14,0,93,38.23090610343646,-109.383675
61322,16,40,13,10,13,0,92,38.23090610343646,-109.3834055
61323,18,39,13,11,12,0,93,38.23090610343646,-109.383136
61324,19,38,14,11,12,0,94,38.23090610343646,-109.3828665
61325,18,38,14,11,12,0,93,38.23090610343646,-109.382597
61326,18,38,14,11,11,0,92,38.23090610343646,-109.3823275
61327,18,38,14,11,12,0,93,38.23090610343646,-109.382058
61328,15,38,14,12,12,1,92,38.23090610343646,-109.3817885
61329,16,38,14,12,12,1,93,38.23090610343646,-109.381519
61330,16,40,14,11,11,1,93,38.23090610343646,-109.3812495
61331,14,41,14,11,11,1,92,38.23090610343646,-109.38098
61332,12,43,14,11,12,1,93,38.23090610343646,-109.3807105
61333,10,43,13,10,12,1,89,38.23090610343646,-109.380441
61334,8,43,13,9,13,2,88,38.23090610343646,-109.3801716
61335,7,43,13,9,13,2,87,38.23090610343646,-109.3799021
61336,8,44,13,10,14,1,90,38.23090610343646,-109.3796326
61337,10,44,13,10,13,1,91,38.23090610343646,-109.3793631
61338,12,45,14,10,11,1,93,38.23090610343646,-109.3790936
61339,10,47,13,9,11,1,91,38.23090610343646,-109.3788241
61340,6,48,13,7,12,2,88,38.23090610343646,-109.3785546
61341,5,49,12,6,12,2,86,38.23090610343646,-109.3782851
61342,7,44,12,8,13,1,85,38.23090610343646,-109.3780156
61343,6,35,10,10,10,1,72,38.23090610343646,-109.3777461
61344,4,31,9,14,7,1,66,38.23090610343646,-109.3774766
61345,6,28,10,11,8,1,64,38.23090610343646,-109.3772071
61346,5,45,9,6,13,2,80,38.23090610343646,-109.3769376
61347,5,43,10,6,11,3,78,38.23090610343646,-109.3766681
61348,6,38,10,7,10,4,75,38.23090610343646,-109.3763986
61349,7,34,11,7,9,4,72,38.23090610343646,-109.3761291
61350,9,32,12,8,8,5,74,38.23090610343646,-109.3758596
61351,13,40,14,9,9,3,88,38.23090610343646,-109.3755901
61352,9,40,13,9,11,4,86,38.23090610343646,-109.3753206
61353,6,39,11,7,13,4,80,38.23090610343646,-109.3750512
61354,5,43,10,7,13,3,81,38.23090610343646,-109.3747817
61355,7,44,10,9,12,2,84,38.23090610343646,-109.3745122
61356,4,42,10,7,13,3,79,38.23090610343646,-109.3742427
61357,4,46,10,6,13,3,82,38.23090610343646,-109.3739732
61358,5,48,11,7,13,3,87,38.23090610343646,-109.3737037
61359,8,46,13,8,13,1,89,38.23090610343646,-109.3734342
61360,4,43,11,5,13,3,79,38.23090610343646,-109.3731647
61361,3,43,9,3,14,3,75,38.23090610343646,-109.3728952
61362,3,45,9,1,15,3,76,38.23090610343646,-109.3726257
61363,4,48,10,3,15,3,83,38.23090610343646,-109.3723562
61364,4,47,10,3,15,4,83,38.23090610343646,-109.3720867
61365,4,47,11,4,16,3,85,38.23090610343646,-109.3718172
61366,6,47,12,5,16,1,87,38.23090610343646,-109.3715477
61367,9,45,12,7,15,1,89,38.23090610343646,-109.3712782
61368,10,42,13,7,15,1,88,38.23090610343646,-109.3710087
61369,6,47,12,6,15,2,88,38.23090610343646,-109.3707392
61370,6,48,12,6,15,2,89,38.23090610343646,-109.3704697
61371,8,45,12,8,13,2,88,38.23090610343646,-109.3702003
61372,8,43,12,9,11,3,86,38.23090610343646,-109.3699308
61373,7,45,12,7,12,2,85,38.23090610343646,-109.3696613
61374,3,45,10,4,13,4,79,38.23090610343646,-109.3693918
61375,2,39,9,3,10,7,70,38.23090610343646,-109.3691223
61376,2,38,9,4,10,7,70,38.23090610343646,-109.3688528
61377,2,40,9,4,10,6,71,38.23090610343646,-109.3685833
61378,1,41,9,2,9,8,70,38.23090610343646,-109.3683138
61379,1,39,9,2,11,7,69,38.23090610343646,-109.3680443
61380,1,46,9,4,12,5,77,38.23090610343646,-109.3677748
61381,2,46,9,4,14,4,79,38.23090610343646,-109.3675053
61382,3,40,11,3,14,6,77,38.23090610343646,-109.3672358
61383,2,26,12,1,6,16,63,38.23090610343646,-109.3669663
61384,2,33,11,4,14,8,72,38.23090610343646,-109.3666968
61385,3,35,11,6,15,6,76,38.23090610343646,-109.3664273
61386,3,37,11,5,15,5,76,38.23090610343646,-109.3661578
61387,4,45,12,5,17,2,85,38.23090610343646,-109.3658883
61388,4,51,12,7,15,1,90,38.23090610343646,-109.3656188
61389,4,49,13,7,15,2,90,38.23090610343646,-109.3653493
61390,3,49,11,5,14,2,84,38.23090610343646,-109.3650799
61391,1,47,9,3,13,4,77,38.23090610343646,-109.3648104
61392,0,49,8,2,11,5,75,38.23090610343646,-109.3645409
61393,2,38,9,4,10,6,69,38.23090610343646,-109.3642714
61394,5,26,11,7,10,8,67,38.23090610343646,-109.3640019
61395,16,31,13,12,12,4,88,38.23090610343646,-109.3637324
61396,32,26,10,16,7,1,92,38.23090610343646,-109.3634629
61397,37,25,10,12,5,1,90,38.23090610343646,-109.3631934
61398,28,24,11,15,13,2,93,38.23090610343646,-109.3629239
61399,15,31,13,13,16,1,89,38.23090610343646,-109.3626544
61400,11,39,14,11,18,0,93,38.23090610343646,-109.3623849
61401,10,41,15,12,16,0,94,38.23090610343646,-109.3621154
61402,7,43,14,11,14,1,90,38.23090610343646,-109.3618459
61403,8,37,13,12,12,4,86,38.23090610343646,-109.3615764
61404,17,27,11,11,10,2,78,38.23090610343646,-109.3613069
61405,28,15,10,18,7,2,80,38.23090610343646,-109.3610374
61406,36,12,10,25,6,1,90,38.23090610343646,-109.3607679
61407,38,10,10,22,8,1,89,38.23090610343646,-109.3604984
61408,33,8,10,21,7,1,80,38.23090610343646,-109.360229
61409,25,7,8,18,5,1,64,38.23090610343646,-109.3599595
61410,22,6,6,14,3,1,52,38.23090610343646,-109.35969
61411,26,9,9,13,4,2,63,38.23090610343646,-109.3594205
61412,16,23,13,12,11,6,81,38.23090610343646,-109.359151
61413,7,31,12,12,11,5,78,38.23090610343646,-109.3588815
61414,14,39,14,13,11,1,92,38.23090610343646,-109.358612
61415,16,22,8,12,7,1,66,38.23090610343646,-109.3583425
61416,20,14,7,12,4,1,58,38.23090610343646,-109.358073
61417,23,13,8,14,4,1,63,38.23090610343646,-109.3578035
61418,23,12,7,13,4,2,61,38.23090610343646,-109.357534
61419,21,10,6,9,3,1,50,38.23090610343646,-109.3572645
61420,18,10,4,4,2,0,38,38.23090610343646,-109.356995
61421,16,13,4,4,3,0,40,38.23090610343646,-109.3567255
61422,15,12,4,4,3,0,38,38.23090610343646,-109.356456
61423,17,13,4,4,2,0,40,38.23090610343646,-109.3561865
61424,26,18,8,11,4,1,68,38.23090610343646,-109.355917
61425,27,17,10,23,10,2,89,38.23090610343646,-109.3556475
61426,16,18,11,31,10,5,91,38.23090610343646,-109.355378
61427,8,22,14,18,15,6,83,38.23090610343646,-109.3551086
61428,2,27,13,12,17,7,78,38.23090610343646,-109.3548391
61429,1,29,10,12,19,4,75,38.23090610343646,-109.3545696
61430,4,35,11,11,17,1,79,38.23090610343646,-109.3543001
61431,3,38,11,3,16,6,77,38.23090610343646,-109.3540306
61432,4,41,12,2,14,8,81,38.23090610343646,-109.3537611
61433,5,44,12,3,15,7,86,38.23090610343646,-109.3534916
61434,7,43,13,7,17,3,90,38.23090610343646,-109.3532221
61435,7,45,14,8,16,2,92,38.23090610343646,-109.3529526
61436,6,44,13,7,16,4,90,38.23090610343646,-109.3526831
61437,5,42,13,6,17,4,87,38.23090610343646,-109.3524136
61438,5,44,14,7,17,3,90,38.23090610343646,-109.3521441
61439,6,45,14,8,18,1,92,38.23090610343646,-109.3518746
61440,8,46,13,7,17,1,92,38.23090610343646,-109.3516051
61441,6,48,12,6,17,2,91,38.23090610343646,-109.3513356
61442,9,43,14,14,14,1,95,38.23063660885122,-109.406582
61443,11,43,14,13,13,0,94,38.23063660885122,-109.4063125
61444,13,43,13,11,13,0,93,38.23063660885122,-109.406043
61445,11,43,13,12,13,1,93,38.23063660885122,-109.4057735
61446,8,45,13,12,13,1,92,38.23063660885122,-109.405504
61447,6,45,13,11,13,2,90,38.23063660885122,-109.4052345
61448,6,45,14,13,13,1,92,38.23063660885122,-109.4049651
61449,9,43,15,14,15,0,96,38.23063660885122,-109.4046956
61450,11,41,14,14,14,0,94,38.23063660885122,-109.4044261
61451,11,42,14,14,14,0,95,38.23063660885122,-109.4041566
61452,10,43,14,13,14,1,95,38.23063660885122,-109.4038871
61453,9,45,14,11,14,1,94,38.23063660885122,-109.4036176
61454,6,45,14,11,14,1,91,38.23063660885122,-109.4033481
61455,6,47,14,11,15,1,94,38.23063660885122,-109.4030786
61456,6,48,13,11,15,1,94,38.23063660885122,-109.4028091
61457,6,47,13,11,14,0,91,38.23063660885122,-109.4025396
61458,11,44,13,11,14,0,93,38.23063660885122,-109.4022701
61459,11,42,14,13,14,0,94,38.23063660885122,-109.4020006
61460,11,41,14,12,14,1,93,38.23063660885122,-109.4017311
61461,10,43,14,11,15,1,94,38.23063660885122,-109.4014616
61462,8,45,13,11,15,0,92,38.23063660885122,-109.4011921
61463,6,47,13,11,15,0,92,38.23063660885122,-109.4009226
61464,4,49,11,7,16,0,87,38.23063660885122,-109.4006531
61465,4,48,12,9,16,0,89,38.23063660885122,-109.4003836
61466,8,47,13,10,15,0,93,38.23063660885122,-109.4001142
61467,10,47,14,10,13,0,94,38.23063660885122,-109.3998447
61468,12,43,14,12,13,0,94,38.23063660885122,-109.3995752
61469,13,41,15,13,13,0,95,38.23063660885122,-109.3993057
61470,14,40,15,13,13,0,95,38.23063660885122,-109.3990362
61471,14,40,15,13,13,0,95,38.23063660885122,-109.3987667
61472,15,39,15,13,12,0,94,38.23063660885122,-109.3984972
61473,16,39,15,12,12,0,94,38.23063660885122,-109.3982277
61474,14,39,15,12,12,0,92,38.23063660885122,-109.3979582
61475,12,43,14,12,13,0,94,38.23063660885122,-109.3976887
61476,11,43,14,12,13,0,93,38.23063660885122,-109.3974192
61477,11,44,14,11,12,0,92,38.23063660885122,-109.3971497
61478,12,44,14,11,12,0,93,38.23063660885122,-109.3968802
61479,13,43,14,11,11,0,92,38.23063660885122,-109.3966107
61480,15,40,14,11,11,0,91,38.23063660885122,-109.3963412
61481,15,39,15,11,12,0,92,38.23063660885122,-109.3960717
61482,16,38,15,12,11,0,92,38.23063660885122,-109.3958022
61483,16,39,14,11,12,0,92,38.23063660885122,-109.3955327
61484,16,39,14,11,12,0,92,38.23063660885122,-109.3952632
61485,16,42,14,10,12,0,94,38.23063660885122,-109.3949938
61486,17,42,13,9,12,0,93,38.23063660885122,-109.3947243
61487,16,40,14,10,12,0,92,38.23063660885122,-109.3944548
61488,16,41,14,10,12,0,93,38.23063660885122,-109.3941853
61489,15,42,14,10,12,0,93,38.23063660885122,-109.3939158
61490,16,42,14,10,12,0,94,38.23063660885122,-109.3936463
61491,16,42,14,9,11,0,92,38.23063660885122,-109.3933768
61492,15,43,14,10,12,0,94,38.23063660885122,-109.3931073
61493,17,40,14,10,11,0,92,38.23063660885122,-109.3928378
61494,19,38,14,10,12,0,93,38.23063660885122,-109.3925683
61495,16,38,14,12,13,0,93,38.23063660885122,-109.3922988
61496,10,43,13,11,14,0,91,38.23063660885122,-109.3920293
61497,8,44,12,10,13,0,87,38.23063660885122,-109.3917598
61498,8,44,13,11,14,0,90,38.23063660885122,-109.3914903
61499,8,44,13,10,14,1,90,38.23063660885122,-109.3912208
61500,8,44,13,10,14,1,90,38.23063660885122,-109.3909513
61501,9,43,13,11,14,1,91,38.23063660885122,-109.3906818
61502,9,43,13,11,15,1,92,38.23063660885122,-109.3904123
61503,9,43,13,11,14,1,91,38.23063660885122,-109.3901429
61504,9,43,13,11,13,1,90,38.23063660885122,-109.3898734
61505,14,40,14,11,12,1,92,38.23063660885122,-109.3896039
61506,17,39,14,10,11,0,91,38.23063660885122,-109.3893344
61507,16,38,14,11,12,0,91,38.23063660885122,-109.3890649
61508,17,38,14,11,11,0,91,38.23063660885122,-109.3887954
61509,19,37,15,11,11,0,93,38.23063660885122,-109.3885259
61510,20,35,15,11,11,0,92,38.23063660885122,-109.3882564
61511,19,37,14,11,11,0,92,38.23063660885122,-109.3879869
61512,18,37,14,11,12,0,92,38.23063660885122,-109.3877174
61513,17,37,14,10,12,0,90,38.23063660885122,-109.3874479
61514,15,41,14,10,12,0,92,38.23063660885122,-109.3871784
61515,9,46,12,9,12,1,89,38.23063660885122,-109.3869089
61516,5,50,11,7,12,1,86,38.23063660885122,-109.3866394
61517,4,51,10,7,12,2,86,38.23063660885122,-109.3863699
61518,4,51,11,7,11,2,86,38.23063660885122,-109.3861004
61519,4,51,10,5,12,3,85,38.23063660885122,-109.3858309
61520,4,54,11,6,16,0,91,38.23063660885122,-109.3855614
61521,5,53,11,6,16,0,91,38.23063660885122,-109.3852919
61522,7,50,12,8,15,0,92,38.23063660885122,-109.3850225
61523,9,47,12,10,14,0,92,38.23063660885122,-109.384753
61524,11,45,13,10,14,0,93,38.23063660885122,-109.3844835
61525,12,44,13,11,14,0,94,38.23063660885122,-109.384214
61526,14,42,13,11,14,0,94,38.23063660885122,-109.3839445
61527,16,41,13,10,13,0,93,38.23063660885122,-109.383675
61528,15,42,13,10,13,0,93,38.23063660885122,-109.3834055
61529,17,39,14,11,13,0,94,38.23063660885122,-109.383136
61530,17,39,14,12,13,0,95,38.23063660885122,-109.3828665
61531,16,39,14,12,12,0,93,38.23063660885122,-109.382597
61532,15,41,14,12,13,0,95,38.23063660885122,-109.3823275
61533,17,39,13,11,12,0,92,38.23063660885122,-109.382058
61534,16,39,14,12,13,0,94,38.23063660885122,-109.3817885
61535,15,40,14,12,13,0,94,38.23063660885122,-109.381519
61536,14,41,14,12,12,0,93,38.23063660885122,-109.3812495
61537,12,42,14,13,12,1,94,38.23063660885122,-109.38098
61538,10,44,14,12,12,1,93,38.23063660885122,-109.3807105
61539,8,46,13,11,13,1,92,38.23063660885122,-109.380441
61540,6,46,12,9,13,1,87,38.23063660885122,-109.3801716
61541,5,46,12,7,13,2,85,38.23063660885122,-109.3799021
61542,5,47,12,8,14,1,87,38.23063660885122,-109.3796326
61543,7,44,13,9,13,1,87,38.23063660885122,-109.3793631
61544,10,44,13,9,11,1,88,38.23063660885122,-109.3790936
61545,11,45,13,9,11,1,90,38.23063660885122,-109.3788241
61546,8,47,13,8,11,1,88,38.23063660885122,-109.3785546
61547,8,47,13,8,11,1,88,38.23063660885122,-109.3782851
61548,8,45,13,8,13,1,88,38.23063660885122,-109.3780156
61549,8,44,11,9,11,1,84,38.23063660885122,-109.3777461
61550,3,38,8,12,6,1,68,38.23063660885122,-109.3774766
61551,1,34,6,11,4,3,59,38.23063660885122,-109.3772071
61552,5,52,8,7,9,1,82,38.23063660885122,-109.3769376
61553,5,43,10,6,10,3,77,38.23063660885122,-109.3766681
61554,6,35,10,7,9,4,71,38.23063660885122,-109.3763986
61555,8,30,11,9,9,4,71,38.23063660885122,-109.3761291
61556,17,32,15,13,9,1,87,38.23063660885122,-109.3758596
61557,19,38,14,11,9,1,92,38.23063660885122,-109.3755901
61558,10,40,13,9,12,3,87,38.23063660885122,-109.3753206
61559,7,40,11,8,14,3,83,38.23063660885122,-109.3750512
61560,6,46,11,9,13,1,86,38.23063660885122,-109.3747817
61561,4,47,9,7,12,2,81,38.23063660885122,-109.3745122
61562,4,44,9,9,12,1,79,38.23063660885122,-109.3742427
61563,4,44,10,8,13,1,80,38.23063660885122,-109.3739732
61564,5,45,11,8,12,3,84,38.23063660885122,-109.3737037
61565,10,43,13,9,11,3,89,38.23063660885122,-109.3734342
61566,6,42,11,4,13,5,81,38.23063660885122,-109.3731647
61567,3,44,9,2,15,3,76,38.23063660885122,-109.3728952
61568,3,46,9,2,15,3,78,38.23063660885122,-109.3726257
61569,3,46,10,3,15,3,80,38.23063660885122,-109.3723562
61570,4,48,10,3,16,2,83,38.23063660885122,-109.3720867
61571,5,50,11,5,15,2,88,38.23063660885122,-109.3718172
61572,6,49,12,6,15,1,89,38.23063660885122,-109.3715477
61573,7,47,13,7,15,1,90,38.23063660885122,-109.3712782
61574,8,45,13,9,13,2,90,38.23063660885122,-109.3710087
61575,7,43,13,10,12,2,87,38.23063660885122,-109.3707392
61576,9,45,13,11,12,2,92,38.23063660885122,-109.3704697
61577,11,42,13,10,11,2,89,38.23063660885122,-109.3702003
61578,11,40,12,8,11,1,83,38.23063660885122,-109.3699308
61579,11,43,13,10,12,1,90,38.23063660885122,-109.3696613
61580,6,42,12,7,13,3,83,38.23063660885122,-109.3693918
61581,5,38,11,4,13,5,76,38.23063660885122,-109.3691223
61582,3,38,10,3,11,7,72,38.23063660885122,-109.3688528
61583,2,39,10,3,11,7,72,38.23063660885122,-109.3685833
61584,2,41,10,4,12,5,74,38.23063660885122,-109.3683138
61585,1,43,9,2,12,6,73,38.23063660885122,-109.3680443
61586,0,49,8,1,13,5,76,38.23063660885122,-109.3677748
61587,1,50,8,1,13,4,77,38.23063660885122,-109.3675053
61588,3,39,10,2,14,6,74,38.23063660885122,-109.3672358
61589,2,28,11,2,7,13,63,38.23063660885122,-109.3669663
61590,3,37,10,3,15,5,73,38.23063660885122,-109.3666968
61591,3,41,10,3,15,5,77,38.23063660885122,-109.3664273
61592,3,42,11,4,15,5,80,38.23063660885122,-109.3661578
61593,3,48,12,3,17,3,86,38.23063660885122,-109.3658883
61594,4,51,11,5,14,2,87,38.23063660885122,-109.3656188
61595,4,50,12,5,15,2,88,38.23063660885122,-109.3653493
61596,3,50,11,3,14,3,84,38.23063660885122,-109.3650799
61597,1,44,9,3,12,5,74,38.23063660885122,-109.3648104
61598,1,39,9,3,11,7,70,38.23063660885122,-109.3645409
61599,1,29,10,5,10,8,63,38.23063660885122,-109.3642714
61600,2,23,11,6,8,12,62,38.23063660885122,-109.3640019
61601,16,32,14,11,11,5,89,38.23063660885122,-109.3637324
61602,33,23,9,15,6,1,87,38.23063660885122,-109.3634629
61603,29,23,8,10,4,0,74,38.23063660885122,-109.3631934
61604,38,24,11,13,7,1,94,38.23063660885122,-109.3629239
61605,33,26,11,12,13,0,95,38.23063660885122,-109.3626544
61606,19,32,13,12,15,1,92,38.23063660885122,-109.3623849
61607,12,39,13,11,16,1,92,38.23063660885122,-109.3621154
61608,8,42,14,10,17,0,91,38.23063660885122,-109.3618459
61609,14,34,14,11,13,4,90,38.23063660885122,-109.3615764
61610,25,19,10,13,11,1,79,38.23063660885122,-109.3613069
61611,36,12,10,19,8,1,86,38.23063660885122,-109.3610374
61612,44,12,9,19,7,1,92,38.23063660885122,-109.3607679
61613,39,10,10,21,8,1,89,38.23063660885122,-109.3604984
61614,35,10,10,24,9,2,90,38.23063660885122,-109.360229
61615,31,9,10,24,8,2,84,38.23063660885122,-109.3599595
61616,27,9,9,19,6,2,72,38.23063660885122,-109.35969
61617,26,16,10,15,6,2,75,38.23063660885122,-109.3594205
61618,20,31,13,12,12,2,90,38.23063660885122,-109.359151
61619,21,31,12,10,9,0,83,38.23063660885122,-109.3588815
61620,19,18,6,7,4,0,54,38.23063660885122,-109.358612
61621,20,12,5,7,3,0,47,38.23063660885122,-109.3583425
61622,21,11,6,11,2,1,52,38.23063660885122,-109.358073
61623,27,11,8,18,3,2,69,38.23063660885122,-109.3578035
61624,29,10,9,22,5,2,77,38.23063660885122,-109.357534
61625,27,9,8,16,4,1,65,38.23063660885122,-109.3572645
61626,22,11,5,6,2,0,46,38.23063660885122,-109.356995
61627,18,13,4,2,3,0,40,38.23063660885122,-109.3567255
61628,22,16,7,11,3,1,60,38.23063660885122,-109.356456
61629,32,18,8,19,10,2,89,38.23063660885122,-109.3561865
61630,17,16,10,28,15,5,91,38.23063660885122,-109.355917
61631,4,23,16,16,11,15,85,38.23063660885122,-109.3556475
61632,3,28,14,11,17,7,80,38.23063660885122,-109.355378
61633,0,28,12,4,14,10,68,38.23063660885122,-109.3551086
61634,0,30,10,6,16,6,68,38.23063660885122,-109.3548391
61635,1,32,10,3,17,6,69,38.23063660885122,-109.3545696
61636,4,33,11,6,16,3,73,38.23063660885122,-109.3543001
61637,2,43,11,4,17,3,80,38.23063660885122,-109.3540306
61638,3,49,11,4,17,3,87,38.23063660885122,-109.3537611
61639,3,51,12,4,15,4,89,38.23063660885122,-109.3534916
61640,4,50,13,6,17,2,92,38.23063660885122,-109.3532221
61641,5,49,14,7,17,2,94,38.23063660885122,-109.3529526
61642,7,47,14,9,17,1,95,38.23063660885122,-109.3526831
61643,7,45,14,9,18,1,94,38.23063660885122,-109.3524136
61644,5,45,14,8,18,1,91,38.23063660885122,-109.3521441
61645,5,46,14,7,19,1,92,38.23063660885122,-109.3518746
61646,6,46,12,7,16,1,88,38.23063660885122,-109.3516051
61647,3,46,10,6,15,2,82,38.23063660885122,-109.3513356
61648,12,43,14,12,13,0,94,38.23036711426599,-109.406582
61649,12,43,14,12,13,0,94,38.23036711426599,-109.4063125
61650,10,46,13,11,13,0,93,38.23036711426599,-109.406043
61651,12,45,13,10,13,1,94,38.23036711426599,-109.4057735
61652,10,45,13,11,14,0,93,38.23036711426599,-109.405504
61653,7,46,14,12,15,1,95,38.23036711426599,-109.4052345
61654,6,47,13,11,15,1,93,38.23036711426599,-109.4049651
61655,7,46,14,12,15,0,94,38.23036711426599,-109.4046956
61656,7,46,14,13,14,0,94,38.23036711426599,-109.4044261
61657,6,45,14,14,14,1,94,38.23036711426599,-109.4041566
61658,7,44,14,14,14,1,94,38.23036711426599,-109.4038871
61659,8,45,14,12,15,1,95,38.23036711426599,-109.4036176
61660,7,47,13,10,15,1,93,38.23036711426599,-109.4033481
61661,5,49,13,8,15,1,91,38.23036711426599,-109.4030786
61662,5,50,12,7,16,1,91,38.23036711426599,-109.4028091
61663,5,50,12,8,15,1,91,38.23036711426599,-109.4025396
61664,8,49,13,8,14,0,92,38.23036711426599,-109.4022701
61665,12,44,13,9,15,0,93,38.23036711426599,-109.4020006
61666,13,44,13,9,14,0,93,38.23036711426599,-109.4017311
61667,11,45,13,10,15,0,94,38.23036711426599,-109.4014616
61668,8,47,13,11,16,0,95,38.23036711426599,-109.4011921
61669,5,50,12,9,16,0,92,38.23036711426599,-109.4009226
61670,4,49,11,9,16,0,89,38.23036711426599,-109.4006531
61671,4,48,11,8,15,0,86,38.23036711426599,-109.4003836
61672,4,47,11,8,15,1,86,38.23036711426599,-109.4001142
61673,4,48,13,9,16,0,90,38.23036711426599,-109.3998447
61674,9,45,14,12,15,0,95,38.23036711426599,-109.3995752
61675,15,40,15,12,13,0,95,38.23036711426599,-109.3993057
61676,17,37,15,13,12,0,94,38.23036711426599,-109.3990362
61677,18,37,15,13,12,0,95,38.23036711426599,-109.3987667
61678,16,37,15,14,12,0,94,38.23036711426599,-109.3984972
61679,15,39,15,13,13,0,95,38.23036711426599,-109.3982277
61680,12,40,15,13,13,0,93,38.23036711426599,-109.3979582
61681,11,42,14,12,14,0,93,38.23036711426599,-109.3976887
61682,9,45,14,12,13,1,94,38.23036711426599,-109.3974192
61683,9,45,13,11,12,1,91,38.23036711426599,-109.3971497
61684,10,45,14,11,12,1,93,38.23036711426599,-109.3968802
61685,11,43,14,12,13,0,93,38.23036711426599,-109.3966107
61686,12,42,14,12,12,1,93,38.23036711426599,-109.3963412
61687,13,40,14,12,12,1,92,38.23036711426599,-109.3960717
61688,14,39,15,13,12,0,93,38.23036711426599,-109.3958022
61689,14,40,15,12,12,0,93,38.23036711426599,-109.3955327
61690,14,40,14,12,13,0,93,38.23036711426599,-109.3952632
61691,14,41,14,11,13,0,93,38.23036711426599,-109.3949938
61692,15,42,14,11,12,0,94,38.23036711426599,-109.3947243
61693,14,41,14,11,13,0,93,38.23036711426599,-109.3944548
61694,15,41,14,11,13,0,94,38.23036711426599,-109.3941853
61695,16,40,14,10,12,0,92,38.23036711426599,-109.3939158
61696,16,41,14,10,12,0,93,38.23036711426599,-109.3936463
61697,15,42,14,10,11,0,92,38.23036711426599,-109.3933768
61698,14,43,14,10,12,0,93,38.23036711426599,-109.3931073
61699,14,43,14,10,12,0,93,38.23036711426599,-109.3928378
61700,14,41,14,11,12,0,92,38.23036711426599,-109.3925683
61701,13,42,14,11,12,0,92,38.23036711426599,-109.3922988
61702,9,46,13,10,14,0,92,38.23036711426599,-109.3920293
61703,7,44,13,11,14,0,89,38.23036711426599,-109.3917598
61704,9,43,13,11,14,1,91,38.23036711426599,-109.3914903
61705,10,44,14,11,14,1,94,38.23036711426599,-109.3912208
61706,10,45,13,10,14,0,92,38.23036711426599,-109.3909513
61707,9,45,13,9,14,1,91,38.23036711426599,-109.3906818
61708,8,44,13,9,14,1,89,38.23036711426599,-109.3904123
61709,10,43,13,10,14,1,91,38.23036711426599,-109.3901429
61710,12,42,14,11,13,1,93,38.23036711426599,-109.3898734
61711,14,38,14,12,13,1,92,38.23036711426599,-109.3896039
61712,15,36,15,12,13,1,92,38.23036711426599,-109.3893344
61713,17,36,15,12,12,0,92,38.23036711426599,-109.3890649
61714,17,36,15,12,12,0,92,38.23036711426599,-109.3887954
61715,14,38,14,12,13,0,91,38.23036711426599,-109.3885259
61716,14,37,14,12,12,1,90,38.23036711426599,-109.3882564
61717,13,36,14,13,12,1,89,38.23036711426599,-109.3879869
61718,13,37,14,12,12,1,89,38.23036711426599,-109.3877174
61719,15,38,14,10,11,1,89,38.23036711426599,-109.3874479
61720,14,40,14,10,11,1,90,38.23036711426599,-109.3871784
61721,8,44,11,7,11,2,83,38.23036711426599,-109.3869089
61722,4,50,10,6,11,2,83,38.23036711426599,-109.3866394
61723,3,52,10,7,12,2,86,38.23036711426599,-109.3863699
61724,4,51,10,7,12,2,86,38.23036711426599,-109.3861004
61725,4,50,11,8,13,2,88,38.23036711426599,-109.3858309
61726,3,51,11,5,16,1,87,38.23036711426599,-109.3855614
61727,3,51,11,5,17,1,88,38.23036711426599,-109.3852919
61728,4,49,11,7,16,0,87,38.23036711426599,-109.3850225
61729,7,48,12,9,15,0,91,38.23036711426599,-109.384753
61730,13,42,13,11,15,0,94,38.23036711426599,-109.3844835
61731,17,40,13,10,13,0,93,38.23036711426599,-109.384214
61732,17,41,13,9,13,0,93,38.23036711426599,-109.3839445
61733,16,41,13,10,13,0,93,38.23036711426599,-109.383675
61734,16,41,13,10,13,0,93,38.23036711426599,-109.3834055
61735,15,42,14,11,13,0,95,38.23036711426599,-109.383136
61736,15,42,14,11,13,0,95,38.23036711426599,-109.3828665
61737,14,42,14,11,13,0,94,38.23036711426599,-109.382597
61738,14,42,14,11,13,0,94,38.23036711426599,-109.3823275
61739,14,42,14,11,13,0,94,38.23036711426599,-109.382058
61740,20,37,14,11,12,0,94,38.23036711426599,-109.3817885
61741,22,34,14,11,12,0,93,38.23036711426599,-109.381519
61742,19,35,14,11,12,0,91,38.23036711426599,-109.3812495
61743,14,42,14,12,12,0,94,38.23036711426599,-109.38098
61744,9,45,12,10,12,1,89,38.23036711426599,-109.3807105
61745,6,47,11,8,12,2,86,38.23036711426599,-109.380441
61746,4,47,11,7,12,2,83,38.23036711426599,-109.3801716
61747,5,46,11,8,12,2,84,38.23036711426599,-109.3799021
61748,5,47,11,8,13,1,85,38.23036711426599,-109.3796326
61749,6,46,12,8,13,1,86,38.23036711426599,-109.3793631
61750,8,45,13,10,12,1,89,38.23036711426599,-109.3790936
61751,10,46,13,9,11,1,90,38.23036711426599,-109.3788241
61752,10,44,13,11,12,1,91,38.23036711426599,-109.3785546
61753,10,42,13,12,13,0,90,38.23036711426599,-109.3782851
61754,11,42,13,11,13,0,90,38.23036711426599,-109.3780156
61755,9,45,12,9,12,0,87,38.23036711426599,-109.3777461
61756,3,43,8,10,6,1,71,38.23036711426599,-109.3774766
61757,1,42,6,14,3,1,67,38.23036711426599,-109.3772071
61758,5,46,8,8,8,2,77,38.23036711426599,-109.3769376
61759,6,40,10,6,9,3,74,38.23036711426599,-109.3766681
61760,8,34,11,8,8,4,73,38.23036711426599,-109.3763986
61761,12,33,12,11,9,2,79,38.23036711426599,-109.3761291
61762,12,39,15,12,10,2,90,38.23036711426599,-109.3758596
61763,15,42,13,12,9,1,92,38.23036711426599,-109.3755901
61764,13,40,12,9,11,3,88,38.23036711426599,-109.3753206
61765,10,38,12,9,11,3,83,38.23036711426599,-109.3750512
61766,7,42,10,9,12,2,82,38.23036711426599,-109.3747817
61767,4,46,9,7,11,2,79,38.23036711426599,-109.3745122
61768,4,48,8,9,9,1,79,38.23036711426599,-109.3742427
61769,3,45,9,8,11,1,77,38.23036711426599,-109.3739732
61770,4,43,10,8,13,2,80,38.23036711426599,-109.3737037
61771,12,41,13,10,10,3,89,38.23036711426599,-109.3734342
61772,10,41,12,6,13,4,86,38.23036711426599,-109.3731647
61773,5,42,10,2,15,3,77,38.23036711426599,-109.3728952
61774,4,42,10,2,16,3,77,38.23036711426599,-109.3726257
61775,4,42,10,4,15,3,78,38.23036711426599,-109.3723562
61776,5,44,11,6,15,2,83,38.23036711426599,-109.3720867
61777,9,46,13,8,15,1,92,38.23036711426599,-109.3718172
61778,9,44,13,9,14,1,90,38.23036711426599,-109.3715477
61779,8,42,13,9,13,2,87,38.23036711426599,-109.3712782
61780,8,42,14,10,13,2,89,38.23036711426599,-109.3710087
61781,9,43,13,10,12,2,89,38.23036711426599,-109.3707392
61782,11,44,14,10,11,1,91,38.23036711426599,-109.3704697
61783,13,41,13,9,11,1,88,38.23036711426599,-109.3702003
61784,14,40,12,8,10,1,85,38.23036711426599,-109.3699308
61785,13,41,14,11,11,1,91,38.23036711426599,-109.3696613
61786,7,41,12,8,12,3,83,38.23036711426599,-109.3693918
61787,4,43,11,5,13,4,80,38.23036711426599,-109.3691223
61788,2,43,10,4,13,5,77,38.23036711426599,-109.3688528
61789,2,45,9,3,13,5,77,38.23036711426599,-109.3685833
61790,2,49,9,2,13,4,79,38.23036711426599,-109.3683138
61791,1,51,9,3,13,4,81,38.23036711426599,-109.3680443
61792,1,53,9,2,14,3,82,38.23036711426599,-109.3677748
61793,2,49,10,2,16,3,82,38.23036711426599,-109.3675053
61794,2,35,11,2,14,7,71,38.23036711426599,-109.3672358
61795,2,32,10,0,11,12,67,38.23036711426599,-109.3669663
61796,3,38,10,1,14,6,72,38.23036711426599,-109.3666968
61797,4,44,10,2,16,4,80,38.23036711426599,-109.3664273
61798,4,49,12,3,18,2,88,38.23036711426599,-109.3661578
61799,4,53,13,5,18,1,94,38.23036711426599,-109.3658883
61800,5,53,13,6,15,1,93,38.23036711426599,-109.3656188
61801,4,52,12,4,16,2,90,38.23036711426599,-109.3653493
61802,3,51,10,2,14,4,84,38.23036711426599,-109.3650799
61803,1,44,9,2,12,5,73,38.23036711426599,-109.3648104
61804,1,40,9,4,10,5,69,38.23036711426599,-109.3645409
61805,3,33,10,4,10,7,67,38.23036711426599,-109.3642714
61806,3,26,10,4,8,11,62,38.23036711426599,-109.3640019
61807,12,32,12,7,9,8,80,38.23036711426599,-109.3637324
61808,26,26,8,7,7,1,75,38.23036711426599,-109.3634629
61809,25,20,6,4,4,0,59,38.23036711426599,-109.3631934
61810,32,25,8,10,5,0,80,38.23036711426599,-109.3629239
61811,36,25,10,12,9,1,93,38.23036711426599,-109.3626544
61812,28,26,11,14,14,0,93,38.23036711426599,-109.3623849
61813,18,33,12,11,14,0,88,38.23036711426599,-109.3621154
61814,14,37,14,11,15,0,91,38.23036711426599,-109.3618459
61815,9,35,14,14,15,2,89,38.23036711426599,-109.3615764
61816,21,25,12,14,14,2,88,38.23036711426599,-109.3613069
61817,33,13,11,18,9,2,86,38.23036711426599,-109.3610374
61818,41,12,10,19,8,1,91,38.23036711426599,-109.3607679
61819,32,11,10,24,7,2,86,38.23036711426599,-109.3604984
61820,33,9,9,24,8,1,84,38.23036711426599,-109.360229
61821,28,8,9,24,10,2,81,38.23036711426599,-109.3599595
61822,22,8,8,16,6,2,62,38.23036711426599,-109.35969
61823,18,14,5,6,3,0,46,38.23036711426599,-109.3594205
61824,18,19,5,3,5,0,50,38.23036711426599,-109.359151
61825,21,16,5,3,3,0,48,38.23036711426599,-109.3588815
61826,21,13,4,5,2,0,45,38.23036711426599,-109.358612
61827,22,12,5,9,2,0,50,38.23036711426599,-109.3583425
61828,27,12,7,14,3,1,64,38.23036711426599,-109.358073
61829,33,11,9,19,5,2,79,38.23036711426599,-109.3578035
61830,34,10,9,20,7,2,82,38.23036711426599,-109.357534
61831,34,11,9,21,9,1,85,38.23036711426599,-109.3572645
61832,33,13,9,22,10,1,88,38.23036711426599,-109.356995
61833,28,15,9,22,13,2,89,38.23036711426599,-109.3567255
61834,17,13,9,31,18,6,94,38.23036711426599,-109.356456
61835,11,15,11,31,18,4,90,38.23036711426599,-109.3561865
61836,1,24,12,24,18,3,82,38.23036711426599,-109.355917
61837,0,28,10,18,18,1,75,38.23036711426599,-109.3556475
61838,1,36,10,12,16,0,75,38.23036711426599,-109.355378
61839,0,35,9,3,15,4,66,38.23036711426599,-109.3551086
61840,0,38,9,2,15,5,69,38.23036711426599,-109.3548391
61841,2,44,9,3,16,2,76,38.23036711426599,-109.3545696
61842,2,50,9,3,15,2,81,38.23036711426599,-109.3543001
61843,1,54,8,4,14,2,83,38.23036711426599,-109.3540306
61844,1,53,8,2,15,3,82,38.23036711426599,-109.3537611
61845,2,51,10,2,17,3,85,38.23036711426599,-109.3534916
61846,3,51,12,5,18,1,90,38.23036711426599,-109.3532221
61847,4,51,14,6,17,2,94,38.23036711426599,-109.3529526
61848,4,48,14,6,18,2,92,38.23036711426599,-109.3526831
61849,5,47,14,6,19,2,93,38.23036711426599,-109.3524136
61850,5,47,14,7,19,1,93,38.23036711426599,-109.3521441
61851,4,49,13,6,19,1,92,38.23036711426599,-109.3518746
61852,3,48,10,4,15,3,83,38.23036711426599,-109.3516051
61853,1,51,8,2,13,4,79,38.23036711426599,-109.3513356
61854,12,43,14,12,13,0,94,38.23009761968075,-109.406582
61855,11,45,13,12,13,0,94,38.23009761968075,-109.4063125
61856,10,46,13,11,14,0,94,38.23009761968075,-109.406043
61857,10,46,13,11,13,0,93,38.23009761968075,-109.4057735
61858,9,46,13,11,14,0,93,38.23009761968075,-109.405504
61859,8,46,13,11,14,0,92,38.23009761968075,-109.4052345
61860,9,47,13,10,14,0,93,38.23009761968075,-109.4049651
61861,10,48,12,9,13,0,92,38.23009761968075,-109.4046956
61862,9,48,13,10,14,0,94,38.23009761968075,-109.4044261
61863,8,48,13,10,14,0,93,38.23009761968075,-109.4041566
61864,6,47,13,11,15,1,93,38.23009761968075,-109.4038871
61865,7,47,13,12,14,1,94,38.23009761968075,-109.4036176
61866,8,46,13,10,16,0,93,38.23009761968075,-109.4033481
61867,7,46,14,11,16,0,94,38.23009761968075,-109.4030786
61868,7,45,14,11,16,0,93,38.23009761968075,-109.4028091
61869,9,44,14,12,15,0,94,38.23009761968075,-109.4025396
61870,16,40,14,10,14,0,94,38.23009761968075,-109.4022701
61871,18,40,14,11,13,0,96,38.23009761968075,-109.4020006
61872,16,41,14,11,14,0,96,38.23009761968075,-109.4017311
61873,13,43,14,12,15,0,97,38.23009761968075,-109.4014616
61874,9,44,14,12,16,0,95,38.23009761968075,-109.4011921
61875,7,46,13,11,16,0,93,38.23009761968075,-109.4009226
61876,5,50,12,9,17,0,93,38.23009761968075,-109.4006531
61877,4,51,11,6,16,0,88,38.23009761968075,-109.4003836
61878,4,50,11,6,16,1,88,38.23009761968075,-109.4001142
61879,5,49,13,8,18,0,93,38.23009761968075,-109.3998447
61880,12,43,14,11,16,0,96,38.23009761968075,-109.3995752
61881,16,40,14,11,14,0,95,38.23009761968075,-109.3993057
61882,17,38,14,12,13,0,94,38.23009761968075,-109.3990362
61883,17,38,15,12,13,0,95,38.23009761968075,-109.3987667
61884,15,38,15,12,13,0,93,38.23009761968075,-109.3984972
61885,14,39,14,12,14,0,93,38.23009761968075,-109.3982277
61886,12,40,14,12,14,0,92,38.23009761968075,-109.3979582
61887,11,42,14,12,14,1,94,38.23009761968075,-109.3976887
61888,9,43,14,11,14,1,92,38.23009761968075,-109.3974192
61889,9,45,13,11,13,1,92,38.23009761968075,-109.3971497
61890,12,44,14,12,13,0,95,38.23009761968075,-109.3968802
61891,12,42,14,12,13,0,93,38.23009761968075,-109.3966107
61892,11,42,14,13,13,1,94,38.23009761968075,-109.3963412
61893,11,41,14,13,12,1,92,38.23009761968075,-109.3960717
61894,12,42,15,13,12,1,95,38.23009761968075,-109.3958022
61895,12,42,14,12,13,0,93,38.23009761968075,-109.3955327
61896,11,43,14,12,13,0,93,38.23009761968075,-109.3952632
61897,11,42,14,13,13,0,93,38.23009761968075,-109.3949938
61898,13,41,14,12,13,0,93,38.23009761968075,-109.3947243
61899,12,41,14,12,13,0,92,38.23009761968075,-109.3944548
61900,13,41,14,12,13,0,93,38.23009761968075,-109.3941853
61901,14,40,14,12,13,0,93,38.23009761968075,-109.3939158
61902,13,40,14,12,13,0,92,38.23009761968075,-109.3936463
61903,12,42,15,11,12,0,92,38.23009761968075,-109.3933768
61904,12,42,14,11,13,0,92,38.23009761968075,-109.3931073
61905,11,43,14,11,13,0,92,38.23009761968075,-109.3928378
61906,11,43,14,11,12,0,91,38.23009761968075,-109.3925683
61907,12,44,14,10,12,0,92,38.23009761968075,-109.3922988
61908,9,45,12,9,14,0,89,38.23009761968075,-109.3920293
61909,8,42,13,10,13,1,87,38.23009761968075,-109.3917598
61910,10,42,14,11,13,0,90,38.23009761968075,-109.3914903
61911,13,43,14,11,13,0,94,38.23009761968075,-109.3912208
61912,12,43,14,11,14,0,94,38.23009761968075,-109.3909513
61913,8,44,13,9,14,1,89,38.23009761968075,-109.3906818
61914,8,44,13,9,15,1,90,38.23009761968075,-109.3904123
61915,8,43,13,10,14,1,89,38.23009761968075,-109.3901429
61916,10,41,14,11,13,1,90,38.23009761968075,-109.3898734
61917,12,37,14,12,13,1,89,38.23009761968075,-109.3896039
61918,12,36,14,12,13,1,88,38.23009761968075,-109.3893344
61919,12,36,14,13,13,1,89,38.23009761968075,-109.3890649
61920,11,37,14,12,13,1,88,38.23009761968075,-109.3887954
61921,8,37,13,11,12,2,83,38.23009761968075,-109.3885259
61922,7,36,13,10,11,3,80,38.23009761968075,-109.3882564
61923,7,36,13,10,10,3,79,38.23009761968075,-109.3879869
61924,8,36,13,10,11,2,80,38.23009761968075,-109.3877174
61925,10,37,13,11,12,2,85,38.23009761968075,-109.3874479
61926,8,39,13,10,11,2,83,38.23009761968075,-109.3871784
61927,6,44,11,8,11,2,82,38.23009761968075,-109.3869089
61928,4,51,9,5,11,2,82,38.23009761968075,-109.3866394
61929,3,52,9,5,12,2,83,38.23009761968075,-109.3863699
61930,5,49,10,9,12,2,87,38.23009761968075,-109.3861004
61931,9,47,12,10,13,1,92,38.23009761968075,-109.3858309
61932,10,43,13,12,13,0,91,38.23009761968075,-109.3855614
61933,9,43,13,11,14,0,90,38.23009761968075,-109.3852919
61934,10,43,13,11,15,0,92,38.23009761968075,-109.3850225
61935,11,43,13,10,15,0,92,38.23009761968075,-109.384753
61936,11,44,12,9,14,0,90,38.23009761968075,-109.3844835
61937,11,43,13,10,14,0,91,38.23009761968075,-109.384214
61938,12,43,13,10,13,0,91,38.23009761968075,-109.3839445
61939,13,41,13,11,14,0,92,38.23009761968075,-109.383675
61940,14,41,13,11,14,0,93,38.23009761968075,-109.3834055
61941,14,43,13,10,14,0,94,38.23009761968075,-109.383136
61942,14,43,13,11,13,0,94,38.23009761968075,-109.3828665
61943,13,44,13,11,12,0,93,38.23009761968075,-109.382597
61944,12,44,13,11,12,0,92,38.23009761968075,-109.3823275
61945,12,43,13,11,13,0,92,38.23009761968075,-109.382058
61946,17,38,14,12,12,0,93,38.23009761968075,-109.3817885
61947,20,34,14,12,12,0,92,38.23009761968075,-109.381519
61948,18,34,14,12,12,1,91,38.23009761968075,-109.3812495
61949,12,42,13,10,12,1,90,38.23009761968075,-109.38098
61950,8,45,12,9,12,1,87,38.23009761968075,-109.3807105
61951,7,47,11,7,11,2,85,38.23009761968075,-109.380441
61952,8,46,11,8,11,1,85,38.23009761968075,-109.3801716
61953,9,43,12,10,13,1,88,38.23009761968075,-109.3799021
61954,8,44,13,10,13,1,89,38.23009761968075,-109.3796326
61955,9,44,12,9,12,1,87,38.23009761968075,-109.3793631
61956,11,44,13,9,11,1,89,38.23009761968075,-109.3790936
61957,12,43,13,10,11,1,90,38.23009761968075,-109.3788241
61958,13,41,13,11,12,0,90,38.23009761968075,-109.3785546
61959,13,40,13,12,13,0,91,38.23009761968075,-109.3782851
61960,10,42,13,12,13,0,90,38.23009761968075,-109.3780156
61961,5,44,10,7,14,1,81,38.23009761968075,-109.3777461
61962,2,43,8,7,9,3,72,38.23009761968075,-109.3774766
61963,1,34,8,16,6,1,66,38.23009761968075,-109.3772071
61964,3,26,10,17,10,2,68,38.23009761968075,-109.3769376
61965,4,32,10,7,8,6,67,38.23009761968075,-109.3766681
61966,9,33,11,9,8,3,73,38.23009761968075,-109.3763986
61967,11,35,12,13,9,1,81,38.23009761968075,-109.3761291
61968,10,41,13,12,11,2,89,38.23009761968075,-109.3758596
61969,11,47,12,10,9,1,90,38.23009761968075,-109.3755901
61970,23,37,12,9,9,2,92,38.23009761968075,-109.3753206
61971,21,32,13,11,10,2,89,38.23009761968075,-109.3750512
61972,11,32,12,13,9,3,80,38.23009761968075,-109.3747817
61973,6,40,9,8,9,3,75,38.23009761968075,-109.3745122
61974,3,48,8,8,9,1,77,38.23009761968075,-109.3742427
61975,3,48,9,8,12,1,81,38.23009761968075,-109.3739732
61976,5,48,10,8,13,1,85,38.23009761968075,-109.3737037
61977,12,44,13,10,11,1,91,38.23009761968075,-109.3734342
61978,13,41,12,7,14,1,88,38.23009761968075,-109.3731647
61979,7,41,11,5,15,3,82,38.23009761968075,-109.3728952
61980,6,41,11,5,15,3,81,38.23009761968075,-109.3726257
61981,7,43,12,7,15,1,85,38.23009761968075,-109.3723562
61982,10,43,13,9,14,1,90,38.23009761968075,-109.3720867
61983,11,44,13,9,14,1,92,38.23009761968075,-109.3718172
61984,9,42,14,9,13,2,89,38.23009761968075,-109.3715477
61985,9,41,14,9,13,2,88,38.23009761968075,-109.3712782
61986,8,42,14,8,13,2,87,38.23009761968075,-109.3710087
61987,8,42,14,8,13,2,87,38.23009761968075,-109.3707392
61988,10,43,13,8,12,2,88,38.23009761968075,-109.3704697
61989,10,42,13,10,11,2,88,38.23009761968075,-109.3702003
61990,10,42,13,10,11,2,88,38.23009761968075,-109.3699308
61991,10,41,13,10,12,1,87,38.23009761968075,-109.3696613
61992,6,43,12,7,14,2,84,38.23009761968075,-109.3693918
61993,3,47,10,4,13,3,80,38.23009761968075,-109.3691223
61994,2,48,9,3,13,4,79,38.23009761968075,-109.3688528
61995,1,48,9,3,13,4,78,38.23009761968075,-109.3685833
61996,1,53,8,3,12,3,80,38.23009761968075,-109.3683138
61997,0,56,8,1,15,3,83,38.23009761968075,-109.3680443
61998,2,52,10,3,15,3,85,38.23009761968075,-109.3677748
61999,2,44,10,3,16,4,79,38.23009761968075,-109.3675053
62000,2,35,11,2,14,7,71,38.23009761968075,-109.3672358
62001,3,32,10,1,9,13,68,38.23009761968075,-109.3669663
62002,2,37,10,1,14,8,72,38.23009761968075,-109.3666968
62003,3,45,11,2,17,5,83,38.23009761968075,-109.3664273
62004,3,53,12,4,18,2,92,38.23009761968075,-109.3661578
62005,4,54,13,6,16,1,94,38.23009761968075,-109.3658883
62006,4,53,13,7,16,1,94,38.23009761968075,-109.3656188
62007,4,53,13,5,17,1,93,38.23009761968075,-109.3653493
62008,3,52,11,3,17,2,88,38.23009761968075,-109.3650799
62009,2,48,10,2,16,3,81,38.23009761968075,-109.3648104
62010,2,42,10,5,14,4,77,38.23009761968075,-109.3645409
62011,2,33,11,1,10,11,68,38.23009761968075,-109.3642714
62012,2,33,10,1,10,11,67,38.23009761968075,-109.3640019
62013,5,33,11,7,10,8,74,38.23009761968075,-109.3637324
62014,22,34,11,10,10,2,89,38.23009761968075,-109.3634629
62015,28,21,6,4,4,0,63,38.23009761968075,-109.3631934
62016,26,24,6,5,4,0,65,38.23009761968075,-109.3629239
62017,37,29,9,12,6,0,93,38.23009761968075,-109.3626544
62018,33,26,10,16,10,0,95,38.23009761968075,-109.3623849
62019,24,30,12,13,12,0,91,38.23009761968075,-109.3621154
62020,12,37,13,13,13,1,89,38.23009761968075,-109.3618459
62021,19,32,12,11,12,2,88,38.23009761968075,-109.3615764
62022,26,19,10,14,8,1,78,38.23009761968075,-109.3613069
62023,29,15,9,20,6,1,80,38.23009761968075,-109.3610374
62024,27,13,9,21,5,1,76,38.23009761968075,-109.3607679
62025,29,11,7,17,4,1,69,38.23009761968075,-109.3604984
62026,26,9,6,16,4,1,62,38.23009761968075,-109.360229
62027,22,7,7,18,5,2,61,38.23009761968075,-109.3599595
62028,18,6,6,17,3,2,52,38.23009761968075,-109.35969
62029,15,7,4,8,1,0,35,38.23009761968075,-109.3594205
62030,14,10,3,0,2,0,29,38.23009761968075,-109.359151
62031,17,12,3,2,2,0,36,38.23009761968075,-109.3588815
62032,22,13,5,6,2,0,48,38.23009761968075,-109.358612
62033,28,15,8,14,6,2,73,38.23009761968075,-109.3583425
62034,25,15,10,18,14,4,86,38.23009761968075,-109.358073
62035,21,13,9,31,17,4,95,38.23009761968075,-109.3578035
62036,19,14,9,33,16,3,94,38.23009761968075,-109.357534
62037,12,19,11,29,17,3,91,38.23009761968075,-109.3572645
62038,7,21,14,25,18,5,90,38.23009761968075,-109.356995
62039,5,22,13,23,17,5,85,38.23009761968075,-109.3567255
62040,3,26,13,18,20,5,85,38.23009761968075,-109.356456
62041,1,28,10,18,19,1,77,38.23009761968075,-109.3561865
62042,0,35,9,16,12,1,73,38.23009761968075,-109.355917
62043,2,47,9,11,10,0,79,38.23009761968075,-109.3556475
62044,2,54,9,8,12,0,85,38.23009761968075,-109.355378
62045,1,53,9,5,15,0,83,38.23009761968075,-109.3551086
62046,0,55,8,1,15,2,81,38.23009761968075,-109.3548391
62047,0,61,8,2,14,1,86,38.23009761968075,-109.3545696
62048,0,62,7,2,13,2,86,38.23009761968075,-109.3543001
62049,0,62,7,2,13,1,85,38.23009761968075,-109.3540306
62050,0,57,8,2,14,2,83,38.23009761968075,-109.3537611
62051,1,49,8,1,15,4,78,38.23009761968075,-109.3534916
62052,2,45,10,3,17,3,80,38.23009761968075,-109.3532221
62053,3,49,12,4,18,2,88,38.23009761968075,-109.3529526
62054,3,48,12,5,18,3,89,38.23009761968075,-109.3526831
62055,4,48,13,6,18,2,91,38.23009761968075,-109.3524136
62056,4,48,13,6,19,1,91,38.23009761968075,-109.3521441
62057,3,50,11,4,17,2,87,38.23009761968075,-109.3518746
62058,1,51,8,2,14,4,80,38.23009761968075,-109.3516051
62059,0,55,7,2,12,4,80,38.23009761968075,-109.3513356
62060,11,46,13,12,13,0,95,38.229828125095516,-109.406582
62061,10,47,13,11,13,0,94,38.229828125095516,-109.4063125
62062,10,48,13,11,13,0,95,38.229828125095516,-109.406043
62063,9,47,13,11,14,0,94,38.229828125095516,-109.4057735
62064,9,48,13,11,14,0,95,38.229828125095516,-109.405504
62065,8,47,13,11,14,0,93,38.229828125095516,-109.4052345
62066,8,47,13,11,15,0,94,38.229828125095516,-109.4049651
62067,7,49,13,10,15,0,94,38.229828125095516,-109.4046956
62068,8,49,13,10,15,0,95,38.229828125095516,-109.4044261
62069,7,46,13,12,14,0,92,38.229828125095516,-109.4041566
62070,7,44,14,14,14,1,94,38.229828125095516,-109.4038871
62071,8,44,14,14,14,1,95,38.229828125095516,-109.4036176
62072,10,43,13,13,14,0,93,38.229828125095516,-109.4033481
62073,11,42,14,13,13,0,93,38.229828125095516,-109.4030786
62074,14,40,14,13,12,0,93,38.229828125095516,-109.4028091
62075,16,39,14,11,12,0,92,38.229828125095516,-109.4025396
62076,19,37,14,10,12,0,92,38.229828125095516,-109.4022701
62077,16,40,14,11,13,0,94,38.229828125095516,-109.4020006
62078,16,40,14,11,14,0,95,38.229828125095516,-109.4017311
62079,16,40,14,11,14,0,95,38.229828125095516,-109.4014616
62080,16,40,14,11,15,0,96,38.229828125095516,-109.4011921
62081,12,42,14,11,15,0,94,38.229828125095516,-109.4009226
62082,9,44,13,11,16,0,93,38.229828125095516,-109.4006531
62083,6,46,13,9,17,0,91,38.229828125095516,-109.4003836
62084,5,47,13,8,18,0,91,38.229828125095516,-109.4001142
62085,7,45,14,9,18,0,93,38.229828125095516,-109.3998447
62086,10,43,14,12,16,0,95,38.229828125095516,-109.3995752
62087,14,41,15,12,14,0,96,38.229828125095516,-109.3993057
62088,16,39,15,12,14,0,96,38.229828125095516,-109.3990362
62089,17,38,15,12,13,0,95,38.229828125095516,-109.3987667
62090,16,39,15,13,13,0,96,38.229828125095516,-109.3984972
62091,13,40,14,12,14,0,93,38.229828125095516,-109.3982277
62092,12,42,14,11,14,1,94,38.229828125095516,-109.3979582
62093,11,42,14,12,15,0,94,38.229828125095516,-109.3976887
62094,10,43,14,11,15,0,93,38.229828125095516,-109.3974192
62095,10,43,13,11,15,0,92,38.229828125095516,-109.3971497
62096,11,44,14,11,14,0,94,38.229828125095516,-109.3968802
62097,10,44,14,12,14,0,94,38.229828125095516,-109.3966107
62098,10,43,14,13,13,1,94,38.229828125095516,-109.3963412
62099,12,41,15,13,12,1,94,38.229828125095516,-109.3960717
62100,13,40,15,12,13,0,93,38.229828125095516,-109.3958022
62101,13,41,15,12,13,0,94,38.229828125095516,-109.3955327
62102,11,42,14,13,13,0,93,38.229828125095516,-109.3952632
62103,11,41,14,13,13,0,92,38.229828125095516,-109.3949938
62104,13,41,14,12,13,0,93,38.229828125095516,-109.3947243
62105,11,41,14,14,13,1,94,38.229828125095516,-109.3944548
62106,10,42,14,14,13,1,94,38.229828125095516,-109.3941853
62107,11,41,14,13,13,1,93,38.229828125095516,-109.3939158
62108,12,40,15,13,13,1,94,38.229828125095516,-109.3936463
62109,12,41,15,13,12,1,94,38.229828125095516,-109.3933768
62110,10,41,14,13,13,1,92,38.229828125095516,-109.3931073
62111,9,40,14,12,13,1,89,38.229828125095516,-109.3928378
62112,9,39,14,12,13,1,88,38.229828125095516,-109.3925683
62113,9,40,14,11,13,1,88,38.229828125095516,-109.3922988
62114,8,43,12,9,13,1,86,38.229828125095516,-109.3920293
62115,10,41,13,10,13,1,88,38.229828125095516,-109.3917598
62116,11,40,14,11,13,1,90,38.229828125095516,-109.3914903
62117,12,41,14,11,13,0,91,38.229828125095516,-109.3912208
62118,9,42,13,11,14,0,89,38.229828125095516,-109.3909513
62119,6,43,13,9,14,1,86,38.229828125095516,-109.3906818
62120,7,42,13,10,14,1,87,38.229828125095516,-109.3904123
62121,9,41,13,11,13,1,88,38.229828125095516,-109.3901429
62122,9,40,14,11,12,1,87,38.229828125095516,-109.3898734
62123,9,37,14,9,12,2,83,38.229828125095516,-109.3896039
62124,9,35,14,11,12,2,83,38.229828125095516,-109.3893344
62125,9,36,14,11,12,2,84,38.229828125095516,-109.3890649
62126,9,38,14,11,12,2,86,38.229828125095516,-109.3887954
62127,7,38,13,10,11,2,81,38.229828125095516,-109.3885259
62128,6,37,13,9,10,3,78,38.229828125095516,-109.3882564
62129,6,37,13,9,10,3,78,38.229828125095516,-109.3879869
62130,6,39,12,9,10,3,79,38.229828125095516,-109.3877174
62131,5,41,11,7,11,3,78,38.229828125095516,-109.3874479
62132,5,46,10,6,11,3,81,38.229828125095516,-109.3871784
62133,4,51,9,5,12,2,83,38.229828125095516,-109.3869089
62134,3,54,9,6,12,2,86,38.229828125095516,-109.3866394
62135,3,53,9,6,13,1,85,38.229828125095516,-109.3863699
62136,5,51,10,7,13,1,87,38.229828125095516,-109.3861004
62137,5,54,10,9,13,1,92,38.229828125095516,-109.3858309
62138,6,47,13,12,13,1,92,38.229828125095516,-109.3855614
62139,10,43,13,11,14,0,91,38.229828125095516,-109.3852919
62140,12,41,14,11,14,0,92,38.229828125095516,-109.3850225
62141,13,41,13,11,15,0,93,38.229828125095516,-109.384753
62142,12,43,13,10,14,0,92,38.229828125095516,-109.3844835
62143,11,44,13,10,14,0,92,38.229828125095516,-109.384214
62144,12,43,13,11,14,0,93,38.229828125095516,-109.3839445
62145,13,43,13,11,13,0,93,38.229828125095516,-109.383675
62146,13,43,13,11,14,0,94,38.229828125095516,-109.3834055
62147,11,44,13,12,13,0,93,38.229828125095516,-109.383136
62148,9,47,12,10,12,1,91,38.229828125095516,-109.3828665
62149,7,47,11,9,12,1,87,38.229828125095516,-109.382597
62150,7,46,11,8,12,2,86,38.229828125095516,-109.3823275
62151,6,48,11,7,11,1,84,38.229828125095516,-109.382058
62152,6,48,10,7,12,1,84,38.229828125095516,-109.3817885
62153,7,45,11,8,12,1,84,38.229828125095516,-109.381519
62154,8,45,11,8,12,1,85,38.229828125095516,-109.3812495
62155,8,45,11,9,12,1,86,38.229828125095516,-109.38098
62156,9,43,12,9,12,1,86,38.229828125095516,-109.3807105
62157,10,43,12,8,11,1,85,38.229828125095516,-109.380441
62158,10,43,13,9,11,1,87,38.229828125095516,-109.3801716
62159,11,43,13,10,12,1,90,38.229828125095516,-109.3799021
62160,11,42,13,11,12,1,90,38.229828125095516,-109.3796326
62161,13,40,13,10,12,1,89,38.229828125095516,-109.3793631
62162,15,38,14,11,11,1,90,38.229828125095516,-109.3790936
62163,16,36,13,12,11,1,89,38.229828125095516,-109.3788241
62164,16,36,13,12,12,0,89,38.229828125095516,-109.3785546
62165,12,42,12,8,14,0,88,38.229828125095516,-109.3782851
62166,7,45,11,7,14,1,85,38.229828125095516,-109.3780156
62167,3,45,9,5,13,2,77,38.229828125095516,-109.3777461
62168,1,40,9,5,12,4,71,38.229828125095516,-109.3774766
62169,2,26,9,13,8,4,62,38.229828125095516,-109.3772071
62170,9,26,11,18,12,0,76,38.229828125095516,-109.3769376
62171,4,25,10,7,9,7,62,38.229828125095516,-109.3766681
62172,6,31,11,9,9,6,72,38.229828125095516,-109.3763986
62173,10,39,13,11,10,2,85,38.229828125095516,-109.3761291
62174,8,42,12,11,11,2,86,38.229828125095516,-109.3758596
62175,8,49,12,11,12,1,93,38.229828125095516,-109.3755901
62176,27,34,12,10,9,0,92,38.229828125095516,-109.3753206
62177,37,26,11,11,10,0,95,38.229828125095516,-109.3750512
62178,15,28,13,14,10,4,84,38.229828125095516,-109.3747817
62179,5,31,11,4,9,8,68,38.229828125095516,-109.3745122
62180,3,43,8,6,11,2,73,38.229828125095516,-109.3742427
62181,3,46,9,6,14,2,80,38.229828125095516,-109.3739732
62182,5,50,11,8,13,1,88,38.229828125095516,-109.3737037
62183,11,45,12,10,11,1,90,38.229828125095516,-109.3734342
62184,9,42,12,8,15,1,87,38.229828125095516,-109.3731647
62185,7,43,11,6,15,2,84,38.229828125095516,-109.3728952
62186,8,43,12,6,15,2,86,38.229828125095516,-109.3726257
62187,11,43,13,7,14,1,89,38.229828125095516,-109.3723562
62188,14,41,14,10,12,0,91,38.229828125095516,-109.3720867
62189,13,42,14,10,12,1,92,38.229828125095516,-109.3718172
62190,11,42,14,10,12,1,90,38.229828125095516,-109.3715477
62191,11,42,14,10,12,2,91,38.229828125095516,-109.3712782
62192,10,42,14,9,13,2,90,38.229828125095516,-109.3710087
62193,8,41,14,8,13,2,86,38.229828125095516,-109.3707392
62194,10,43,13,8,12,2,88,38.229828125095516,-109.3704697
62195,8,43,12,7,12,2,84,38.229828125095516,-109.3702003
62196,6,43,11,6,13,3,82,38.229828125095516,-109.3699308
62197,5,44,11,6,13,2,81,38.229828125095516,-109.3696613
62198,4,47,10,5,13,2,81,38.229828125095516,-109.3693918
62199,2,49,9,4,13,3,80,38.229828125095516,-109.3691223
62200,1,49,9,3,13,4,79,38.229828125095516,-109.3688528
62201,1,50,9,3,13,4,80,38.229828125095516,-109.3685833
62202,1,53,9,3,13,3,82,38.229828125095516,-109.3683138
62203,1,52,10,1,15,5,84,38.229828125095516,-109.3680443
62204,2,53,11,2,17,2,87,38.229828125095516,-109.3677748
62205,3,49,11,4,17,2,86,38.229828125095516,-109.3675053
62206,5,41,10,5,16,3,80,38.229828125095516,-109.3672358
62207,4,30,10,4,13,7,68,38.229828125095516,-109.3669663
62208,2,39,10,2,14,7,74,38.229828125095516,-109.3666968
62209,3,51,11,2,16,3,86,38.229828125095516,-109.3664273
62210,3,55,11,3,16,2,90,38.229828125095516,-109.3661578
62211,4,55,12,4,15,2,92,38.229828125095516,-109.3658883
62212,4,52,12,5,15,2,90,38.229828125095516,-109.3656188
62213,4,53,12,5,16,1,91,38.229828125095516,-109.3653493
62214,5,53,12,5,17,1,93,38.229828125095516,-109.3650799
62215,4,49,12,4,18,1,88,38.229828125095516,-109.3648104
62216,4,40,12,3,17,5,81,38.229828125095516,-109.3645409
62217,2,32,11,3,13,9,70,38.229828125095516,-109.3642714
62218,1,33,10,2,9,11,66,38.229828125095516,-109.3640019
62219,5,32,11,7,9,9,73,38.229828125095516,-109.3637324
62220,22,33,11,10,9,2,87,38.229828125095516,-109.3634629
62221,26,22,5,2,3,0,58,38.229828125095516,-109.3631934
62222,20,24,3,0,3,0,50,38.229828125095516,-109.3629239
62223,20,26,5,3,4,0,58,38.229828125095516,-109.3626544
62224,26,29,8,11,6,0,80,38.229828125095516,-109.3623849
62225,28,30,10,16,7,1,92,38.229828125095516,-109.3621154
62226,25,27,8,12,6,0,78,38.229828125095516,-109.3618459
62227,26,22,7,11,5,0,71,38.229828125095516,-109.3615764
62228,27,18,7,11,4,0,67,38.229828125095516,-109.3613069
62229,27,15,7,15,4,0,68,38.229828125095516,-109.3610374
62230,26,13,8,16,4,1,68,38.229828125095516,-109.3607679
62231,26,10,6,14,2,1,59,38.229828125095516,-109.3604984
62232,23,6,6,15,3,1,54,38.229828125095516,-109.360229
62233,18,5,5,18,3,1,50,38.229828125095516,-109.3599595
62234,17,5,6,20,3,3,54,38.229828125095516,-109.35969
62235,20,5,6,17,3,2,53,38.229828125095516,-109.3594205
62236,16,5,4,8,1,1,35,38.229828125095516,-109.359151
62237,23,9,5,9,3,1,50,38.229828125095516,-109.3588815
62238,35,14,10,20,8,2,89,38.229828125095516,-109.358612
62239,16,16,11,28,16,5,92,38.229828125095516,-109.3583425
62240,5,22,14,20,17,13,91,38.229828125095516,-109.358073
62241,2,24,15,11,15,16,83,38.229828125095516,-109.3578035
62242,1,25,12,11,15,11,75,38.229828125095516,-109.357534
62243,1,30,10,14,16,3,74,38.229828125095516,-109.3572645
62244,2,34,10,13,15,2,76,38.229828125095516,-109.356995
62245,2,35,10,15,13,2,77,38.229828125095516,-109.3567255
62246,2,42,10,11,12,1,78,38.229828125095516,-109.356456
62247,2,48,9,9,11,1,80,38.229828125095516,-109.3561865
62248,2,53,8,9,9,1,82,38.229828125095516,-109.355917
62249,2,61,8,9,9,0,89,38.229828125095516,-109.3556475
62250,1,62,8,6,11,0,88,38.229828125095516,-109.355378
62251,1,63,8,5,12,1,90,38.229828125095516,-109.3551086
62252,0,63,7,3,11,1,85,38.229828125095516,-109.3548391
62253,1,64,7,3,11,1,87,38.229828125095516,-109.3545696
62254,1,64,7,4,10,1,87,38.229828125095516,-109.3543001
62255,1,65,7,4,10,0,87,38.229828125095516,-109.3540306
62256,1,60,8,4,12,0,85,38.229828125095516,-109.3537611
62257,0,56,8,3,14,1,82,38.229828125095516,-109.3534916
62258,1,51,8,1,15,3,79,38.229828125095516,-109.3532221
62259,1,47,9,3,16,3,79,38.229828125095516,-109.3529526
62260,2,45,10,4,17,3,81,38.229828125095516,-109.3526831
62261,2,44,10,5,17,2,80,38.229828125095516,-109.3524136
62262,3,46,10,5,16,2,82,38.229828125095516,-109.3521441
62263,2,49,9,4,14,3,81,38.229828125095516,-109.3518746
62264,0,53,7,2,12,4,78,38.229828125095516,-109.3516051
62265,0,54,7,2,10,3,76,38.229828125095516,-109.3513356
62266,11,46,13,11,13,0,94,38.229558630510276,-109.406582
62267,9,49,12,10,13,0,93,38.229558630510276,-109.4063125
62268,8,50,12,10,13,0,93,38.229558630510276,-109.406043
62269,7,48,12,11,14,1,93,38.229558630510276,-109.4057735
62270,6,47,12,11,15,0,91,38.229558630510276,-109.405504
62271,6,48,12,10,16,0,92,38.229558630510276,-109.4052345
62272,6,49,12,10,16,0,93,38.229558630510276,-109.4049651
62273,4,48,12,11,16,0,91,38.229558630510276,-109.4046956
62274,6,49,12,10,15,0,92,38.229558630510276,-109.4044261
62275,7,45,14,14,13,0,93,38.229558630510276,-109.4041566
62276,7,44,14,15,14,0,94,38.229558630510276,-109.4038871
62277,6,44,14,14,14,1,93,38.229558630510276,-109.4036176
62278,10,44,13,11,13,0,91,38.229558630510276,-109.4033481
62279,13,42,14,13,12,0,94,38.229558630510276,-109.4030786
62280,17,37,15,14,11,0,94,38.229558630510276,-109.4028091
62281,20,34,15,13,11,0,93,38.229558630510276,-109.4025396
62282,25,32,14,11,11,0,93,38.229558630510276,-109.4022701
62283,22,36,14,11,11,0,94,38.229558630510276,-109.4020006
62284,20,37,14,11,12,0,94,38.229558630510276,-109.4017311
62285,19,37,14,11,13,0,94,38.229558630510276,-109.4014616
62286,18,37,14,11,13,0,93,38.229558630510276,-109.4011921
62287,16,39,14,12,13,0,94,38.229558630510276,-109.4009226
62288,14,40,13,11,15,0,93,38.229558630510276,-109.4006531
62289,11,42,13,10,17,0,93,38.229558630510276,-109.4003836
62290,10,43,14,9,17,0,93,38.229558630510276,-109.4001142
62291,10,43,14,9,17,0,93,38.229558630510276,-109.3998447
62292,12,44,13,9,15,0,93,38.229558630510276,-109.3995752
62293,15,41,14,11,14,0,95,38.229558630510276,-109.3993057
62294,15,40,14,11,14,0,94,38.229558630510276,-109.3990362
62295,15,40,15,12,13,0,95,38.229558630510276,-109.3987667
62296,15,39,15,12,13,0,94,38.229558630510276,-109.3984972
62297,12,41,14,12,14,1,94,38.229558630510276,-109.3982277
62298,12,42,14,11,14,1,94,38.229558630510276,-109.3979582
62299,10,44,13,10,14,0,91,38.229558630510276,-109.3976887
62300,10,44,13,9,15,0,91,38.229558630510276,-109.3974192
62301,11,43,14,10,14,0,92,38.229558630510276,-109.3971497
62302,11,43,14,11,14,0,93,38.229558630510276,-109.3968802
62303,10,44,14,12,14,0,94,38.229558630510276,-109.3966107
62304,10,43,15,13,13,0,94,38.229558630510276,-109.3963412
62305,13,40,15,13,13,0,94,38.229558630510276,-109.3960717
62306,14,39,15,12,13,0,93,38.229558630510276,-109.3958022
62307,14,39,15,12,13,0,93,38.229558630510276,-109.3955327
62308,14,39,15,13,13,0,94,38.229558630510276,-109.3952632
62309,13,39,15,13,13,0,93,38.229558630510276,-109.3949938
62310,12,41,14,13,14,0,94,38.229558630510276,-109.3947243
62311,10,42,15,14,14,1,96,38.229558630510276,-109.3944548
62312,10,42,15,13,14,1,95,38.229558630510276,-109.3941853
62313,11,42,15,13,14,1,96,38.229558630510276,-109.3939158
62314,11,40,15,13,13,1,93,38.229558630510276,-109.3936463
62315,11,38,15,13,12,1,90,38.229558630510276,-109.3933768
62316,12,39,15,13,13,1,93,38.229558630510276,-109.3931073
62317,11,38,14,13,13,1,90,38.229558630510276,-109.3928378
62318,11,37,14,13,13,1,89,38.229558630510276,-109.3925683
62319,10,40,14,12,13,1,90,38.229558630510276,-109.3922988
62320,7,43,12,10,13,1,86,38.229558630510276,-109.3920293
62321,8,41,13,11,13,1,87,38.229558630510276,-109.3917598
62322,9,40,13,11,13,1,87,38.229558630510276,-109.3914903
62323,8,41,13,11,13,1,87,38.229558630510276,-109.3912208
62324,5,42,12,9,13,1,82,38.229558630510276,-109.3909513
62325,6,44,12,8,13,1,84,38.229558630510276,-109.3906818
62326,6,43,12,9,13,2,85,38.229558630510276,-109.3904123
62327,8,40,13,11,13,1,86,38.229558630510276,-109.3901429
62328,9,37,14,11,13,1,85,38.229558630510276,-109.3898734
62329,8,38,13,10,12,2,83,38.229558630510276,-109.3896039
62330,8,38,13,10,12,2,83,38.229558630510276,-109.3893344
62331,9,38,13,10,12,1,83,38.229558630510276,-109.3890649
62332,9,38,13,11,13,1,85,38.229558630510276,-109.3887954
62333,7,39,13,11,12,2,84,38.229558630510276,-109.3885259
62334,5,39,12,9,11,3,79,38.229558630510276,-109.3882564
62335,6,40,12,9,11,2,80,38.229558630510276,-109.3879869
62336,5,44,11,8,11,2,81,38.229558630510276,-109.3877174
62337,5,48,10,6,11,2,82,38.229558630510276,-109.3874479
62338,4,51,9,5,12,2,83,38.229558630510276,-109.3871784
62339,3,54,9,5,12,1,84,38.229558630510276,-109.3869089
62340,3,53,10,5,12,2,85,38.229558630510276,-109.3866394
62341,3,52,10,4,13,2,84,38.229558630510276,-109.3863699
62342,3,52,10,4,14,2,85,38.229558630510276,-109.3861004
62343,4,52,10,8,14,0,88,38.229558630510276,-109.3858309
62344,6,48,12,9,15,0,90,38.229558630510276,-109.3855614
62345,8,46,13,10,15,0,92,38.229558630510276,-109.3852919
62346,9,45,12,9,15,0,90,38.229558630510276,-109.3850225
62347,8,46,12,8,15,0,89,38.229558630510276,-109.384753
62348,11,46,12,10,14,0,93,38.229558630510276,-109.3844835
62349,11,45,12,10,14,0,92,38.229558630510276,-109.384214
62350,10,45,13,11,13,0,92,38.229558630510276,-109.3839445
62351,8,46,12,10,13,1,90,38.229558630510276,-109.383675
62352,6,46,11,9,12,1,85,38.229558630510276,-109.3834055
62353,5,49,9,7,12,1,83,38.229558630510276,-109.383136
62354,4,51,9,5,11,2,82,38.229558630510276,-109.3828665
62355,5,49,9,5,11,2,81,38.229558630510276,-109.382597
62356,5,47,10,6,11,2,81,38.229558630510276,-109.3823275
62357,5,47,10,6,11,1,80,38.229558630510276,-109.382058
62358,6,47,10,5,10,2,80,38.229558630510276,-109.3817885
62359,8,45,11,6,10,1,81,38.229558630510276,-109.381519
62360,10,44,12,8,11,1,86,38.229558630510276,-109.3812495
62361,11,44,13,10,11,1,90,38.229558630510276,-109.38098
62362,10,42,13,11,12,1,89,38.229558630510276,-109.3807105
62363,8,42,13,12,12,1,88,38.229558630510276,-109.380441
62364,7,44,13,11,11,1,87,38.229558630510276,-109.3801716
62365,8,44,13,11,11,2,89,38.229558630510276,-109.3799021
62366,10,43,14,10,11,2,90,38.229558630510276,-109.3796326
62367,12,40,13,10,11,2,88,38.229558630510276,-109.3793631
62368,13,38,13,12,11,2,89,38.229558630510276,-109.3790936
62369,15,36,13,12,11,1,88,38.229558630510276,-109.3788241
62370,17,36,13,12,12,0,90,38.229558630510276,-109.3785546
62371,15,40,13,10,12,0,90,38.229558630510276,-109.3782851
62372,9,46,11,6,12,1,85,38.229558630510276,-109.3780156
62373,4,45,10,4,13,2,78,38.229558630510276,-109.3777461
62374,4,37,10,5,13,4,73,38.229558630510276,-109.3774766
62375,6,22,10,10,10,4,62,38.229558630510276,-109.3772071
62376,13,28,10,14,10,0,75,38.229558630510276,-109.3769376
62377,4,24,10,8,10,7,63,38.229558630510276,-109.3766681
62378,9,32,12,10,12,3,78,38.229558630510276,-109.3763986
62379,10,45,12,9,11,2,89,38.229558630510276,-109.3761291
62380,4,51,10,7,10,2,84,38.229558630510276,-109.3758596
62381,5,52,11,12,11,0,91,38.229558630510276,-109.3755901
62382,21,34,12,12,12,0,91,38.229558630510276,-109.3753206
62383,24,30,12,13,12,1,92,38.229558630510276,-109.3750512
62384,9,30,12,10,11,8,80,38.229558630510276,-109.3747817
62385,4,28,12,5,9,10,68,38.229558630510276,-109.3745122
62386,4,34,9,3,10,7,67,38.229558630510276,-109.3742427
62387,3,41,9,6,13,3,75,38.229558630510276,-109.3739732
62388,5,47,10,8,13,1,84,38.229558630510276,-109.3737037
62389,11,45,12,9,12,1,90,38.229558630510276,-109.3734342
62390,9,41,12,7,15,1,85,38.229558630510276,-109.3731647
62391,7,43,11,6,16,1,84,38.229558630510276,-109.3728952
62392,9,43,12,8,16,0,88,38.229558630510276,-109.3726257
62393,12,42,13,9,14,0,90,38.229558630510276,-109.3723562
62394,15,40,14,10,12,0,91,38.229558630510276,-109.3720867
62395,13,41,14,10,12,1,91,38.229558630510276,-109.3718172
62396,11,41,14,10,12,2,90,38.229558630510276,-109.3715477
62397,10,41,14,9,12,2,88,38.229558630510276,-109.3712782
62398,9,43,14,8,12,2,88,38.229558630510276,-109.3710087
62399,8,45,13,7,12,2,87,38.229558630510276,-109.3707392
62400,6,47,11,5,13,1,83,38.229558630510276,-109.3704697
62401,4,46,10,6,14,2,82,38.229558630510276,-109.3702003
62402,3,48,9,6,13,2,81,38.229558630510276,-109.3699308
62403,2,51,9,4,12,3,81,38.229558630510276,-109.3696613
62404,2,53,8,5,11,2,81,38.229558630510276,-109.3693918
62405,2,54,8,5,12,2,83,38.229558630510276,-109.3691223
62406,2,53,9,4,13,2,83,38.229558630510276,-109.3688528
62407,3,52,10,3,14,3,85,38.229558630510276,-109.3685833
62408,4,48,11,3,14,4,84,38.229558630510276,-109.3683138
62409,4,45,12,4,16,4,85,38.229558630510276,-109.3680443
62410,4,49,12,6,16,2,89,38.229558630510276,-109.3677748
62411,5,48,12,6,16,2,89,38.229558630510276,-109.3675053
62412,5,41,11,6,16,2,81,38.229558630510276,-109.3672358
62413,4,28,10,7,13,5,67,38.229558630510276,-109.3669663
62414,2,30,11,5,12,7,67,38.229558630510276,-109.3666968
62415,3,44,11,3,15,4,80,38.229558630510276,-109.3664273
62416,3,50,10,3,14,3,83,38.229558630510276,-109.3661578
62417,3,49,10,3,14,3,82,38.229558630510276,-109.3658883
62418,3,45,10,4,14,4,80,38.229558630510276,-109.3656188
62419,4,45,10,7,11,3,80,38.229558630510276,-109.3653493
62420,3,43,10,5,14,3,78,38.229558630510276,-109.3650799
62421,3,44,11,5,16,2,81,38.229558630510276,-109.3648104
62422,3,43,11,4,16,3,80,38.229558630510276,-109.3645409
62423,2,44,9,2,15,5,77,38.229558630510276,-109.3642714
62424,1,40,9,1,11,9,71,38.229558630510276,-109.3640019
62425,2,33,9,4,8,11,67,38.229558630510276,-109.3637324
62426,18,35,13,8,8,5,87,38.229558630510276,-109.3634629
62427,27,23,5,3,2,0,60,38.229558630510276,-109.3631934
62428,17,23,2,0,3,0,45,38.229558630510276,-109.3629239
62429,17,25,3,1,3,0,49,38.229558630510276,-109.3626544
62430,20,26,5,5,3,0,59,38.229558630510276,-109.3623849
62431,26,24,7,10,4,0,71,38.229558630510276,-109.3621154
62432,28,19,7,9,4,0,67,38.229558630510276,-109.3618459
62433,30,20,8,13,4,1,76,38.229558630510276,-109.3615764
62434,32,19,8,14,4,0,77,38.229558630510276,-109.3613069
62435,28,14,7,14,3,0,66,38.229558630510276,-109.3610374
62436,25,10,7,15,3,1,61,38.229558630510276,-109.3607679
62437,28,6,6,17,3,1,61,38.229558630510276,-109.3604984
62438,18,4,5,22,3,2,54,38.229558630510276,-109.360229
62439,15,4,5,19,2,2,47,38.229558630510276,-109.3599595
62440,18,5,5,14,2,1,45,38.229558630510276,-109.35969
62441,21,5,5,12,2,1,46,38.229558630510276,-109.3594205
62442,25,9,7,17,6,3,67,38.229558630510276,-109.359151
62443,24,17,11,19,11,3,85,38.229558630510276,-109.3588815
62444,9,23,12,24,14,6,88,38.229558630510276,-109.358612
62445,3,27,14,15,16,8,83,38.229558630510276,-109.3583425
62446,1,26,13,9,14,12,75,38.229558630510276,-109.358073
62447,0,29,11,3,12,12,67,38.229558630510276,-109.3578035
62448,1,36,10,6,12,6,71,38.229558630510276,-109.357534
62449,1,46,9,8,10,3,77,38.229558630510276,-109.3572645
62450,1,50,9,6,9,2,77,38.229558630510276,-109.356995
62451,2,51,9,7,9,1,79,38.229558630510276,-109.3567255
62452,2,52,8,6,9,1,78,38.229558630510276,-109.356456
62453,2,52,8,5,9,1,77,38.229558630510276,-109.3561865
62454,1,53,7,4,9,1,75,38.229558630510276,-109.355917
62455,1,56,7,4,10,1,79,38.229558630510276,-109.3556475
62456,1,54,7,3,10,2,77,38.229558630510276,-109.355378
62457,1,54,7,2,10,2,76,38.229558630510276,-109.3551086
62458,1,55,7,3,10,2,78,38.229558630510276,-109.3548391
62459,1,56,7,3,10,1,78,38.229558630510276,-109.3545696
62460,1,53,7,3,9,2,75,38.229558630510276,-109.3543001
62461,2,57,8,5,9,1,82,38.229558630510276,-109.3540306
62462,2,57,8,5,9,1,82,38.229558630510276,-109.3537611
62463,1,58,8,4,11,1,83,38.229558630510276,-109.3534916
62464,1,57,8,3,12,2,83,38.229558630510276,-109.3532221
62465,1,55,7,3,12,2,80,38.229558630510276,-109.3529526
62466,1,49,8,3,13,3,77,38.229558630510276,-109.3526831
62467,1,46,8,3,14,3,75,38.229558630510276,-109.3524136
62468,1,47,8,3,13,4,76,38.229558630510276,-109.3521441
62469,0,53,7,3,12,3,78,38.229558630510276,-109.3518746
62470,0,56,7,2,11,3,79,38.229558630510276,-109.3516051
62471,0,52,7,2,10,3,74,38.229558630510276,-109.3513356
62472,10,47,12,9,13,0,91,38.22928913592504,-109.406582
62473,9,48,12,10,13,0,92,38.22928913592504,-109.4063125
62474,8,45,13,12,14,0,92,38.22928913592504,-109.406043
62475,9,43,13,13,15,1,94,38.22928913592504,-109.4057735
62476,8,43,13,13,15,0,92,38.22928913592504,-109.405504
62477,7,44,13,13,15,0,92,38.22928913592504,-109.4052345
62478,7,44,13,14,14,0,92,38.22928913592504,-109.4049651
62479,8,46,13,13,14,0,94,38.22928913592504,-109.4046956
62480,6,49,13,13,13,0,94,38.22928913592504,-109.4044261
62481,5,49,13,12,13,1,93,38.22928913592504,-109.4041566
62482,6,49,13,12,13,1,94,38.22928913592504,-109.4038871
62483,7,48,13,12,13,1,94,38.22928913592504,-109.4036176
62484,8,48,13,9,13,1,92,38.22928913592504,-109.4033481
62485,10,45,14,11,13,0,93,38.22928913592504,-109.4030786
62486,12,40,14,14,12,0,92,38.22928913592504,-109.4028091
62487,18,35,15,14,12,0,94,38.22928913592504,-109.4025396
62488,23,33,15,13,11,0,95,38.22928913592504,-109.4022701
62489,22,34,14,13,11,0,94,38.22928913592504,-109.4020006
62490,22,34,14,12,11,0,93,38.22928913592504,-109.4017311
62491,20,36,14,12,12,0,94,38.22928913592504,-109.4014616
62492,17,38,14,12,13,0,94,38.22928913592504,-109.4011921
62493,13,41,14,11,14,0,93,38.22928913592504,-109.4009226
62494,12,41,13,11,15,0,92,38.22928913592504,-109.4006531
62495,12,42,13,10,16,0,93,38.22928913592504,-109.4003836
62496,11,43,13,9,17,0,93,38.22928913592504,-109.4001142
62497,11,43,14,10,16,0,94,38.22928913592504,-109.3998447
62498,12,45,13,10,14,0,94,38.22928913592504,-109.3995752
62499,15,42,14,10,14,0,95,38.22928913592504,-109.3993057
62500,14,41,14,11,14,0,94,38.22928913592504,-109.3990362
62501,14,41,14,11,14,0,94,38.22928913592504,-109.3987667
62502,15,41,14,11,14,0,95,38.22928913592504,-109.3984972
62503,15,41,14,11,14,0,95,38.22928913592504,-109.3982277
62504,14,42,13,10,14,0,93,38.22928913592504,-109.3979582
62505,14,43,13,9,14,0,93,38.22928913592504,-109.3976887
62506,13,44,13,9,14,0,93,38.22928913592504,-109.3974192
62507,14,42,13,10,14,0,93,38.22928913592504,-109.3971497
62508,13,42,14,12,14,0,95,38.22928913592504,-109.3968802
62509,12,42,15,13,13,0,95,38.22928913592504,-109.3966107
62510,11,42,14,13,13,0,93,38.22928913592504,-109.3963412
62511,12,40,14,13,13,0,92,38.22928913592504,-109.3960717
62512,14,40,14,12,13,0,93,38.22928913592504,-109.3958022
62513,13,40,14,13,13,0,93,38.22928913592504,-109.3955327
62514,13,39,14,13,13,0,92,38.22928913592504,-109.3952632
62515,13,40,15,13,13,0,94,38.22928913592504,-109.3949938
62516,11,42,15,13,14,1,96,38.22928913592504,-109.3947243
62517,10,42,15,14,14,1,96,38.22928913592504,-109.3944548
62518,11,42,15,13,14,0,95,38.22928913592504,-109.3941853
62519,11,42,15,13,14,0,95,38.22928913592504,-109.3939158
62520,11,41,15,14,14,1,96,38.22928913592504,-109.3936463
62521,12,38,15,14,13,1,93,38.22928913592504,-109.3933768
62522,11,39,14,13,13,1,91,38.22928913592504,-109.3931073
62523,12,40,15,13,13,1,94,38.22928913592504,-109.3928378
62524,12,41,14,12,13,1,93,38.22928913592504,-109.3925683
62525,10,43,13,11,13,1,91,38.22928913592504,-109.3922988
62526,6,44,11,8,13,1,83,38.22928913592504,-109.3920293
62527,6,43,12,9,14,1,85,38.22928913592504,-109.3917598
62528,5,42,12,10,13,1,83,38.22928913592504,-109.3914903
62529,5,43,12,9,13,1,83,38.22928913592504,-109.3912208
62530,4,46,11,8,13,1,83,38.22928913592504,-109.3909513
62531,3,48,10,6,13,2,82,38.22928913592504,-109.3906818
62532,4,46,11,8,13,1,83,38.22928913592504,-109.3904123
62533,6,44,12,11,13,1,87,38.22928913592504,-109.3901429
62534,8,43,13,12,12,1,89,38.22928913592504,-109.3898734
62535,6,44,12,10,12,1,85,38.22928913592504,-109.3896039
62536,5,44,11,9,12,2,83,38.22928913592504,-109.3893344
62537,7,44,11,9,12,1,84,38.22928913592504,-109.3890649
62538,8,43,12,10,13,1,87,38.22928913592504,-109.3887954
62539,7,43,12,10,12,1,85,38.22928913592504,-109.3885259
62540,6,44,11,9,12,2,84,38.22928913592504,-109.3882564
62541,6,41,11,10,11,2,81,38.22928913592504,-109.3879869
62542,7,42,11,9,12,1,82,38.22928913592504,-109.3877174
62543,8,42,11,7,11,1,80,38.22928913592504,-109.3874479
62544,7,42,12,8,11,1,81,38.22928913592504,-109.3871784
62545,6,44,12,8,11,1,82,38.22928913592504,-109.3869089
62546,4,47,12,8,12,2,85,38.22928913592504,-109.3866394
62547,3,52,10,5,12,3,85,38.22928913592504,-109.3863699
62548,3,52,10,5,12,2,84,38.22928913592504,-109.3861004
62549,4,47,11,9,14,1,86,38.22928913592504,-109.3858309
62550,6,47,12,11,14,1,91,38.22928913592504,-109.3855614
62551,10,47,13,10,14,0,94,38.22928913592504,-109.3852919
62552,10,49,12,8,14,0,93,38.22928913592504,-109.3850225
62553,8,51,11,8,15,0,93,38.22928913592504,-109.384753
62554,8,50,11,9,13,0,91,38.22928913592504,-109.3844835
62555,7,52,11,8,12,1,91,38.22928913592504,-109.384214
62556,5,51,10,8,12,1,87,38.22928913592504,-109.3839445
62557,5,51,10,7,12,1,86,38.22928913592504,-109.383675
62558,4,54,9,6,12,1,86,38.22928913592504,-109.3834055
62559,3,54,8,5,11,1,82,38.22928913592504,-109.383136
62560,5,52,9,5,10,1,82,38.22928913592504,-109.3828665
62561,6,48,10,6,10,1,81,38.22928913592504,-109.382597
62562,7,44,11,8,10,1,81,38.22928913592504,-109.3823275
62563,7,41,12,10,11,2,83,38.22928913592504,-109.382058
62564,9,41,13,10,11,1,85,38.22928913592504,-109.3817885
62565,10,40,13,11,11,1,86,38.22928913592504,-109.381519
62566,9,41,13,11,12,1,87,38.22928913592504,-109.3812495
62567,9,40,13,12,12,1,87,38.22928913592504,-109.38098
62568,8,40,14,13,11,1,87,38.22928913592504,-109.3807105
62569,8,42,14,12,11,1,88,38.22928913592504,-109.380441
62570,8,43,14,11,10,2,88,38.22928913592504,-109.3801716
62571,8,43,13,10,10,2,86,38.22928913592504,-109.3799021
62572,8,43,13,11,10,2,87,38.22928913592504,-109.3796326
62573,10,42,13,10,10,2,87,38.22928913592504,-109.3793631
62574,9,40,14,11,11,2,87,38.22928913592504,-109.3790936
62575,10,38,13,12,11,2,86,38.22928913592504,-109.3788241
62576,12,38,13,12,11,1,87,38.22928913592504,-109.3785546
62577,13,38,13,12,12,1,89,38.22928913592504,-109.3782851
62578,10,41,13,10,13,1,88,38.22928913592504,-109.3780156
62579,6,38,12,8,12,3,79,38.22928913592504,-109.3777461
62580,5,31,11,10,12,4,73,38.22928913592504,-109.3774766
62581,6,23,11,13,11,4,68,38.22928913592504,-109.3772071
62582,5,24,9,16,10,2,66,38.22928913592504,-109.3769376
62583,5,26,10,14,10,4,69,38.22928913592504,-109.3766681
62584,9,33,12,12,13,3,82,38.22928913592504,-109.3763986
62585,8,45,12,10,11,2,88,38.22928913592504,-109.3761291
62586,6,54,10,8,11,1,90,38.22928913592504,-109.3758596
62587,12,41,13,14,12,0,92,38.22928913592504,-109.3755901
62588,19,32,12,16,13,0,92,38.22928913592504,-109.3753206
62589,14,33,12,14,13,2,88,38.22928913592504,-109.3750512
62590,7,33,12,6,11,9,78,38.22928913592504,-109.3747817
62591,3,32,12,4,9,11,71,38.22928913592504,-109.3745122
62592,2,28,10,2,8,11,61,38.22928913592504,-109.3742427
62593,5,39,9,7,11,3,74,38.22928913592504,-109.3739732
62594,7,44,10,8,13,1,83,38.22928913592504,-109.3737037
62595,10,45,11,8,14,1,89,38.22928913592504,-109.3734342
62596,11,43,11,7,15,0,87,38.22928913592504,-109.3731647
62597,6,41,10,5,16,1,79,38.22928913592504,-109.3728952
62598,8,44,12,9,16,0,89,38.22928913592504,-109.3726257
62599,10,44,13,10,15,0,92,38.22928913592504,-109.3723562
62600,10,43,13,9,13,2,90,38.22928913592504,-109.3720867
62601,7,42,12,8,13,2,84,38.22928913592504,-109.3718172
62602,6,43,12,7,12,2,82,38.22928913592504,-109.3715477
62603,5,45,11,6,13,2,82,38.22928913592504,-109.3712782
62604,5,47,11,5,13,2,83,38.22928913592504,-109.3710087
62605,4,49,10,5,12,2,82,38.22928913592504,-109.3707392
62606,3,50,9,4,11,3,80,38.22928913592504,-109.3704697
62607,3,50,9,6,11,2,81,38.22928913592504,-109.3702003
62608,2,53,9,5,11,2,82,38.22928913592504,-109.3699308
62609,2,55,8,4,11,2,82,38.22928913592504,-109.3696613
62610,2,53,9,6,12,2,84,38.22928913592504,-109.3693918
62611,3,52,9,7,13,1,85,38.22928913592504,-109.3691223
62612,4,50,10,7,13,1,85,38.22928913592504,-109.3688528
62613,5,49,11,7,13,2,87,38.22928913592504,-109.3685833
62614,7,48,12,8,13,3,91,38.22928913592504,-109.3683138
62615,5,48,11,6,14,4,88,38.22928913592504,-109.3680443
62616,4,53,11,6,13,3,90,38.22928913592504,-109.3677748
62617,4,51,11,6,13,3,88,38.22928913592504,-109.3675053
62618,4,44,10,6,14,2,80,38.22928913592504,-109.3672358
62619,5,33,10,6,13,3,70,38.22928913592504,-109.3669663
62620,7,28,10,7,10,5,67,38.22928913592504,-109.3666968
62621,3,39,10,5,14,4,75,38.22928913592504,-109.3664273
62622,2,45,9,4,13,4,77,38.22928913592504,-109.3661578
62623,2,48,9,5,11,3,78,38.22928913592504,-109.3658883
62624,3,47,9,5,11,3,78,38.22928913592504,-109.3656188
62625,2,46,9,4,11,4,76,38.22928913592504,-109.3653493
62626,2,45,9,4,13,4,77,38.22928913592504,-109.3650799
62627,1,42,9,3,14,4,73,38.22928913592504,-109.3648104
62628,2,45,10,2,14,4,77,38.22928913592504,-109.3645409
62629,1,54,9,0,13,4,81,38.22928913592504,-109.3642714
62630,1,50,8,2,13,4,78,38.22928913592504,-109.3640019
62631,1,40,8,4,10,6,69,38.22928913592504,-109.3637324
62632,6,29,10,10,10,7,72,38.22928913592504,-109.3634629
62633,29,30,11,9,7,3,89,38.22928913592504,-109.3631934
62634,19,19,3,1,3,0,45,38.22928913592504,-109.3629239
62635,16,21,3,1,2,0,43,38.22928913592504,-109.3626544
62636,18,22,4,2,2,0,48,38.22928913592504,-109.3623849
62637,26,22,6,7,3,0,64,38.22928913592504,-109.3621154
62638,29,18,8,13,4,1,73,38.22928913592504,-109.3618459
62639,36,20,10,17,6,1,90,38.22928913592504,-109.3615764
62640,36,17,9,17,5,1,85,38.22928913592504,-109.3613069
62641,30,13,7,14,3,0,67,38.22928913592504,-109.3610374
62642,28,10,6,14,2,1,61,38.22928913592504,-109.3607679
62643,29,5,7,20,3,1,65,38.22928913592504,-109.3604984
62644,16,4,5,16,3,1,45,38.22928913592504,-109.360229
62645,16,4,4,11,2,1,38,38.22928913592504,-109.3599595
62646,22,6,5,10,2,1,46,38.22928913592504,-109.35969
62647,30,13,8,14,7,2,74,38.22928913592504,-109.3594205
62648,17,23,12,14,10,8,84,38.22928913592504,-109.359151
62649,2,27,13,7,9,17,75,38.22928913592504,-109.3588815
62650,0,28,12,2,8,19,69,38.22928913592504,-109.358612
62651,0,27,11,1,7,19,65,38.22928913592504,-109.3583425
62652,1,28,11,0,6,18,64,38.22928913592504,-109.358073
62653,0,38,9,0,10,11,68,38.22928913592504,-109.3578035
62654,1,43,9,3,11,5,72,38.22928913592504,-109.357534
62655,1,46,9,4,9,3,72,38.22928913592504,-109.3572645
62656,1,48,9,2,8,3,71,38.22928913592504,-109.356995
62657,1,47,8,2,9,3,70,38.22928913592504,-109.3567255
62658,1,45,8,2,9,3,68,38.22928913592504,-109.356456
62659,1,43,8,2,9,3,66,38.22928913592504,-109.3561865
62660,1,42,7,2,8,3,63,38.22928913592504,-109.355917
62661,1,43,7,2,9,3,65,38.22928913592504,-109.3556475
62662,1,39,7,2,9,4,62,38.22928913592504,-109.355378
62663,1,38,8,2,10,5,64,38.22928913592504,-109.3551086
62664,0,37,7,2,10,5,61,38.22928913592504,-109.3548391
62665,0,38,7,2,10,5,62,38.22928913592504,-109.3545696
62666,1,39,8,2,10,4,64,38.22928913592504,-109.3543001
62667,1,42,8,4,10,3,68,38.22928913592504,-109.3540306
62668,2,46,8,4,9,2,71,38.22928913592504,-109.3537611
62669,1,49,8,3,9,2,72,38.22928913592504,-109.3534916
62670,1,52,8,3,10,2,76,38.22928913592504,-109.3532221
62671,1,53,8,4,10,2,78,38.22928913592504,-109.3529526
62672,1,55,7,3,10,2,78,38.22928913592504,-109.3526831
62673,1,57,7,3,11,2,81,38.22928913592504,-109.3524136
62674,0,57,7,2,11,2,79,38.22928913592504,-109.3521441
62675,0,57,7,2,11,2,79,38.22928913592504,-109.3518746
62676,0,53,7,1,10,3,74,38.22928913592504,-109.3516051
62677,0,45,7,0,9,4,65,38.22928913592504,-109.3513356
62678,7,48,12,11,15,0,93,38.229019641339804,-109.406582
62679,8,45,13,11,15,0,92,38.229019641339804,-109.4063125
62680,9,41,14,14,15,0,93,38.229019641339804,-109.406043
62681,8,44,14,13,15,1,95,38.229019641339804,-109.4057735
62682,7,46,14,12,15,1,95,38.229019641339804,-109.405504
62683,7,46,13,13,14,1,94,38.229019641339804,-109.4052345
62684,8,45,13,14,14,1,95,38.229019641339804,-109.4049651
62685,10,45,13,13,14,1,96,38.229019641339804,-109.4046956
62686,8,45,13,13,14,0,93,38.229019641339804,-109.4044261
62687,6,46,13,13,14,0,92,38.229019641339804,-109.4041566
62688,6,46,13,13,14,1,93,38.229019641339804,-109.4038871
62689,6,47,14,13,14,1,95,38.229019641339804,-109.4036176
62690,7,45,14,13,14,1,94,38.229019641339804,-109.4033481
62691,7,45,14,12,14,1,93,38.229019641339804,-109.4030786
62692,8,43,14,13,14,1,93,38.229019641339804,-109.4028091
62693,10,40,14,14,14,0,92,38.229019641339804,-109.4025396
62694,12,38,14,15,13,0,92,38.229019641339804,-109.4022701
62695,14,37,14,14,13,0,92,38.229019641339804,-109.4020006
62696,17,37,14,12,12,0,92,38.229019641339804,-109.4017311
62697,18,38,14,12,12,0,94,38.229019641339804,-109.4014616
62698,14,39,14,12,13,0,92,38.229019641339804,-109.4011921
62699,10,42,14,13,14,0,93,38.229019641339804,-109.4009226
62700,9,44,13,11,15,0,92,38.229019641339804,-109.4006531
62701,9,44,13,10,16,0,92,38.229019641339804,-109.4003836
62702,11,42,14,10,16,0,93,38.229019641339804,-109.4001142
62703,13,42,14,11,15,0,95,38.229019641339804,-109.3998447
62704,12,43,13,10,14,0,92,38.229019641339804,-109.3995752
62705,15,41,14,10,13,0,93,38.229019641339804,-109.3993057
62706,14,42,14,10,13,0,93,38.229019641339804,-109.3990362
62707,12,43,13,11,13,0,92,38.229019641339804,-109.3987667
62708,12,44,13,10,13,0,92,38.229019641339804,-109.3984972
62709,14,42,13,10,13,0,92,38.229019641339804,-109.3982277
62710,14,42,13,10,13,0,92,38.229019641339804,-109.3979582
62711,14,43,13,9,13,0,92,38.229019641339804,-109.3976887
62712,15,43,13,9,13,0,93,38.229019641339804,-109.3974192
62713,18,41,13,9,12,0,93,38.229019641339804,-109.3971497
62714,18,40,14,10,12,0,94,38.229019641339804,-109.3968802
62715,15,42,14,10,12,0,93,38.229019641339804,-109.3966107
62716,13,42,14,11,13,0,93,38.229019641339804,-109.3963412
62717,15,40,14,11,13,0,93,38.229019641339804,-109.3960717
62718,16,40,14,11,12,0,93,38.229019641339804,-109.3958022
62719,15,39,14,12,14,0,94,38.229019641339804,-109.3955327
62720,14,40,14,12,13,0,93,38.229019641339804,-109.3952632
62721,11,42,14,12,13,0,92,38.229019641339804,-109.3949938
62722,9,44,14,13,14,1,95,38.229019641339804,-109.3947243
62723,9,43,15,13,14,0,94,38.229019641339804,-109.3944548
62724,11,42,15,14,14,0,96,38.229019641339804,-109.3941853
62725,11,42,15,13,14,1,96,38.229019641339804,-109.3939158
62726,11,42,14,14,14,1,96,38.229019641339804,-109.3936463
62727,12,40,14,14,13,1,94,38.229019641339804,-109.3933768
62728,10,41,14,12,13,1,91,38.229019641339804,-109.3931073
62729,9,42,13,11,13,1,89,38.229019641339804,-109.3928378
62730,8,44,13,10,13,1,89,38.229019641339804,-109.3925683
62731,6,45,12,9,13,1,86,38.229019641339804,-109.3922988
62732,4,41,10,8,13,1,77,38.229019641339804,-109.3920293
62733,3,45,10,8,13,1,80,38.229019641339804,-109.3917598
62734,4,46,10,8,13,1,82,38.229019641339804,-109.3914903
62735,4,47,10,8,12,1,82,38.229019641339804,-109.3912208
62736,3,48,10,8,12,2,83,38.229019641339804,-109.3909513
62737,3,49,10,8,13,1,84,38.229019641339804,-109.3906818
62738,3,46,10,9,13,1,82,38.229019641339804,-109.3904123
62739,5,46,11,9,12,1,84,38.229019641339804,-109.3901429
62740,5,46,11,9,12,1,84,38.229019641339804,-109.3898734
62741,4,48,10,8,12,1,83,38.229019641339804,-109.3896039
62742,5,46,10,9,12,1,83,38.229019641339804,-109.3893344
62743,6,45,10,9,12,1,83,38.229019641339804,-109.3890649
62744,6,45,10,9,12,1,83,38.229019641339804,-109.3887954
62745,5,45,10,8,12,1,81,38.229019641339804,-109.3885259
62746,7,42,11,9,12,1,82,38.229019641339804,-109.3882564
62747,9,37,12,11,11,1,81,38.229019641339804,-109.3879869
62748,13,36,13,12,11,1,86,38.229019641339804,-109.3877174
62749,13,35,14,11,11,1,85,38.229019641339804,-109.3874479
62750,11,35,14,11,11,1,83,38.229019641339804,-109.3871784
62751,8,37,13,10,11,2,81,38.229019641339804,-109.3869089
62752,6,43,12,10,11,2,84,38.229019641339804,-109.3866394
62753,3,46,10,6,11,3,79,38.229019641339804,-109.3863699
62754,3,48,10,6,12,2,81,38.229019641339804,-109.3861004
62755,6,48,11,9,13,1,88,38.229019641339804,-109.3858309
62756,4,48,11,7,12,2,84,38.229019641339804,-109.3855614
62757,5,50,11,8,14,1,89,38.229019641339804,-109.3852919
62758,5,51,11,7,15,0,89,38.229019641339804,-109.3850225
62759,4,51,10,6,15,0,86,38.229019641339804,-109.384753
62760,5,49,10,8,12,1,85,38.229019641339804,-109.3844835
62761,6,49,9,6,12,1,83,38.229019641339804,-109.384214
62762,5,49,10,6,12,1,83,38.229019641339804,-109.3839445
62763,5,49,10,6,11,1,82,38.229019641339804,-109.383675
62764,5,49,10,6,11,1,82,38.229019641339804,-109.3834055
62765,6,49,10,6,11,1,83,38.229019641339804,-109.383136
62766,7,47,10,7,11,1,83,38.229019641339804,-109.3828665
62767,7,44,12,8,11,2,84,38.229019641339804,-109.382597
62768,7,41,13,10,10,2,83,38.229019641339804,-109.3823275
62769,8,40,14,11,10,2,85,38.229019641339804,-109.382058
62770,8,40,13,11,10,2,84,38.229019641339804,-109.3817885
62771,8,41,13,11,11,2,86,38.229019641339804,-109.381519
62772,7,41,13,11,11,2,85,38.229019641339804,-109.3812495
62773,6,39,13,11,11,2,82,38.229019641339804,-109.38098
62774,7,39,13,11,11,2,83,38.229019641339804,-109.3807105
62775,7,42,13,10,10,2,84,38.229019641339804,-109.380441
62776,7,43,12,9,10,3,84,38.229019641339804,-109.3801716
62777,6,41,12,9,10,4,82,38.229019641339804,-109.3799021
62778,6,41,13,10,11,3,84,38.229019641339804,-109.3796326
62779,7,41,13,10,11,2,84,38.229019641339804,-109.3793631
62780,7,39,13,10,11,2,82,38.229019641339804,-109.3790936
62781,7,38,13,10,10,3,81,38.229019641339804,-109.3788241
62782,7,37,13,10,11,3,81,38.229019641339804,-109.3785546
62783,7,40,13,11,11,2,84,38.229019641339804,-109.3782851
62784,7,43,12,9,11,2,84,38.229019641339804,-109.3780156
62785,7,41,12,8,10,2,80,38.229019641339804,-109.3777461
62786,6,36,11,9,10,2,74,38.229019641339804,-109.3774766
62787,6,29,10,10,10,3,68,38.229019641339804,-109.3772071
62788,4,25,8,14,7,3,61,38.229019641339804,-109.3769376
62789,5,22,9,17,10,4,67,38.229019641339804,-109.3766681
62790,10,32,12,12,11,3,80,38.229019641339804,-109.3763986
62791,7,45,12,9,11,2,86,38.229019641339804,-109.3761291
62792,7,52,11,11,11,0,92,38.229019641339804,-109.3758596
62793,32,35,12,11,9,0,99,38.229019641339804,-109.3755901
62794,35,27,11,12,10,0,95,38.229019641339804,-109.3753206
62795,19,31,12,13,11,1,87,38.229019641339804,-109.3750512
62796,5,31,11,7,11,7,72,38.229019641339804,-109.3747817
62797,1,35,9,1,10,10,66,38.229019641339804,-109.3745122
62798,2,36,9,1,9,9,66,38.229019641339804,-109.3742427
62799,4,41,9,7,10,2,73,38.229019641339804,-109.3739732
62800,6,43,9,8,12,1,79,38.229019641339804,-109.3737037
62801,7,46,11,8,14,1,87,38.229019641339804,-109.3734342
62802,11,47,11,7,14,0,90,38.229019641339804,-109.3731647
62803,5,42,10,5,16,2,80,38.229019641339804,-109.3728952
62804,5,46,12,8,17,0,88,38.229019641339804,-109.3726257
62805,6,46,12,8,14,2,88,38.229019641339804,-109.3723562
62806,6,46,11,7,12,3,85,38.229019641339804,-109.3720867
62807,4,48,11,6,12,3,84,38.229019641339804,-109.3718172
62808,3,51,10,4,13,2,83,38.229019641339804,-109.3715477
62809,2,52,9,3,13,3,82,38.229019641339804,-109.3712782
62810,2,52,9,3,12,3,81,38.229019641339804,-109.3710087
62811,3,51,9,5,12,2,82,38.229019641339804,-109.3707392
62812,2,53,8,3,12,2,80,38.229019641339804,-109.3704697
62813,2,55,9,4,13,2,85,38.229019641339804,-109.3702003
62814,2,55,8,3,13,2,83,38.229019641339804,-109.3699308
62815,2,54,9,4,12,3,84,38.229019641339804,-109.3696613
62816,4,52,10,6,12,2,86,38.229019641339804,-109.3693918
62817,3,49,9,4,11,4,80,38.229019641339804,-109.3691223
62818,3,48,8,4,12,2,77,38.229019641339804,-109.3688528
62819,4,47,9,6,12,2,80,38.229019641339804,-109.3685833
62820,4,47,9,7,13,1,81,38.229019641339804,-109.3683138
62821,2,54,9,4,13,3,85,38.229019641339804,-109.3680443
62822,2,54,9,5,13,3,86,38.229019641339804,-109.3677748
62823,3,50,9,5,13,3,83,38.229019641339804,-109.3675053
62824,4,46,10,6,13,2,81,38.229019641339804,-109.3672358
62825,7,41,11,8,13,1,81,38.229019641339804,-109.3669663
62826,9,38,10,8,12,2,79,38.229019641339804,-109.3666968
62827,6,41,10,8,12,2,79,38.229019641339804,-109.3664273
62828,3,44,10,6,13,3,79,38.229019641339804,-109.3661578
62829,2,48,9,4,13,2,78,38.229019641339804,-109.3658883
62830,4,45,10,6,12,2,79,38.229019641339804,-109.3656188
62831,4,39,10,7,12,4,76,38.229019641339804,-109.3653493
62832,5,43,10,6,12,3,79,38.229019641339804,-109.3650799
62833,3,42,9,3,13,5,75,38.229019641339804,-109.3648104
62834,1,43,8,1,12,6,71,38.229019641339804,-109.3645409
62835,2,50,9,4,11,3,79,38.229019641339804,-109.3642714
62836,1,57,8,3,10,2,81,38.229019641339804,-109.3640019
62837,1,47,8,2,9,4,71,38.229019641339804,-109.3637324
62838,2,33,8,4,10,6,63,38.229019641339804,-109.3634629
62839,8,30,12,11,9,6,76,38.229019641339804,-109.3631934
62840,25,22,7,8,4,0,66,38.229019641339804,-109.3629239
62841,17,22,4,3,3,0,49,38.229019641339804,-109.3626544
62842,20,23,4,2,2,0,51,38.229019641339804,-109.3623849
62843,27,25,5,5,2,0,64,38.229019641339804,-109.3621154
62844,25,23,6,8,3,0,65,38.229019641339804,-109.3618459
62845,35,20,9,17,4,1,86,38.229019641339804,-109.3615764
62846,31,15,8,15,4,1,74,38.229019641339804,-109.3613069
62847,29,14,6,11,3,0,63,38.229019641339804,-109.3610374
62848,31,13,5,11,1,0,61,38.229019641339804,-109.3607679
62849,29,6,6,19,3,1,64,38.229019641339804,-109.3604984
62850,21,6,6,13,2,1,49,38.229019641339804,-109.360229
62851,22,8,6,11,3,1,51,38.229019641339804,-109.3599595
62852,26,17,9,16,7,3,78,38.229019641339804,-109.35969
62853,13,28,12,14,11,7,85,38.229019641339804,-109.3594205
62854,2,31,13,3,9,17,75,38.229019641339804,-109.359151
62855,2,35,12,1,11,14,75,38.229019641339804,-109.3588815
62856,2,36,11,1,11,13,74,38.229019641339804,-109.358612
62857,2,38,10,0,10,13,73,38.229019641339804,-109.3583425
62858,1,37,10,0,8,13,69,38.229019641339804,-109.358073
62859,0,41,9,0,10,9,69,38.229019641339804,-109.3578035
62860,1,41,9,2,10,7,70,38.229019641339804,-109.357534
62861,1,39,9,2,9,6,66,38.229019641339804,-109.3572645
62862,1,40,8,1,9,6,65,38.229019641339804,-109.356995
62863,1,38,8,1,9,6,63,38.229019641339804,-109.3567255
62864,1,35,8,1,9,6,60,38.229019641339804,-109.356456
62865,1,35,8,2,9,5,60,38.229019641339804,-109.3561865
62866,1,34,8,2,10,5,60,38.229019641339804,-109.355917
62867,1,32,8,3,10,6,60,38.229019641339804,-109.3556475
62868,2,31,9,4,11,6,63,38.229019641339804,-109.355378
62869,1,33,9,4,11,7,65,38.229019641339804,-109.3551086
62870,1,35,9,2,10,8,65,38.229019641339804,-109.3548391
62871,0,34,8,1,9,9,61,38.229019641339804,-109.3545696
62872,0,31,8,2,7,10,58,38.229019641339804,-109.3543001
62873,2,33,8,3,9,7,62,38.229019641339804,-109.3540306
62874,2,37,8,3,11,4,65,38.229019641339804,-109.3537611
62875,1,40,8,3,10,4,66,38.229019641339804,-109.3534916
62876,1,41,8,2,10,4,66,38.229019641339804,-109.3532221
62877,1,43,8,3,10,4,69,38.229019641339804,-109.3529526
62878,1,45,8,3,10,3,70,38.229019641339804,-109.3526831
62879,1,48,8,4,10,3,74,38.229019641339804,-109.3524136
62880,1,50,8,4,11,3,77,38.229019641339804,-109.3521441
62881,0,48,8,2,12,4,74,38.229019641339804,-109.3518746
62882,0,41,8,1,11,5,66,38.229019641339804,-109.3516051
62883,0,36,8,1,10,6,61,38.229019641339804,-109.3513356
62884,12,40,13,13,14,0,92,38.22875014675457,-109.406582
62885,13,38,14,14,14,0,93,38.22875014675457,-109.4063125
62886,14,37,14,14,13,0,92,38.22875014675457,-109.406043
62887,11,41,14,13,14,0,93,38.22875014675457,-109.4057735
62888,9,44,14,12,14,0,93,38.22875014675457,-109.405504
62889,9,44,14,13,14,1,95,38.22875014675457,-109.4052345
62890,9,43,14,13,14,1,94,38.22875014675457,-109.4049651
62891,12,41,13,13,14,1,94,38.22875014675457,-109.4046956
62892,11,41,13,14,14,0,93,38.22875014675457,-109.4044261
62893,9,41,13,15,14,0,92,38.22875014675457,-109.4041566
62894,8,43,14,14,15,0,94,38.22875014675457,-109.4038871
62895,7,45,14,13,15,1,95,38.22875014675457,-109.4036176
62896,9,42,14,14,14,0,93,38.22875014675457,-109.4033481
62897,8,43,14,14,14,0,93,38.22875014675457,-109.4030786
62898,10,41,14,14,13,0,92,38.22875014675457,-109.4028091
62899,11,41,14,13,13,0,92,38.22875014675457,-109.4025396
62900,11,42,14,12,13,0,92,38.22875014675457,-109.4022701
62901,12,39,14,14,13,0,92,38.22875014675457,-109.4020006
62902,12,40,14,14,13,0,93,38.22875014675457,-109.4017311
62903,12,41,14,13,14,0,94,38.22875014675457,-109.4014616
62904,12,42,14,13,14,0,95,38.22875014675457,-109.4011921
62905,11,42,14,13,14,0,94,38.22875014675457,-109.4009226
62906,8,44,13,12,16,0,93,38.22875014675457,-109.4006531
62907,9,44,13,10,16,0,92,38.22875014675457,-109.4003836
62908,13,41,13,10,15,0,92,38.22875014675457,-109.4001142
62909,16,40,14,10,14,0,94,38.22875014675457,-109.3998447
62910,13,42,13,10,14,0,92,38.22875014675457,-109.3995752
62911,13,42,14,11,14,0,94,38.22875014675457,-109.3993057
62912,12,43,14,11,13,0,93,38.22875014675457,-109.3990362
62913,12,44,14,10,13,0,93,38.22875014675457,-109.3987667
62914,12,44,14,10,12,0,92,38.22875014675457,-109.3984972
62915,13,43,13,10,13,0,92,38.22875014675457,-109.3982277
62916,12,45,13,10,13,0,93,38.22875014675457,-109.3979582
62917,13,44,13,10,14,0,94,38.22875014675457,-109.3976887
62918,14,42,14,10,13,0,93,38.22875014675457,-109.3974192
62919,21,38,14,10,11,0,94,38.22875014675457,-109.3971497
62920,22,37,14,10,11,0,94,38.22875014675457,-109.3968802
62921,18,39,14,10,12,0,93,38.22875014675457,-109.3966107
62922,16,40,14,11,12,0,93,38.22875014675457,-109.3963412
62923,17,39,14,11,12,0,93,38.22875014675457,-109.3960717
62924,17,40,14,11,13,0,95,38.22875014675457,-109.3958022
62925,16,39,14,11,13,0,93,38.22875014675457,-109.3955327
62926,15,41,14,11,13,0,94,38.22875014675457,-109.3952632
62927,12,44,14,11,13,0,94,38.22875014675457,-109.3949938
62928,9,45,14,11,14,1,94,38.22875014675457,-109.3947243
62929,9,44,14,12,14,0,93,38.22875014675457,-109.3944548
62930,11,42,14,13,14,0,94,38.22875014675457,-109.3941853
62931,11,41,14,13,14,1,94,38.22875014675457,-109.3939158
62932,10,41,14,12,13,1,91,38.22875014675457,-109.3936463
62933,9,42,14,12,13,1,91,38.22875014675457,-109.3933768
62934,8,43,13,11,13,1,89,38.22875014675457,-109.3931073
62935,6,44,12,9,13,2,86,38.22875014675457,-109.3928378
62936,5,47,11,9,13,1,86,38.22875014675457,-109.3925683
62937,5,46,10,9,12,1,83,38.22875014675457,-109.3922988
62938,4,42,9,8,11,2,76,38.22875014675457,-109.3920293
62939,3,46,10,7,12,2,80,38.22875014675457,-109.3917598
62940,3,48,10,8,12,2,83,38.22875014675457,-109.3914903
62941,4,47,11,10,12,1,85,38.22875014675457,-109.3912208
62942,4,47,11,9,12,1,84,38.22875014675457,-109.3909513
62943,3,50,11,6,14,2,86,38.22875014675457,-109.3906818
62944,5,47,12,6,13,2,85,38.22875014675457,-109.3904123
62945,6,44,12,8,11,2,83,38.22875014675457,-109.3901429
62946,5,44,12,8,11,2,82,38.22875014675457,-109.3898734
62947,4,47,11,7,11,2,82,38.22875014675457,-109.3896039
62948,6,41,12,9,13,2,83,38.22875014675457,-109.3893344
62949,9,40,13,10,12,1,85,38.22875014675457,-109.3890649
62950,9,40,13,9,11,2,84,38.22875014675457,-109.3887954
62951,7,40,13,8,11,2,81,38.22875014675457,-109.3885259
62952,8,38,13,10,12,2,83,38.22875014675457,-109.3882564
62953,13,37,14,11,12,1,88,38.22875014675457,-109.3879869
62954,15,36,14,12,11,1,89,38.22875014675457,-109.3877174
62955,15,36,14,12,11,1,89,38.22875014675457,-109.3874479
62956,14,37,14,12,12,1,90,38.22875014675457,-109.3871784
62957,12,38,14,13,12,1,90,38.22875014675457,-109.3869089
62958,8,42,13,12,12,1,88,38.22875014675457,-109.3866394
62959,5,47,12,10,11,1,86,38.22875014675457,-109.3863699
62960,4,50,11,9,11,1,86,38.22875014675457,-109.3861004
62961,4,49,11,10,12,1,87,38.22875014675457,-109.3858309
62962,4,50,11,8,13,1,87,38.22875014675457,-109.3855614
62963,6,46,12,9,14,1,88,38.22875014675457,-109.3852919
62964,7,45,12,9,14,1,88,38.22875014675457,-109.3850225
62965,6,45,12,9,13,1,86,38.22875014675457,-109.384753
62966,4,45,11,8,12,1,81,38.22875014675457,-109.3844835
62967,7,42,11,8,11,1,80,38.22875014675457,-109.384214
62968,7,43,10,7,11,1,79,38.22875014675457,-109.3839445
62969,7,44,11,7,11,1,81,38.22875014675457,-109.383675
62970,8,45,11,8,10,1,83,38.22875014675457,-109.3834055
62971,7,42,12,9,10,2,82,38.22875014675457,-109.383136
62972,7,44,12,9,10,2,84,38.22875014675457,-109.3828665
62973,7,44,12,8,10,2,83,38.22875014675457,-109.382597
62974,6,44,12,9,10,2,83,38.22875014675457,-109.3823275
62975,7,44,12,10,10,2,85,38.22875014675457,-109.382058
62976,7,46,11,8,10,2,84,38.22875014675457,-109.3817885
62977,6,47,11,7,10,3,84,38.22875014675457,-109.381519
62978,6,48,11,7,10,3,85,38.22875014675457,-109.3812495
62979,5,47,11,7,9,3,82,38.22875014675457,-109.38098
62980,5,46,11,6,9,3,80,38.22875014675457,-109.3807105
62981,4,49,10,6,10,3,82,38.22875014675457,-109.380441
62982,5,50,10,6,10,3,84,38.22875014675457,-109.3801716
62983,5,49,10,7,11,3,85,38.22875014675457,-109.3799021
62984,5,48,11,7,10,3,84,38.22875014675457,-109.3796326
62985,6,44,12,9,10,3,84,38.22875014675457,-109.3793631
62986,5,42,12,9,10,3,81,38.22875014675457,-109.3790936
62987,5,43,12,8,10,3,81,38.22875014675457,-109.3788241
62988,5,44,12,8,10,3,82,38.22875014675457,-109.3785546
62989,6,47,11,7,11,3,85,38.22875014675457,-109.3782851
62990,5,49,10,5,11,3,83,38.22875014675457,-109.3780156
62991,5,49,9,5,11,2,81,38.22875014675457,-109.3777461
62992,4,42,9,5,11,2,73,38.22875014675457,-109.3774766
62993,5,34,9,7,10,3,68,38.22875014675457,-109.3772071
62994,6,28,9,14,7,1,65,38.22875014675457,-109.3769376
62995,1,19,9,19,11,4,63,38.22875014675457,-109.3766681
62996,6,27,11,13,11,5,73,38.22875014675457,-109.3763986
62997,7,39,11,10,12,3,82,38.22875014675457,-109.3761291
62998,8,45,12,13,13,0,91,38.22875014675457,-109.3758596
62999,34,34,11,12,7,0,98,38.22875014675457,-109.3755901
63000,43,27,10,11,6,0,97,38.22875014675457,-109.3753206
63001,27,27,12,14,10,0,90,38.22875014675457,-109.3750512
63002,7,26,11,12,11,4,71,38.22875014675457,-109.3747817
63003,2,36,8,5,7,7,65,38.22875014675457,-109.3745122
63004,2,40,7,5,7,4,65,38.22875014675457,-109.3742427
63005,4,43,7,8,8,2,72,38.22875014675457,-109.3739732
63006,6,43,9,9,12,1,80,38.22875014675457,-109.3737037
63007,7,47,11,9,14,1,89,38.22875014675457,-109.3734342
63008,8,51,11,7,14,0,91,38.22875014675457,-109.3731647
63009,4,49,10,4,17,0,84,38.22875014675457,-109.3728952
63010,3,49,10,5,16,1,84,38.22875014675457,-109.3726257
63011,4,47,10,5,13,3,82,38.22875014675457,-109.3723562
63012,6,45,10,6,11,3,81,38.22875014675457,-109.3720867
63013,8,45,11,9,11,2,86,38.22875014675457,-109.3718172
63014,5,52,10,6,12,1,86,38.22875014675457,-109.3715477
63015,3,53,9,3,13,2,83,38.22875014675457,-109.3712782
63016,3,53,9,4,13,2,84,38.22875014675457,-109.3710087
63017,5,51,11,5,13,2,87,38.22875014675457,-109.3707392
63018,7,49,11,5,12,2,86,38.22875014675457,-109.3704697
63019,5,51,10,5,13,2,86,38.22875014675457,-109.3702003
63020,4,51,9,4,12,4,84,38.22875014675457,-109.3699308
63021,3,47,9,4,11,4,78,38.22875014675457,-109.3696613
63022,3,42,9,4,12,3,73,38.22875014675457,-109.3693918
63023,2,41,8,3,10,4,68,38.22875014675457,-109.3691223
63024,2,45,7,3,9,3,69,38.22875014675457,-109.3688528
63025,2,44,7,3,10,3,69,38.22875014675457,-109.3685833
63026,2,42,8,3,11,3,69,38.22875014675457,-109.3683138
63027,2,45,8,3,11,3,72,38.22875014675457,-109.3680443
63028,2,46,8,5,13,2,76,38.22875014675457,-109.3677748
63029,2,47,9,4,14,3,79,38.22875014675457,-109.3675053
63030,3,48,10,3,15,4,83,38.22875014675457,-109.3672358
63031,4,46,11,5,16,3,85,38.22875014675457,-109.3669663
63032,5,47,11,7,17,1,88,38.22875014675457,-109.3666968
63033,5,46,11,5,14,3,84,38.22875014675457,-109.3664273
63034,6,49,11,4,14,2,86,38.22875014675457,-109.3661578
63035,6,51,11,5,15,2,90,38.22875014675457,-109.3658883
63036,6,47,12,5,16,1,87,38.22875014675457,-109.3656188
63037,13,42,12,8,14,1,90,38.22875014675457,-109.3653493
63038,10,39,12,11,11,1,84,38.22875014675457,-109.3650799
63039,4,47,10,6,11,2,80,38.22875014675457,-109.3648104
63040,1,54,8,5,13,1,82,38.22875014675457,-109.3645409
63041,1,58,8,4,12,1,84,38.22875014675457,-109.3642714
63042,1,60,8,5,11,1,86,38.22875014675457,-109.3640019
63043,1,51,8,5,10,1,76,38.22875014675457,-109.3637324
63044,2,39,8,6,10,3,68,38.22875014675457,-109.3634629
63045,6,35,9,9,11,2,72,38.22875014675457,-109.3631934
63046,20,29,13,11,13,2,88,38.22875014675457,-109.3629239
63047,19,25,5,4,3,0,56,38.22875014675457,-109.3626544
63048,19,21,3,2,2,0,47,38.22875014675457,-109.3623849
63049,23,23,4,3,2,0,55,38.22875014675457,-109.3621154
63050,26,23,6,7,3,0,65,38.22875014675457,-109.3618459
63051,33,20,8,15,3,0,79,38.22875014675457,-109.3615764
63052,29,16,5,10,2,0,62,38.22875014675457,-109.3613069
63053,29,16,5,7,1,0,58,38.22875014675457,-109.3610374
63054,28,15,5,9,1,0,58,38.22875014675457,-109.3607679
63055,21,9,6,13,2,1,52,38.22875014675457,-109.3604984
63056,25,7,7,13,4,1,57,38.22875014675457,-109.360229
63057,29,18,10,17,8,2,84,38.22875014675457,-109.3599595
63058,14,29,12,13,10,6,84,38.22875014675457,-109.35969
63059,3,34,11,4,13,10,75,38.22875014675457,-109.3594205
63060,6,39,12,7,14,7,85,38.22875014675457,-109.359151
63061,5,43,12,8,12,6,86,38.22875014675457,-109.3588815
63062,3,47,10,4,12,7,83,38.22875014675457,-109.358612
63063,2,43,9,2,11,8,75,38.22875014675457,-109.3583425
63064,1,39,9,1,9,10,69,38.22875014675457,-109.358073
63065,2,36,9,3,10,8,68,38.22875014675457,-109.3578035
63066,1,37,9,2,9,8,66,38.22875014675457,-109.357534
63067,1,37,9,1,9,8,65,38.22875014675457,-109.3572645
63068,0,36,8,1,9,8,62,38.22875014675457,-109.356995
63069,1,34,8,2,9,7,61,38.22875014675457,-109.3567255
63070,1,34,8,1,9,7,60,38.22875014675457,-109.356456
63071,0,34,8,1,9,8,60,38.22875014675457,-109.3561865
63072,0,33,8,2,9,8,60,38.22875014675457,-109.355917
63073,1,33,9,2,9,10,64,38.22875014675457,-109.3556475
63074,2,36,9,2,9,10,68,38.22875014675457,-109.355378
63075,1,38,9,2,11,9,70,38.22875014675457,-109.3551086
63076,1,39,9,1,11,9,70,38.22875014675457,-109.3548391
63077,1,37,9,1,10,10,68,38.22875014675457,-109.3545696
63078,1,28,9,4,9,10,61,38.22875014675457,-109.3543001
63079,2,27,8,4,8,9,58,38.22875014675457,-109.3540306
63080,3,31,8,3,9,7,61,38.22875014675457,-109.3537611
63081,2,31,8,2,9,8,60,38.22875014675457,-109.3534916
63082,1,30,9,2,9,10,61,38.22875014675457,-109.3532221
63083,1,34,9,2,9,9,64,38.22875014675457,-109.3529526
63084,1,41,10,1,12,6,71,38.22875014675457,-109.3526831
63085,1,42,10,4,13,5,75,38.22875014675457,-109.3524136
63086,2,45,9,3,13,5,77,38.22875014675457,-109.3521441
63087,1,44,9,2,13,6,75,38.22875014675457,-109.3518746
63088,1,35,9,4,10,7,66,38.22875014675457,-109.3516051
63089,1,31,10,4,10,9,65,38.22875014675457,-109.3513356
63090,10,41,14,14,15,1,95,38.22848065216934,-109.406582
63091,14,37,14,14,14,0,93,38.22848065216934,-109.4063125
63092,19,33,14,13,13,0,92,38.22848065216934,-109.406043
63093,20,33,14,12,12,0,91,38.22848065216934,-109.4057735
63094,15,37,14,13,12,0,91,38.22848065216934,-109.405504
63095,13,39,14,13,12,0,91,38.22848065216934,-109.4052345
63096,15,38,14,14,12,0,93,38.22848065216934,-109.4049651
63097,18,36,13,13,12,0,92,38.22848065216934,-109.4046956
63098,18,36,13,13,13,0,93,38.22848065216934,-109.4044261
63099,13,38,13,14,14,0,92,38.22848065216934,-109.4041566
63100,9,41,13,14,14,1,92,38.22848065216934,-109.4038871
63101,8,43,14,14,15,1,95,38.22848065216934,-109.4036176
63102,8,44,14,13,14,0,93,38.22848065216934,-109.4033481
63103,8,43,14,14,14,1,94,38.22848065216934,-109.4030786
63104,10,43,14,13,13,1,94,38.22848065216934,-109.4028091
63105,12,42,14,12,13,1,94,38.22848065216934,-109.4025396
63106,12,40,14,13,13,0,92,38.22848065216934,-109.4022701
63107,10,41,14,14,14,1,94,38.22848065216934,-109.4020006
63108,10,41,14,14,14,0,93,38.22848065216934,-109.4017311
63109,9,42,14,14,14,0,93,38.22848065216934,-109.4014616
63110,10,43,14,13,14,0,94,38.22848065216934,-109.4011921
63111,13,41,14,12,14,0,94,38.22848065216934,-109.4009226
63112,9,43,13,11,17,0,93,38.22848065216934,-109.4006531
63113,11,41,13,10,17,0,92,38.22848065216934,-109.4003836
63114,14,41,13,9,16,0,93,38.22848065216934,-109.4001142
63115,15,41,13,10,15,0,94,38.22848065216934,-109.3998447
63116,13,43,13,9,14,0,92,38.22848065216934,-109.3995752
63117,13,43,14,10,13,0,93,38.22848065216934,-109.3993057
63118,13,42,14,10,13,0,92,38.22848065216934,-109.3990362
63119,12,42,14,11,14,0,93,38.22848065216934,-109.3987667
63120,11,44,14,11,13,0,93,38.22848065216934,-109.3984972
63121,12,45,13,10,13,0,93,38.22848065216934,-109.3982277
63122,11,45,13,10,14,0,93,38.22848065216934,-109.3979582
63123,13,42,13,11,14,0,93,38.22848065216934,-109.3976887
63124,17,39,14,10,13,0,93,38.22848065216934,-109.3974192
63125,21,37,14,10,12,0,94,38.22848065216934,-109.3971497
63126,21,37,14,10,11,0,93,38.22848065216934,-109.3968802
63127,19,38,14,10,12,0,93,38.22848065216934,-109.3966107
63128,18,39,14,10,12,0,93,38.22848065216934,-109.3963412
63129,17,40,14,11,12,0,94,38.22848065216934,-109.3960717
63130,15,41,14,11,13,0,94,38.22848065216934,-109.3958022
63131,13,42,14,12,13,0,94,38.22848065216934,-109.3955327
63132,13,42,14,11,13,0,93,38.22848065216934,-109.3952632
63133,12,43,14,11,13,0,93,38.22848065216934,-109.3949938
63134,11,43,14,12,14,0,94,38.22848065216934,-109.3947243
63135,10,44,14,11,14,1,94,38.22848065216934,-109.3944548
63136,11,42,14,12,13,1,93,38.22848065216934,-109.3941853
63137,9,41,14,11,13,1,89,38.22848065216934,-109.3939158
63138,8,43,13,11,13,1,89,38.22848065216934,-109.3936463
63139,7,47,12,10,14,1,91,38.22848065216934,-109.3933768
63140,6,49,11,8,12,1,87,38.22848065216934,-109.3931073
63141,4,49,10,8,13,1,85,38.22848065216934,-109.3928378
63142,3,49,9,7,12,1,81,38.22848065216934,-109.3925683
63143,4,49,9,7,11,2,82,38.22848065216934,-109.3922988
63144,5,45,10,9,11,1,81,38.22848065216934,-109.3920293
63145,4,49,11,7,12,2,85,38.22848065216934,-109.3917598
63146,4,47,11,7,13,2,84,38.22848065216934,-109.3914903
63147,5,45,12,8,13,2,85,38.22848065216934,-109.3912208
63148,6,44,13,10,13,2,88,38.22848065216934,-109.3909513
63149,4,46,12,8,14,2,86,38.22848065216934,-109.3906818
63150,7,44,13,10,13,2,89,38.22848065216934,-109.3904123
63151,8,40,13,12,13,2,88,38.22848065216934,-109.3901429
63152,7,40,13,11,12,2,85,38.22848065216934,-109.3898734
63153,6,41,12,9,12,3,83,38.22848065216934,-109.3896039
63154,8,41,13,10,12,2,86,38.22848065216934,-109.3893344
63155,10,38,14,11,12,1,86,38.22848065216934,-109.3890649
63156,11,38,14,12,12,1,88,38.22848065216934,-109.3887954
63157,10,39,14,12,13,1,89,38.22848065216934,-109.3885259
63158,9,40,14,12,13,2,90,38.22848065216934,-109.3882564
63159,9,38,14,12,12,2,87,38.22848065216934,-109.3879869
63160,9,39,14,11,11,2,86,38.22848065216934,-109.3877174
63161,9,39,14,11,11,2,86,38.22848065216934,-109.3874479
63162,9,40,14,11,11,1,86,38.22848065216934,-109.3871784
63163,9,40,14,13,12,1,89,38.22848065216934,-109.3869089
63164,5,43,12,9,10,3,82,38.22848065216934,-109.3866394
63165,4,49,10,7,11,2,83,38.22848065216934,-109.3863699
63166,3,53,10,8,11,2,87,38.22848065216934,-109.3861004
63167,3,51,10,7,10,3,84,38.22848065216934,-109.3858309
63168,6,47,12,10,12,2,89,38.22848065216934,-109.3855614
63169,6,43,13,12,12,2,88,38.22848065216934,-109.3852919
63170,6,41,13,13,11,2,86,38.22848065216934,-109.3850225
63171,7,41,13,13,11,1,86,38.22848065216934,-109.384753
63172,8,41,14,14,10,1,88,38.22848065216934,-109.3844835
63173,9,41,13,13,11,1,88,38.22848065216934,-109.384214
63174,9,42,12,11,10,1,85,38.22848065216934,-109.3839445
63175,7,44,12,10,10,1,84,38.22848065216934,-109.383675
63176,6,44,12,10,10,2,84,38.22848065216934,-109.3834055
63177,5,43,11,8,10,3,80,38.22848065216934,-109.383136
63178,4,45,10,6,10,4,79,38.22848065216934,-109.3828665
63179,4,47,9,6,11,3,80,38.22848065216934,-109.382597
63180,4,46,9,5,10,3,77,38.22848065216934,-109.3823275
63181,4,45,9,3,10,3,74,38.22848065216934,-109.382058
63182,6,43,9,5,10,2,75,38.22848065216934,-109.3817885
63183,5,43,9,6,11,2,76,38.22848065216934,-109.381519
63184,5,45,9,6,11,2,78,38.22848065216934,-109.3812495
63185,5,47,9,5,11,2,79,38.22848065216934,-109.38098
63186,4,47,9,5,10,2,77,38.22848065216934,-109.3807105
63187,4,44,9,5,10,2,74,38.22848065216934,-109.380441
63188,4,47,9,6,11,2,79,38.22848065216934,-109.3801716
63189,4,48,9,5,11,2,79,38.22848065216934,-109.3799021
63190,4,49,9,4,11,2,79,38.22848065216934,-109.3796326
63191,5,49,9,4,10,2,79,38.22848065216934,-109.3793631
63192,4,48,9,4,11,3,79,38.22848065216934,-109.3790936
63193,5,49,9,4,11,2,80,38.22848065216934,-109.3788241
63194,5,49,9,5,11,2,81,38.22848065216934,-109.3785546
63195,4,48,9,4,11,2,78,38.22848065216934,-109.3782851
63196,5,53,9,4,11,1,83,38.22848065216934,-109.3780156
63197,3,52,8,3,11,2,79,38.22848065216934,-109.3777461
63198,2,43,8,2,10,3,68,38.22848065216934,-109.3774766
63199,3,32,8,5,9,3,60,38.22848065216934,-109.3772071
63200,6,24,9,12,9,2,62,38.22848065216934,-109.3769376
63201,3,21,9,16,11,3,63,38.22848065216934,-109.3766681
63202,2,25,9,17,14,3,70,38.22848065216934,-109.3763986
63203,5,33,11,16,14,1,80,38.22848065216934,-109.3761291
63204,10,36,12,14,14,1,87,38.22848065216934,-109.3758596
63205,25,37,12,9,11,0,94,38.22848065216934,-109.3755901
63206,39,27,10,12,9,0,97,38.22848065216934,-109.3753206
63207,30,26,11,15,11,0,93,38.22848065216934,-109.3750512
63208,10,24,12,19,11,3,79,38.22848065216934,-109.3747817
63209,3,30,10,10,10,5,68,38.22848065216934,-109.3745122
63210,2,40,6,6,6,3,63,38.22848065216934,-109.3742427
63211,5,42,8,8,9,2,74,38.22848065216934,-109.3739732
63212,7,42,9,8,11,1,78,38.22848065216934,-109.3737037
63213,6,48,11,10,12,1,88,38.22848065216934,-109.3734342
63214,6,52,11,9,12,1,91,38.22848065216934,-109.3731647
63215,3,56,9,4,15,1,88,38.22848065216934,-109.3728952
63216,2,52,9,3,14,3,83,38.22848065216934,-109.3726257
63217,3,47,9,4,12,4,79,38.22848065216934,-109.3723562
63218,6,43,11,7,10,4,81,38.22848065216934,-109.3720867
63219,11,42,13,10,10,2,88,38.22848065216934,-109.3718172
63220,8,48,12,9,11,2,90,38.22848065216934,-109.3715477
63221,7,50,11,9,11,1,89,38.22848065216934,-109.3712782
63222,6,50,11,8,11,2,88,38.22848065216934,-109.3710087
63223,7,48,11,8,11,2,87,38.22848065216934,-109.3707392
63224,11,47,12,9,10,1,90,38.22848065216934,-109.3704697
63225,7,49,10,6,11,1,84,38.22848065216934,-109.3702003
63226,4,47,8,4,12,2,77,38.22848065216934,-109.3699308
63227,3,45,8,3,10,3,72,38.22848065216934,-109.3696613
63228,3,41,7,3,9,3,66,38.22848065216934,-109.3693918
63229,3,38,7,4,9,4,65,38.22848065216934,-109.3691223
63230,3,36,8,4,12,3,66,38.22848065216934,-109.3688528
63231,4,33,9,7,12,3,68,38.22848065216934,-109.3685833
63232,6,33,10,10,11,3,73,38.22848065216934,-109.3683138
63233,5,30,10,11,14,3,73,38.22848065216934,-109.3680443
63234,3,34,9,8,15,2,71,38.22848065216934,-109.3677748
63235,3,40,9,6,14,3,75,38.22848065216934,-109.3675053
63236,2,43,10,4,14,5,78,38.22848065216934,-109.3672358
63237,2,44,10,4,15,5,80,38.22848065216934,-109.3669663
63238,3,47,10,5,13,2,80,38.22848065216934,-109.3666968
63239,4,46,10,4,12,3,79,38.22848065216934,-109.3664273
63240,4,46,10,5,13,3,81,38.22848065216934,-109.3661578
63241,4,46,11,6,15,2,84,38.22848065216934,-109.3658883
63242,6,49,11,6,15,1,88,38.22848065216934,-109.3656188
63243,12,40,13,8,14,1,88,38.22848065216934,-109.3653493
63244,8,35,11,6,13,5,78,38.22848065216934,-109.3650799
63245,3,38,10,2,13,6,72,38.22848065216934,-109.3648104
63246,1,52,8,1,14,3,79,38.22848065216934,-109.3645409
63247,1,64,7,4,10,1,87,38.22848065216934,-109.3642714
63248,1,63,7,5,10,1,87,38.22848065216934,-109.3640019
63249,1,54,7,5,9,1,77,38.22848065216934,-109.3637324
63250,2,43,8,5,9,2,69,38.22848065216934,-109.3634629
63251,3,36,9,6,11,3,68,38.22848065216934,-109.3631934
63252,14,29,14,17,11,2,87,38.22848065216934,-109.3629239
63253,33,19,7,10,3,0,72,38.22848065216934,-109.3626544
63254,23,16,5,7,3,0,54,38.22848065216934,-109.3623849
63255,28,17,6,8,2,0,61,38.22848065216934,-109.3621154
63256,30,20,6,7,2,0,65,38.22848065216934,-109.3618459
63257,28,19,5,6,1,0,59,38.22848065216934,-109.3615764
63258,28,15,4,6,1,0,54,38.22848065216934,-109.3613069
63259,30,13,4,7,0,0,54,38.22848065216934,-109.3610374
63260,31,12,5,9,1,0,58,38.22848065216934,-109.3607679
63261,21,10,5,9,2,0,47,38.22848065216934,-109.3604984
63262,26,17,10,16,9,2,80,38.22848065216934,-109.360229
63263,11,24,11,15,10,6,77,38.22848065216934,-109.3599595
63264,4,33,11,7,11,8,74,38.22848065216934,-109.35969
63265,3,41,10,3,13,7,77,38.22848065216934,-109.3594205
63266,4,49,11,4,12,6,86,38.22848065216934,-109.359151
63267,3,52,10,5,12,4,86,38.22848065216934,-109.3588815
63268,2,52,9,3,12,5,83,38.22848065216934,-109.358612
63269,1,48,9,2,12,6,78,38.22848065216934,-109.3583425
63270,2,39,9,3,9,8,70,38.22848065216934,-109.358073
63271,2,34,9,2,8,9,64,38.22848065216934,-109.3578035
63272,1,34,8,2,9,8,62,38.22848065216934,-109.357534
63273,1,34,8,2,10,7,62,38.22848065216934,-109.3572645
63274,1,33,8,3,10,7,62,38.22848065216934,-109.356995
63275,1,35,8,2,9,8,63,38.22848065216934,-109.3567255
63276,1,37,8,1,9,8,64,38.22848065216934,-109.356456
63277,0,39,8,1,9,9,66,38.22848065216934,-109.3561865
63278,0,39,9,1,9,10,68,38.22848065216934,-109.355917
63279,0,37,9,1,9,11,67,38.22848065216934,-109.3556475
63280,1,38,9,1,8,10,67,38.22848065216934,-109.355378
63281,1,37,9,2,12,9,70,38.22848065216934,-109.3551086
63282,1,37,10,3,12,8,71,38.22848065216934,-109.3548391
63283,1,35,10,3,12,9,70,38.22848065216934,-109.3545696
63284,1,33,9,4,10,8,65,38.22848065216934,-109.3543001
63285,2,31,8,3,9,8,61,38.22848065216934,-109.3540306
63286,2,29,8,3,10,7,59,38.22848065216934,-109.3537611
63287,2,25,8,3,8,10,56,38.22848065216934,-109.3534916
63288,1,21,10,2,5,14,53,38.22848065216934,-109.3532221
63289,1,27,10,3,7,12,60,38.22848065216934,-109.3529526
63290,1,37,10,2,12,8,70,38.22848065216934,-109.3526831
63291,1,41,9,1,13,8,73,38.22848065216934,-109.3524136
63292,3,45,10,1,13,7,79,38.22848065216934,-109.3521441
63293,2,42,9,3,12,6,74,38.22848065216934,-109.3518746
63294,3,33,9,6,10,5,66,38.22848065216934,-109.3516051
63295,2,28,10,6,10,8,64,38.22848065216934,-109.3513356
63296,9,43,13,14,14,1,94,38.22821116,-109.406582
63297,10,41,14,15,14,0,94,38.22821116,-109.4063125
63298,13,38,14,15,13,0,93,38.22821116,-109.406043
63299,15,35,14,14,13,0,91,38.22821116,-109.4057735
63300,18,35,14,13,13,0,93,38.22821116,-109.405504
63301,17,35,14,14,12,0,92,38.22821116,-109.4052345
63302,17,36,14,14,12,0,93,38.22821116,-109.4049651
63303,18,35,14,13,12,0,92,38.22821116,-109.4046956
63304,16,36,13,13,13,0,91,38.22821116,-109.4044261
63305,13,38,14,14,14,0,93,38.22821116,-109.4041566
63306,10,40,13,14,14,0,91,38.22821116,-109.4038871
63307,9,42,13,13,14,0,91,38.22821116,-109.4036176
63308,8,43,14,13,15,0,93,38.22821116,-109.4033481
63309,6,44,14,15,14,0,93,38.22821116,-109.4030786
63310,8,44,14,13,13,1,93,38.22821116,-109.4028091
63311,9,42,14,13,13,1,92,38.22821116,-109.4025396
63312,9,40,14,14,14,1,92,38.22821116,-109.4022701
63313,8,41,14,13,14,1,91,38.22821116,-109.4020006
63314,8,42,14,13,14,1,92,38.22821116,-109.4017311
63315,9,42,14,13,14,1,93,38.22821116,-109.4014616
63316,10,42,14,13,15,1,95,38.22821116,-109.4011921
63317,9,43,14,12,16,0,94,38.22821116,-109.4009226
63318,6,44,14,11,17,0,92,38.22821116,-109.4006531
63319,8,42,14,11,17,0,92,38.22821116,-109.4003836
63320,11,41,14,11,17,0,94,38.22821116,-109.4001142
63321,11,41,14,11,16,0,93,38.22821116,-109.3998447
63322,12,42,14,10,14,0,92,38.22821116,-109.3995752
63323,14,42,14,11,13,0,94,38.22821116,-109.3993057
63324,13,43,14,10,13,0,93,38.22821116,-109.3990362
63325,12,43,13,10,13,0,91,38.22821116,-109.3987667
63326,12,44,13,11,13,0,93,38.22821116,-109.3984972
63327,11,45,13,9,13,0,91,38.22821116,-109.3982277
63328,11,44,13,9,15,0,92,38.22821116,-109.3979582
63329,14,41,13,10,15,0,93,38.22821116,-109.3976887
63330,17,39,14,10,14,0,94,38.22821116,-109.3974192
63331,17,38,14,10,14,0,93,38.22821116,-109.3971497
63332,19,39,14,10,13,0,95,38.22821116,-109.3968802
63333,19,39,14,10,12,0,94,38.22821116,-109.3966107
63334,18,39,14,10,12,0,93,38.22821116,-109.3963412
63335,17,39,14,11,13,0,94,38.22821116,-109.3960717
63336,15,41,14,11,13,0,94,38.22821116,-109.3958022
63337,13,43,14,11,13,0,94,38.22821116,-109.3955327
63338,12,42,14,12,13,0,93,38.22821116,-109.3952632
63339,11,42,14,12,14,0,93,38.22821116,-109.3949938
63340,11,42,14,12,14,0,93,38.22821116,-109.3947243
63341,9,43,14,11,13,1,91,38.22821116,-109.3944548
63342,7,44,13,9,12,2,87,38.22821116,-109.3941853
63343,5,47,11,7,12,2,84,38.22821116,-109.3939158
63344,5,51,10,7,13,1,87,38.22821116,-109.3936463
63345,4,51,9,8,13,1,86,38.22821116,-109.3933768
63346,5,50,10,8,12,1,86,38.22821116,-109.3931073
63347,4,48,10,7,12,1,82,38.22821116,-109.3928378
63348,4,50,10,6,12,2,84,38.22821116,-109.3925683
63349,4,54,10,6,11,1,86,38.22821116,-109.3922988
63350,8,48,11,8,12,1,88,38.22821116,-109.3920293
63351,7,48,12,8,12,2,89,38.22821116,-109.3917598
63352,7,47,12,8,12,2,88,38.22821116,-109.3914903
63353,8,44,13,9,13,2,89,38.22821116,-109.3912208
63354,8,43,13,11,13,1,89,38.22821116,-109.3909513
63355,5,48,12,9,13,2,89,38.22821116,-109.3906818
63356,6,45,12,11,13,1,88,38.22821116,-109.3904123
63357,7,43,12,11,13,1,87,38.22821116,-109.3901429
63358,6,43,12,9,12,2,84,38.22821116,-109.3898734
63359,6,42,12,8,11,4,83,38.22821116,-109.3896039
63360,7,42,13,10,11,3,86,38.22821116,-109.3893344
63361,7,39,12,10,11,3,82,38.22821116,-109.3890649
63362,7,38,13,10,11,3,82,38.22821116,-109.3887954
63363,7,39,13,10,11,3,83,38.22821116,-109.3885259
63364,6,42,12,10,11,3,84,38.22821116,-109.3882564
63365,5,39,12,9,10,4,79,38.22821116,-109.3879869
63366,5,37,12,9,10,4,77,38.22821116,-109.3877174
63367,6,38,12,8,9,4,77,38.22821116,-109.3874479
63368,6,40,13,8,10,3,80,38.22821116,-109.3871784
63369,7,44,12,10,11,2,86,38.22821116,-109.3869089
63370,3,48,10,7,11,3,82,38.22821116,-109.3866394
63371,3,54,10,7,12,2,88,38.22821116,-109.3863699
63372,3,55,10,8,12,2,90,38.22821116,-109.3861004
63373,4,49,11,8,12,3,87,38.22821116,-109.3858309
63374,6,47,12,10,12,2,89,38.22821116,-109.3855614
63375,6,44,12,9,11,3,85,38.22821116,-109.3852919
63376,6,43,12,9,11,4,85,38.22821116,-109.3850225
63377,6,42,13,10,11,3,85,38.22821116,-109.384753
63378,7,41,13,11,10,2,84,38.22821116,-109.3844835
63379,8,39,13,11,10,2,83,38.22821116,-109.384214
63380,8,40,13,10,10,2,83,38.22821116,-109.3839445
63381,7,42,12,8,10,2,81,38.22821116,-109.383675
63382,5,45,10,5,10,3,78,38.22821116,-109.3834055
63383,4,46,9,6,10,2,77,38.22821116,-109.383136
63384,4,47,9,5,10,2,77,38.22821116,-109.3828665
63385,3,44,8,5,11,3,74,38.22821116,-109.382597
63386,3,40,8,4,10,3,68,38.22821116,-109.3823275
63387,3,37,8,4,10,3,65,38.22821116,-109.382058
63388,2,34,8,4,10,4,62,38.22821116,-109.3817885
63389,2,35,8,4,10,4,63,38.22821116,-109.381519
63390,2,37,8,4,10,3,64,38.22821116,-109.3812495
63391,2,39,8,5,10,3,67,38.22821116,-109.38098
63392,2,40,7,5,9,3,66,38.22821116,-109.3807105
63393,2,39,7,5,8,3,64,38.22821116,-109.380441
63394,2,41,7,5,9,2,66,38.22821116,-109.3801716
63395,2,42,7,4,9,2,66,38.22821116,-109.3799021
63396,3,41,8,3,9,3,67,38.22821116,-109.3796326
63397,3,40,8,3,10,3,67,38.22821116,-109.3793631
63398,3,40,8,4,10,3,68,38.22821116,-109.3790936
63399,3,40,9,4,10,3,69,38.22821116,-109.3788241
63400,3,38,9,4,10,3,67,38.22821116,-109.3785546
63401,3,38,9,4,10,3,67,38.22821116,-109.3782851
63402,6,45,9,5,10,2,77,38.22821116,-109.3780156
63403,3,46,7,3,10,2,71,38.22821116,-109.3777461
63404,2,38,8,3,10,3,64,38.22821116,-109.3774766
63405,4,29,9,7,10,3,62,38.22821116,-109.3772071
63406,6,21,11,18,13,2,71,38.22821116,-109.3769376
63407,2,19,8,18,13,3,63,38.22821116,-109.3766681
63408,1,22,8,23,14,2,70,38.22821116,-109.3763986
63409,8,30,10,20,14,1,83,38.22821116,-109.3761291
63410,14,36,13,13,14,1,91,38.22821116,-109.3758596
63411,13,37,12,11,13,2,88,38.22821116,-109.3755901
63412,20,32,12,12,13,0,89,38.22821116,-109.3753206
63413,12,34,12,14,13,2,87,38.22821116,-109.3750512
63414,6,33,12,13,12,5,81,38.22821116,-109.3747817
63415,5,35,10,10,14,3,77,38.22821116,-109.3745122
63416,6,40,9,9,12,1,77,38.22821116,-109.3742427
63417,7,42,10,10,12,1,82,38.22821116,-109.3739732
63418,6,45,11,9,13,1,85,38.22821116,-109.3737037
63419,6,48,11,9,12,1,87,38.22821116,-109.3734342
63420,7,52,11,9,12,1,92,38.22821116,-109.3731647
63421,4,55,9,7,11,2,88,38.22821116,-109.3728952
63422,3,54,9,6,11,2,85,38.22821116,-109.3726257
63423,4,50,9,6,11,3,83,38.22821116,-109.3723562
63424,6,46,10,7,10,3,82,38.22821116,-109.3720867
63425,7,45,11,9,11,2,85,38.22821116,-109.3718172
63426,6,49,10,7,10,2,84,38.22821116,-109.3715477
63427,5,48,9,5,11,1,79,38.22821116,-109.3712782
63428,5,47,9,5,11,1,78,38.22821116,-109.3710087
63429,5,45,9,5,11,2,77,38.22821116,-109.3707392
63430,6,45,9,4,10,2,76,38.22821116,-109.3704697
63431,3,41,8,3,9,3,67,38.22821116,-109.3702003
63432,2,43,7,3,8,3,66,38.22821116,-109.3699308
63433,2,41,7,3,8,3,64,38.22821116,-109.3696613
63434,2,33,8,3,11,4,61,38.22821116,-109.3693918
63435,5,26,10,12,16,3,72,38.22821116,-109.3691223
63436,10,25,13,15,18,2,83,38.22821116,-109.3688528
63437,21,23,14,15,17,1,91,38.22821116,-109.3685833
63438,29,20,12,19,11,1,92,38.22821116,-109.3683138
63439,31,16,13,18,8,2,88,38.22821116,-109.3680443
63440,7,23,11,14,12,4,71,38.22821116,-109.3677748
63441,3,31,9,7,12,5,67,38.22821116,-109.3675053
63442,3,36,8,4,12,4,67,38.22821116,-109.3672358
63443,5,38,9,5,12,4,73,38.22821116,-109.3669663
63444,5,40,9,5,11,4,74,38.22821116,-109.3666968
63445,5,37,9,5,12,3,71,38.22821116,-109.3664273
63446,5,37,9,5,13,3,72,38.22821116,-109.3661578
63447,5,40,9,5,13,3,75,38.22821116,-109.3658883
63448,6,42,10,5,15,3,81,38.22821116,-109.3656188
63449,10,41,12,6,14,3,86,38.22821116,-109.3653493
63450,8,40,12,6,15,4,85,38.22821116,-109.3650799
63451,5,39,11,4,15,5,79,38.22821116,-109.3648104
63452,3,43,10,2,15,4,77,38.22821116,-109.3645409
63453,1,60,7,1,13,1,83,38.22821116,-109.3642714
63454,1,60,7,4,11,1,84,38.22821116,-109.3640019
63455,1,53,7,3,10,2,76,38.22821116,-109.3637324
63456,1,44,7,3,9,3,67,38.22821116,-109.3634629
63457,2,34,9,6,11,4,66,38.22821116,-109.3631934
63458,21,23,15,9,13,4,85,38.22821116,-109.3629239
63459,37,12,9,14,8,2,82,38.22821116,-109.3626544
63460,37,9,8,19,3,0,76,38.22821116,-109.3623849
63461,38,15,8,16,3,1,81,38.22821116,-109.3621154
63462,38,20,7,10,2,0,77,38.22821116,-109.3618459
63463,32,22,5,6,1,0,66,38.22821116,-109.3615764
63464,33,19,5,6,1,0,64,38.22821116,-109.3613069
63465,32,15,4,7,1,0,59,38.22821116,-109.3610374
63466,32,12,5,8,1,0,58,38.22821116,-109.3607679
63467,31,10,6,13,3,1,64,38.22821116,-109.3604984
63468,16,26,10,16,11,3,82,38.22821116,-109.360229
63469,3,30,9,12,11,5,70,38.22821116,-109.3599595
63470,3,38,9,7,11,4,72,38.22821116,-109.35969
63471,3,48,9,4,14,3,81,38.22821116,-109.3594205
63472,3,49,10,6,11,3,82,38.22821116,-109.359151
63473,2,50,9,6,12,3,82,38.22821116,-109.3588815
63474,1,53,9,4,12,4,83,38.22821116,-109.358612
63475,2,51,8,3,11,6,81,38.22821116,-109.3583425
63476,2,41,9,3,9,8,72,38.22821116,-109.358073
63477,3,37,9,3,8,8,68,38.22821116,-109.3578035
63478,1,33,9,3,10,7,63,38.22821116,-109.357534
63479,1,33,8,3,10,7,62,38.22821116,-109.3572645
63480,1,36,8,3,10,6,64,38.22821116,-109.356995
63481,1,35,8,3,10,7,64,38.22821116,-109.3567255
63482,0,36,8,1,9,7,61,38.22821116,-109.356456
63483,1,38,8,2,9,7,65,38.22821116,-109.3561865
63484,1,39,8,3,10,7,68,38.22821116,-109.355917
63485,1,38,8,3,10,7,67,38.22821116,-109.3556475
63486,1,39,9,2,9,8,68,38.22821116,-109.355378
63487,2,40,9,5,14,4,74,38.22821116,-109.3551086
63488,2,41,10,4,15,5,77,38.22821116,-109.3548391
63489,2,40,10,3,14,7,76,38.22821116,-109.3545696
63490,1,38,10,3,11,9,72,38.22821116,-109.3543001
63491,1,36,9,1,10,10,67,38.22821116,-109.3540306
63492,1,32,10,4,10,9,66,38.22821116,-109.3537611
63493,1,24,11,4,9,12,61,38.22821116,-109.3534916
63494,0,19,11,3,6,14,53,38.22821116,-109.3532221
63495,1,20,10,3,8,12,54,38.22821116,-109.3529526
63496,2,29,10,4,9,9,63,38.22821116,-109.3526831
63497,1,33,9,2,10,10,65,38.22821116,-109.3524136
63498,1,37,9,1,11,9,68,38.22821116,-109.3521441
63499,2,36,9,4,11,5,67,38.22821116,-109.3518746
63500,2,33,8,4,10,5,62,38.22821116,-109.3516051
63501,2,30,8,4,10,6,60,38.22821116,-109.3513356
63502,6,42,12,13,14,1,88,38.22794166299886,-109.406582
63503,8,46,12,12,13,1,92,38.22794166299886,-109.4063125
63504,9,45,13,12,14,1,94,38.22794166299886,-109.406043
63505,13,40,14,14,14,0,95,38.22794166299886,-109.4057735
63506,17,36,14,14,13,0,94,38.22794166299886,-109.405504
63507,19,34,14,13,12,0,92,38.22794166299886,-109.4052345
63508,17,35,14,14,12,0,92,38.22794166299886,-109.4049651
63509,14,37,14,15,13,0,93,38.22794166299886,-109.4046956
63510,16,36,14,15,13,0,94,38.22794166299886,-109.4044261
63511,14,37,14,15,13,0,93,38.22794166299886,-109.4041566
63512,11,40,14,14,13,0,92,38.22794166299886,-109.4038871
63513,9,42,14,14,14,0,93,38.22794166299886,-109.4036176
63514,6,42,13,14,14,1,90,38.22794166299886,-109.4033481
63515,6,44,14,14,14,0,92,38.22794166299886,-109.4030786
63516,7,44,14,14,14,0,93,38.22794166299886,-109.4028091
63517,7,42,14,14,14,1,92,38.22794166299886,-109.4025396
63518,7,42,14,15,14,1,93,38.22794166299886,-109.4022701
63519,7,42,14,13,13,2,91,38.22794166299886,-109.4020006
63520,8,41,13,12,14,2,90,38.22794166299886,-109.4017311
63521,10,41,14,12,14,1,92,38.22794166299886,-109.4014616
63522,11,41,14,12,15,1,94,38.22794166299886,-109.4011921
63523,11,42,13,12,15,0,93,38.22794166299886,-109.4009226
63524,7,45,13,10,16,0,91,38.22794166299886,-109.4006531
63525,7,43,13,11,17,0,91,38.22794166299886,-109.4003836
63526,9,42,14,11,17,0,93,38.22794166299886,-109.4001142
63527,10,41,15,13,15,0,94,38.22794166299886,-109.3998447
63528,11,41,14,12,13,1,92,38.22794166299886,-109.3995752
63529,12,40,15,12,13,1,93,38.22794166299886,-109.3993057
63530,11,41,14,12,13,1,92,38.22794166299886,-109.3990362
63531,11,40,14,12,13,1,91,38.22794166299886,-109.3987667
63532,11,40,14,12,14,1,92,38.22794166299886,-109.3984972
63533,9,41,14,12,15,0,91,38.22794166299886,-109.3982277
63534,9,43,14,11,16,0,93,38.22794166299886,-109.3979582
63535,11,42,13,10,16,0,92,38.22794166299886,-109.3976887
63536,13,41,14,11,15,0,94,38.22794166299886,-109.3974192
63537,15,40,14,11,14,0,94,38.22794166299886,-109.3971497
63538,19,38,14,10,13,0,94,38.22794166299886,-109.3968802
63539,19,39,14,10,12,0,94,38.22794166299886,-109.3966107
63540,17,40,14,10,12,0,93,38.22794166299886,-109.3963412
63541,15,41,14,11,13,0,94,38.22794166299886,-109.3960717
63542,15,41,14,11,13,0,94,38.22794166299886,-109.3958022
63543,13,43,14,11,13,0,94,38.22794166299886,-109.3955327
63544,10,44,14,11,13,0,92,38.22794166299886,-109.3952632
63545,9,44,13,10,13,1,90,38.22794166299886,-109.3949938
63546,8,45,12,10,13,1,89,38.22794166299886,-109.3947243
63547,5,46,12,9,13,2,87,38.22794166299886,-109.3944548
63548,4,47,11,7,12,2,83,38.22794166299886,-109.3941853
63549,3,51,9,6,12,2,83,38.22794166299886,-109.3939158
63550,3,52,9,6,12,2,84,38.22794166299886,-109.3936463
63551,4,51,9,7,12,1,84,38.22794166299886,-109.3933768
63552,7,46,11,9,12,1,86,38.22794166299886,-109.3931073
63553,7,46,11,8,12,1,85,38.22794166299886,-109.3928378
63554,5,51,10,6,11,2,85,38.22794166299886,-109.3925683
63555,5,52,10,7,11,1,86,38.22794166299886,-109.3922988
63556,10,48,12,10,12,0,92,38.22794166299886,-109.3920293
63557,9,47,12,10,12,1,91,38.22794166299886,-109.3917598
63558,7,47,12,9,11,2,88,38.22794166299886,-109.3914903
63559,6,47,12,8,12,2,87,38.22794166299886,-109.3912208
63560,6,47,12,9,12,2,88,38.22794166299886,-109.3909513
63561,6,50,11,7,12,2,88,38.22794166299886,-109.3906818
63562,5,48,10,7,12,2,84,38.22794166299886,-109.3904123
63563,5,46,10,7,12,2,82,38.22794166299886,-109.3901429
63564,5,45,10,6,12,2,80,38.22794166299886,-109.3898734
63565,4,47,10,6,12,3,82,38.22794166299886,-109.3896039
63566,5,50,11,8,12,1,87,38.22794166299886,-109.3893344
63567,5,47,11,8,12,3,86,38.22794166299886,-109.3890649
63568,6,46,11,8,11,2,84,38.22794166299886,-109.3887954
63569,5,47,11,6,12,3,84,38.22794166299886,-109.3885259
63570,3,50,10,5,12,3,83,38.22794166299886,-109.3882564
63571,3,48,10,6,11,4,82,38.22794166299886,-109.3879869
63572,4,47,10,6,11,3,81,38.22794166299886,-109.3877174
63573,5,46,10,6,10,3,80,38.22794166299886,-109.3874479
63574,5,44,10,6,10,3,78,38.22794166299886,-109.3871784
63575,5,47,10,7,10,2,81,38.22794166299886,-109.3869089
63576,2,49,9,5,11,2,78,38.22794166299886,-109.3866394
63577,3,52,9,6,11,1,82,38.22794166299886,-109.3863699
63578,4,54,9,7,11,1,86,38.22794166299886,-109.3861004
63579,2,54,10,6,12,3,87,38.22794166299886,-109.3858309
63580,3,53,10,6,11,3,86,38.22794166299886,-109.3855614
63581,4,52,10,8,12,2,88,38.22794166299886,-109.3852919
63582,4,51,10,7,11,3,86,38.22794166299886,-109.3850225
63583,3,50,10,5,11,4,83,38.22794166299886,-109.384753
63584,5,48,10,7,11,3,84,38.22794166299886,-109.3844835
63585,6,44,11,9,11,3,84,38.22794166299886,-109.384214
63586,6,42,12,9,11,3,83,38.22794166299886,-109.3839445
63587,6,44,11,8,11,2,82,38.22794166299886,-109.383675
63588,5,46,10,7,11,2,81,38.22794166299886,-109.3834055
63589,3,44,9,5,10,3,74,38.22794166299886,-109.383136
63590,3,45,8,5,10,2,73,38.22794166299886,-109.3828665
63591,2,40,8,3,10,3,66,38.22794166299886,-109.382597
63592,2,37,7,3,9,3,61,38.22794166299886,-109.3823275
63593,2,38,6,4,8,3,61,38.22794166299886,-109.382058
63594,2,39,7,4,8,3,63,38.22794166299886,-109.3817885
63595,1,41,6,4,7,3,62,38.22794166299886,-109.381519
63596,2,42,6,6,8,2,66,38.22794166299886,-109.3812495
63597,2,44,6,6,8,2,68,38.22794166299886,-109.38098
63598,2,43,6,6,7,2,66,38.22794166299886,-109.3807105
63599,1,41,6,6,8,2,64,38.22794166299886,-109.380441
63600,1,42,6,5,8,2,64,38.22794166299886,-109.3801716
63601,1,43,6,6,7,2,65,38.22794166299886,-109.3799021
63602,2,44,6,6,7,2,67,38.22794166299886,-109.3796326
63603,2,43,7,6,8,2,68,38.22794166299886,-109.3793631
63604,2,42,7,6,8,2,67,38.22794166299886,-109.3790936
63605,2,39,8,6,8,3,66,38.22794166299886,-109.3788241
63606,2,38,8,6,9,3,66,38.22794166299886,-109.3785546
63607,2,40,8,5,9,3,67,38.22794166299886,-109.3782851
63608,3,44,7,5,9,2,70,38.22794166299886,-109.3780156
63609,3,43,7,4,9,2,68,38.22794166299886,-109.3777461
63610,3,32,8,5,10,3,61,38.22794166299886,-109.3774766
63611,7,24,11,14,11,3,70,38.22794166299886,-109.3772071
63612,9,28,13,20,15,1,86,38.22794166299886,-109.3769376
63613,4,19,8,21,15,2,69,38.22794166299886,-109.3766681
63614,5,22,8,27,14,0,76,38.22794166299886,-109.3763986
63615,13,30,10,20,13,1,87,38.22794166299886,-109.3761291
63616,11,40,13,11,13,2,90,38.22794166299886,-109.3758596
63617,6,40,11,12,14,1,84,38.22794166299886,-109.3755901
63618,9,33,12,13,14,1,82,38.22794166299886,-109.3753206
63619,5,37,10,10,14,2,78,38.22794166299886,-109.3750512
63620,5,43,11,8,15,1,83,38.22794166299886,-109.3747817
63621,7,46,12,10,16,1,92,38.22794166299886,-109.3745122
63622,7,48,12,9,15,0,91,38.22794166299886,-109.3742427
63623,8,49,12,9,15,0,93,38.22794166299886,-109.3739732
63624,8,48,12,9,14,0,91,38.22794166299886,-109.3737037
63625,7,49,11,8,12,1,88,38.22794166299886,-109.3734342
63626,7,52,10,8,12,1,90,38.22794166299886,-109.3731647
63627,5,52,9,6,11,2,85,38.22794166299886,-109.3728952
63628,4,52,9,6,11,2,84,38.22794166299886,-109.3726257
63629,4,53,8,5,11,2,83,38.22794166299886,-109.3723562
63630,4,50,8,4,11,2,79,38.22794166299886,-109.3720867
63631,4,46,8,5,11,2,76,38.22794166299886,-109.3718172
63632,2,42,8,4,10,2,68,38.22794166299886,-109.3715477
63633,2,39,8,3,9,3,64,38.22794166299886,-109.3712782
63634,2,38,7,3,9,3,62,38.22794166299886,-109.3710087
63635,2,35,7,3,9,4,60,38.22794166299886,-109.3707392
63636,2,36,7,4,9,3,61,38.22794166299886,-109.3704697
63637,3,35,7,4,9,3,61,38.22794166299886,-109.3702003
63638,3,32,8,4,11,4,62,38.22794166299886,-109.3699308
63639,5,30,9,5,12,4,65,38.22794166299886,-109.3696613
63640,8,35,10,10,10,3,76,38.22794166299886,-109.3693918
63641,23,23,15,15,13,1,90,38.22794166299886,-109.3691223
63642,32,16,13,22,11,0,94,38.22794166299886,-109.3688528
63643,35,15,10,23,6,1,90,38.22794166299886,-109.3685833
63644,40,16,10,21,4,1,92,38.22794166299886,-109.3683138
63645,36,15,13,22,5,1,92,38.22794166299886,-109.3680443
63646,9,22,12,14,12,3,72,38.22794166299886,-109.3677748
63647,2,31,9,7,11,5,65,38.22794166299886,-109.3675053
63648,3,37,8,5,11,4,68,38.22794166299886,-109.3672358
63649,4,39,9,6,12,3,73,38.22794166299886,-109.3669663
63650,3,38,9,5,12,4,71,38.22794166299886,-109.3666968
63651,2,34,8,4,11,5,64,38.22794166299886,-109.3664273
63652,2,33,8,5,10,5,63,38.22794166299886,-109.3661578
63653,3,34,7,5,10,4,63,38.22794166299886,-109.3658883
63654,7,33,8,5,12,3,68,38.22794166299886,-109.3656188
63655,7,44,10,7,13,2,83,38.22794166299886,-109.3653493
63656,5,47,11,7,15,2,87,38.22794166299886,-109.3650799
63657,4,49,12,5,16,1,87,38.22794166299886,-109.3648104
63658,3,52,10,2,16,1,84,38.22794166299886,-109.3645409
63659,1,61,7,0,14,1,84,38.22794166299886,-109.3642714
63660,0,61,7,2,12,2,84,38.22794166299886,-109.3640019
63661,0,52,7,1,10,3,73,38.22794166299886,-109.3637324
63662,1,45,8,2,10,4,70,38.22794166299886,-109.3634629
63663,3,35,9,7,12,4,70,38.22794166299886,-109.3631934
63664,20,18,14,9,18,4,83,38.22794166299886,-109.3629239
63665,39,10,9,16,7,2,83,38.22794166299886,-109.3626544
63666,37,13,7,17,3,1,78,38.22794166299886,-109.3623849
63667,38,18,8,15,3,1,83,38.22794166299886,-109.3621154
63668,46,22,8,15,1,0,92,38.22794166299886,-109.3618459
63669,45,22,7,12,2,0,88,38.22794166299886,-109.3615764
63670,40,20,7,11,1,0,79,38.22794166299886,-109.3613069
63671,33,14,6,10,1,1,65,38.22794166299886,-109.3610374
63672,33,12,5,11,1,1,63,38.22794166299886,-109.3607679
63673,31,16,11,17,9,3,87,38.22794166299886,-109.3604984
63674,2,29,10,14,12,4,71,38.22794166299886,-109.360229
63675,1,38,8,8,9,4,68,38.22794166299886,-109.3599595
63676,2,44,7,5,12,3,73,38.22794166299886,-109.35969
63677,2,45,9,5,12,4,77,38.22794166299886,-109.3594205
63678,3,44,9,6,10,4,76,38.22794166299886,-109.359151
63679,3,42,9,7,10,3,74,38.22794166299886,-109.3588815
63680,2,45,8,4,10,4,73,38.22794166299886,-109.358612
63681,2,45,8,3,10,5,73,38.22794166299886,-109.3583425
63682,1,36,8,3,10,7,65,38.22794166299886,-109.358073
63683,3,37,8,4,8,7,67,38.22794166299886,-109.3578035
63684,2,31,9,5,10,7,64,38.22794166299886,-109.357534
63685,3,31,9,5,10,6,64,38.22794166299886,-109.3572645
63686,4,33,9,5,10,5,66,38.22794166299886,-109.356995
63687,2,31,9,6,11,5,64,38.22794166299886,-109.3567255
63688,3,30,8,5,10,6,62,38.22794166299886,-109.356456
63689,1,33,8,4,10,7,63,38.22794166299886,-109.3561865
63690,2,33,9,6,11,6,67,38.22794166299886,-109.355917
63691,3,31,10,10,11,6,71,38.22794166299886,-109.3556475
63692,3,30,10,8,11,7,69,38.22794166299886,-109.355378
63693,2,39,10,4,13,7,75,38.22794166299886,-109.3551086
63694,3,42,11,4,15,5,80,38.22794166299886,-109.3548391
63695,2,38,10,4,13,6,73,38.22794166299886,-109.3545696
63696,1,36,10,2,11,10,70,38.22794166299886,-109.3543001
63697,0,35,9,2,9,11,66,38.22794166299886,-109.3540306
63698,1,34,10,1,9,12,67,38.22794166299886,-109.3537611
63699,1,29,10,2,7,13,62,38.22794166299886,-109.3534916
63700,1,22,11,3,6,14,57,38.22794166299886,-109.3532221
63701,1,22,10,3,9,12,57,38.22794166299886,-109.3529526
63702,1,24,11,4,9,12,61,38.22794166299886,-109.3526831
63703,3,30,10,4,11,9,67,38.22794166299886,-109.3524136
63704,3,36,8,4,10,7,68,38.22794166299886,-109.3521441
63705,2,37,8,4,10,5,66,38.22794166299886,-109.3518746
63706,2,31,7,2,10,5,57,38.22794166299886,-109.3516051
63707,2,29,8,4,11,5,59,38.22794166299886,-109.3513356
63708,4,33,9,8,13,2,69,38.227672168413626,-109.406582
63709,4,39,10,9,14,1,77,38.227672168413626,-109.4063125
63710,4,45,11,9,13,1,83,38.227672168413626,-109.406043
63711,7,48,12,11,13,1,92,38.227672168413626,-109.4057735
63712,11,44,12,12,13,1,93,38.227672168413626,-109.405504
63713,14,38,13,14,14,0,93,38.227672168413626,-109.4052345
63714,18,34,14,14,13,0,93,38.227672168413626,-109.4049651
63715,18,34,14,14,12,0,92,38.227672168413626,-109.4046956
63716,14,36,14,15,13,0,92,38.227672168413626,-109.4044261
63717,13,37,14,15,13,0,92,38.227672168413626,-109.4041566
63718,11,39,14,14,13,0,91,38.227672168413626,-109.4038871
63719,9,42,14,14,14,0,93,38.227672168413626,-109.4036176
63720,8,42,13,14,14,0,91,38.227672168413626,-109.4033481
63721,7,42,14,13,14,1,91,38.227672168413626,-109.4030786
63722,7,43,13,12,14,1,90,38.227672168413626,-109.4028091
63723,7,44,14,12,14,1,92,38.227672168413626,-109.4025396
63724,8,41,14,14,14,1,92,38.227672168413626,-109.4022701
63725,10,40,14,14,13,1,92,38.227672168413626,-109.4020006
63726,10,40,14,14,13,1,92,38.227672168413626,-109.4017311
63727,11,40,14,14,14,1,94,38.227672168413626,-109.4014616
63728,12,39,14,13,14,1,93,38.227672168413626,-109.4011921
63729,14,40,13,13,14,0,94,38.227672168413626,-109.4009226
63730,10,45,13,11,15,0,94,38.227672168413626,-109.4006531
63731,6,46,12,10,16,0,90,38.227672168413626,-109.4003836
63732,7,44,13,10,16,0,90,38.227672168413626,-109.4001142
63733,8,40,14,13,14,1,90,38.227672168413626,-109.3998447
63734,9,39,14,12,13,1,88,38.227672168413626,-109.3995752
63735,9,39,14,12,13,1,88,38.227672168413626,-109.3993057
63736,9,39,14,13,13,1,89,38.227672168413626,-109.3990362
63737,8,40,14,13,13,1,89,38.227672168413626,-109.3987667
63738,8,42,13,11,13,1,88,38.227672168413626,-109.3984972
63739,6,46,13,9,16,0,90,38.227672168413626,-109.3982277
63740,6,46,13,8,16,1,90,38.227672168413626,-109.3979582
63741,7,44,13,10,16,1,91,38.227672168413626,-109.3976887
63742,11,42,14,12,14,0,93,38.227672168413626,-109.3974192
63743,14,40,14,12,14,0,94,38.227672168413626,-109.3971497
63744,17,38,14,11,13,0,93,38.227672168413626,-109.3968802
63745,19,37,14,11,12,0,93,38.227672168413626,-109.3966107
63746,17,39,14,10,12,0,92,38.227672168413626,-109.3963412
63747,15,41,14,11,12,0,93,38.227672168413626,-109.3960717
63748,13,42,14,12,13,0,94,38.227672168413626,-109.3958022
63749,9,46,13,10,13,1,92,38.227672168413626,-109.3955327
63750,6,48,12,9,13,1,89,38.227672168413626,-109.3952632
63751,4,50,11,8,13,1,87,38.227672168413626,-109.3949938
63752,4,53,10,7,12,1,87,38.227672168413626,-109.3947243
63753,3,50,10,7,12,2,84,38.227672168413626,-109.3944548
63754,4,48,11,8,12,1,84,38.227672168413626,-109.3941853
63755,4,48,11,8,12,2,85,38.227672168413626,-109.3939158
63756,5,48,11,7,12,2,85,38.227672168413626,-109.3936463
63757,7,47,11,7,11,2,85,38.227672168413626,-109.3933768
63758,10,44,13,10,11,2,90,38.227672168413626,-109.3931073
63759,9,46,12,10,11,1,89,38.227672168413626,-109.3928378
63760,6,51,11,7,11,2,88,38.227672168413626,-109.3925683
63761,5,52,10,6,11,2,86,38.227672168413626,-109.3922988
63762,8,49,12,10,12,1,92,38.227672168413626,-109.3920293
63763,8,46,11,11,12,1,89,38.227672168413626,-109.3917598
63764,5,44,10,7,11,2,79,38.227672168413626,-109.3914903
63765,4,44,10,6,11,2,77,38.227672168413626,-109.3912208
63766,4,45,9,6,11,2,77,38.227672168413626,-109.3909513
63767,4,48,10,5,12,2,81,38.227672168413626,-109.3906818
63768,4,44,9,5,12,2,76,38.227672168413626,-109.3904123
63769,3,41,9,5,11,3,72,38.227672168413626,-109.3901429
63770,3,40,9,5,11,3,71,38.227672168413626,-109.3898734
63771,3,42,9,5,11,3,73,38.227672168413626,-109.3896039
63772,4,48,9,7,11,1,80,38.227672168413626,-109.3893344
63773,4,47,9,7,11,1,79,38.227672168413626,-109.3890649
63774,4,46,9,7,11,2,79,38.227672168413626,-109.3887954
63775,4,46,9,6,11,2,78,38.227672168413626,-109.3885259
63776,4,48,8,5,11,1,77,38.227672168413626,-109.3882564
63777,4,46,8,4,11,2,75,38.227672168413626,-109.3879869
63778,5,43,8,4,10,2,72,38.227672168413626,-109.3877174
63779,6,39,8,4,9,3,69,38.227672168413626,-109.3874479
63780,5,35,8,4,10,3,65,38.227672168413626,-109.3871784
63781,5,36,8,4,10,3,66,38.227672168413626,-109.3869089
63782,4,36,8,4,9,3,64,38.227672168413626,-109.3866394
63783,4,39,8,5,10,3,69,38.227672168413626,-109.3863699
63784,5,43,9,7,11,2,77,38.227672168413626,-109.3861004
63785,3,54,10,7,12,1,87,38.227672168413626,-109.3858309
63786,3,56,9,6,12,2,88,38.227672168413626,-109.3855614
63787,4,51,9,7,11,1,83,38.227672168413626,-109.3852919
63788,3,48,8,6,11,2,78,38.227672168413626,-109.3850225
63789,3,49,8,5,11,2,78,38.227672168413626,-109.384753
63790,4,48,8,6,11,2,79,38.227672168413626,-109.3844835
63791,4,50,8,6,10,2,80,38.227672168413626,-109.384214
63792,4,50,8,6,11,2,81,38.227672168413626,-109.3839445
63793,4,48,8,6,10,2,78,38.227672168413626,-109.383675
63794,4,45,8,6,10,2,75,38.227672168413626,-109.3834055
63795,2,43,8,4,9,3,69,38.227672168413626,-109.383136
63796,2,43,8,4,9,2,68,38.227672168413626,-109.3828665
63797,2,40,7,4,9,3,65,38.227672168413626,-109.382597
63798,2,40,7,4,8,3,64,38.227672168413626,-109.3823275
63799,2,42,6,5,7,2,64,38.227672168413626,-109.382058
63800,2,39,7,5,8,3,64,38.227672168413626,-109.3817885
63801,1,38,7,4,7,4,61,38.227672168413626,-109.381519
63802,2,37,7,5,7,4,62,38.227672168413626,-109.3812495
63803,3,40,7,6,7,3,66,38.227672168413626,-109.38098
63804,2,40,7,5,7,3,64,38.227672168413626,-109.3807105
63805,2,40,7,6,9,2,66,38.227672168413626,-109.380441
63806,2,38,8,6,9,3,66,38.227672168413626,-109.3801716
63807,2,38,8,6,9,3,66,38.227672168413626,-109.3799021
63808,2,39,7,6,8,3,65,38.227672168413626,-109.3796326
63809,2,42,7,6,8,2,67,38.227672168413626,-109.3793631
63810,2,45,6,7,6,2,68,38.227672168413626,-109.3790936
63811,2,45,7,7,7,2,70,38.227672168413626,-109.3788241
63812,2,42,7,7,9,2,69,38.227672168413626,-109.3785546
63813,2,45,8,5,11,2,73,38.227672168413626,-109.3782851
63814,3,44,7,5,9,2,70,38.227672168413626,-109.3780156
63815,3,37,7,6,10,3,66,38.227672168413626,-109.3777461
63816,7,27,10,13,11,2,70,38.227672168413626,-109.3774766
63817,13,26,14,19,13,1,86,38.227672168413626,-109.3772071
63818,11,29,13,19,16,1,89,38.227672168413626,-109.3769376
63819,5,26,9,25,15,1,81,38.227672168413626,-109.3766681
63820,3,22,8,27,14,0,74,38.227672168413626,-109.3763986
63821,6,27,10,23,13,1,80,38.227672168413626,-109.3761291
63822,8,40,12,13,14,2,89,38.227672168413626,-109.3758596
63823,7,41,13,15,13,1,90,38.227672168413626,-109.3755901
63824,12,32,13,15,13,1,86,38.227672168413626,-109.3753206
63825,5,33,11,13,12,2,76,38.227672168413626,-109.3750512
63826,5,41,11,10,14,1,82,38.227672168413626,-109.3747817
63827,7,48,12,10,14,0,91,38.227672168413626,-109.3745122
63828,7,48,12,9,15,1,92,38.227672168413626,-109.3742427
63829,10,46,13,9,14,0,92,38.227672168413626,-109.3739732
63830,9,48,12,9,12,1,91,38.227672168413626,-109.3737037
63831,6,46,10,6,11,1,80,38.227672168413626,-109.3734342
63832,4,43,8,5,11,2,73,38.227672168413626,-109.3731647
63833,4,43,8,4,11,2,72,38.227672168413626,-109.3728952
63834,3,49,8,5,11,1,77,38.227672168413626,-109.3726257
63835,3,50,7,4,11,1,76,38.227672168413626,-109.3723562
63836,2,45,7,3,9,2,68,38.227672168413626,-109.3720867
63837,2,39,7,3,8,3,62,38.227672168413626,-109.3718172
63838,2,37,7,3,9,3,61,38.227672168413626,-109.3715477
63839,2,36,7,3,9,3,60,38.227672168413626,-109.3712782
63840,2,33,7,4,10,4,60,38.227672168413626,-109.3710087
63841,3,29,8,5,10,5,60,38.227672168413626,-109.3707392
63842,4,27,9,7,13,3,63,38.227672168413626,-109.3704697
63843,6,25,11,11,14,3,70,38.227672168413626,-109.3702003
63844,8,27,11,13,14,3,76,38.227672168413626,-109.3699308
63845,17,31,13,14,12,1,88,38.227672168413626,-109.3696613
63846,28,32,12,14,7,0,93,38.227672168413626,-109.3693918
63847,35,21,10,18,5,0,89,38.227672168413626,-109.3691223
63848,41,18,10,21,5,0,95,38.227672168413626,-109.3688528
63849,39,17,10,22,5,1,94,38.227672168413626,-109.3685833
63850,37,17,10,21,5,1,91,38.227672168413626,-109.3683138
63851,39,16,12,20,5,1,93,38.227672168413626,-109.3680443
63852,16,27,13,17,10,1,84,38.227672168413626,-109.3677748
63853,5,31,9,8,11,3,67,38.227672168413626,-109.3675053
63854,3,33,8,5,10,4,63,38.227672168413626,-109.3672358
63855,2,39,7,4,9,4,65,38.227672168413626,-109.3669663
63856,3,35,8,4,11,4,65,38.227672168413626,-109.3666968
63857,4,37,9,5,11,3,69,38.227672168413626,-109.3664273
63858,5,35,9,6,12,3,70,38.227672168413626,-109.3661578
63859,4,33,8,5,11,4,65,38.227672168413626,-109.3658883
63860,4,39,7,6,8,3,67,38.227672168413626,-109.3656188
63861,9,39,9,7,13,1,78,38.227672168413626,-109.3653493
63862,9,47,11,9,12,1,89,38.227672168413626,-109.3650799
63863,5,52,11,6,14,1,89,38.227672168413626,-109.3648104
63864,2,56,9,3,14,1,85,38.227672168413626,-109.3645409
63865,0,65,7,2,12,1,87,38.227672168413626,-109.3642714
63866,1,64,7,3,11,1,87,38.227672168413626,-109.3640019
63867,1,56,7,3,10,2,79,38.227672168413626,-109.3637324
63868,1,48,7,2,9,3,70,38.227672168413626,-109.3634629
63869,4,37,9,6,12,3,71,38.227672168413626,-109.3631934
63870,18,23,14,16,13,1,85,38.227672168413626,-109.3629239
63871,43,21,9,11,3,0,87,38.227672168413626,-109.3626544
63872,39,22,7,12,3,0,83,38.227672168413626,-109.3623849
63873,39,22,7,11,2,0,81,38.227672168413626,-109.3621154
63874,40,22,7,10,2,0,81,38.227672168413626,-109.3618459
63875,36,20,6,10,2,0,74,38.227672168413626,-109.3615764
63876,35,17,7,12,1,0,72,38.227672168413626,-109.3613069
63877,31,13,6,11,2,1,64,38.227672168413626,-109.3610374
63878,29,13,7,16,3,2,70,38.227672168413626,-109.3607679
63879,19,21,12,13,13,6,84,38.227672168413626,-109.3604984
63880,1,31,9,12,10,3,66,38.227672168413626,-109.360229
63881,1,41,7,6,9,3,67,38.227672168413626,-109.3599595
63882,2,41,7,4,10,3,67,38.227672168413626,-109.35969
63883,2,37,8,4,12,4,67,38.227672168413626,-109.3594205
63884,3,41,9,6,11,3,73,38.227672168413626,-109.359151
63885,4,36,10,8,9,4,71,38.227672168413626,-109.3588815
63886,4,34,10,8,9,5,70,38.227672168413626,-109.358612
63887,3,34,9,7,10,5,68,38.227672168413626,-109.3583425
63888,3,34,9,7,11,5,69,38.227672168413626,-109.358073
63889,7,30,10,11,11,4,73,38.227672168413626,-109.3578035
63890,12,28,12,16,11,2,81,38.227672168413626,-109.357534
63891,16,25,12,14,13,2,82,38.227672168413626,-109.3572645
63892,15,23,12,14,12,3,79,38.227672168413626,-109.356995
63893,13,25,12,17,13,2,82,38.227672168413626,-109.3567255
63894,8,23,12,12,10,6,71,38.227672168413626,-109.356456
63895,3,28,10,6,8,9,64,38.227672168413626,-109.3561865
63896,5,27,11,11,11,7,72,38.227672168413626,-109.355917
63897,16,24,15,13,13,4,85,38.227672168413626,-109.3556475
63898,7,21,14,10,9,11,72,38.227672168413626,-109.355378
63899,2,34,10,5,11,8,70,38.227672168413626,-109.3551086
63900,3,39,10,6,13,4,75,38.227672168413626,-109.3548391
63901,3,37,9,5,11,5,70,38.227672168413626,-109.3545696
63902,2,32,8,3,10,7,62,38.227672168413626,-109.3543001
63903,1,33,8,3,9,8,62,38.227672168413626,-109.3540306
63904,1,32,9,2,8,10,62,38.227672168413626,-109.3537611
63905,1,27,11,3,6,14,62,38.227672168413626,-109.3534916
63906,1,27,11,3,6,15,63,38.227672168413626,-109.3532221
63907,3,36,10,3,11,10,73,38.227672168413626,-109.3529526
63908,2,34,11,2,9,14,72,38.227672168413626,-109.3526831
63909,3,38,10,4,13,7,75,38.227672168413626,-109.3524136
63910,4,39,9,6,11,5,74,38.227672168413626,-109.3521441
63911,2,37,8,3,10,6,66,38.227672168413626,-109.3518746
63912,1,31,8,2,10,6,58,38.227672168413626,-109.3516051
63913,4,27,10,10,14,4,69,38.227672168413626,-109.3513356
63914,2,28,9,10,12,4,65,38.227402673828394,-109.406582
63915,3,37,8,6,9,3,66,38.227402673828394,-109.4063125
63916,2,41,8,7,10,3,71,38.227402673828394,-109.406043
63917,3,48,9,7,13,2,82,38.227402673828394,-109.4057735
63918,6,51,11,11,13,1,93,38.227402673828394,-109.405504
63919,10,45,12,12,13,1,93,38.227402673828394,-109.4052345
63920,14,38,13,13,14,0,92,38.227402673828394,-109.4049651
63921,18,34,13,14,13,0,92,38.227402673828394,-109.4046956
63922,12,38,14,14,13,1,92,38.227402673828394,-109.4044261
63923,10,40,14,13,13,1,91,38.227402673828394,-109.4041566
63924,8,41,14,12,14,1,90,38.227402673828394,-109.4038871
63925,8,42,14,13,13,1,91,38.227402673828394,-109.4036176
63926,8,41,14,15,13,0,91,38.227402673828394,-109.4033481
63927,8,42,14,15,14,1,94,38.227402673828394,-109.4030786
63928,6,45,13,12,13,1,90,38.227402673828394,-109.4028091
63929,6,44,13,12,14,1,90,38.227402673828394,-109.4025396
63930,7,42,14,13,14,1,91,38.227402673828394,-109.4022701
63931,10,41,13,13,14,0,91,38.227402673828394,-109.4020006
63932,10,42,13,14,14,1,94,38.227402673828394,-109.4017311
63933,10,42,14,13,14,1,94,38.227402673828394,-109.4014616
63934,10,42,14,13,14,1,94,38.227402673828394,-109.4011921
63935,11,42,13,13,14,0,93,38.227402673828394,-109.4009226
63936,10,45,13,11,15,0,94,38.227402673828394,-109.4006531
63937,6,46,11,9,15,0,87,38.227402673828394,-109.4003836
63938,5,45,11,9,15,1,86,38.227402673828394,-109.4001142
63939,6,44,12,10,14,1,87,38.227402673828394,-109.3998447
63940,6,43,12,10,13,1,85,38.227402673828394,-109.3995752
63941,6,41,12,10,13,1,83,38.227402673828394,-109.3993057
63942,6,40,13,11,13,1,84,38.227402673828394,-109.3990362
63943,6,42,13,10,12,2,85,38.227402673828394,-109.3987667
63944,5,46,12,8,12,2,85,38.227402673828394,-109.3984972
63945,3,51,11,6,15,1,87,38.227402673828394,-109.3982277
63946,4,51,11,7,14,1,88,38.227402673828394,-109.3979582
63947,6,46,13,9,15,1,90,38.227402673828394,-109.3976887
63948,8,42,14,11,15,1,91,38.227402673828394,-109.3974192
63949,12,40,14,12,14,0,92,38.227402673828394,-109.3971497
63950,13,39,14,13,14,0,93,38.227402673828394,-109.3968802
63951,15,37,14,13,13,0,92,38.227402673828394,-109.3966107
63952,14,38,14,12,12,1,91,38.227402673828394,-109.3963412
63953,11,41,14,12,13,1,92,38.227402673828394,-109.3960717
63954,8,44,13,11,12,1,89,38.227402673828394,-109.3958022
63955,5,47,11,8,13,1,85,38.227402673828394,-109.3955327
63956,4,47,10,8,13,1,83,38.227402673828394,-109.3952632
63957,4,49,10,7,13,1,84,38.227402673828394,-109.3949938
63958,3,52,10,6,12,2,85,38.227402673828394,-109.3947243
63959,3,51,10,6,12,2,84,38.227402673828394,-109.3944548
63960,7,43,12,10,12,1,85,38.227402673828394,-109.3941853
63961,9,41,13,10,11,1,85,38.227402673828394,-109.3939158
63962,9,41,13,9,11,2,85,38.227402673828394,-109.3936463
63963,9,40,13,9,11,2,84,38.227402673828394,-109.3933768
63964,10,42,12,10,11,2,87,38.227402673828394,-109.3931073
63965,8,47,11,9,11,1,87,38.227402673828394,-109.3928378
63966,5,50,10,6,11,2,84,38.227402673828394,-109.3925683
63967,4,49,9,6,11,2,81,38.227402673828394,-109.3922988
63968,6,45,10,7,12,1,81,38.227402673828394,-109.3920293
63969,6,42,9,7,11,2,77,38.227402673828394,-109.3917598
63970,4,41,8,5,10,2,70,38.227402673828394,-109.3914903
63971,3,40,8,4,10,3,68,38.227402673828394,-109.3912208
63972,3,41,8,4,10,3,69,38.227402673828394,-109.3909513
63973,2,40,8,4,10,4,68,38.227402673828394,-109.3906818
63974,2,40,8,4,10,3,67,38.227402673828394,-109.3904123
63975,2,40,8,4,9,3,66,38.227402673828394,-109.3901429
63976,2,39,7,4,9,3,64,38.227402673828394,-109.3898734
63977,2,39,7,4,8,3,63,38.227402673828394,-109.3896039
63978,2,43,6,4,8,3,66,38.227402673828394,-109.3893344
63979,2,42,6,5,8,2,65,38.227402673828394,-109.3890649
63980,3,41,6,5,8,2,65,38.227402673828394,-109.3887954
63981,3,40,7,5,8,2,65,38.227402673828394,-109.3885259
63982,3,41,7,4,9,3,67,38.227402673828394,-109.3882564
63983,2,37,7,4,8,3,61,38.227402673828394,-109.3879869
63984,2,38,7,5,8,3,63,38.227402673828394,-109.3877174
63985,3,35,7,5,8,3,61,38.227402673828394,-109.3874479
63986,5,32,8,6,9,3,63,38.227402673828394,-109.3871784
63987,7,36,10,7,11,2,73,38.227402673828394,-109.3869089
63988,6,39,9,5,10,2,71,38.227402673828394,-109.3866394
63989,7,40,9,6,11,2,75,38.227402673828394,-109.3863699
63990,6,45,9,7,12,1,80,38.227402673828394,-109.3861004
63991,4,54,10,7,12,1,88,38.227402673828394,-109.3858309
63992,4,51,9,7,11,1,83,38.227402673828394,-109.3855614
63993,6,44,9,6,10,2,77,38.227402673828394,-109.3852919
63994,5,44,8,6,10,2,75,38.227402673828394,-109.3850225
63995,4,45,7,5,9,2,72,38.227402673828394,-109.384753
63996,3,46,7,5,7,2,70,38.227402673828394,-109.3844835
63997,3,46,6,5,8,2,70,38.227402673828394,-109.384214
63998,3,46,6,4,8,2,69,38.227402673828394,-109.3839445
63999,2,45,6,4,8,2,67,38.227402673828394,-109.383675
64000,2,44,6,5,7,2,66,38.227402673828394,-109.3834055
64001,2,40,6,4,7,3,62,38.227402673828394,-109.383136
64002,2,40,7,4,8,3,64,38.227402673828394,-109.3828665
64003,3,42,8,6,9,2,70,38.227402673828394,-109.382597
64004,3,43,8,6,10,2,72,38.227402673828394,-109.3823275
64005,4,41,8,6,9,2,70,38.227402673828394,-109.382058
64006,2,35,8,5,10,3,63,38.227402673828394,-109.3817885
64007,4,30,10,8,9,4,65,38.227402673828394,-109.381519
64008,6,29,11,9,10,4,69,38.227402673828394,-109.3812495
64009,7,30,11,10,11,3,72,38.227402673828394,-109.38098
64010,6,28,11,9,9,6,69,38.227402673828394,-109.3807105
64011,4,33,9,6,9,4,65,38.227402673828394,-109.380441
64012,2,36,8,6,9,3,64,38.227402673828394,-109.3801716
64013,2,37,8,6,8,4,65,38.227402673828394,-109.3799021
64014,2,39,7,6,7,4,65,38.227402673828394,-109.3796326
64015,3,45,6,7,6,3,70,38.227402673828394,-109.3793631
64016,2,48,6,6,5,3,70,38.227402673828394,-109.3790936
64017,2,48,6,7,6,2,71,38.227402673828394,-109.3788241
64018,2,44,7,7,8,2,70,38.227402673828394,-109.3785546
64019,2,44,8,5,10,2,71,38.227402673828394,-109.3782851
64020,2,41,7,4,8,3,65,38.227402673828394,-109.3780156
64021,7,30,9,9,10,3,68,38.227402673828394,-109.3777461
64022,13,26,12,15,12,1,79,38.227402673828394,-109.3774766
64023,18,30,14,16,14,1,93,38.227402673828394,-109.3772071
64024,16,33,13,14,14,1,91,38.227402673828394,-109.3769376
64025,13,28,11,23,13,1,89,38.227402673828394,-109.3766681
64026,3,25,8,22,17,1,76,38.227402673828394,-109.3763986
64027,2,26,9,21,14,1,73,38.227402673828394,-109.3761291
64028,7,30,10,18,13,2,80,38.227402673828394,-109.3758596
64029,12,38,13,15,14,1,93,38.227402673828394,-109.3755901
64030,14,32,13,15,13,2,89,38.227402673828394,-109.3753206
64031,6,30,12,15,12,3,78,38.227402673828394,-109.3750512
64032,3,37,10,11,12,2,75,38.227402673828394,-109.3747817
64033,3,46,10,9,13,1,82,38.227402673828394,-109.3745122
64034,5,47,12,8,14,2,88,38.227402673828394,-109.3742427
64035,7,46,12,8,13,2,88,38.227402673828394,-109.3739732
64036,7,47,11,7,11,2,85,38.227402673828394,-109.3737037
64037,4,42,9,5,10,3,73,38.227402673828394,-109.3734342
64038,2,36,8,4,9,3,62,38.227402673828394,-109.3731647
64039,3,40,8,5,9,2,67,38.227402673828394,-109.3728952
64040,3,44,7,4,9,2,69,38.227402673828394,-109.3726257
64041,2,47,7,4,9,2,71,38.227402673828394,-109.3723562
64042,3,45,7,4,9,2,70,38.227402673828394,-109.3720867
64043,3,37,7,4,9,3,63,38.227402673828394,-109.3718172
64044,4,36,8,4,10,3,65,38.227402673828394,-109.3715477
64045,5,33,9,5,12,3,67,38.227402673828394,-109.3712782
64046,7,33,10,9,12,3,74,38.227402673828394,-109.3710087
64047,10,30,12,13,12,2,79,38.227402673828394,-109.3707392
64048,9,32,13,13,13,2,82,38.227402673828394,-109.3704697
64049,12,33,13,14,13,1,86,38.227402673828394,-109.3702003
64050,26,30,13,14,12,0,95,38.227402673828394,-109.3699308
64051,46,25,8,10,6,0,95,38.227402673828394,-109.3696613
64052,59,21,7,9,3,0,99,38.227402673828394,-109.3693918
64053,56,22,8,12,3,0,101,38.227402673828394,-109.3691223
64054,52,20,8,14,5,0,99,38.227402673828394,-109.3688528
64055,47,14,10,17,6,1,95,38.227402673828394,-109.3685833
64056,44,13,10,20,5,1,93,38.227402673828394,-109.3683138
64057,46,14,10,18,4,1,93,38.227402673828394,-109.3680443
64058,38,22,11,16,7,0,94,38.227402673828394,-109.3677748
64059,14,25,10,13,13,2,77,38.227402673828394,-109.3675053
64060,6,28,9,7,13,3,66,38.227402673828394,-109.3672358
64061,5,31,9,6,13,3,67,38.227402673828394,-109.3669663
64062,8,33,8,5,12,2,68,38.227402673828394,-109.3666968
64063,6,33,10,7,14,2,72,38.227402673828394,-109.3664273
64064,5,29,11,9,15,4,73,38.227402673828394,-109.3661578
64065,3,24,10,10,13,6,66,38.227402673828394,-109.3658883
64066,1,30,9,8,10,6,64,38.227402673828394,-109.3656188
64067,5,42,9,9,11,1,77,38.227402673828394,-109.3653493
64068,6,44,9,8,13,1,81,38.227402673828394,-109.3650799
64069,5,49,9,6,11,2,82,38.227402673828394,-109.3648104
64070,2,54,8,4,11,2,81,38.227402673828394,-109.3645409
64071,1,62,7,3,10,1,84,38.227402673828394,-109.3642714
64072,1,63,7,3,9,1,84,38.227402673828394,-109.3640019
64073,1,56,7,3,9,2,78,38.227402673828394,-109.3637324
64074,2,46,8,4,11,3,74,38.227402673828394,-109.3634629
64075,6,36,10,10,14,2,78,38.227402673828394,-109.3631934
64076,18,25,11,15,10,0,79,38.227402673828394,-109.3629239
64077,35,23,8,13,3,0,82,38.227402673828394,-109.3626544
64078,33,22,7,12,2,0,76,38.227402673828394,-109.3623849
64079,33,21,5,9,2,0,70,38.227402673828394,-109.3621154
64080,33,19,5,6,1,0,64,38.227402673828394,-109.3618459
64081,29,18,4,3,1,0,55,38.227402673828394,-109.3615764
64082,31,15,5,5,1,0,57,38.227402673828394,-109.3613069
64083,31,13,5,9,1,1,60,38.227402673828394,-109.3610374
64084,33,14,8,13,5,3,76,38.227402673828394,-109.3607679
64085,13,22,12,9,11,10,77,38.227402673828394,-109.3604984
64086,1,30,9,7,11,6,64,38.227402673828394,-109.360229
64087,2,38,7,4,10,4,65,38.227402673828394,-109.3599595
64088,2,38,7,4,10,3,64,38.227402673828394,-109.35969
64089,2,34,8,5,13,4,66,38.227402673828394,-109.3594205
64090,7,36,10,11,11,2,77,38.227402673828394,-109.359151
64091,9,32,12,13,11,2,79,38.227402673828394,-109.3588815
64092,10,33,12,14,11,2,82,38.227402673828394,-109.358612
64093,13,33,12,14,11,1,84,38.227402673828394,-109.3583425
64094,16,32,12,16,11,1,88,38.227402673828394,-109.358073
64095,21,24,11,17,8,0,81,38.227402673828394,-109.3578035
64096,43,19,10,12,5,0,89,38.227402673828394,-109.357534
64097,48,16,10,16,4,0,94,38.227402673828394,-109.3572645
64098,38,15,10,22,5,0,90,38.227402673828394,-109.356995
64099,33,16,10,22,4,1,86,38.227402673828394,-109.3567255
64100,33,24,12,16,7,1,93,38.227402673828394,-109.356456
64101,12,32,12,13,10,4,83,38.227402673828394,-109.3561865
64102,17,30,14,13,9,4,87,38.227402673828394,-109.355917
64103,25,17,13,8,5,1,69,38.227402673828394,-109.3556475
64104,18,24,15,13,8,6,84,38.227402673828394,-109.355378
64105,4,33,9,7,11,6,70,38.227402673828394,-109.3551086
64106,3,35,9,6,11,5,69,38.227402673828394,-109.3548391
64107,3,33,9,5,10,6,66,38.227402673828394,-109.3545696
64108,2,32,8,3,9,8,62,38.227402673828394,-109.3543001
64109,1,30,8,4,9,8,60,38.227402673828394,-109.3540306
64110,3,31,11,3,9,10,67,38.227402673828394,-109.3537611
64111,1,32,11,2,7,15,68,38.227402673828394,-109.3534916
64112,1,35,10,1,7,15,69,38.227402673828394,-109.3532221
64113,3,46,10,2,12,7,80,38.227402673828394,-109.3529526
64114,3,45,10,2,13,8,81,38.227402673828394,-109.3526831
64115,2,44,10,2,12,7,77,38.227402673828394,-109.3524136
64116,3,39,8,4,11,5,70,38.227402673828394,-109.3521441
64117,2,35,8,2,9,7,63,38.227402673828394,-109.3518746
64118,2,32,9,4,9,7,63,38.227402673828394,-109.3516051
64119,10,27,12,15,11,4,79,38.227402673828394,-109.3513356
64120,3,24,10,19,12,4,72,38.227133179243154,-109.406582
64121,1,32,9,10,9,6,67,38.227133179243154,-109.4063125
64122,2,41,7,6,8,4,68,38.227133179243154,-109.406043
64123,2,39,9,7,10,3,70,38.227133179243154,-109.4057735
64124,4,45,9,7,13,1,79,38.227133179243154,-109.405504
64125,6,50,11,11,13,1,92,38.227133179243154,-109.4052345
64126,10,46,12,12,13,1,94,38.227133179243154,-109.4049651
64127,13,40,13,12,14,1,93,38.227133179243154,-109.4046956
64128,10,40,14,14,14,1,93,38.227133179243154,-109.4044261
64129,7,41,14,12,13,2,89,38.227133179243154,-109.4041566
64130,6,41,13,10,13,2,85,38.227133179243154,-109.4038871
64131,6,41,13,11,13,2,86,38.227133179243154,-109.4036176
64132,7,42,13,12,13,2,89,38.227133179243154,-109.4033481
64133,6,44,13,12,13,1,89,38.227133179243154,-109.4030786
64134,6,47,12,11,13,1,90,38.227133179243154,-109.4028091
64135,5,47,12,12,13,1,90,38.227133179243154,-109.4025396
64136,5,46,13,12,13,1,90,38.227133179243154,-109.4022701
64137,7,45,13,12,14,1,92,38.227133179243154,-109.4020006
64138,7,46,13,12,14,1,93,38.227133179243154,-109.4017311
64139,8,46,13,12,13,1,93,38.227133179243154,-109.4014616
64140,9,45,13,12,13,1,93,38.227133179243154,-109.4011921
64141,10,43,13,12,13,1,92,38.227133179243154,-109.4009226
64142,9,44,13,12,14,1,93,38.227133179243154,-109.4006531
64143,5,50,11,9,14,1,90,38.227133179243154,-109.4003836
64144,4,50,11,9,13,1,88,38.227133179243154,-109.4001142
64145,4,49,11,8,13,1,86,38.227133179243154,-109.3998447
64146,5,46,11,8,13,1,84,38.227133179243154,-109.3995752
64147,6,45,12,9,13,1,86,38.227133179243154,-109.3993057
64148,7,42,13,10,12,1,85,38.227133179243154,-109.3990362
64149,6,43,13,11,12,1,86,38.227133179243154,-109.3987667
64150,5,47,12,10,12,1,87,38.227133179243154,-109.3984972
64151,4,54,11,8,14,1,92,38.227133179243154,-109.3982277
64152,5,52,12,8,14,1,92,38.227133179243154,-109.3979582
64153,7,46,13,10,15,0,91,38.227133179243154,-109.3976887
64154,8,43,13,11,15,0,90,38.227133179243154,-109.3974192
64155,8,42,13,11,14,1,89,38.227133179243154,-109.3971497
64156,10,42,14,12,14,0,92,38.227133179243154,-109.3968802
64157,11,39,15,13,14,1,93,38.227133179243154,-109.3966107
64158,9,40,14,12,13,1,89,38.227133179243154,-109.3963412
64159,7,43,12,10,13,1,86,38.227133179243154,-109.3960717
64160,4,46,10,7,12,2,81,38.227133179243154,-109.3958022
64161,3,49,10,7,13,1,83,38.227133179243154,-109.3955327
64162,5,45,11,9,12,1,83,38.227133179243154,-109.3952632
64163,7,44,12,10,12,1,86,38.227133179243154,-109.3949938
64164,7,44,12,9,11,2,85,38.227133179243154,-109.3947243
64165,5,44,12,8,11,2,82,38.227133179243154,-109.3944548
64166,7,40,13,11,12,2,85,38.227133179243154,-109.3941853
64167,8,39,13,10,10,2,82,38.227133179243154,-109.3939158
64168,8,38,13,10,10,3,82,38.227133179243154,-109.3936463
64169,8,39,13,10,11,3,84,38.227133179243154,-109.3933768
64170,8,42,12,10,12,2,86,38.227133179243154,-109.3931073
64171,4,45,10,8,11,2,80,38.227133179243154,-109.3928378
64172,3,47,9,6,10,2,77,38.227133179243154,-109.3925683
64173,3,47,8,6,10,2,76,38.227133179243154,-109.3922988
64174,4,43,8,5,10,2,72,38.227133179243154,-109.3920293
64175,2,40,8,4,10,3,67,38.227133179243154,-109.3917598
64176,3,38,8,4,9,3,65,38.227133179243154,-109.3914903
64177,3,36,8,4,9,3,63,38.227133179243154,-109.3912208
64178,3,37,8,4,9,3,64,38.227133179243154,-109.3909513
64179,2,37,7,4,8,4,62,38.227133179243154,-109.3906818
64180,2,41,7,5,8,3,66,38.227133179243154,-109.3904123
64181,2,40,7,5,8,3,65,38.227133179243154,-109.3901429
64182,2,39,7,5,8,3,64,38.227133179243154,-109.3898734
64183,2,40,7,5,8,3,65,38.227133179243154,-109.3896039
64184,2,40,7,5,7,3,64,38.227133179243154,-109.3893344
64185,2,40,6,5,6,4,63,38.227133179243154,-109.3890649
64186,2,40,6,5,7,3,63,38.227133179243154,-109.3887954
64187,2,40,7,5,7,3,64,38.227133179243154,-109.3885259
64188,2,40,7,4,8,3,64,38.227133179243154,-109.3882564
64189,2,36,7,4,9,4,62,38.227133179243154,-109.3879869
64190,3,38,8,5,9,3,66,38.227133179243154,-109.3877174
64191,5,34,9,7,10,3,68,38.227133179243154,-109.3874479
64192,11,28,11,11,11,2,74,38.227133179243154,-109.3871784
64193,15,33,13,11,12,1,85,38.227133179243154,-109.3869089
64194,11,39,11,7,11,1,80,38.227133179243154,-109.3866394
64195,6,43,10,7,11,2,79,38.227133179243154,-109.3863699
64196,4,48,9,6,11,2,80,38.227133179243154,-109.3861004
64197,4,52,9,6,11,1,83,38.227133179243154,-109.3858309
64198,5,45,9,7,9,1,76,38.227133179243154,-109.3855614
64199,4,42,8,6,9,2,71,38.227133179243154,-109.3852919
64200,4,43,7,6,9,2,71,38.227133179243154,-109.3850225
64201,4,44,7,6,8,2,71,38.227133179243154,-109.384753
64202,3,45,7,6,7,2,70,38.227133179243154,-109.3844835
64203,3,40,6,6,7,2,64,38.227133179243154,-109.384214
64204,2,42,6,5,7,2,64,38.227133179243154,-109.3839445
64205,2,43,6,5,6,3,65,38.227133179243154,-109.383675
64206,2,42,6,6,6,2,64,38.227133179243154,-109.3834055
64207,2,40,6,6,6,3,63,38.227133179243154,-109.383136
64208,2,40,7,6,9,2,66,38.227133179243154,-109.3828665
64209,4,41,9,7,11,2,74,38.227133179243154,-109.382597
64210,3,44,9,7,11,2,76,38.227133179243154,-109.3823275
64211,3,42,10,6,11,3,75,38.227133179243154,-109.382058
64212,6,32,11,8,12,3,72,38.227133179243154,-109.3817885
64213,7,30,13,15,9,3,77,38.227133179243154,-109.381519
64214,8,29,12,12,11,3,75,38.227133179243154,-109.3812495
64215,9,26,13,13,11,4,76,38.227133179243154,-109.38098
64216,12,23,17,13,8,7,80,38.227133179243154,-109.3807105
64217,8,26,12,9,9,6,70,38.227133179243154,-109.380441
64218,2,33,8,6,8,6,63,38.227133179243154,-109.3801716
64219,1,39,7,6,8,5,66,38.227133179243154,-109.3799021
64220,1,41,7,6,8,4,67,38.227133179243154,-109.3796326
64221,1,40,7,6,8,4,66,38.227133179243154,-109.3793631
64222,2,42,6,6,7,3,66,38.227133179243154,-109.3790936
64223,2,42,7,5,8,3,67,38.227133179243154,-109.3788241
64224,2,41,7,6,9,3,68,38.227133179243154,-109.3785546
64225,2,40,8,5,9,3,67,38.227133179243154,-109.3782851
64226,3,36,9,6,10,3,67,38.227133179243154,-109.3780156
64227,11,31,12,13,11,2,80,38.227133179243154,-109.3777461
64228,18,34,14,13,11,1,91,38.227133179243154,-109.3774766
64229,21,35,14,12,11,1,94,38.227133179243154,-109.3772071
64230,21,34,13,12,11,1,92,38.227133179243154,-109.3769376
64231,16,30,12,19,14,1,92,38.227133179243154,-109.3766681
64232,4,29,7,22,17,0,79,38.227133179243154,-109.3763986
64233,2,30,8,16,17,1,74,38.227133179243154,-109.3761291
64234,2,32,9,21,13,0,77,38.227133179243154,-109.3758596
64235,13,36,12,15,14,1,91,38.227133179243154,-109.3755901
64236,14,34,13,15,14,2,92,38.227133179243154,-109.3753206
64237,5,31,12,14,12,4,78,38.227133179243154,-109.3750512
64238,2,35,10,9,11,4,71,38.227133179243154,-109.3747817
64239,3,42,10,9,12,2,78,38.227133179243154,-109.3745122
64240,4,49,10,7,12,2,84,38.227133179243154,-109.3742427
64241,5,46,12,8,12,3,86,38.227133179243154,-109.3739732
64242,4,46,11,7,11,3,82,38.227133179243154,-109.3737037
64243,9,26,11,20,20,2,88,38.22686368465792,-109.4114329
64244,13,27,11,20,16,1,88,38.22686368465792,-109.4111634
64245,14,30,10,20,14,1,89,38.22686368465792,-109.4108939
64246,13,25,9,19,17,1,84,38.22686368465792,-109.4106244
64247,10,25,10,17,19,2,83,38.22686368465792,-109.4103549
64248,10,27,11,17,19,2,86,38.22686368465792,-109.4100855
64249,8,30,11,19,19,1,88,38.22686368465792,-109.409816
64250,7,32,11,19,17,1,87,38.22686368465792,-109.4095465
64251,7,32,11,19,18,1,88,38.22686368465792,-109.409277
64252,9,27,11,18,19,2,86,38.22686368465792,-109.4090075
64253,5,25,11,19,21,4,85,38.22686368465792,-109.408738
64254,3,21,11,17,23,7,82,38.22686368465792,-109.4084685
64255,5,16,11,27,18,4,81,38.22686368465792,-109.408199
64256,5,11,11,35,19,3,84,38.22686368465792,-109.4079295
64257,5,9,10,35,19,6,84,38.22686368465792,-109.40766
64258,5,10,10,35,21,6,87,38.22686368465792,-109.4073905
64259,7,17,10,27,25,4,90,38.22686368465792,-109.407121
64260,14,18,11,17,26,5,91,38.22686368465792,-109.4068515
64261,10,25,11,20,15,4,85,38.22686368465792,-109.406582
64262,5,27,10,13,12,4,71,38.22686368465792,-109.4063125
64263,3,42,8,8,7,2,70,38.22686368465792,-109.406043
64264,3,40,8,6,9,3,69,38.22686368465792,-109.4057735
64265,4,38,9,7,11,2,71,38.22686368465792,-109.405504
64266,7,42,10,9,12,1,81,38.22686368465792,-109.4052345
64267,10,48,11,10,13,0,92,38.22686368465792,-109.4049651
64268,10,49,11,10,13,1,94,38.22686368465792,-109.4046956
64269,12,46,12,10,13,1,94,38.22686368465792,-109.4044261
64270,10,45,13,10,13,1,92,38.22686368465792,-109.4041566
64271,8,44,13,9,12,2,88,38.22686368465792,-109.4038871
64272,6,41,13,8,12,3,83,38.22686368465792,-109.4036176
64273,5,43,12,9,12,3,84,38.22686368465792,-109.4033481
64274,5,45,12,8,12,3,85,38.22686368465792,-109.4030786
64275,5,47,11,10,13,1,87,38.22686368465792,-109.4028091
64276,5,49,12,11,13,1,91,38.22686368465792,-109.4025396
64277,5,49,12,12,13,1,92,38.22686368465792,-109.4022701
64278,5,47,13,11,14,1,91,38.22686368465792,-109.4020006
64279,6,45,13,12,14,1,91,38.22686368465792,-109.4017311
64280,8,44,13,13,13,1,92,38.22686368465792,-109.4014616
64281,9,44,13,13,13,1,93,38.22686368465792,-109.4011921
64282,9,44,13,12,13,1,92,38.22686368465792,-109.4009226
64283,7,46,12,11,13,1,90,38.22686368465792,-109.4006531
64284,5,48,12,10,13,1,89,38.22686368465792,-109.4003836
64285,5,47,12,10,13,1,88,38.22686368465792,-109.4001142
64286,6,45,12,10,12,1,86,38.22686368465792,-109.3998447
64287,7,44,12,10,12,1,86,38.22686368465792,-109.3995752
64288,7,43,13,11,12,1,87,38.22686368465792,-109.3993057
64289,9,41,13,12,12,1,88,38.22686368465792,-109.3990362
64290,9,42,13,12,12,1,89,38.22686368465792,-109.3987667
64291,7,47,13,11,13,1,92,38.22686368465792,-109.3984972
64292,7,52,12,9,13,1,94,38.22686368465792,-109.3982277
64293,8,47,13,10,14,1,93,38.22686368465792,-109.3979582
64294,9,44,14,12,14,0,93,38.22686368465792,-109.3976887
64295,8,44,13,12,14,0,91,38.22686368465792,-109.3974192
64296,6,45,13,10,14,1,89,38.22686368465792,-109.3971497
64297,6,44,13,9,14,1,87,38.22686368465792,-109.3968802
64298,7,41,14,12,15,1,90,38.22686368465792,-109.3966107
64299,6,42,13,10,14,1,86,38.22686368465792,-109.3963412
64300,4,47,11,7,12,2,83,38.22686368465792,-109.3960717
64301,2,51,9,6,13,2,83,38.22686368465792,-109.3958022
64302,3,50,10,8,13,1,85,38.22686368465792,-109.3955327
64303,6,45,12,9,12,2,86,38.22686368465792,-109.3952632
64304,8,41,13,10,11,2,85,38.22686368465792,-109.3949938
64305,8,40,13,10,10,2,83,38.22686368465792,-109.3947243
64306,7,41,12,9,11,2,82,38.22686368465792,-109.3944548
64307,6,42,12,9,12,2,83,38.22686368465792,-109.3941853
64308,6,41,11,9,12,2,81,38.22686368465792,-109.3939158
64309,5,43,11,9,12,2,82,38.22686368465792,-109.3936463
64310,5,46,11,9,12,2,85,38.22686368465792,-109.3933768
64311,4,49,10,9,12,2,86,38.22686368465792,-109.3931073
64312,3,48,9,7,11,2,80,38.22686368465792,-109.3928378
64313,2,47,8,6,10,2,75,38.22686368465792,-109.3925683
64314,2,45,8,6,10,2,73,38.22686368465792,-109.3922988
64315,3,37,9,5,11,3,68,38.22686368465792,-109.3920293
64316,3,35,8,4,10,4,64,38.22686368465792,-109.3917598
64317,2,35,8,4,10,4,63,38.22686368465792,-109.3914903
64318,2,36,8,4,10,4,64,38.22686368465792,-109.3912208
64319,3,35,8,5,11,4,66,38.22686368465792,-109.3909513
64320,2,32,8,5,10,5,62,38.22686368465792,-109.3906818
64321,2,34,8,5,10,4,63,38.22686368465792,-109.3904123
64322,2,35,8,6,11,3,65,38.22686368465792,-109.3901429
64323,2,37,9,6,11,3,68,38.22686368465792,-109.3898734
64324,2,41,9,6,11,2,71,38.22686368465792,-109.3896039
64325,3,37,8,5,11,3,67,38.22686368465792,-109.3893344
64326,2,34,8,5,10,4,63,38.22686368465792,-109.3890649
64327,2,38,8,5,10,3,66,38.22686368465792,-109.3887954
64328,2,40,8,5,10,3,68,38.22686368465792,-109.3885259
64329,2,40,7,4,9,3,65,38.22686368465792,-109.3882564
64330,3,40,7,5,8,3,66,38.22686368465792,-109.3879869
64331,3,38,8,6,9,3,67,38.22686368465792,-109.3877174
64332,6,34,10,10,11,2,73,38.22686368465792,-109.3874479
64333,10,34,13,15,11,1,84,38.22686368465792,-109.3871784
64334,17,34,14,12,12,1,90,38.22686368465792,-109.3869089
64335,10,41,14,12,11,1,89,38.22686368465792,-109.3866394
64336,7,45,12,11,11,2,88,38.22686368465792,-109.3863699
64337,4,48,11,8,11,2,84,38.22686368465792,-109.3861004
64338,4,50,9,6,11,1,81,38.22686368465792,-109.3858309
64339,3,43,8,6,8,2,70,38.22686368465792,-109.3855614
64340,3,41,6,6,7,2,65,38.22686368465792,-109.3852919
64341,2,41,6,5,7,3,64,38.22686368465792,-109.3850225
64342,2,41,6,5,7,2,63,38.22686368465792,-109.384753
64343,2,40,6,5,7,3,63,38.22686368465792,-109.3844835
64344,2,39,6,5,7,3,62,38.22686368465792,-109.384214
64345,3,36,7,6,8,3,63,38.22686368465792,-109.3839445
64346,4,33,9,8,10,3,67,38.22686368465792,-109.383675
64347,5,30,10,11,12,2,70,38.22686368465792,-109.3834055
64348,4,30,10,14,12,3,73,38.22686368465792,-109.383136
64349,6,32,11,14,14,2,79,38.22686368465792,-109.3828665
64350,4,40,11,9,13,2,79,38.22686368465792,-109.382597
64351,4,46,11,8,12,2,83,38.22686368465792,-109.3823275
64352,6,44,12,9,12,1,84,38.22686368465792,-109.382058
64353,8,39,14,12,13,1,87,38.22686368465792,-109.3817885
64354,10,34,15,16,12,1,88,38.22686368465792,-109.381519
64355,12,32,15,16,12,1,88,38.22686368465792,-109.3812495
64356,15,27,15,18,12,2,89,38.22686368465792,-109.38098
64357,18,19,17,18,11,7,90,38.22686368465792,-109.3807105
64358,13,18,16,14,6,8,75,38.22686368465792,-109.380441
64359,2,28,9,5,7,9,60,38.22686368465792,-109.3801716
64360,1,38,7,6,8,5,65,38.22686368465792,-109.3799021
64361,2,40,8,8,10,3,71,38.22686368465792,-109.3796326
64362,2,41,9,6,11,4,73,38.22686368465792,-109.3793631
64363,2,38,8,6,10,3,67,38.22686368465792,-109.3790936
64364,2,38,7,5,9,4,65,38.22686368465792,-109.3788241
64365,2,36,8,5,9,5,65,38.22686368465792,-109.3785546
64366,4,33,9,8,11,4,69,38.22686368465792,-109.3782851
64367,6,33,11,12,12,2,76,38.22686368465792,-109.3780156
64368,13,37,14,13,11,1,89,38.22686368465792,-109.3777461
64369,18,37,14,12,10,1,92,38.22686368465792,-109.3774766
64370,20,36,12,11,9,1,89,38.22686368465792,-109.3772071
64371,22,34,12,13,10,0,91,38.22686368465792,-109.3769376
64372,16,31,13,17,16,1,94,38.22686368465792,-109.3766681
64373,8,28,8,25,16,1,86,38.22686368465792,-109.3763986
64374,2,30,8,15,19,0,74,38.22686368465792,-109.3761291
64375,3,37,8,18,12,0,78,38.22686368465792,-109.3758596
64376,9,37,11,12,13,2,84,38.22686368465792,-109.3755901
64377,11,36,13,13,13,2,88,38.22686368465792,-109.3753206
64378,4,31,11,8,11,7,72,38.22686368465792,-109.3750512
64379,2,35,9,7,11,6,70,38.22686368465792,-109.3747817
64380,3,41,10,9,12,2,77,38.22686368465792,-109.3745122
64381,4,50,10,7,12,1,84,38.22686368465792,-109.3742427
64382,4,48,11,8,13,2,86,38.22686368465792,-109.3739732
64383,4,46,11,8,12,2,83,38.22686368465792,-109.3737037
64384,3,26,11,17,27,4,88,38.22659419007268,-109.4114329
64385,7,27,11,17,23,3,88,38.22659419007268,-109.4111634
64386,11,28,11,17,20,2,89,38.22659419007268,-109.4108939
64387,13,26,10,20,18,1,88,38.22659419007268,-109.4106244
64388,9,27,11,18,18,2,85,38.22659419007268,-109.4103549
64389,7,32,11,17,18,1,86,38.22659419007268,-109.4100855
64390,6,35,12,17,17,1,88,38.22659419007268,-109.409816
64391,7,34,11,19,17,1,89,38.22659419007268,-109.4095465
64392,6,34,11,19,17,0,87,38.22659419007268,-109.409277
64393,7,31,11,21,18,0,88,38.22659419007268,-109.4090075
64394,7,27,11,20,20,1,86,38.22659419007268,-109.408738
64395,4,24,11,22,22,3,86,38.22659419007268,-109.4084685
64396,3,16,11,25,21,6,82,38.22659419007268,-109.408199
64397,6,12,11,31,19,4,83,38.22659419007268,-109.4079295
64398,7,11,11,36,18,3,86,38.22659419007268,-109.40766
64399,6,10,11,35,20,4,86,38.22659419007268,-109.4073905
64400,5,9,8,33,22,7,84,38.22659419007268,-109.407121
64401,3,10,7,30,25,9,84,38.22659419007268,-109.4068515
64402,8,18,11,15,24,10,86,38.22659419007268,-109.406582
64403,7,22,10,22,14,3,78,38.22659419007268,-109.4063125
64404,4,29,9,11,13,3,69,38.22659419007268,-109.406043
64405,2,39,7,5,8,4,65,38.22659419007268,-109.4057735
64406,2,41,7,5,9,4,68,38.22659419007268,-109.405504
64407,2,40,7,4,9,3,65,38.22659419007268,-109.4052345
64408,6,41,8,6,10,2,73,38.22659419007268,-109.4049651
64409,11,42,10,8,11,1,83,38.22659419007268,-109.4046956
64410,9,50,11,8,13,1,92,38.22659419007268,-109.4044261
64411,10,48,12,10,13,1,94,38.22659419007268,-109.4041566
64412,8,45,12,9,12,2,88,38.22659419007268,-109.4038871
64413,7,44,12,8,11,3,85,38.22659419007268,-109.4036176
64414,6,43,12,7,10,4,82,38.22659419007268,-109.4033481
64415,6,45,11,6,11,3,82,38.22659419007268,-109.4030786
64416,5,47,11,7,12,2,84,38.22659419007268,-109.4028091
64417,5,49,11,9,12,1,87,38.22659419007268,-109.4025396
64418,5,49,12,10,12,1,89,38.22659419007268,-109.4022701
64419,6,49,12,11,13,1,92,38.22659419007268,-109.4020006
64420,6,49,12,10,13,1,91,38.22659419007268,-109.4017311
64421,7,49,12,10,13,1,92,38.22659419007268,-109.4014616
64422,8,48,12,10,13,1,92,38.22659419007268,-109.4011921
64423,9,46,13,11,13,1,93,38.22659419007268,-109.4009226
64424,7,47,13,11,13,1,92,38.22659419007268,-109.4006531
64425,7,47,12,10,13,1,90,38.22659419007268,-109.4003836
64426,8,46,13,11,13,1,92,38.22659419007268,-109.4001142
64427,9,45,13,12,12,1,92,38.22659419007268,-109.3998447
64428,9,42,13,12,12,1,89,38.22659419007268,-109.3995752
64429,10,40,13,12,12,1,88,38.22659419007268,-109.3993057
64430,11,41,14,12,12,1,91,38.22659419007268,-109.3990362
64431,10,43,13,12,13,1,92,38.22659419007268,-109.3987667
64432,8,47,13,11,13,1,93,38.22659419007268,-109.3984972
64433,9,46,13,11,13,1,93,38.22659419007268,-109.3982277
64434,12,41,14,12,13,1,93,38.22659419007268,-109.3979582
64435,12,41,14,12,13,1,93,38.22659419007268,-109.3976887
64436,10,44,13,12,13,1,93,38.22659419007268,-109.3974192
64437,7,47,12,10,14,1,91,38.22659419007268,-109.3971497
64438,5,48,11,7,13,1,85,38.22659419007268,-109.3968802
64439,4,47,11,8,13,1,84,38.22659419007268,-109.3966107
64440,3,48,10,6,13,2,82,38.22659419007268,-109.3963412
64441,3,48,10,6,13,2,82,38.22659419007268,-109.3960717
64442,4,47,10,7,13,2,83,38.22659419007268,-109.3958022
64443,5,48,11,8,13,2,87,38.22659419007268,-109.3955327
64444,4,46,11,9,12,2,84,38.22659419007268,-109.3952632
64445,4,44,11,8,11,2,80,38.22659419007268,-109.3949938
64446,5,44,11,7,11,2,80,38.22659419007268,-109.3947243
64447,5,45,11,8,11,2,82,38.22659419007268,-109.3944548
64448,6,47,11,9,12,1,86,38.22659419007268,-109.3941853
64449,4,48,10,9,12,1,84,38.22659419007268,-109.3939158
64450,4,49,10,8,12,2,85,38.22659419007268,-109.3936463
64451,4,49,9,7,12,2,83,38.22659419007268,-109.3933768
64452,3,50,8,6,11,3,81,38.22659419007268,-109.3931073
64453,3,51,9,6,11,2,82,38.22659419007268,-109.3928378
64454,3,49,8,7,11,1,79,38.22659419007268,-109.3925683
64455,3,47,8,6,10,2,76,38.22659419007268,-109.3922988
64456,3,42,9,6,11,2,73,38.22659419007268,-109.3920293
64457,2,37,9,4,11,4,67,38.22659419007268,-109.3917598
64458,2,36,8,4,10,4,64,38.22659419007268,-109.3914903
64459,2,34,8,4,11,4,63,38.22659419007268,-109.3912208
64460,2,33,9,5,12,5,66,38.22659419007268,-109.3909513
64461,3,31,10,6,12,5,67,38.22659419007268,-109.3906818
64462,5,29,11,12,14,3,74,38.22659419007268,-109.3904123
64463,5,30,11,12,14,2,74,38.22659419007268,-109.3901429
64464,4,37,10,10,13,2,76,38.22659419007268,-109.3898734
64465,3,41,9,8,13,2,76,38.22659419007268,-109.3896039
64466,3,36,9,7,13,3,71,38.22659419007268,-109.3893344
64467,3,39,9,7,12,2,72,38.22659419007268,-109.3890649
64468,3,42,8,6,10,2,71,38.22659419007268,-109.3887954
64469,2,44,8,5,10,2,71,38.22659419007268,-109.3885259
64470,2,41,8,4,10,3,68,38.22659419007268,-109.3882564
64471,5,39,9,7,10,2,72,38.22659419007268,-109.3879869
64472,6,36,10,13,10,2,77,38.22659419007268,-109.3877174
64473,8,36,12,17,10,1,84,38.22659419007268,-109.3874479
64474,12,40,14,15,12,1,94,38.22659419007268,-109.3871784
64475,15,36,13,12,12,1,89,38.22659419007268,-109.3869089
64476,13,38,13,12,10,1,87,38.22659419007268,-109.3866394
64477,10,42,11,11,10,1,85,38.22659419007268,-109.3863699
64478,7,49,11,11,11,1,90,38.22659419007268,-109.3861004
64479,6,50,11,10,11,1,89,38.22659419007268,-109.3858309
64480,4,40,9,10,9,2,74,38.22659419007268,-109.3855614
64481,4,39,8,7,9,2,69,38.22659419007268,-109.3852919
64482,3,38,7,6,8,3,65,38.22659419007268,-109.3850225
64483,3,37,7,6,9,3,65,38.22659419007268,-109.384753
64484,3,36,8,7,10,2,66,38.22659419007268,-109.3844835
64485,4,32,9,8,11,3,67,38.22659419007268,-109.384214
64486,4,30,11,19,12,2,78,38.22659419007268,-109.3839445
64487,12,30,13,23,12,1,91,38.22659419007268,-109.383675
64488,17,24,12,26,12,1,92,38.22659419007268,-109.3834055
64489,21,32,13,16,13,0,95,38.22659419007268,-109.383136
64490,17,38,14,13,13,0,95,38.22659419007268,-109.3828665
64491,7,43,14,14,13,1,92,38.22659419007268,-109.382597
64492,6,46,13,12,12,1,90,38.22659419007268,-109.3823275
64493,7,44,14,14,12,1,92,38.22659419007268,-109.382058
64494,9,41,15,16,13,1,95,38.22659419007268,-109.3817885
64495,12,40,15,14,13,1,95,38.22659419007268,-109.381519
64496,11,38,15,14,13,1,92,38.22659419007268,-109.3812495
64497,16,32,15,15,13,1,92,38.22659419007268,-109.38098
64498,18,22,15,21,13,3,92,38.22659419007268,-109.3807105
64499,17,24,15,16,10,4,86,38.22659419007268,-109.380441
64500,3,28,10,5,8,9,63,38.22659419007268,-109.3801716
64501,2,35,8,5,8,6,64,38.22659419007268,-109.3799021
64502,3,38,8,7,10,3,69,38.22659419007268,-109.3796326
64503,2,43,9,6,11,3,74,38.22659419007268,-109.3793631
64504,3,44,9,6,12,2,76,38.22659419007268,-109.3790936
64505,2,39,8,5,10,3,67,38.22659419007268,-109.3788241
64506,4,31,9,7,11,4,66,38.22659419007268,-109.3785546
64507,8,33,12,12,11,2,78,38.22659419007268,-109.3782851
64508,8,39,14,13,12,1,87,38.22659419007268,-109.3780156
64509,14,40,13,11,10,1,89,38.22659419007268,-109.3777461
64510,17,37,11,11,8,1,85,38.22659419007268,-109.3774766
64511,19,36,10,10,8,0,83,38.22659419007268,-109.3772071
64512,23,35,13,13,10,0,94,38.22659419007268,-109.3769376
64513,17,31,13,18,15,1,95,38.22659419007268,-109.3766681
64514,11,25,8,28,15,1,88,38.22659419007268,-109.3763986
64515,2,26,7,17,19,1,72,38.22659419007268,-109.3761291
64516,3,34,8,17,12,0,74,38.22659419007268,-109.3758596
64517,7,37,10,15,12,1,82,38.22659419007268,-109.3755901
64518,8,36,12,12,13,3,84,38.22659419007268,-109.3753206
64519,4,32,10,8,11,7,72,38.22659419007268,-109.3750512
64520,2,36,9,7,10,6,70,38.22659419007268,-109.3747817
64521,3,39,10,8,11,3,74,38.22659419007268,-109.3745122
64522,4,47,10,7,13,1,82,38.22659419007268,-109.3742427
64523,5,47,11,9,14,1,87,38.22659419007268,-109.3739732
64524,5,46,12,9,14,1,87,38.22659419007268,-109.3737037
64525,3,25,12,18,28,4,90,38.22632469548745,-109.4114329
64526,4,25,11,17,27,4,88,38.22632469548745,-109.4111634
64527,4,26,12,14,26,4,86,38.22632469548745,-109.4108939
64528,7,26,12,18,22,3,88,38.22632469548745,-109.4106244
64529,8,27,11,18,20,2,86,38.22632469548745,-109.4103549
64530,8,30,11,16,19,2,86,38.22632469548745,-109.4100855
64531,7,35,12,15,18,1,88,38.22632469548745,-109.409816
64532,6,37,12,17,17,1,90,38.22632469548745,-109.4095465
64533,7,31,11,19,18,1,87,38.22632469548745,-109.409277
64534,9,26,11,22,19,1,88,38.22632469548745,-109.4090075
64535,9,25,11,23,20,1,89,38.22632469548745,-109.408738
64536,7,25,10,22,20,2,86,38.22632469548745,-109.4084685
64537,6,18,10,25,20,4,83,38.22632469548745,-109.408199
64538,7,14,11,29,20,3,84,38.22632469548745,-109.4079295
64539,7,12,11,34,19,2,85,38.22632469548745,-109.40766
64540,5,11,11,36,19,3,85,38.22632469548745,-109.4073905
64541,4,9,9,33,21,7,83,38.22632469548745,-109.407121
64542,2,8,6,20,25,10,71,38.22632469548745,-109.4068515
64543,5,11,8,21,27,13,85,38.22632469548745,-109.406582
64544,6,15,10,14,24,13,82,38.22632469548745,-109.4063125
64545,6,21,11,17,16,6,77,38.22632469548745,-109.406043
64546,3,33,8,7,11,4,66,38.22632469548745,-109.4057735
64547,3,38,7,6,9,3,66,38.22632469548745,-109.405504
64548,4,39,8,6,9,2,68,38.22632469548745,-109.4052345
64549,4,41,7,5,8,2,67,38.22632469548745,-109.4049651
64550,3,42,8,5,8,2,68,38.22632469548745,-109.4046956
64551,7,41,9,7,10,2,76,38.22632469548745,-109.4044261
64552,9,48,10,8,12,0,87,38.22632469548745,-109.4041566
64553,8,50,11,8,12,1,90,38.22632469548745,-109.4038871
64554,7,46,12,8,12,2,87,38.22632469548745,-109.4036176
64555,6,42,12,8,10,3,81,38.22632469548745,-109.4033481
64556,7,43,13,8,11,2,84,38.22632469548745,-109.4030786
64557,7,44,12,7,11,2,83,38.22632469548745,-109.4028091
64558,6,43,12,8,12,2,83,38.22632469548745,-109.4025396
64559,7,44,12,8,12,2,85,38.22632469548745,-109.4022701
64560,6,45,12,9,12,2,86,38.22632469548745,-109.4020006
64561,6,47,12,11,12,1,89,38.22632469548745,-109.4017311
64562,8,48,12,9,13,1,91,38.22632469548745,-109.4014616
64563,10,47,12,9,13,1,92,38.22632469548745,-109.4011921
64564,11,46,13,9,13,1,93,38.22632469548745,-109.4009226
64565,9,46,12,9,13,1,90,38.22632469548745,-109.4006531
64566,10,46,12,9,13,1,91,38.22632469548745,-109.4003836
64567,11,45,12,10,12,1,91,38.22632469548745,-109.4001142
64568,12,44,13,11,12,1,93,38.22632469548745,-109.3998447
64569,14,41,13,10,12,1,91,38.22632469548745,-109.3995752
64570,14,41,13,11,12,1,92,38.22632469548745,-109.3993057
64571,12,41,13,12,12,1,91,38.22632469548745,-109.3990362
64572,10,44,13,12,13,1,93,38.22632469548745,-109.3987667
64573,9,46,12,11,13,1,92,38.22632469548745,-109.3984972
64574,10,44,13,11,13,1,92,38.22632469548745,-109.3982277
64575,11,42,13,11,13,1,91,38.22632469548745,-109.3979582
64576,9,44,13,11,13,1,91,38.22632469548745,-109.3976887
64577,9,45,13,11,13,1,92,38.22632469548745,-109.3974192
64578,9,46,13,11,13,1,93,38.22632469548745,-109.3971497
64579,6,47,11,8,13,1,86,38.22632469548745,-109.3968802
64580,3,50,9,6,12,2,82,38.22632469548745,-109.3966107
64581,2,50,9,7,12,2,82,38.22632469548745,-109.3963412
64582,3,45,10,8,12,2,80,38.22632469548745,-109.3960717
64583,7,41,11,10,13,1,83,38.22632469548745,-109.3958022
64584,5,48,11,9,13,1,87,38.22632469548745,-109.3955327
64585,3,50,10,8,12,1,84,38.22632469548745,-109.3952632
64586,4,48,10,8,11,2,83,38.22632469548745,-109.3949938
64587,4,46,9,6,10,2,77,38.22632469548745,-109.3947243
64588,4,43,9,7,11,2,76,38.22632469548745,-109.3944548
64589,6,46,10,8,11,1,82,38.22632469548745,-109.3941853
64590,5,48,9,7,11,1,81,38.22632469548745,-109.3939158
64591,4,46,9,6,11,2,78,38.22632469548745,-109.3936463
64592,3,42,9,5,11,2,72,38.22632469548745,-109.3933768
64593,2,40,9,4,11,4,70,38.22632469548745,-109.3931073
64594,3,47,9,6,11,2,78,38.22632469548745,-109.3928378
64595,3,47,8,7,11,2,78,38.22632469548745,-109.3925683
64596,2,44,8,6,10,2,72,38.22632469548745,-109.3922988
64597,3,41,8,5,11,3,71,38.22632469548745,-109.3920293
64598,2,36,8,4,10,4,64,38.22632469548745,-109.3917598
64599,2,34,9,4,10,5,64,38.22632469548745,-109.3914903
64600,3,34,9,5,10,5,66,38.22632469548745,-109.3912208
64601,3,30,10,7,12,5,67,38.22632469548745,-109.3909513
64602,5,32,11,12,14,2,76,38.22632469548745,-109.3906818
64603,7,37,13,16,15,1,89,38.22632469548745,-109.3904123
64604,12,39,14,16,14,1,96,38.22632469548745,-109.3901429
64605,9,36,13,15,13,1,87,38.22632469548745,-109.3898734
64606,4,35,11,12,13,2,77,38.22632469548745,-109.3896039
64607,3,37,11,11,13,2,77,38.22632469548745,-109.3893344
64608,4,44,10,9,13,1,81,38.22632469548745,-109.3890649
64609,3,43,9,7,11,2,75,38.22632469548745,-109.3887954
64610,2,43,8,6,10,2,71,38.22632469548745,-109.3885259
64611,3,41,9,7,10,2,72,38.22632469548745,-109.3882564
64612,7,41,12,13,12,1,86,38.22632469548745,-109.3879869
64613,10,41,14,15,13,1,94,38.22632469548745,-109.3877174
64614,13,39,15,14,13,1,95,38.22632469548745,-109.3874479
64615,13,39,14,16,13,1,96,38.22632469548745,-109.3871784
64616,13,40,14,16,13,1,97,38.22632469548745,-109.3869089
64617,13,43,13,12,11,1,93,38.22632469548745,-109.3866394
64618,12,40,9,9,9,1,80,38.22632469548745,-109.3863699
64619,11,40,8,8,8,0,75,38.22632469548745,-109.3861004
64620,10,44,10,10,9,1,84,38.22632469548745,-109.3858309
64621,7,42,12,12,12,1,86,38.22632469548745,-109.3855614
64622,6,42,11,9,13,1,82,38.22632469548745,-109.3852919
64623,7,37,12,11,12,1,80,38.22632469548745,-109.3850225
64624,8,31,13,17,13,1,83,38.22632469548745,-109.384753
64625,13,29,13,20,13,1,89,38.22632469548745,-109.3844835
64626,18,32,14,13,13,0,90,38.22632469548745,-109.384214
64627,12,40,14,17,12,0,95,38.22632469548745,-109.3839445
64628,15,40,14,13,12,1,95,38.22632469548745,-109.383675
64629,18,36,12,11,9,1,87,38.22632469548745,-109.3834055
64630,19,34,10,11,8,1,83,38.22632469548745,-109.383136
64631,19,35,11,10,8,1,84,38.22632469548745,-109.3828665
64632,15,39,13,12,10,1,90,38.22632469548745,-109.382597
64633,13,40,13,12,11,1,90,38.22632469548745,-109.3823275
64634,14,40,14,13,11,1,93,38.22632469548745,-109.382058
64635,17,39,12,13,9,1,91,38.22632469548745,-109.3817885
64636,14,41,13,13,11,1,93,38.22632469548745,-109.381519
64637,13,39,14,14,12,1,93,38.22632469548745,-109.3812495
64638,15,37,15,15,13,0,95,38.22632469548745,-109.38098
64639,19,27,13,17,15,1,92,38.22632469548745,-109.3807105
64640,19,27,12,17,13,1,89,38.22632469548745,-109.380441
64641,4,26,10,8,9,7,64,38.22632469548745,-109.3801716
64642,2,34,7,5,8,5,61,38.22632469548745,-109.3799021
64643,2,39,7,5,9,3,65,38.22632469548745,-109.3796326
64644,2,40,9,5,10,3,69,38.22632469548745,-109.3793631
64645,2,45,9,6,11,2,75,38.22632469548745,-109.3790936
64646,3,39,9,6,11,2,70,38.22632469548745,-109.3788241
64647,6,34,10,8,12,2,72,38.22632469548745,-109.3785546
64648,9,38,14,13,12,1,87,38.22632469548745,-109.3782851
64649,13,40,14,12,11,1,91,38.22632469548745,-109.3780156
64650,16,39,11,11,8,1,86,38.22632469548745,-109.3777461
64651,19,39,11,13,8,1,91,38.22632469548745,-109.3774766
64652,21,38,12,13,9,0,93,38.22632469548745,-109.3772071
64653,23,35,13,14,11,0,96,38.22632469548745,-109.3769376
64654,19,30,12,18,15,1,95,38.22632469548745,-109.3766681
64655,13,26,9,27,15,1,91,38.22632469548745,-109.3763986
64656,3,29,8,20,18,0,78,38.22632469548745,-109.3761291
64657,3,34,8,18,14,0,77,38.22632469548745,-109.3758596
64658,5,34,9,19,13,1,81,38.22632469548745,-109.3755901
64659,8,36,12,12,14,3,85,38.22632469548745,-109.3753206
64660,6,33,11,11,12,4,77,38.22632469548745,-109.3750512
64661,3,34,10,9,10,6,72,38.22632469548745,-109.3747817
64662,3,36,9,7,11,5,71,38.22632469548745,-109.3745122
64663,5,38,9,6,13,2,73,38.22632469548745,-109.3742427
64664,6,40,10,7,13,2,78,38.22632469548745,-109.3739732
64665,6,42,11,9,14,1,83,38.22632469548745,-109.3737037
64666,7,27,13,19,22,5,93,38.22605520090221,-109.4114329
64667,6,26,12,19,25,4,92,38.22605520090221,-109.4111634
64668,8,25,11,18,24,3,89,38.22605520090221,-109.4108939
64669,7,25,12,18,23,3,88,38.22605520090221,-109.4106244
64670,8,25,12,18,23,3,89,38.22605520090221,-109.4103549
64671,8,26,12,18,22,2,88,38.22605520090221,-109.4100855
64672,8,29,11,17,20,2,87,38.22605520090221,-109.409816
64673,7,31,11,16,18,2,85,38.22605520090221,-109.4095465
64674,10,25,11,20,20,2,88,38.22605520090221,-109.409277
64675,11,20,11,25,21,2,90,38.22605520090221,-109.4090075
64676,11,20,11,26,20,2,90,38.22605520090221,-109.408738
64677,10,23,11,20,19,2,85,38.22605520090221,-109.4084685
64678,7,21,10,20,20,4,82,38.22605520090221,-109.408199
64679,8,17,12,26,20,2,85,38.22605520090221,-109.4079295
64680,8,15,11,29,20,2,85,38.22605520090221,-109.40766
64681,7,13,10,30,21,4,85,38.22605520090221,-109.4073905
64682,4,13,9,27,23,8,84,38.22605520090221,-109.407121
64683,2,10,7,20,25,10,74,38.22605520090221,-109.4068515
64684,3,12,10,22,29,11,87,38.22605520090221,-109.406582
64685,2,14,11,19,32,12,90,38.22605520090221,-109.4063125
64686,6,18,11,19,28,7,89,38.22605520090221,-109.406043
64687,4,20,10,24,15,3,76,38.22605520090221,-109.4057735
64688,2,28,8,7,12,5,62,38.22605520090221,-109.405504
64689,4,37,7,6,10,3,67,38.22605520090221,-109.4052345
64690,4,42,7,6,8,2,69,38.22605520090221,-109.4049651
64691,4,43,7,7,8,2,71,38.22605520090221,-109.4046956
64692,4,40,7,5,8,2,66,38.22605520090221,-109.4044261
64693,6,41,8,7,10,2,74,38.22605520090221,-109.4041566
64694,6,46,10,9,11,1,83,38.22605520090221,-109.4038871
64695,7,47,11,9,12,1,87,38.22605520090221,-109.4036176
64696,7,45,11,8,11,2,84,38.22605520090221,-109.4033481
64697,7,43,12,8,10,3,83,38.22605520090221,-109.4030786
64698,8,42,12,7,11,3,83,38.22605520090221,-109.4028091
64699,8,42,12,7,10,3,82,38.22605520090221,-109.4025396
64700,8,42,12,7,10,3,82,38.22605520090221,-109.4022701
64701,8,42,12,7,10,3,82,38.22605520090221,-109.4020006
64702,7,42,12,10,11,2,84,38.22605520090221,-109.4017311
64703,8,44,12,10,12,1,87,38.22605520090221,-109.4014616
64704,10,44,12,9,12,1,88,38.22605520090221,-109.4011921
64705,11,44,13,10,12,1,91,38.22605520090221,-109.4009226
64706,13,45,13,10,12,1,94,38.22605520090221,-109.4006531
64707,13,45,12,9,12,1,92,38.22605520090221,-109.4003836
64708,16,43,12,9,12,0,92,38.22605520090221,-109.4001142
64709,18,41,13,9,11,0,92,38.22605520090221,-109.3998447
64710,19,40,12,9,11,0,91,38.22605520090221,-109.3995752
64711,15,44,13,10,11,0,93,38.22605520090221,-109.3993057
64712,11,46,12,9,12,1,91,38.22605520090221,-109.3990362
64713,10,49,12,8,12,1,92,38.22605520090221,-109.3987667
64714,9,49,11,8,13,1,91,38.22605520090221,-109.3984972
64715,9,48,12,9,12,1,91,38.22605520090221,-109.3982277
64716,8,48,12,8,13,1,90,38.22605520090221,-109.3979582
64717,7,49,12,7,14,1,90,38.22605520090221,-109.3976887
64718,8,46,12,9,13,1,89,38.22605520090221,-109.3974192
64719,11,45,12,10,12,1,91,38.22605520090221,-109.3971497
64720,11,46,12,8,11,1,89,38.22605520090221,-109.3968802
64721,6,48,10,6,11,2,83,38.22605520090221,-109.3966107
64722,4,46,11,7,12,2,82,38.22605520090221,-109.3963412
64723,5,43,11,9,12,2,82,38.22605520090221,-109.3960717
64724,5,43,11,8,12,2,81,38.22605520090221,-109.3958022
64725,4,46,10,8,12,2,82,38.22605520090221,-109.3955327
64726,3,46,9,6,10,2,76,38.22605520090221,-109.3952632
64727,3,45,8,5,9,2,72,38.22605520090221,-109.3949938
64728,3,44,7,5,8,2,69,38.22605520090221,-109.3947243
64729,3,45,7,5,8,2,70,38.22605520090221,-109.3944548
64730,3,44,7,5,8,2,69,38.22605520090221,-109.3941853
64731,3,43,7,6,8,2,69,38.22605520090221,-109.3939158
64732,3,41,7,5,9,2,67,38.22605520090221,-109.3936463
64733,2,37,7,4,9,3,62,38.22605520090221,-109.3933768
64734,3,37,8,5,10,3,66,38.22605520090221,-109.3931073
64735,3,39,9,7,11,2,71,38.22605520090221,-109.3928378
64736,3,43,9,6,11,2,74,38.22605520090221,-109.3925683
64737,3,43,9,6,11,2,74,38.22605520090221,-109.3922988
64738,3,39,9,7,12,2,72,38.22605520090221,-109.3920293
64739,3,37,10,7,12,3,72,38.22605520090221,-109.3917598
64740,5,39,11,10,11,2,78,38.22605520090221,-109.3914903
64741,7,37,12,13,12,2,83,38.22605520090221,-109.3912208
64742,8,33,13,18,12,1,85,38.22605520090221,-109.3909513
64743,16,32,13,21,12,0,94,38.22605520090221,-109.3906818
64744,17,36,14,16,12,0,95,38.22605520090221,-109.3904123
64745,20,34,11,15,8,0,88,38.22605520090221,-109.3901429
64746,20,33,12,13,9,0,87,38.22605520090221,-109.3898734
64747,12,38,14,14,13,1,92,38.22605520090221,-109.3896039
64748,5,40,13,13,14,1,86,38.22605520090221,-109.3893344
64749,5,46,12,11,13,1,88,38.22605520090221,-109.3890649
64750,4,44,10,8,12,2,80,38.22605520090221,-109.3887954
64751,2,43,9,7,10,2,73,38.22605520090221,-109.3885259
64752,3,42,9,9,11,2,76,38.22605520090221,-109.3882564
64753,7,45,13,15,12,1,93,38.22605520090221,-109.3879869
64754,11,42,13,15,12,1,94,38.22605520090221,-109.3877174
64755,10,41,14,16,13,1,95,38.22605520090221,-109.3874479
64756,9,41,14,17,13,1,95,38.22605520090221,-109.3871784
64757,10,39,13,16,13,1,92,38.22605520090221,-109.3869089
64758,14,41,12,12,11,1,91,38.22605520090221,-109.3866394
64759,13,34,7,7,7,0,68,38.22605520090221,-109.3863699
64760,11,32,5,6,6,0,60,38.22605520090221,-109.3861004
64761,12,36,6,6,7,0,67,38.22605520090221,-109.3858309
64762,13,39,10,8,8,0,78,38.22605520090221,-109.3855614
64763,13,40,13,15,11,0,92,38.22605520090221,-109.3852919
64764,17,38,14,15,10,0,94,38.22605520090221,-109.3850225
64765,20,34,13,17,10,0,94,38.22605520090221,-109.384753
64766,24,31,13,20,9,0,97,38.22605520090221,-109.3844835
64767,23,34,14,13,9,0,93,38.22605520090221,-109.384214
64768,13,42,14,14,11,1,95,38.22605520090221,-109.3839445
64769,13,42,13,14,10,1,93,38.22605520090221,-109.383675
64770,15,38,12,12,9,1,87,38.22605520090221,-109.3834055
64771,16,34,11,9,8,0,78,38.22605520090221,-109.383136
64772,18,35,12,11,9,1,86,38.22605520090221,-109.3828665
64773,16,36,12,11,9,1,85,38.22605520090221,-109.382597
64774,17,36,12,12,9,1,87,38.22605520090221,-109.3823275
64775,17,36,12,12,9,1,87,38.22605520090221,-109.382058
64776,16,36,13,12,9,1,87,38.22605520090221,-109.3817885
64777,16,38,14,14,11,1,94,38.22605520090221,-109.381519
64778,18,37,14,15,12,1,97,38.22605520090221,-109.3812495
64779,20,33,13,17,13,0,96,38.22605520090221,-109.38098
64780,23,27,12,20,12,0,94,38.22605520090221,-109.3807105
64781,19,27,12,20,13,0,91,38.22605520090221,-109.380441
64782,3,31,9,10,10,6,69,38.22605520090221,-109.3801716
64783,2,39,7,6,8,4,66,38.22605520090221,-109.3799021
64784,2,41,7,6,8,3,67,38.22605520090221,-109.3796326
64785,2,40,8,5,9,3,67,38.22605520090221,-109.3793631
64786,2,44,9,7,10,3,75,38.22605520090221,-109.3790936
64787,3,40,9,6,11,3,72,38.22605520090221,-109.3788241
64788,3,39,10,7,11,2,72,38.22605520090221,-109.3785546
64789,7,44,13,12,12,1,89,38.22605520090221,-109.3782851
64790,15,39,13,13,10,1,91,38.22605520090221,-109.3780156
64791,20,37,11,14,9,1,92,38.22605520090221,-109.3777461
64792,25,36,12,15,9,0,97,38.22605520090221,-109.3774766
64793,26,32,12,18,10,0,98,38.22605520090221,-109.3772071
64794,27,31,12,18,11,0,99,38.22605520090221,-109.3769376
64795,25,29,11,16,14,1,96,38.22605520090221,-109.3766681
64796,13,28,11,23,15,1,91,38.22605520090221,-109.3763986
64797,5,30,8,25,13,0,81,38.22605520090221,-109.3761291
64798,5,34,8,19,13,0,79,38.22605520090221,-109.3758596
64799,8,34,9,19,12,1,83,38.22605520090221,-109.3755901
64800,9,39,13,12,15,2,90,38.22605520090221,-109.3753206
64801,12,37,13,13,13,2,90,38.22605520090221,-109.3750512
64802,10,32,12,15,13,2,84,38.22605520090221,-109.3747817
64803,8,33,11,13,11,3,79,38.22605520090221,-109.3745122
64804,9,32,11,10,10,4,76,38.22605520090221,-109.3742427
64805,5,33,9,7,10,6,70,38.22605520090221,-109.3739732
64806,4,35,9,6,12,4,70,38.22605520090221,-109.3737037
64807,5,31,14,9,16,11,86,38.22578570631698,-109.4114329
64808,5,31,13,10,20,8,87,38.22578570631698,-109.4111634
64809,7,33,13,13,20,3,89,38.22578570631698,-109.4108939
64810,6,35,12,12,21,1,87,38.22578570631698,-109.4106244
64811,9,34,12,12,21,1,89,38.22578570631698,-109.4103549
64812,10,31,12,12,21,1,87,38.22578570631698,-109.4100855
64813,11,30,12,12,21,2,88,38.22578570631698,-109.409816
64814,10,29,12,14,19,2,86,38.22578570631698,-109.4095465
64815,13,24,12,16,22,3,90,38.22578570631698,-109.409277
64816,7,21,11,21,25,3,88,38.22578570631698,-109.4090075
64817,7,22,11,21,24,3,88,38.22578570631698,-109.408738
64818,8,23,11,19,20,4,85,38.22578570631698,-109.4084685
64819,7,21,10,19,21,4,82,38.22578570631698,-109.408199
64820,6,17,11,22,21,6,83,38.22578570631698,-109.4079295
64821,6,15,10,22,21,7,81,38.22578570631698,-109.40766
64822,5,13,7,21,20,9,75,38.22578570631698,-109.4073905
64823,3,10,5,21,19,8,66,38.22578570631698,-109.407121
64824,2,7,5,21,22,11,68,38.22578570631698,-109.4068515
64825,6,10,9,26,26,9,86,38.22578570631698,-109.406582
64826,4,13,11,22,30,10,90,38.22578570631698,-109.4063125
64827,1,16,12,18,33,11,91,38.22578570631698,-109.406043
64828,8,18,12,11,30,11,90,38.22578570631698,-109.4057735
64829,1,25,10,15,14,5,70,38.22578570631698,-109.405504
64830,2,34,8,7,11,4,66,38.22578570631698,-109.4052345
64831,3,41,7,7,9,2,69,38.22578570631698,-109.4049651
64832,3,42,7,7,8,2,69,38.22578570631698,-109.4046956
64833,3,41,7,6,6,3,66,38.22578570631698,-109.4044261
64834,3,41,7,6,7,3,67,38.22578570631698,-109.4041566
64835,3,42,8,6,9,2,70,38.22578570631698,-109.4038871
64836,4,45,9,6,11,2,77,38.22578570631698,-109.4036176
64837,4,51,9,5,11,2,82,38.22578570631698,-109.4033481
64838,4,48,10,6,11,3,82,38.22578570631698,-109.4030786
64839,7,43,11,7,9,3,80,38.22578570631698,-109.4028091
64840,8,42,12,8,9,3,82,38.22578570631698,-109.4025396
64841,7,41,12,8,9,3,80,38.22578570631698,-109.4022701
64842,7,42,12,7,9,4,81,38.22578570631698,-109.4020006
64843,8,41,12,9,10,3,83,38.22578570631698,-109.4017311
64844,8,43,12,8,10,2,83,38.22578570631698,-109.4014616
64845,8,42,12,8,10,2,82,38.22578570631698,-109.4011921
64846,8,43,12,9,11,2,85,38.22578570631698,-109.4009226
64847,12,45,13,11,12,1,94,38.22578570631698,-109.4006531
64848,15,44,12,9,12,1,93,38.22578570631698,-109.4003836
64849,19,41,13,9,11,0,93,38.22578570631698,-109.4001142
64850,18,41,13,10,11,0,93,38.22578570631698,-109.3998447
64851,14,44,13,9,11,1,92,38.22578570631698,-109.3995752
64852,11,47,13,9,11,1,92,38.22578570631698,-109.3993057
64853,11,48,12,8,12,1,92,38.22578570631698,-109.3990362
64854,9,49,11,7,12,1,89,38.22578570631698,-109.3987667
64855,8,50,11,6,13,1,89,38.22578570631698,-109.3984972
64856,7,50,12,6,12,2,89,38.22578570631698,-109.3982277
64857,9,48,12,7,12,2,90,38.22578570631698,-109.3979582
64858,7,49,12,6,12,2,88,38.22578570631698,-109.3976887
64859,9,48,12,7,11,2,89,38.22578570631698,-109.3974192
64860,11,47,12,8,10,1,89,38.22578570631698,-109.3971497
64861,11,48,12,8,10,1,90,38.22578570631698,-109.3968802
64862,8,47,12,7,9,3,86,38.22578570631698,-109.3966107
64863,8,47,12,7,9,3,86,38.22578570631698,-109.3963412
64864,7,45,12,7,10,3,84,38.22578570631698,-109.3960717
64865,5,46,11,6,11,3,82,38.22578570631698,-109.3958022
64866,3,42,10,7,11,2,75,38.22578570631698,-109.3955327
64867,3,40,8,5,9,2,67,38.22578570631698,-109.3952632
64868,2,40,7,5,8,3,65,38.22578570631698,-109.3949938
64869,2,40,7,5,8,3,65,38.22578570631698,-109.3947243
64870,3,41,7,5,8,3,67,38.22578570631698,-109.3944548
64871,2,39,7,4,9,3,64,38.22578570631698,-109.3941853
64872,2,38,7,4,8,4,63,38.22578570631698,-109.3939158
64873,2,37,7,5,8,4,63,38.22578570631698,-109.3936463
64874,2,37,7,5,8,3,62,38.22578570631698,-109.3933768
64875,2,39,7,5,9,3,65,38.22578570631698,-109.3931073
64876,3,38,8,6,10,3,68,38.22578570631698,-109.3928378
64877,3,42,9,7,12,2,75,38.22578570631698,-109.3925683
64878,3,46,10,7,12,2,80,38.22578570631698,-109.3922988
64879,4,44,11,9,12,2,82,38.22578570631698,-109.3920293
64880,5,46,12,10,12,1,86,38.22578570631698,-109.3917598
64881,8,43,14,15,13,1,94,38.22578570631698,-109.3914903
64882,14,39,14,15,12,1,95,38.22578570631698,-109.3912208
64883,20,32,13,19,12,0,96,38.22578570631698,-109.3909513
64884,25,26,11,23,12,0,97,38.22578570631698,-109.3906818
64885,32,26,10,19,10,0,97,38.22578570631698,-109.3904123
64886,27,32,11,16,9,0,95,38.22578570631698,-109.3901429
64887,22,35,13,14,11,0,95,38.22578570631698,-109.3898734
64888,10,41,13,14,15,0,93,38.22578570631698,-109.3896039
64889,5,45,13,14,15,0,92,38.22578570631698,-109.3893344
64890,5,47,12,13,13,1,91,38.22578570631698,-109.3890649
64891,4,48,11,9,12,1,85,38.22578570631698,-109.3887954
64892,3,49,10,7,12,2,83,38.22578570631698,-109.3885259
64893,4,50,11,10,12,2,89,38.22578570631698,-109.3882564
64894,10,43,13,16,10,1,93,38.22578570631698,-109.3879869
64895,11,41,14,15,12,1,94,38.22578570631698,-109.3877174
64896,10,41,14,15,13,1,94,38.22578570631698,-109.3874479
64897,10,40,14,15,14,1,94,38.22578570631698,-109.3871784
64898,11,40,13,14,14,1,93,38.22578570631698,-109.3869089
64899,13,43,10,10,10,1,87,38.22578570631698,-109.3866394
64900,11,39,7,6,8,0,71,38.22578570631698,-109.3863699
64901,10,38,6,6,7,0,67,38.22578570631698,-109.3861004
64902,12,40,7,8,8,0,75,38.22578570631698,-109.3858309
64903,15,39,9,11,8,0,82,38.22578570631698,-109.3855614
64904,22,32,10,15,7,0,86,38.22578570631698,-109.3852919
64905,22,31,12,17,7,0,89,38.22578570631698,-109.3850225
64906,20,33,13,17,9,1,93,38.22578570631698,-109.384753
64907,17,36,13,14,10,1,91,38.22578570631698,-109.3844835
64908,18,39,12,15,9,1,94,38.22578570631698,-109.384214
64909,16,39,13,14,9,1,92,38.22578570631698,-109.3839445
64910,16,39,13,15,9,1,93,38.22578570631698,-109.383675
64911,18,38,13,15,9,1,94,38.22578570631698,-109.3834055
64912,20,36,13,14,9,1,93,38.22578570631698,-109.383136
64913,21,36,13,17,10,0,97,38.22578570631698,-109.3828665
64914,19,34,13,16,11,0,93,38.22578570631698,-109.382597
64915,18,36,13,14,10,1,92,38.22578570631698,-109.3823275
64916,17,37,14,14,11,1,94,38.22578570631698,-109.382058
64917,18,36,14,14,12,1,95,38.22578570631698,-109.3817885
64918,21,29,11,22,12,0,95,38.22578570631698,-109.381519
64919,21,26,11,24,12,1,95,38.22578570631698,-109.3812495
64920,22,25,11,22,12,1,93,38.22578570631698,-109.38098
64921,23,28,12,19,12,0,94,38.22578570631698,-109.3807105
64922,17,35,13,17,13,0,95,38.22578570631698,-109.380441
64923,7,35,12,13,13,2,82,38.22578570631698,-109.3801716
64924,4,39,9,10,11,2,75,38.22578570631698,-109.3799021
64925,3,39,8,8,10,2,70,38.22578570631698,-109.3796326
64926,2,39,8,6,9,3,67,38.22578570631698,-109.3793631
64927,2,41,8,7,9,3,70,38.22578570631698,-109.3790936
64928,2,40,9,9,10,2,72,38.22578570631698,-109.3788241
64929,3,41,10,10,11,2,77,38.22578570631698,-109.3785546
64930,8,44,13,14,12,1,92,38.22578570631698,-109.3782851
64931,20,36,12,17,8,0,93,38.22578570631698,-109.3780156
64932,27,33,11,15,10,0,96,38.22578570631698,-109.3777461
64933,26,28,11,19,12,0,96,38.22578570631698,-109.3774766
64934,28,27,11,20,11,0,97,38.22578570631698,-109.3772071
64935,31,25,10,20,10,0,96,38.22578570631698,-109.3769376
64936,30,26,11,16,13,0,96,38.22578570631698,-109.3766681
64937,15,32,12,17,15,1,92,38.22578570631698,-109.3763986
64938,6,33,9,25,11,0,84,38.22578570631698,-109.3761291
64939,5,32,8,21,11,0,77,38.22578570631698,-109.3758596
64940,7,30,9,25,12,0,83,38.22578570631698,-109.3755901
64941,13,32,12,17,15,1,90,38.22578570631698,-109.3753206
64942,19,28,11,18,14,2,92,38.22578570631698,-109.3750512
64943,21,26,10,23,12,1,93,38.22578570631698,-109.3747817
64944,23,26,11,23,10,1,94,38.22578570631698,-109.3745122
64945,19,31,13,17,9,1,90,38.22578570631698,-109.3742427
64946,12,33,12,12,11,2,82,38.22578570631698,-109.3739732
64947,8,36,11,12,11,1,79,38.22578570631698,-109.3737037
64948,4,30,14,6,13,13,80,38.225516211731744,-109.4114329
64949,5,35,13,7,17,9,86,38.225516211731744,-109.4111634
64950,7,40,13,10,19,1,90,38.225516211731744,-109.4108939
64951,6,43,13,11,19,0,92,38.225516211731744,-109.4106244
64952,10,42,13,11,18,0,94,38.225516211731744,-109.4103549
64953,11,41,13,11,18,0,94,38.225516211731744,-109.4100855
64954,9,40,12,11,19,0,91,38.225516211731744,-109.409816
64955,7,39,12,14,17,0,89,38.225516211731744,-109.4095465
64956,9,31,11,16,18,0,85,38.225516211731744,-109.409277
64957,9,23,11,20,21,3,87,38.225516211731744,-109.4090075
64958,6,21,11,21,26,3,88,38.225516211731744,-109.408738
64959,5,20,11,22,25,4,87,38.225516211731744,-109.4084685
64960,9,17,11,23,22,4,86,38.225516211731744,-109.408199
64961,11,17,11,19,22,5,85,38.225516211731744,-109.4079295
64962,12,17,10,18,22,6,85,38.225516211731744,-109.40766
64963,7,16,9,19,23,9,83,38.225516211731744,-109.4073905
64964,1,11,6,20,22,10,70,38.225516211731744,-109.407121
64965,1,8,5,20,21,10,65,38.225516211731744,-109.4068515
64966,6,9,7,28,24,10,84,38.225516211731744,-109.406582
64967,6,10,9,30,29,9,93,38.225516211731744,-109.4063125
64968,3,13,11,24,32,11,94,38.225516211731744,-109.406043
64969,3,15,11,20,32,11,92,38.225516211731744,-109.4057735
64970,6,22,11,20,17,4,80,38.225516211731744,-109.405504
64971,2,30,10,12,11,5,70,38.225516211731744,-109.4052345
64972,2,41,8,9,8,3,71,38.225516211731744,-109.4049651
64973,3,41,8,8,9,3,72,38.225516211731744,-109.4046956
64974,3,39,8,7,8,4,69,38.225516211731744,-109.4044261
64975,4,40,8,8,8,2,70,38.225516211731744,-109.4041566
64976,5,40,7,7,8,3,70,38.225516211731744,-109.4038871
64977,6,43,9,8,10,1,77,38.225516211731744,-109.4036176
64978,5,50,10,9,11,1,86,38.225516211731744,-109.4033481
64979,4,52,9,5,12,2,84,38.225516211731744,-109.4030786
64980,7,49,10,6,10,2,84,38.225516211731744,-109.4028091
64981,8,47,10,6,10,2,83,38.225516211731744,-109.4025396
64982,9,47,11,7,9,2,85,38.225516211731744,-109.4022701
64983,10,47,12,8,9,2,88,38.225516211731744,-109.4020006
64984,8,46,11,8,10,3,86,38.225516211731744,-109.4017311
64985,6,44,11,7,9,4,81,38.225516211731744,-109.4014616
64986,6,42,12,7,9,4,80,38.225516211731744,-109.4011921
64987,7,41,12,9,10,3,82,38.225516211731744,-109.4009226
64988,8,42,13,12,13,1,89,38.225516211731744,-109.4006531
64989,13,44,13,11,12,0,93,38.225516211731744,-109.4003836
64990,14,44,13,11,12,0,94,38.225516211731744,-109.4001142
64991,13,45,13,10,12,0,93,38.225516211731744,-109.3998447
64992,11,46,12,9,12,1,91,38.225516211731744,-109.3995752
64993,11,46,12,9,11,1,90,38.225516211731744,-109.3993057
64994,13,47,13,8,11,1,93,38.225516211731744,-109.3990362
64995,11,47,12,8,13,1,92,38.225516211731744,-109.3987667
64996,6,49,11,8,12,1,87,38.225516211731744,-109.3984972
64997,5,52,10,6,12,2,87,38.225516211731744,-109.3982277
64998,6,49,10,7,11,2,85,38.225516211731744,-109.3979582
64999,6,47,10,7,11,2,83,38.225516211731744,-109.3976887
65000,6,45,10,6,11,2,80,38.225516211731744,-109.3974192
65001,6,45,10,6,10,2,79,38.225516211731744,-109.3971497
65002,7,44,10,6,11,2,80,38.225516211731744,-109.3968802
65003,8,45,11,8,10,2,84,38.225516211731744,-109.3966107
65004,10,46,12,8,10,2,88,38.225516211731744,-109.3963412
65005,10,47,12,7,10,2,88,38.225516211731744,-109.3960717
65006,8,48,12,7,10,2,87,38.225516211731744,-109.3958022
65007,6,49,11,6,10,2,84,38.225516211731744,-109.3955327
65008,6,41,10,7,10,2,76,38.225516211731744,-109.3952632
65009,4,38,8,6,9,3,68,38.225516211731744,-109.3949938
65010,3,40,7,5,9,3,67,38.225516211731744,-109.3947243
65011,3,40,7,5,9,3,67,38.225516211731744,-109.3944548
65012,3,42,7,5,9,3,69,38.225516211731744,-109.3941853
65013,2,32,9,5,11,5,64,38.225516211731744,-109.3939158
65014,2,29,10,6,11,6,64,38.225516211731744,-109.3936463
65015,2,31,10,7,11,5,66,38.225516211731744,-109.3933768
65016,2,35,9,7,11,3,67,38.225516211731744,-109.3931073
65017,2,42,9,7,9,2,71,38.225516211731744,-109.3928378
65018,3,44,10,8,11,2,78,38.225516211731744,-109.3925683
65019,4,44,11,8,12,2,81,38.225516211731744,-109.3922988
65020,4,43,12,10,12,2,83,38.225516211731744,-109.3920293
65021,4,43,12,13,12,1,85,38.225516211731744,-109.3917598
65022,8,42,14,14,12,1,91,38.225516211731744,-109.3914903
65023,9,42,14,15,13,1,94,38.225516211731744,-109.3912208
65024,12,39,13,16,13,1,94,38.225516211731744,-109.3909513
65025,17,33,12,21,13,0,96,38.225516211731744,-109.3906818
65026,22,24,11,25,13,0,95,38.225516211731744,-109.3904123
65027,27,25,10,19,12,0,93,38.225516211731744,-109.3901429
65028,19,32,12,17,14,0,94,38.225516211731744,-109.3898734
65029,8,42,14,16,14,0,94,38.225516211731744,-109.3896039
65030,4,48,12,13,12,1,90,38.225516211731744,-109.3893344
65031,4,50,11,10,12,1,88,38.225516211731744,-109.3890649
65032,4,51,11,9,12,2,89,38.225516211731744,-109.3887954
65033,5,51,12,10,11,2,91,38.225516211731744,-109.3885259
65034,7,48,12,14,11,1,93,38.225516211731744,-109.3882564
65035,11,44,13,15,10,1,94,38.225516211731744,-109.3879869
65036,11,42,14,16,12,1,96,38.225516211731744,-109.3877174
65037,12,39,14,16,12,1,94,38.225516211731744,-109.3874479
65038,14,38,14,16,13,0,95,38.225516211731744,-109.3871784
65039,14,38,14,15,13,0,94,38.225516211731744,-109.3869089
65040,10,48,12,12,10,1,93,38.225516211731744,-109.3866394
65041,10,48,10,11,10,1,90,38.225516211731744,-109.3863699
65042,11,43,9,11,9,1,84,38.225516211731744,-109.3861004
65043,13,40,9,10,8,0,80,38.225516211731744,-109.3858309
65044,14,41,11,13,11,1,91,38.225516211731744,-109.3855614
65045,27,28,11,19,8,1,94,38.225516211731744,-109.3852919
65046,27,23,10,20,10,1,91,38.225516211731744,-109.3850225
65047,30,20,10,20,9,1,90,38.225516211731744,-109.384753
65048,29,21,10,22,9,1,92,38.225516211731744,-109.3844835
65049,23,26,10,19,14,1,93,38.225516211731744,-109.384214
65050,22,27,11,22,13,1,96,38.225516211731744,-109.3839445
65051,23,28,11,24,11,0,97,38.225516211731744,-109.383675
65052,24,28,11,24,10,0,97,38.225516211731744,-109.3834055
65053,25,26,10,25,9,0,95,38.225516211731744,-109.383136
65054,24,25,11,25,11,0,96,38.225516211731744,-109.3828665
65055,22,27,11,23,12,0,95,38.225516211731744,-109.382597
65056,20,29,12,21,13,0,95,38.225516211731744,-109.3823275
65057,19,29,12,21,13,1,95,38.225516211731744,-109.382058
65058,16,27,11,25,13,1,93,38.225516211731744,-109.3817885
65059,17,23,10,28,12,1,91,38.225516211731744,-109.381519
65060,17,23,10,29,11,1,91,38.225516211731744,-109.3812495
65061,19,23,10,28,11,1,92,38.225516211731744,-109.38098
65062,23,25,11,24,11,0,94,38.225516211731744,-109.3807105
65063,22,31,13,18,11,0,95,38.225516211731744,-109.380441
65064,14,39,14,14,13,1,95,38.225516211731744,-109.3801716
65065,9,40,14,15,13,1,92,38.225516211731744,-109.3799021
65066,6,37,12,13,12,2,82,38.225516211731744,-109.3796326
65067,4,38,9,8,11,3,73,38.225516211731744,-109.3793631
65068,2,39,9,9,10,3,72,38.225516211731744,-109.3790936
65069,4,40,11,12,12,1,80,38.225516211731744,-109.3788241
65070,8,41,13,16,12,1,91,38.225516211731744,-109.3785546
65071,17,37,13,17,11,0,95,38.225516211731744,-109.3782851
65072,30,30,10,17,8,0,95,38.225516211731744,-109.3780156
65073,29,25,9,21,12,0,96,38.225516211731744,-109.3777461
65074,28,23,9,23,12,0,95,38.225516211731744,-109.3774766
65075,32,22,9,22,10,0,95,38.225516211731744,-109.3772071
65076,33,24,10,19,9,0,95,38.225516211731744,-109.3769376
65077,27,32,11,14,9,0,93,38.225516211731744,-109.3766681
65078,13,38,13,16,14,0,94,38.225516211731744,-109.3763986
65079,6,33,10,23,13,0,85,38.225516211731744,-109.3761291
65080,2,27,9,25,12,0,75,38.225516211731744,-109.3758596
65081,5,26,9,27,13,0,80,38.225516211731744,-109.3755901
65082,16,25,11,20,15,3,90,38.225516211731744,-109.3753206
65083,17,22,10,22,17,2,90,38.225516211731744,-109.3750512
65084,20,20,10,25,16,1,92,38.225516211731744,-109.3747817
65085,20,22,10,29,14,1,96,38.225516211731744,-109.3745122
65086,19,24,11,27,12,1,94,38.225516211731744,-109.3742427
65087,21,27,11,22,11,1,93,38.225516211731744,-109.3739732
65088,22,28,11,21,11,0,93,38.225516211731744,-109.3737037
65089,4,33,13,8,15,7,80,38.225246717146504,-109.4114329
65090,5,39,13,9,18,3,87,38.225246717146504,-109.4111634
65091,6,44,14,12,17,0,93,38.225246717146504,-109.4108939
65092,7,43,14,12,18,0,94,38.225246717146504,-109.4106244
65093,11,41,13,12,17,0,94,38.225246717146504,-109.4103549
65094,12,40,13,12,17,0,94,38.225246717146504,-109.4100855
65095,11,39,13,14,16,0,93,38.225246717146504,-109.409816
65096,10,37,12,15,16,0,90,38.225246717146504,-109.4095465
65097,11,29,11,16,20,1,88,38.225246717146504,-109.409277
65098,7,23,11,22,23,3,89,38.225246717146504,-109.4090075
65099,6,19,10,25,26,3,89,38.225246717146504,-109.408738
65100,8,14,9,27,25,5,88,38.225246717146504,-109.4084685
65101,10,11,9,26,26,7,89,38.225246717146504,-109.408199
65102,24,13,11,18,21,4,91,38.225246717146504,-109.4079295
65103,22,15,11,17,20,5,90,38.225246717146504,-109.40766
65104,16,15,11,20,22,7,91,38.225246717146504,-109.4073905
65105,6,14,9,25,24,9,87,38.225246717146504,-109.407121
65106,2,15,8,19,28,10,82,38.225246717146504,-109.4068515
65107,3,14,9,22,29,10,87,38.225246717146504,-109.406582
65108,5,11,10,26,26,11,89,38.225246717146504,-109.4063125
65109,5,11,11,24,28,12,91,38.225246717146504,-109.406043
65110,3,14,12,19,33,11,92,38.225246717146504,-109.4057735
65111,5,20,12,21,16,6,80,38.225246717146504,-109.405504
65112,2,29,11,12,12,5,71,38.225246717146504,-109.4052345
65113,4,42,8,9,10,1,74,38.225246717146504,-109.4049651
65114,5,40,10,9,13,1,78,38.225246717146504,-109.4046956
65115,5,40,10,11,13,1,80,38.225246717146504,-109.4044261
65116,6,42,10,10,12,1,81,38.225246717146504,-109.4041566
65117,6,43,9,8,13,1,80,38.225246717146504,-109.4038871
65118,6,47,10,8,13,1,85,38.225246717146504,-109.4036176
65119,7,50,10,8,13,1,89,38.225246717146504,-109.4033481
65120,6,49,10,7,12,1,85,38.225246717146504,-109.4030786
65121,7,45,10,8,11,1,82,38.225246717146504,-109.4028091
65122,7,42,9,7,11,1,77,38.225246717146504,-109.4025396
65123,7,42,9,6,11,1,76,38.225246717146504,-109.4022701
65124,8,46,10,7,11,1,83,38.225246717146504,-109.4020006
65125,6,48,10,7,11,2,84,38.225246717146504,-109.4017311
65126,5,47,11,7,10,3,83,38.225246717146504,-109.4014616
65127,6,45,12,7,9,4,83,38.225246717146504,-109.4011921
65128,7,44,12,8,10,3,84,38.225246717146504,-109.4009226
65129,8,44,12,9,11,2,86,38.225246717146504,-109.4006531
65130,11,46,13,10,11,1,92,38.225246717146504,-109.4003836
65131,11,47,12,10,12,1,93,38.225246717146504,-109.4001142
65132,10,47,12,9,12,1,91,38.225246717146504,-109.3998447
65133,9,48,12,9,12,1,91,38.225246717146504,-109.3995752
65134,10,48,12,9,11,1,91,38.225246717146504,-109.3993057
65135,11,47,12,9,12,1,92,38.225246717146504,-109.3990362
65136,9,48,12,9,13,1,92,38.225246717146504,-109.3987667
65137,7,48,11,9,12,1,88,38.225246717146504,-109.3984972
65138,5,49,10,8,11,1,84,38.225246717146504,-109.3982277
65139,5,45,10,6,11,2,79,38.225246717146504,-109.3979582
65140,4,43,9,6,10,2,74,38.225246717146504,-109.3976887
65141,3,44,9,5,9,2,72,38.225246717146504,-109.3974192
65142,3,43,8,4,9,3,70,38.225246717146504,-109.3971497
65143,3,42,9,5,10,3,72,38.225246717146504,-109.3968802
65144,6,44,10,7,11,2,80,38.225246717146504,-109.3966107
65145,7,46,11,7,11,2,84,38.225246717146504,-109.3963412
65146,8,47,11,7,10,2,85,38.225246717146504,-109.3960717
65147,9,44,11,7,10,1,82,38.225246717146504,-109.3958022
65148,8,42,10,7,10,2,79,38.225246717146504,-109.3955327
65149,6,41,9,7,10,2,75,38.225246717146504,-109.3952632
65150,5,40,8,6,10,3,72,38.225246717146504,-109.3949938
65151,4,41,7,5,8,3,68,38.225246717146504,-109.3947243
65152,3,40,7,5,9,3,67,38.225246717146504,-109.3944548
65153,4,42,8,6,10,2,72,38.225246717146504,-109.3941853
65154,5,33,10,10,13,3,74,38.225246717146504,-109.3939158
65155,6,30,12,13,14,4,79,38.225246717146504,-109.3936463
65156,7,33,13,13,13,5,84,38.225246717146504,-109.3933768
65157,3,37,11,10,12,5,78,38.225246717146504,-109.3931073
65158,3,43,10,8,11,4,79,38.225246717146504,-109.3928378
65159,4,45,11,8,10,3,81,38.225246717146504,-109.3925683
65160,4,44,11,9,10,3,81,38.225246717146504,-109.3922988
65161,5,41,12,11,10,2,81,38.225246717146504,-109.3920293
65162,4,41,12,12,10,2,81,38.225246717146504,-109.3917598
65163,4,40,11,12,11,2,80,38.225246717146504,-109.3914903
65164,4,43,11,10,11,2,81,38.225246717146504,-109.3912208
65165,6,44,12,13,12,1,88,38.225246717146504,-109.3909513
65166,10,39,13,19,12,1,94,38.225246717146504,-109.3906818
65167,20,29,12,21,13,0,95,38.225246717146504,-109.3904123
65168,19,27,11,22,14,1,94,38.225246717146504,-109.3901429
65169,14,30,12,21,16,1,94,38.225246717146504,-109.3898734
65170,10,38,14,16,16,0,94,38.225246717146504,-109.3896039
65171,5,44,13,13,13,1,89,38.225246717146504,-109.3893344
65172,3,48,11,11,11,1,85,38.225246717146504,-109.3890649
65173,4,51,11,11,11,1,89,38.225246717146504,-109.3887954
65174,7,48,13,14,11,1,94,38.225246717146504,-109.3885259
65175,9,44,13,15,11,1,93,38.225246717146504,-109.3882564
65176,10,41,14,16,12,1,94,38.225246717146504,-109.3879869
65177,12,39,14,16,12,1,94,38.225246717146504,-109.3877174
65178,17,37,14,16,12,0,96,38.225246717146504,-109.3874479
65179,18,37,13,16,11,0,95,38.225246717146504,-109.3871784
65180,12,41,13,15,12,1,94,38.225246717146504,-109.3869089
65181,8,48,12,13,10,1,92,38.225246717146504,-109.3866394
65182,7,50,12,12,11,1,93,38.225246717146504,-109.3863699
65183,8,48,11,12,11,1,91,38.225246717146504,-109.3861004
65184,11,44,11,13,10,1,90,38.225246717146504,-109.3858309
65185,13,40,13,16,11,1,94,38.225246717146504,-109.3855614
65186,18,32,13,20,13,0,96,38.225246717146504,-109.3852919
65187,19,26,10,19,16,1,91,38.225246717146504,-109.3850225
65188,19,20,9,19,21,1,89,38.225246717146504,-109.384753
65189,21,17,9,23,20,1,91,38.225246717146504,-109.3844835
65190,20,17,9,27,18,1,92,38.225246717146504,-109.384214
65191,16,21,10,29,14,1,91,38.225246717146504,-109.3839445
65192,13,24,10,30,13,1,91,38.225246717146504,-109.383675
65193,15,25,11,29,13,1,94,38.225246717146504,-109.3834055
65194,17,25,11,27,13,1,94,38.225246717146504,-109.383136
65195,14,25,11,29,12,1,92,38.225246717146504,-109.3828665
65196,16,24,11,29,12,1,93,38.225246717146504,-109.382597
65197,17,24,11,27,13,1,93,38.225246717146504,-109.3823275
65198,16,24,11,26,13,1,91,38.225246717146504,-109.382058
65199,14,23,10,29,13,1,90,38.225246717146504,-109.3817885
65200,17,22,10,29,12,1,91,38.225246717146504,-109.381519
65201,16,23,10,29,12,1,91,38.225246717146504,-109.3812495
65202,17,23,10,28,12,1,91,38.225246717146504,-109.38098
65203,19,23,10,27,12,1,92,38.225246717146504,-109.3807105
65204,20,26,11,25,12,0,94,38.225246717146504,-109.380441
65205,19,33,12,20,13,0,97,38.225246717146504,-109.3801716
65206,16,35,13,18,13,0,95,38.225246717146504,-109.3799021
65207,14,38,14,16,13,0,95,38.225246717146504,-109.3796326
65208,10,40,14,16,13,1,94,38.225246717146504,-109.3793631
65209,6,39,13,19,13,1,91,38.225246717146504,-109.3790936
65210,12,39,13,18,13,0,95,38.225246717146504,-109.3788241
65211,20,33,13,19,11,0,96,38.225246717146504,-109.3785546
65212,29,29,11,18,8,0,95,38.225246717146504,-109.3782851
65213,34,28,9,17,8,0,96,38.225246717146504,-109.3780156
65214,28,23,9,24,11,0,95,38.225246717146504,-109.3777461
65215,31,24,9,21,10,0,95,38.225246717146504,-109.3774766
65216,31,26,10,19,8,0,94,38.225246717146504,-109.3772071
65217,26,31,11,17,9,0,94,38.225246717146504,-109.3769376
65218,19,37,11,14,9,0,90,38.225246717146504,-109.3766681
65219,12,38,12,16,13,1,92,38.225246717146504,-109.3763986
65220,8,25,10,24,14,1,82,38.225246717146504,-109.3761291
65221,2,22,8,24,16,1,73,38.225246717146504,-109.3758596
65222,3,24,9,23,17,1,77,38.225246717146504,-109.3755901
65223,14,22,10,23,13,3,85,38.225246717146504,-109.3753206
65224,15,20,10,23,18,2,88,38.225246717146504,-109.3750512
65225,16,19,10,25,20,1,91,38.225246717146504,-109.3747817
65226,16,18,10,30,17,1,92,38.225246717146504,-109.3745122
65227,16,20,9,31,14,1,91,38.225246717146504,-109.3742427
65228,20,22,8,29,13,0,92,38.225246717146504,-109.3739732
65229,21,25,8,26,14,0,94,38.225246717146504,-109.3737037
65230,5,38,13,13,14,2,85,38.224977222561265,-109.4114329
65231,6,41,14,15,16,1,93,38.224977222561265,-109.4111634
65232,9,41,14,17,14,0,95,38.224977222561265,-109.4108939
65233,10,38,13,16,15,0,92,38.224977222561265,-109.4106244
65234,13,34,13,19,16,0,95,38.224977222561265,-109.4103549
65235,11,34,13,20,16,0,94,38.224977222561265,-109.4100855
65236,9,34,12,20,17,0,92,38.224977222561265,-109.409816
65237,8,30,11,20,19,1,89,38.224977222561265,-109.4095465
65238,6,25,12,19,24,3,89,38.224977222561265,-109.409277
65239,4,22,11,21,26,3,87,38.224977222561265,-109.4090075
65240,5,21,11,23,25,3,88,38.224977222561265,-109.408738
65241,7,19,11,23,26,4,90,38.224977222561265,-109.4084685
65242,12,12,11,21,29,7,92,38.224977222561265,-109.408199
65243,28,11,10,21,21,5,96,38.224977222561265,-109.4079295
65244,28,11,9,21,21,5,95,38.224977222561265,-109.40766
65245,22,12,10,24,21,6,95,38.224977222561265,-109.4073905
65246,11,13,10,25,25,8,92,38.224977222561265,-109.407121
65247,3,18,10,19,29,7,86,38.224977222561265,-109.4068515
65248,3,17,10,20,29,9,88,38.224977222561265,-109.406582
65249,3,13,10,22,29,11,88,38.224977222561265,-109.4063125
65250,3,11,11,21,31,13,90,38.224977222561265,-109.406043
65251,3,13,12,23,30,11,92,38.224977222561265,-109.4057735
65252,10,20,12,25,17,2,86,38.224977222561265,-109.405504
65253,1,27,11,14,11,5,69,38.224977222561265,-109.4052345
65254,3,38,9,9,13,2,74,38.224977222561265,-109.4049651
65255,5,45,10,10,14,1,85,38.224977222561265,-109.4046956
65256,4,46,11,11,14,1,87,38.224977222561265,-109.4044261
65257,5,44,10,10,13,1,83,38.224977222561265,-109.4041566
65258,6,47,10,9,12,1,85,38.224977222561265,-109.4038871
65259,7,46,9,9,13,1,85,38.224977222561265,-109.4036176
65260,6,46,9,10,12,1,84,38.224977222561265,-109.4033481
65261,5,44,8,7,12,1,77,38.224977222561265,-109.4030786
65262,6,46,9,6,11,1,79,38.224977222561265,-109.4028091
65263,7,43,9,6,11,1,77,38.224977222561265,-109.4025396
65264,6,42,8,6,10,2,74,38.224977222561265,-109.4022701
65265,5,42,8,6,9,2,72,38.224977222561265,-109.4020006
65266,6,44,8,6,10,2,76,38.224977222561265,-109.4017311
65267,5,49,9,5,11,2,81,38.224977222561265,-109.4014616
65268,6,47,11,6,10,3,83,38.224977222561265,-109.4011921
65269,8,45,12,8,9,3,85,38.224977222561265,-109.4009226
65270,9,45,13,9,10,2,88,38.224977222561265,-109.4006531
65271,8,46,12,9,11,2,88,38.224977222561265,-109.4003836
65272,9,46,12,8,12,1,88,38.224977222561265,-109.4001142
65273,9,47,12,9,12,1,90,38.224977222561265,-109.3998447
65274,8,47,12,9,11,1,88,38.224977222561265,-109.3995752
65275,11,47,13,9,11,1,92,38.224977222561265,-109.3993057
65276,10,47,12,9,12,1,91,38.224977222561265,-109.3990362
65277,10,49,12,8,12,1,92,38.224977222561265,-109.3987667
65278,9,51,11,7,12,1,91,38.224977222561265,-109.3984972
65279,7,48,11,7,12,1,86,38.224977222561265,-109.3982277
65280,7,42,10,8,12,1,80,38.224977222561265,-109.3979582
65281,4,39,9,7,10,3,72,38.224977222561265,-109.3976887
65282,3,41,9,6,9,3,71,38.224977222561265,-109.3974192
65283,4,42,9,6,9,2,72,38.224977222561265,-109.3971497
65284,4,39,9,7,10,3,72,38.224977222561265,-109.3968802
65285,5,42,9,6,11,2,75,38.224977222561265,-109.3966107
65286,5,48,9,6,11,2,81,38.224977222561265,-109.3963412
65287,6,46,9,6,10,2,79,38.224977222561265,-109.3960717
65288,6,39,9,6,9,2,71,38.224977222561265,-109.3958022
65289,5,37,8,6,9,3,68,38.224977222561265,-109.3955327
65290,4,40,7,6,8,2,67,38.224977222561265,-109.3952632
65291,3,43,6,5,8,2,67,38.224977222561265,-109.3949938
65292,3,38,7,4,9,3,64,38.224977222561265,-109.3947243
65293,4,34,8,6,11,4,67,38.224977222561265,-109.3944548
65294,4,40,10,10,11,3,78,38.224977222561265,-109.3941853
65295,7,39,12,13,13,2,86,38.224977222561265,-109.3939158
65296,13,34,13,12,14,3,89,38.224977222561265,-109.3936463
65297,13,29,13,13,15,5,88,38.224977222561265,-109.3933768
65298,11,34,13,13,13,5,89,38.224977222561265,-109.3931073
65299,6,44,11,11,13,2,87,38.224977222561265,-109.3928378
65300,6,48,12,12,11,1,90,38.224977222561265,-109.3925683
65301,6,46,12,13,11,1,89,38.224977222561265,-109.3922988
65302,6,40,13,13,11,2,85,38.224977222561265,-109.3920293
65303,6,39,13,12,11,2,83,38.224977222561265,-109.3917598
65304,6,43,12,11,10,2,84,38.224977222561265,-109.3914903
65305,7,43,12,12,11,2,87,38.224977222561265,-109.3912208
65306,12,40,12,14,12,1,91,38.224977222561265,-109.3909513
65307,19,31,12,19,11,1,93,38.224977222561265,-109.3906818
65308,24,26,11,19,12,1,93,38.224977222561265,-109.3904123
65309,22,23,10,23,15,1,94,38.224977222561265,-109.3901429
65310,15,24,11,26,17,2,95,38.224977222561265,-109.3898734
65311,11,27,12,25,17,2,94,38.224977222561265,-109.3896039
65312,11,32,12,21,16,1,93,38.224977222561265,-109.3893344
65313,9,39,13,14,15,1,91,38.224977222561265,-109.3890649
65314,8,42,13,13,14,1,91,38.224977222561265,-109.3887954
65315,9,43,14,14,13,1,94,38.224977222561265,-109.3885259
65316,11,41,14,15,13,1,95,38.224977222561265,-109.3882564
65317,13,37,13,15,14,1,93,38.224977222561265,-109.3879869
65318,15,36,13,16,13,1,94,38.224977222561265,-109.3877174
65319,17,38,13,17,11,0,96,38.224977222561265,-109.3874479
65320,14,41,12,16,11,0,94,38.224977222561265,-109.3871784
65321,9,45,13,14,11,1,93,38.224977222561265,-109.3869089
65322,6,48,13,12,11,1,91,38.224977222561265,-109.3866394
65323,5,54,12,11,10,1,93,38.224977222561265,-109.3863699
65324,6,52,12,11,11,1,93,38.224977222561265,-109.3861004
65325,8,47,12,13,11,1,92,38.224977222561265,-109.3858309
65326,14,39,13,16,13,1,96,38.224977222561265,-109.3855614
65327,15,30,12,23,15,1,96,38.224977222561265,-109.3852919
65328,14,27,11,21,16,1,90,38.224977222561265,-109.3850225
65329,14,26,10,20,18,1,89,38.224977222561265,-109.384753
65330,13,24,10,24,17,2,90,38.224977222561265,-109.3844835
65331,9,25,10,28,15,1,88,38.224977222561265,-109.384214
65332,11,26,11,28,14,1,91,38.224977222561265,-109.3839445
65333,12,24,11,30,13,1,91,38.224977222561265,-109.383675
65334,15,25,11,29,13,1,94,38.224977222561265,-109.3834055
65335,16,26,11,27,12,1,93,38.224977222561265,-109.383136
65336,17,24,10,28,12,1,92,38.224977222561265,-109.3828665
65337,17,24,10,30,11,0,92,38.224977222561265,-109.382597
65338,15,24,10,29,12,1,91,38.224977222561265,-109.3823275
65339,14,25,11,27,13,1,91,38.224977222561265,-109.382058
65340,14,24,11,29,12,1,91,38.224977222561265,-109.3817885
65341,15,25,10,27,13,1,91,38.224977222561265,-109.381519
65342,14,25,10,28,12,1,90,38.224977222561265,-109.3812495
65343,16,24,10,30,12,1,93,38.224977222561265,-109.38098
65344,18,23,10,29,12,1,93,38.224977222561265,-109.3807105
65345,19,24,10,27,12,1,93,38.224977222561265,-109.380441
65346,19,26,11,25,12,1,94,38.224977222561265,-109.3801716
65347,18,27,11,25,12,1,94,38.224977222561265,-109.3799021
65348,17,29,12,23,13,0,94,38.224977222561265,-109.3796326
65349,16,32,13,22,13,0,96,38.224977222561265,-109.3793631
65350,16,32,13,22,13,0,96,38.224977222561265,-109.3790936
65351,18,31,12,21,13,0,95,38.224977222561265,-109.3788241
65352,24,29,11,20,10,0,94,38.224977222561265,-109.3785546
65353,30,30,10,18,8,0,96,38.224977222561265,-109.3782851
65354,32,30,9,18,9,0,98,38.224977222561265,-109.3780156
65355,30,26,9,21,8,0,94,38.224977222561265,-109.3777461
65356,27,32,10,19,8,0,96,38.224977222561265,-109.3774766
65357,22,36,11,16,8,0,93,38.224977222561265,-109.3772071
65358,19,36,12,15,10,0,92,38.224977222561265,-109.3769376
65359,17,34,12,18,12,1,94,38.224977222561265,-109.3766681
65360,13,27,11,21,15,1,88,38.224977222561265,-109.3763986
65361,10,20,9,28,17,2,86,38.224977222561265,-109.3761291
65362,1,20,7,20,18,3,69,38.224977222561265,-109.3758596
65363,0,22,7,19,19,2,69,38.224977222561265,-109.3755901
65364,7,22,10,27,14,1,81,38.224977222561265,-109.3753206
65365,11,21,10,24,19,2,87,38.224977222561265,-109.3750512
65366,14,19,9,29,18,1,90,38.224977222561265,-109.3747817
65367,16,19,9,31,15,1,91,38.224977222561265,-109.3745122
65368,16,20,9,29,15,1,90,38.224977222561265,-109.3742427
65369,19,20,9,28,14,1,91,38.224977222561265,-109.3739732
65370,19,22,9,24,14,2,90,38.224977222561265,-109.3737037
65371,8,31,14,14,16,3,86,38.22470772797603,-109.4114329
65372,12,34,13,16,16,1,92,38.22470772797603,-109.4111634
65373,14,34,13,18,14,0,93,38.22470772797603,-109.4108939
65374,16,29,13,25,11,0,94,38.22470772797603,-109.4106244
65375,11,22,11,30,17,2,93,38.22470772797603,-109.4103549
65376,9,22,10,27,21,2,91,38.22470772797603,-109.4100855
65377,7,25,11,23,21,2,89,38.22470772797603,-109.409816
65378,7,26,11,20,22,2,88,38.22470772797603,-109.4095465
65379,7,23,11,22,24,3,90,38.22470772797603,-109.409277
65380,5,23,11,21,23,3,86,38.22470772797603,-109.4090075
65381,5,24,11,20,24,3,87,38.22470772797603,-109.408738
65382,6,22,11,18,26,4,87,38.22470772797603,-109.4084685
65383,7,17,12,17,29,8,90,38.22470772797603,-109.408199
65384,23,9,9,27,24,4,96,38.22470772797603,-109.4079295
65385,26,8,9,25,24,6,98,38.22470772797603,-109.40766
65386,18,9,10,27,26,7,97,38.22470772797603,-109.4073905
65387,9,13,11,23,30,7,93,38.22470772797603,-109.407121
65388,6,18,12,23,27,4,90,38.22470772797603,-109.4068515
65389,5,16,11,25,28,6,91,38.22470772797603,-109.406582
65390,4,13,10,26,29,9,91,38.22470772797603,-109.4063125
65391,3,13,11,22,30,11,90,38.22470772797603,-109.406043
65392,4,18,12,19,31,8,92,38.22470772797603,-109.4057735
65393,11,22,12,23,18,2,88,38.22470772797603,-109.405504
65394,3,29,10,19,14,2,77,38.22470772797603,-109.4052345
65395,3,39,9,10,13,2,76,38.22470772797603,-109.4049651
65396,4,45,10,9,14,1,83,38.22470772797603,-109.4046956
65397,6,50,10,11,13,0,90,38.22470772797603,-109.4044261
65398,7,50,10,9,13,0,89,38.22470772797603,-109.4041566
65399,6,48,9,7,11,1,82,38.22470772797603,-109.4038871
65400,5,45,7,5,10,1,73,38.22470772797603,-109.4036176
65401,4,44,7,5,9,2,71,38.22470772797603,-109.4033481
65402,4,43,7,5,9,2,70,38.22470772797603,-109.4030786
65403,5,43,7,5,9,2,71,38.22470772797603,-109.4028091
65404,6,44,8,5,10,1,74,38.22470772797603,-109.4025396
65405,6,45,8,6,9,1,75,38.22470772797603,-109.4022701
65406,5,45,8,6,8,2,74,38.22470772797603,-109.4020006
65407,4,42,7,7,8,2,70,38.22470772797603,-109.4017311
65408,5,41,8,6,10,2,72,38.22470772797603,-109.4014616
65409,7,45,9,7,11,1,80,38.22470772797603,-109.4011921
65410,7,49,11,8,10,2,87,38.22470772797603,-109.4009226
65411,8,48,12,9,11,1,89,38.22470772797603,-109.4006531
65412,7,50,12,8,11,2,90,38.22470772797603,-109.4003836
65413,7,49,12,7,12,2,89,38.22470772797603,-109.4001142
65414,7,48,12,9,12,2,90,38.22470772797603,-109.3998447
65415,9,47,13,10,11,1,91,38.22470772797603,-109.3995752
65416,12,45,13,11,11,1,93,38.22470772797603,-109.3993057
65417,16,43,13,10,10,0,92,38.22470772797603,-109.3990362
65418,15,41,13,12,11,0,92,38.22470772797603,-109.3987667
65419,10,45,12,10,12,1,90,38.22470772797603,-109.3984972
65420,7,48,10,7,12,1,85,38.22470772797603,-109.3982277
65421,9,43,11,10,12,1,86,38.22470772797603,-109.3979582
65422,7,42,10,8,11,2,80,38.22470772797603,-109.3976887
65423,6,42,9,7,10,2,76,38.22470772797603,-109.3974192
65424,6,44,9,7,9,2,77,38.22470772797603,-109.3971497
65425,5,42,9,7,11,2,76,38.22470772797603,-109.3968802
65426,3,50,8,4,11,2,78,38.22470772797603,-109.3966107
65427,3,49,8,5,11,2,78,38.22470772797603,-109.3963412
65428,4,45,8,6,10,2,75,38.22470772797603,-109.3960717
65429,5,41,8,6,9,2,71,38.22470772797603,-109.3958022
65430,4,40,8,6,8,2,68,38.22470772797603,-109.3955327
65431,4,44,7,5,7,2,69,38.22470772797603,-109.3952632
65432,3,42,7,5,8,2,67,38.22470772797603,-109.3949938
65433,4,36,8,6,11,3,68,38.22470772797603,-109.3947243
65434,5,34,10,10,14,3,76,38.22470772797603,-109.3944548
65435,6,40,12,12,13,3,86,38.22470772797603,-109.3941853
65436,7,43,12,12,12,2,88,38.22470772797603,-109.3939158
65437,14,38,13,12,13,1,91,38.22470772797603,-109.3936463
65438,18,33,13,13,13,1,91,38.22470772797603,-109.3933768
65439,13,39,13,13,12,1,91,38.22470772797603,-109.3931073
65440,7,46,12,11,12,1,89,38.22470772797603,-109.3928378
65441,5,49,11,9,11,2,87,38.22470772797603,-109.3925683
65442,5,46,12,9,11,2,85,38.22470772797603,-109.3922988
65443,6,43,12,10,11,3,85,38.22470772797603,-109.3920293
65444,8,45,12,11,11,2,89,38.22470772797603,-109.3917598
65445,11,42,11,12,11,1,88,38.22470772797603,-109.3914903
65446,21,36,11,12,9,1,90,38.22470772797603,-109.3912208
65447,33,27,10,13,7,1,91,38.22470772797603,-109.3909513
65448,28,18,11,17,11,2,87,38.22470772797603,-109.3906818
65449,27,17,10,17,15,2,88,38.22470772797603,-109.3904123
65450,26,16,9,23,18,2,94,38.22470772797603,-109.3901429
65451,17,18,10,26,22,3,96,38.22470772797603,-109.3898734
65452,10,23,11,25,21,3,93,38.22470772797603,-109.3896039
65453,10,25,12,25,17,2,91,38.22470772797603,-109.3893344
65454,11,31,12,20,17,1,92,38.22470772797603,-109.3890649
65455,12,33,12,18,16,1,92,38.22470772797603,-109.3887954
65456,13,35,13,16,15,1,93,38.22470772797603,-109.3885259
65457,13,36,13,15,15,1,93,38.22470772797603,-109.3882564
65458,14,37,12,17,14,0,94,38.22470772797603,-109.3879869
65459,14,39,13,18,13,0,97,38.22470772797603,-109.3877174
65460,12,41,13,17,12,1,96,38.22470772797603,-109.3874479
65461,9,42,13,16,13,1,94,38.22470772797603,-109.3871784
65462,8,42,13,14,13,1,91,38.22470772797603,-109.3869089
65463,7,46,13,13,12,1,92,38.22470772797603,-109.3866394
65464,9,46,12,13,11,1,92,38.22470772797603,-109.3863699
65465,12,43,11,14,10,1,91,38.22470772797603,-109.3861004
65466,14,41,12,16,10,1,94,38.22470772797603,-109.3858309
65467,16,35,12,17,13,1,94,38.22470772797603,-109.3855614
65468,19,25,10,21,16,1,92,38.22470772797603,-109.3852919
65469,17,23,9,21,18,1,89,38.22470772797603,-109.3850225
65470,15,23,10,20,18,2,88,38.22470772797603,-109.384753
65471,12,27,11,22,16,2,90,38.22470772797603,-109.3844835
65472,9,30,12,23,16,1,91,38.22470772797603,-109.384214
65473,9,30,12,24,15,1,91,38.22470772797603,-109.3839445
65474,11,28,12,24,15,1,91,38.22470772797603,-109.383675
65475,12,29,12,22,15,1,91,38.22470772797603,-109.3834055
65476,14,29,12,20,15,1,91,38.22470772797603,-109.383136
65477,17,26,11,23,14,1,92,38.22470772797603,-109.3828665
65478,17,26,11,27,12,1,94,38.22470772797603,-109.382597
65479,16,24,11,28,12,1,92,38.22470772797603,-109.3823275
65480,16,25,11,26,13,1,92,38.22470772797603,-109.382058
65481,15,26,11,24,14,1,91,38.22470772797603,-109.3817885
65482,14,27,11,26,13,1,92,38.22470772797603,-109.381519
65483,14,24,11,26,14,1,90,38.22470772797603,-109.3812495
65484,16,22,11,29,13,1,92,38.22470772797603,-109.38098
65485,17,22,10,29,12,1,91,38.22470772797603,-109.3807105
65486,18,25,11,26,12,1,93,38.22470772797603,-109.380441
65487,17,29,11,24,12,1,94,38.22470772797603,-109.3801716
65488,18,27,11,24,12,1,93,38.22470772797603,-109.3799021
65489,17,25,11,25,12,1,91,38.22470772797603,-109.3796326
65490,17,27,11,25,12,1,93,38.22470772797603,-109.3793631
65491,20,29,12,24,12,0,97,38.22470772797603,-109.3790936
65492,20,32,12,20,11,0,95,38.22470772797603,-109.3788241
65493,21,33,11,19,11,0,95,38.22470772797603,-109.3785546
65494,23,33,10,19,10,0,95,38.22470772797603,-109.3782851
65495,25,33,10,19,9,0,96,38.22470772797603,-109.3780156
65496,22,32,11,21,9,0,95,38.22470772797603,-109.3777461
65497,20,36,11,17,9,0,93,38.22470772797603,-109.3774766
65498,20,35,11,16,9,0,91,38.22470772797603,-109.3772071
65499,20,31,12,19,11,0,93,38.22470772797603,-109.3769376
65500,20,26,11,20,14,1,92,38.22470772797603,-109.3766681
65501,18,23,10,24,14,1,90,38.22470772797603,-109.3763986
65502,13,20,9,27,18,2,89,38.22470772797603,-109.3761291
65503,3,18,7,24,18,5,75,38.22470772797603,-109.3758596
65504,1,20,7,17,19,4,68,38.22470772797603,-109.3755901
65505,2,23,9,24,18,1,77,38.22470772797603,-109.3753206
65506,10,21,10,22,17,3,83,38.22470772797603,-109.3750512
65507,14,20,9,26,17,1,87,38.22470772797603,-109.3747817
65508,15,20,8,28,16,1,88,38.22470772797603,-109.3745122
65509,15,22,8,27,17,1,90,38.22470772797603,-109.3742427
65510,14,23,9,25,16,2,89,38.22470772797603,-109.3739732
65511,21,20,11,21,14,2,89,38.22470772797603,-109.3737037
65512,6,27,14,12,14,7,80,38.22443823,-109.4114329
65513,12,31,13,13,17,2,88,38.22443823,-109.4111634
65514,14,32,13,17,16,1,93,38.22443823,-109.4108939
65515,17,23,11,25,14,2,92,38.22443823,-109.4106244
65516,8,18,12,25,24,3,90,38.22443823,-109.4103549
65517,5,18,11,27,25,4,90,38.22443823,-109.4100855
65518,7,21,11,23,25,3,90,38.22443823,-109.409816
65519,9,25,11,20,21,3,89,38.22443823,-109.4095465
65520,16,24,10,20,18,2,90,38.22443823,-109.409277
65521,12,25,10,22,19,2,90,38.22443823,-109.4090075
65522,11,24,11,21,22,3,92,38.22443823,-109.408738
65523,7,23,11,18,27,3,89,38.22443823,-109.4084685
65524,6,19,11,14,29,7,86,38.22443823,-109.408199
65525,5,15,11,19,35,7,92,38.22443823,-109.4079295
65526,14,10,9,27,29,7,96,38.22443823,-109.40766
65527,11,10,9,28,32,7,97,38.22443823,-109.4073905
65528,5,15,11,21,32,7,91,38.22443823,-109.407121
65529,3,19,11,24,28,4,89,38.22443823,-109.4068515
65530,5,18,11,23,27,6,90,38.22443823,-109.406582
65531,5,17,12,21,29,7,91,38.22443823,-109.4063125
65532,9,17,12,19,29,6,92,38.22443823,-109.406043
65533,11,21,12,18,24,4,90,38.22443823,-109.4057735
65534,5,23,11,19,14,5,77,38.22443823,-109.405504
65535,1,30,9,14,11,4,69,38.22443823,-109.4052345
65536,1,38,8,8,9,3,67,38.22443823,-109.4049651
65537,2,43,7,7,9,3,71,38.22443823,-109.4046956
65538,3,45,7,8,10,1,74,38.22443823,-109.4044261
65539,2,44,7,6,10,2,71,38.22443823,-109.4041566
65540,4,45,6,6,7,2,70,38.22443823,-109.4038871
65541,3,44,6,5,7,2,67,38.22443823,-109.4036176
65542,2,43,6,4,8,2,65,38.22443823,-109.4033481
65543,3,42,6,4,8,2,65,38.22443823,-109.4030786
65544,3,42,7,5,9,2,68,38.22443823,-109.4028091
65545,5,43,7,5,10,2,72,38.22443823,-109.4025396
65546,5,44,7,5,10,2,73,38.22443823,-109.4022701
65547,4,43,7,5,9,2,70,38.22443823,-109.4020006
65548,2,42,6,5,7,3,65,38.22443823,-109.4017311
65549,2,41,6,5,8,3,65,38.22443823,-109.4014616
65550,5,42,8,6,11,2,74,38.22443823,-109.4011921
65551,6,50,10,7,12,1,86,38.22443823,-109.4009226
65552,8,52,12,9,11,1,93,38.22443823,-109.4006531
65553,8,53,12,9,12,1,95,38.22443823,-109.4003836
65554,7,52,12,9,12,1,93,38.22443823,-109.4001142
65555,8,50,12,10,12,1,93,38.22443823,-109.3998447
65556,10,47,13,12,11,1,94,38.22443823,-109.3995752
65557,12,45,13,12,10,1,93,38.22443823,-109.3993057
65558,13,44,13,12,11,0,93,38.22443823,-109.3990362
65559,13,42,13,12,11,1,92,38.22443823,-109.3987667
65560,7,47,11,9,11,1,86,38.22443823,-109.3984972
65561,5,48,9,6,11,1,80,38.22443823,-109.3982277
65562,8,44,10,8,11,1,82,38.22443823,-109.3979582
65563,8,43,9,7,10,1,78,38.22443823,-109.3976887
65564,7,43,8,7,9,2,76,38.22443823,-109.3974192
65565,6,44,8,7,8,2,75,38.22443823,-109.3971497
65566,6,43,7,6,9,2,73,38.22443823,-109.3968802
65567,5,47,8,6,11,1,78,38.22443823,-109.3966107
65568,4,46,7,5,9,2,73,38.22443823,-109.3963412
65569,4,43,8,6,9,2,72,38.22443823,-109.3960717
65570,5,42,8,7,10,2,74,38.22443823,-109.3958022
65571,6,41,9,7,10,2,75,38.22443823,-109.3955327
65572,5,42,8,6,9,2,72,38.22443823,-109.3952632
65573,4,36,9,6,11,3,69,38.22443823,-109.3949938
65574,4,37,10,8,12,2,73,38.22443823,-109.3947243
65575,6,38,11,11,14,2,82,38.22443823,-109.3944548
65576,7,41,13,13,13,2,89,38.22443823,-109.3941853
65577,12,42,13,12,11,1,91,38.22443823,-109.3939158
65578,18,38,13,13,10,1,93,38.22443823,-109.3936463
65579,22,32,13,15,9,1,92,38.22443823,-109.3933768
65580,20,35,13,14,10,1,93,38.22443823,-109.3931073
65581,9,46,12,12,11,1,91,38.22443823,-109.3928378
65582,7,51,10,9,11,1,89,38.22443823,-109.3925683
65583,6,51,10,8,11,1,87,38.22443823,-109.3922988
65584,8,47,11,9,11,1,87,38.22443823,-109.3920293
65585,14,42,11,12,10,1,90,38.22443823,-109.3917598
65586,32,33,8,9,7,0,89,38.22443823,-109.3914903
65587,37,26,9,11,7,0,90,38.22443823,-109.3912208
65588,28,17,10,19,9,4,87,38.22443823,-109.3909513
65589,15,12,9,20,17,12,85,38.22443823,-109.3906818
65590,17,12,10,20,21,11,91,38.22443823,-109.3904123
65591,22,12,10,25,21,2,92,38.22443823,-109.3901429
65592,24,13,10,25,19,2,93,38.22443823,-109.3898734
65593,24,15,10,24,17,2,92,38.22443823,-109.3896039
65594,22,19,10,23,16,2,92,38.22443823,-109.3893344
65595,22,19,10,27,13,2,93,38.22443823,-109.3890649
65596,18,26,11,23,14,1,93,38.22443823,-109.3887954
65597,16,32,12,19,14,1,94,38.22443823,-109.3885259
65598,16,35,12,17,13,1,94,38.22443823,-109.3882564
65599,18,37,12,15,12,1,95,38.22443823,-109.3879869
65600,13,42,12,13,11,1,92,38.22443823,-109.3877174
65601,11,41,13,15,13,1,94,38.22443823,-109.3874479
65602,10,40,13,15,14,1,93,38.22443823,-109.3871784
65603,9,41,13,15,14,1,93,38.22443823,-109.3869089
65604,10,44,12,14,11,1,92,38.22443823,-109.3866394
65605,14,40,11,13,9,1,88,38.22443823,-109.3863699
65606,20,36,11,15,9,1,92,38.22443823,-109.3861004
65607,28,28,10,17,9,0,92,38.22443823,-109.3858309
65608,28,22,9,20,13,1,93,38.22443823,-109.3855614
65609,30,18,9,16,19,1,93,38.22443823,-109.3852919
65610,23,20,10,19,16,1,89,38.22443823,-109.3850225
65611,19,20,10,22,13,2,86,38.22443823,-109.384753
65612,17,22,11,22,13,2,87,38.22443823,-109.3844835
65613,14,25,11,24,14,2,90,38.22443823,-109.384214
65614,12,25,11,24,14,2,88,38.22443823,-109.3839445
65615,13,25,11,23,14,2,88,38.22443823,-109.383675
65616,16,25,11,22,15,2,91,38.22443823,-109.3834055
65617,16,26,11,20,15,2,90,38.22443823,-109.383136
65618,13,30,11,20,16,1,91,38.22443823,-109.3828665
65619,10,30,11,21,16,2,90,38.22443823,-109.382597
65620,10,30,11,21,16,2,90,38.22443823,-109.3823275
65621,12,29,11,22,15,2,91,38.22443823,-109.382058
65622,12,29,10,23,14,2,90,38.22443823,-109.3817885
65623,11,30,11,22,15,1,90,38.22443823,-109.381519
65624,12,27,11,23,15,1,89,38.22443823,-109.3812495
65625,14,27,11,23,15,1,91,38.22443823,-109.38098
65626,14,29,12,22,14,1,92,38.22443823,-109.3807105
65627,13,33,12,20,14,1,93,38.22443823,-109.380441
65628,12,34,12,21,14,1,94,38.22443823,-109.3801716
65629,12,33,12,22,13,1,93,38.22443823,-109.3799021
65630,14,30,12,23,13,1,93,38.22443823,-109.3796326
65631,17,30,12,22,13,1,95,38.22443823,-109.3793631
65632,19,34,11,19,11,0,94,38.22443823,-109.3790936
65633,20,34,12,18,11,0,95,38.22443823,-109.3788241
65634,18,33,11,20,12,0,94,38.22443823,-109.3785546
65635,19,33,11,19,12,0,94,38.22443823,-109.3782851
65636,20,32,11,19,11,0,93,38.22443823,-109.3780156
65637,19,33,11,18,10,0,91,38.22443823,-109.3777461
65638,19,32,11,18,10,0,90,38.22443823,-109.3774766
65639,19,27,11,20,10,0,87,38.22443823,-109.3772071
65640,21,23,11,20,12,1,88,38.22443823,-109.3769376
65641,26,22,10,15,12,1,86,38.22443823,-109.3766681
65642,26,23,11,20,11,1,92,38.22443823,-109.3763986
65643,21,21,10,20,17,1,90,38.22443823,-109.3761291
65644,11,19,9,26,15,4,84,38.22443823,-109.3758596
65645,3,23,7,21,17,3,74,38.22443823,-109.3755901
65646,2,24,8,24,16,3,77,38.22443823,-109.3753206
65647,11,25,10,22,14,3,85,38.22443823,-109.3750512
65648,15,21,10,20,17,2,85,38.22443823,-109.3747817
65649,15,21,9,22,18,2,87,38.22443823,-109.3745122
65650,13,24,9,23,18,2,89,38.22443823,-109.3742427
65651,14,24,10,20,19,2,89,38.22443823,-109.3739732
65652,21,21,10,17,16,3,88,38.22443823,-109.3737037
65653,4,27,12,9,10,8,70,38.22416873880556,-109.4114329
65654,7,30,12,13,13,4,79,38.22416873880556,-109.4111634
65655,11,32,13,16,17,2,91,38.22416873880556,-109.4108939
65656,10,24,12,23,20,3,92,38.22416873880556,-109.4106244
65657,7,21,12,20,28,4,92,38.22416873880556,-109.4103549
65658,9,19,11,23,25,4,91,38.22416873880556,-109.4100855
65659,14,21,10,23,21,2,91,38.22416873880556,-109.409816
65660,17,24,9,21,18,1,90,38.22416873880556,-109.4095465
65661,15,26,11,18,18,1,89,38.22416873880556,-109.409277
65662,13,25,11,21,19,2,91,38.22416873880556,-109.4090075
65663,9,24,11,20,23,2,89,38.22416873880556,-109.408738
65664,5,23,12,18,27,3,88,38.22416873880556,-109.4084685
65665,5,19,12,17,33,4,90,38.22416873880556,-109.408199
65666,5,15,11,28,32,3,94,38.22416873880556,-109.4079295
65667,10,10,10,32,31,5,98,38.22416873880556,-109.40766
65668,6,9,9,31,34,7,96,38.22416873880556,-109.4073905
65669,3,11,9,29,33,8,93,38.22416873880556,-109.407121
65670,2,15,9,26,27,8,87,38.22416873880556,-109.4068515
65671,5,16,11,26,24,7,89,38.22416873880556,-109.406582
65672,9,19,12,19,25,5,89,38.22416873880556,-109.4063125
65673,9,23,12,18,19,5,86,38.22416873880556,-109.406043
65674,5,24,11,16,14,5,75,38.22416873880556,-109.4057735
65675,2,37,10,9,12,4,74,38.22416873880556,-109.405504
65676,1,38,8,7,10,5,69,38.22416873880556,-109.4052345
65677,2,42,8,8,8,3,71,38.22416873880556,-109.4049651
65678,4,44,8,8,7,2,73,38.22416873880556,-109.4046956
65679,3,42,7,8,8,2,70,38.22416873880556,-109.4044261
65680,2,45,6,6,7,2,68,38.22416873880556,-109.4041566
65681,2,40,6,5,9,3,65,38.22416873880556,-109.4038871
65682,3,37,8,5,11,2,66,38.22416873880556,-109.4036176
65683,4,37,8,5,12,2,68,38.22416873880556,-109.4033481
65684,4,34,7,5,10,3,63,38.22416873880556,-109.4030786
65685,2,37,6,5,8,4,62,38.22416873880556,-109.4028091
65686,2,41,6,5,8,3,65,38.22416873880556,-109.4025396
65687,3,43,6,5,8,2,67,38.22416873880556,-109.4022701
65688,2,44,6,5,8,2,67,38.22416873880556,-109.4020006
65689,2,41,6,4,6,4,63,38.22416873880556,-109.4017311
65690,3,43,6,5,5,4,66,38.22416873880556,-109.4014616
65691,4,43,7,6,9,2,71,38.22416873880556,-109.4011921
65692,6,47,9,7,12,1,82,38.22416873880556,-109.4009226
65693,7,52,11,9,12,1,92,38.22416873880556,-109.4006531
65694,10,48,12,11,11,1,93,38.22416873880556,-109.4003836
65695,9,46,11,9,10,1,86,38.22416873880556,-109.4001142
65696,9,45,10,9,9,0,82,38.22416873880556,-109.3998447
65697,10,45,11,10,8,0,84,38.22416873880556,-109.3995752
65698,10,47,13,14,10,1,95,38.22416873880556,-109.3993057
65699,10,48,13,12,11,1,95,38.22416873880556,-109.3990362
65700,9,48,12,9,11,1,90,38.22416873880556,-109.3987667
65701,6,47,10,6,11,1,81,38.22416873880556,-109.3984972
65702,5,46,8,5,9,2,75,38.22416873880556,-109.3982277
65703,4,46,7,6,7,2,72,38.22416873880556,-109.3979582
65704,3,45,6,6,7,2,69,38.22416873880556,-109.3976887
65705,3,46,6,6,7,2,70,38.22416873880556,-109.3974192
65706,3,47,6,7,7,2,72,38.22416873880556,-109.3971497
65707,3,47,6,6,7,2,71,38.22416873880556,-109.3968802
65708,3,45,6,5,8,2,69,38.22416873880556,-109.3966107
65709,3,44,6,5,7,2,67,38.22416873880556,-109.3963412
65710,4,42,7,6,8,2,69,38.22416873880556,-109.3960717
65711,5,41,7,6,9,2,70,38.22416873880556,-109.3958022
65712,5,46,9,6,11,2,79,38.22416873880556,-109.3955327
65713,5,47,9,6,11,2,80,38.22416873880556,-109.3952632
65714,4,43,10,6,12,2,77,38.22416873880556,-109.3949938
65715,4,42,10,8,13,2,79,38.22416873880556,-109.3947243
65716,5,43,11,11,12,1,83,38.22416873880556,-109.3944548
65717,6,43,12,11,11,2,85,38.22416873880556,-109.3941853
65718,15,41,14,12,10,1,93,38.22416873880556,-109.3939158
65719,20,37,13,14,8,1,93,38.22416873880556,-109.3936463
65720,22,34,13,16,7,0,92,38.22416873880556,-109.3933768
65721,21,35,12,15,8,0,91,38.22416873880556,-109.3931073
65722,12,45,11,12,11,1,92,38.22416873880556,-109.3928378
65723,13,48,10,11,10,0,92,38.22416873880556,-109.3925683
65724,14,47,9,11,9,0,90,38.22416873880556,-109.3922988
65725,17,43,9,12,9,0,90,38.22416873880556,-109.3920293
65726,26,33,8,12,9,0,88,38.22416873880556,-109.3917598
65727,31,25,9,13,9,0,87,38.22416873880556,-109.3914903
65728,24,14,10,22,13,4,87,38.22416873880556,-109.3912208
65729,10,10,9,24,19,14,86,38.22416873880556,-109.3909513
65730,8,9,8,20,20,14,79,38.22416873880556,-109.3906818
65731,13,9,9,18,20,13,82,38.22416873880556,-109.3904123
65732,20,11,11,21,23,7,93,38.22416873880556,-109.3901429
65733,25,12,11,21,18,2,89,38.22416873880556,-109.3898734
65734,28,15,11,20,16,2,92,38.22416873880556,-109.3896039
65735,30,16,10,19,14,2,91,38.22416873880556,-109.3893344
65736,25,16,11,20,18,2,92,38.22416873880556,-109.3890649
65737,26,18,10,20,15,2,91,38.22416873880556,-109.3887954
65738,27,20,10,18,14,2,91,38.22416873880556,-109.3885259
65739,28,22,11,16,12,1,90,38.22416873880556,-109.3882564
65740,29,23,11,17,10,1,91,38.22416873880556,-109.3879869
65741,25,26,11,19,10,1,92,38.22416873880556,-109.3877174
65742,23,26,12,19,13,1,94,38.22416873880556,-109.3874479
65743,21,27,12,17,14,1,92,38.22416873880556,-109.3871784
65744,21,27,12,16,14,1,91,38.22416873880556,-109.3869089
65745,26,25,10,18,11,1,91,38.22416873880556,-109.3866394
65746,30,23,10,19,9,1,92,38.22416873880556,-109.3863699
65747,32,19,10,18,10,1,90,38.22416873880556,-109.3861004
65748,37,18,9,18,10,2,94,38.22416873880556,-109.3858309
65749,38,19,9,18,8,1,93,38.22416873880556,-109.3855614
65750,31,26,9,18,9,1,94,38.22416873880556,-109.3852919
65751,29,25,10,16,11,1,92,38.22416873880556,-109.3850225
65752,25,23,11,16,11,2,88,38.22416873880556,-109.384753
65753,22,21,11,19,11,3,87,38.22416873880556,-109.3844835
65754,24,18,11,20,11,3,87,38.22416873880556,-109.384214
65755,26,14,11,21,12,2,86,38.22416873880556,-109.3839445
65756,22,15,11,20,14,2,84,38.22416873880556,-109.383675
65757,23,16,11,17,15,3,85,38.22416873880556,-109.3834055
65758,21,21,10,15,14,2,83,38.22416873880556,-109.383136
65759,17,27,11,17,12,2,86,38.22416873880556,-109.3828665
65760,13,31,11,20,14,2,91,38.22416873880556,-109.382597
65761,11,31,11,21,15,1,90,38.22416873880556,-109.3823275
65762,11,29,10,21,16,2,89,38.22416873880556,-109.382058
65763,13,27,10,22,15,2,89,38.22416873880556,-109.3817885
65764,12,29,11,21,15,1,89,38.22416873880556,-109.381519
65765,12,29,11,23,15,1,91,38.22416873880556,-109.3812495
65766,10,31,12,22,14,1,90,38.22416873880556,-109.38098
65767,9,34,12,21,14,1,91,38.22416873880556,-109.3807105
65768,8,36,12,20,15,1,92,38.22416873880556,-109.380441
65769,8,36,12,21,14,1,92,38.22416873880556,-109.3801716
65770,9,35,12,21,14,1,92,38.22416873880556,-109.3799021
65771,10,35,12,20,15,1,93,38.22416873880556,-109.3796326
65772,11,36,12,19,14,1,93,38.22416873880556,-109.3793631
65773,10,39,11,18,13,1,92,38.22416873880556,-109.3790936
65774,14,34,12,19,14,1,94,38.22416873880556,-109.3788241
65775,18,30,11,20,14,1,94,38.22416873880556,-109.3785546
65776,21,28,11,20,13,1,94,38.22416873880556,-109.3782851
65777,22,29,11,20,10,1,93,38.22416873880556,-109.3780156
65778,25,29,10,19,9,0,92,38.22416873880556,-109.3777461
65779,24,25,11,20,9,0,89,38.22416873880556,-109.3774766
65780,21,23,10,16,9,0,79,38.22416873880556,-109.3772071
65781,19,22,9,12,9,0,71,38.22416873880556,-109.3769376
65782,21,21,9,10,8,0,69,38.22416873880556,-109.3766681
65783,25,24,11,16,10,1,87,38.22416873880556,-109.3763986
65784,22,24,11,16,13,1,87,38.22416873880556,-109.3761291
65785,14,22,10,24,14,4,88,38.22416873880556,-109.3758596
65786,5,24,7,24,17,5,82,38.22416873880556,-109.3755901
65787,3,25,7,20,17,3,75,38.22416873880556,-109.3753206
65788,9,23,9,24,14,4,83,38.22416873880556,-109.3750512
65789,17,20,10,20,14,4,85,38.22416873880556,-109.3747817
65790,20,20,11,20,15,2,88,38.22416873880556,-109.3745122
65791,20,23,10,19,16,2,90,38.22416873880556,-109.3742427
65792,20,21,10,19,16,2,88,38.22416873880556,-109.3739732
65793,25,23,10,16,16,2,92,38.22416873880556,-109.3737037
65794,4,26,11,8,9,7,65,38.22389924422033,-109.4114329
65795,8,22,12,14,13,5,74,38.22389924422033,-109.4111634
65796,13,23,12,19,17,3,87,38.22389924422033,-109.4108939
65797,10,22,10,22,25,3,92,38.22389924422033,-109.4106244
65798,13,22,11,17,25,3,91,38.22389924422033,-109.4103549
65799,18,21,9,20,19,2,89,38.22389924422033,-109.4100855
65800,17,22,10,23,17,1,90,38.22389924422033,-109.409816
65801,14,24,10,22,18,1,89,38.22389924422033,-109.4095465
65802,15,25,11,20,18,2,91,38.22389924422033,-109.409277
65803,11,25,11,24,19,2,92,38.22389924422033,-109.4090075
65804,8,24,11,19,24,3,89,38.22389924422033,-109.408738
65805,5,23,12,18,28,4,90,38.22389924422033,-109.4084685
65806,4,19,13,17,33,5,91,38.22389924422033,-109.408199
65807,4,14,11,27,33,4,93,38.22389924422033,-109.4079295
65808,9,11,10,31,30,4,95,38.22389924422033,-109.40766
65809,8,12,10,32,29,5,96,38.22389924422033,-109.4073905
65810,4,13,10,32,29,6,94,38.22389924422033,-109.407121
65811,2,11,7,27,27,9,83,38.22389924422033,-109.4068515
65812,3,14,10,26,27,9,89,38.22389924422033,-109.406582
65813,7,23,12,21,21,4,88,38.22389924422033,-109.4063125
65814,3,23,11,14,13,7,71,38.22389924422033,-109.406043
65815,1,36,9,5,10,7,68,38.22389924422033,-109.4057735
65816,2,45,8,7,12,2,76,38.22389924422033,-109.405504
65817,2,42,8,6,11,3,72,38.22389924422033,-109.4052345
65818,3,36,7,5,10,4,65,38.22389924422033,-109.4049651
65819,2,28,7,5,10,5,57,38.22389924422033,-109.4046956
65820,4,26,8,7,12,5,62,38.22389924422033,-109.4044261
65821,5,21,10,13,15,4,68,38.22389924422033,-109.4041566
65822,8,23,10,17,16,2,76,38.22389924422033,-109.4038871
65823,8,27,12,19,16,2,84,38.22389924422033,-109.4036176
65824,9,30,13,19,14,1,86,38.22389924422033,-109.4033481
65825,9,31,12,18,14,1,85,38.22389924422033,-109.4030786
65826,7,33,11,15,12,1,79,38.22389924422033,-109.4028091
65827,5,37,9,10,12,2,75,38.22389924422033,-109.4025396
65828,3,40,7,7,10,2,69,38.22389924422033,-109.4022701
65829,2,41,6,5,8,3,65,38.22389924422033,-109.4020006
65830,2,42,6,4,7,3,64,38.22389924422033,-109.4017311
65831,2,44,5,5,5,3,64,38.22389924422033,-109.4014616
65832,3,47,5,5,6,2,68,38.22389924422033,-109.4011921
65833,6,46,7,5,8,1,73,38.22389924422033,-109.4009226
65834,6,48,9,7,11,1,82,38.22389924422033,-109.4006531
65835,6,54,10,8,12,1,91,38.22389924422033,-109.4003836
65836,6,53,10,10,12,2,93,38.22389924422033,-109.4001142
65837,7,51,11,10,11,1,91,38.22389924422033,-109.3998447
65838,8,49,12,12,11,1,93,38.22389924422033,-109.3995752
65839,9,49,12,11,11,1,93,38.22389924422033,-109.3993057
65840,7,53,11,8,11,1,91,38.22389924422033,-109.3990362
65841,6,53,10,6,11,1,87,38.22389924422033,-109.3987667
65842,5,47,9,5,10,1,77,38.22389924422033,-109.3984972
65843,4,45,7,5,8,2,71,38.22389924422033,-109.3982277
65844,2,46,5,4,6,2,65,38.22389924422033,-109.3979582
65845,2,46,4,4,6,3,65,38.22389924422033,-109.3976887
65846,3,48,4,5,6,2,68,38.22389924422033,-109.3974192
65847,3,49,5,6,6,1,70,38.22389924422033,-109.3971497
65848,3,49,4,5,6,2,69,38.22389924422033,-109.3968802
65849,2,45,5,4,6,3,65,38.22389924422033,-109.3966107
65850,3,45,5,5,6,2,66,38.22389924422033,-109.3963412
65851,3,44,5,5,6,2,65,38.22389924422033,-109.3960717
65852,3,43,6,5,8,2,67,38.22389924422033,-109.3958022
65853,4,43,7,5,9,2,70,38.22389924422033,-109.3955327
65854,4,45,8,7,10,2,76,38.22389924422033,-109.3952632
65855,3,49,9,6,11,2,80,38.22389924422033,-109.3949938
65856,4,49,10,6,11,2,82,38.22389924422033,-109.3947243
65857,5,48,11,8,11,2,85,38.22389924422033,-109.3944548
65858,7,46,12,12,11,1,89,38.22389924422033,-109.3941853
65859,15,40,14,13,11,1,94,38.22389924422033,-109.3939158
65860,21,36,12,15,9,1,94,38.22389924422033,-109.3936463
65861,21,37,11,16,8,0,93,38.22389924422033,-109.3933768
65862,16,39,11,17,10,0,93,38.22389924422033,-109.3931073
65863,13,45,10,12,11,0,91,38.22389924422033,-109.3928378
65864,14,46,9,13,9,0,91,38.22389924422033,-109.3925683
65865,18,41,9,13,10,0,91,38.22389924422033,-109.3922988
65866,20,32,9,14,12,0,87,38.22389924422033,-109.3920293
65867,21,22,11,17,11,1,83,38.22389924422033,-109.3917598
65868,20,11,11,20,17,4,83,38.22389924422033,-109.3914903
65869,12,13,10,21,21,8,85,38.22389924422033,-109.3912208
65870,12,13,10,20,21,9,85,38.22389924422033,-109.3909513
65871,16,12,10,20,20,9,87,38.22389924422033,-109.3906818
65872,21,10,10,18,19,8,86,38.22389924422033,-109.3904123
65873,24,9,11,22,20,7,93,38.22389924422033,-109.3901429
65874,29,10,11,20,19,4,93,38.22389924422033,-109.3898734
65875,30,13,11,20,16,2,92,38.22389924422033,-109.3896039
65876,31,16,11,21,12,1,92,38.22389924422033,-109.3893344
65877,31,16,9,23,13,2,94,38.22389924422033,-109.3890649
65878,30,13,10,21,18,2,94,38.22389924422033,-109.3887954
65879,25,9,9,18,22,10,93,38.22389924422033,-109.3885259
65880,21,7,9,18,24,15,94,38.22389924422033,-109.3882564
65881,27,8,9,17,23,11,95,38.22389924422033,-109.3879869
65882,25,10,10,17,22,8,92,38.22389924422033,-109.3877174
65883,26,12,11,17,20,6,92,38.22389924422033,-109.3874479
65884,27,12,10,18,19,4,90,38.22389924422033,-109.3871784
65885,29,13,10,19,17,2,90,38.22389924422033,-109.3869089
65886,29,15,10,25,12,1,92,38.22389924422033,-109.3866394
65887,29,18,10,20,13,2,92,38.22389924422033,-109.3863699
65888,32,18,10,21,12,1,94,38.22389924422033,-109.3861004
65889,35,20,9,21,9,0,94,38.22389924422033,-109.3858309
65890,37,24,9,19,7,0,96,38.22389924422033,-109.3855614
65891,31,23,10,19,9,0,92,38.22389924422033,-109.3852919
65892,29,20,11,18,10,2,90,38.22389924422033,-109.3850225
65893,28,19,11,18,10,2,88,38.22389924422033,-109.384753
65894,26,20,11,18,10,2,87,38.22389924422033,-109.3844835
65895,27,23,10,18,9,1,88,38.22389924422033,-109.384214
65896,28,20,11,20,8,2,89,38.22389924422033,-109.3839445
65897,26,13,12,20,10,2,83,38.22389924422033,-109.383675
65898,26,9,11,19,9,4,78,38.22389924422033,-109.3834055
65899,24,10,10,17,9,4,74,38.22389924422033,-109.383136
65900,21,16,10,14,11,3,75,38.22389924422033,-109.3828665
65901,15,23,10,13,12,3,76,38.22389924422033,-109.382597
65902,15,26,10,15,11,3,80,38.22389924422033,-109.3823275
65903,18,26,10,17,12,2,85,38.22389924422033,-109.382058
65904,18,26,10,19,12,2,87,38.22389924422033,-109.3817885
65905,16,27,11,20,14,2,90,38.22389924422033,-109.381519
65906,14,28,11,21,14,2,90,38.22389924422033,-109.3812495
65907,13,29,11,21,14,2,90,38.22389924422033,-109.38098
65908,12,30,12,21,15,1,91,38.22389924422033,-109.3807105
65909,10,30,12,22,15,1,90,38.22389924422033,-109.380441
65910,9,33,12,22,15,1,92,38.22389924422033,-109.3801716
65911,9,34,12,21,15,1,92,38.22389924422033,-109.3799021
65912,10,34,12,21,15,1,93,38.22389924422033,-109.3796326
65913,10,34,12,20,15,1,92,38.22389924422033,-109.3793631
65914,9,34,11,21,14,1,90,38.22389924422033,-109.3790936
65915,12,30,11,20,15,1,89,38.22389924422033,-109.3788241
65916,17,25,10,20,17,1,90,38.22389924422033,-109.3785546
65917,19,24,10,21,17,1,92,38.22389924422033,-109.3782851
65918,19,26,10,23,14,1,93,38.22389924422033,-109.3780156
65919,24,25,10,23,10,1,93,38.22389924422033,-109.3777461
65920,25,24,11,19,11,0,90,38.22389924422033,-109.3774766
65921,22,23,10,13,10,0,78,38.22389924422033,-109.3772071
65922,20,22,10,12,10,1,75,38.22389924422033,-109.3769376
65923,20,22,11,17,13,1,84,38.22389924422033,-109.3766681
65924,17,26,11,19,15,2,90,38.22389924422033,-109.3763986
65925,14,24,11,20,17,2,88,38.22389924422033,-109.3761291
65926,11,22,10,21,19,3,86,38.22389924422033,-109.3758596
65927,4,23,8,22,19,4,80,38.22389924422033,-109.3755901
65928,5,24,8,16,19,3,75,38.22389924422033,-109.3753206
65929,7,21,9,27,16,4,84,38.22389924422033,-109.3750512
65930,21,16,10,23,14,4,88,38.22389924422033,-109.3747817
65931,25,17,10,22,12,2,88,38.22389924422033,-109.3745122
65932,25,19,10,23,10,1,88,38.22389924422033,-109.3742427
65933,26,18,10,23,11,2,90,38.22389924422033,-109.3739732
65934,28,21,10,19,12,1,91,38.22389924422033,-109.3737037
65935,4,27,10,10,11,4,66,38.22362974963509,-109.4114329
65936,8,21,12,17,13,4,75,38.22362974963509,-109.4111634
65937,13,17,12,22,23,3,90,38.22362974963509,-109.4108939
65938,13,19,11,20,26,3,92,38.22362974963509,-109.4106244
65939,13,20,11,21,23,3,91,38.22362974963509,-109.4103549
65940,16,22,10,22,19,2,91,38.22362974963509,-109.4100855
65941,15,22,10,23,19,1,90,38.22362974963509,-109.409816
65942,13,22,10,23,20,2,90,38.22362974963509,-109.4095465
65943,14,21,11,22,21,3,92,38.22362974963509,-109.409277
65944,10,22,11,24,20,3,90,38.22362974963509,-109.4090075
65945,8,23,11,22,23,3,90,38.22362974963509,-109.408738
65946,6,22,11,20,27,4,90,38.22362974963509,-109.4084685
65947,5,17,12,24,29,4,91,38.22362974963509,-109.408199
65948,4,14,11,28,32,3,92,38.22362974963509,-109.4079295
65949,17,17,10,22,25,2,93,38.22362974963509,-109.40766
65950,23,20,10,17,21,3,94,38.22362974963509,-109.4073905
65951,17,21,10,18,23,3,92,38.22362974963509,-109.407121
65952,3,17,10,25,28,7,90,38.22362974963509,-109.4068515
65953,4,12,10,28,27,8,89,38.22362974963509,-109.406582
65954,5,20,13,20,25,6,89,38.22362974963509,-109.4063125
65955,4,20,11,19,13,5,72,38.22362974963509,-109.406043
65956,1,33,8,8,8,6,64,38.22362974963509,-109.4057735
65957,2,44,7,6,8,2,69,38.22362974963509,-109.405504
65958,2,36,8,6,11,3,66,38.22362974963509,-109.4052345
65959,2,30,9,9,14,3,67,38.22362974963509,-109.4049651
65960,4,25,11,13,16,3,72,38.22362974963509,-109.4046956
65961,8,24,12,19,15,2,80,38.22362974963509,-109.4044261
65962,13,24,12,21,14,3,87,38.22362974963509,-109.4041566
65963,11,26,12,23,15,3,90,38.22362974963509,-109.4038871
65964,11,27,12,24,14,3,91,38.22362974963509,-109.4036176
65965,12,25,12,28,13,2,92,38.22362974963509,-109.4033481
65966,13,22,11,32,12,1,91,38.22362974963509,-109.4030786
65967,14,22,12,30,12,1,91,38.22362974963509,-109.4028091
65968,11,25,12,24,12,1,85,38.22362974963509,-109.4025396
65969,7,25,11,17,13,3,76,38.22362974963509,-109.4022701
65970,4,26,9,11,13,5,68,38.22362974963509,-109.4020006
65971,4,30,9,8,11,4,66,38.22362974963509,-109.4017311
65972,3,36,8,7,10,3,67,38.22362974963509,-109.4014616
65973,3,43,7,7,8,2,70,38.22362974963509,-109.4011921
65974,3,45,6,6,8,2,70,38.22362974963509,-109.4009226
65975,4,44,7,5,9,2,71,38.22362974963509,-109.4006531
65976,4,49,8,6,11,1,79,38.22362974963509,-109.4003836
65977,5,49,9,7,11,1,82,38.22362974963509,-109.4001142
65978,5,46,9,7,11,1,79,38.22362974963509,-109.3998447
65979,7,43,9,6,11,1,77,38.22362974963509,-109.3995752
65980,7,43,9,6,11,1,77,38.22362974963509,-109.3993057
65981,6,43,9,5,11,2,76,38.22362974963509,-109.3990362
65982,4,49,8,4,11,2,78,38.22362974963509,-109.3987667
65983,4,47,8,4,10,2,75,38.22362974963509,-109.3984972
65984,3,43,7,4,8,2,67,38.22362974963509,-109.3982277
65985,3,36,6,5,8,4,62,38.22362974963509,-109.3979582
65986,2,35,7,5,7,5,61,38.22362974963509,-109.3976887
65987,2,43,5,5,5,4,64,38.22362974963509,-109.3974192
65988,2,49,4,5,5,2,67,38.22362974963509,-109.3971497
65989,3,49,4,5,6,2,69,38.22362974963509,-109.3968802
65990,2,46,4,5,5,3,65,38.22362974963509,-109.3966107
65991,2,48,5,5,6,2,68,38.22362974963509,-109.3963412
65992,2,46,5,5,6,2,66,38.22362974963509,-109.3960717
65993,2,42,5,5,6,3,63,38.22362974963509,-109.3958022
65994,3,43,6,5,7,2,66,38.22362974963509,-109.3955327
65995,3,42,7,5,9,2,68,38.22362974963509,-109.3952632
65996,3,41,8,5,11,2,70,38.22362974963509,-109.3949938
65997,3,41,9,5,11,2,71,38.22362974963509,-109.3947243
65998,4,42,10,7,12,2,77,38.22362974963509,-109.3944548
65999,5,46,11,11,11,1,85,38.22362974963509,-109.3941853
66000,14,40,13,16,12,1,96,38.22362974963509,-109.3939158
66001,22,33,11,19,9,0,94,38.22362974963509,-109.3936463
66002,23,32,10,20,9,0,94,38.22362974963509,-109.3933768
66003,15,36,10,19,12,0,92,38.22362974963509,-109.3931073
66004,14,39,10,12,13,0,88,38.22362974963509,-109.3928378
66005,15,37,10,12,14,1,89,38.22362974963509,-109.3925683
66006,15,30,11,15,14,2,87,38.22362974963509,-109.3922988
66007,17,20,11,20,15,2,85,38.22362974963509,-109.3920293
66008,15,14,10,19,20,6,84,38.22362974963509,-109.3917598
66009,15,14,11,19,21,5,85,38.22362974963509,-109.3914903
66010,15,16,12,20,20,3,86,38.22362974963509,-109.3912208
66011,15,17,12,21,19,3,87,38.22362974963509,-109.3909513
66012,18,16,12,21,17,2,86,38.22362974963509,-109.3906818
66013,22,13,12,20,18,2,87,38.22362974963509,-109.3904123
66014,26,11,12,20,18,3,90,38.22362974963509,-109.3901429
66015,28,10,11,21,18,3,91,38.22362974963509,-109.3898734
66016,30,11,11,21,17,2,92,38.22362974963509,-109.3896039
66017,31,13,10,21,15,2,92,38.22362974963509,-109.3893344
66018,32,15,9,21,14,1,92,38.22362974963509,-109.3890649
66019,32,13,9,19,18,2,93,38.22362974963509,-109.3887954
66020,30,14,10,17,22,3,96,38.22362974963509,-109.3885259
66021,32,12,9,15,22,3,93,38.22362974963509,-109.3882564
66022,37,11,9,17,16,2,92,38.22362974963509,-109.3879869
66023,30,10,11,18,18,3,90,38.22362974963509,-109.3877174
66024,27,9,11,19,19,6,91,38.22362974963509,-109.3874479
66025,23,9,11,20,21,7,91,38.22362974963509,-109.3871784
66026,24,11,11,19,22,5,92,38.22362974963509,-109.3869089
66027,28,13,11,19,18,2,91,38.22362974963509,-109.3866394
66028,27,16,10,22,13,2,90,38.22362974963509,-109.3863699
66029,28,15,10,24,13,1,91,38.22362974963509,-109.3861004
66030,30,16,10,23,11,1,91,38.22362974963509,-109.3858309
66031,33,18,10,20,9,1,91,38.22362974963509,-109.3855614
66032,30,19,11,18,10,2,90,38.22362974963509,-109.3852919
66033,27,19,12,19,11,2,90,38.22362974963509,-109.3850225
66034,28,21,11,17,11,2,90,38.22362974963509,-109.384753
66035,29,22,11,16,11,2,91,38.22362974963509,-109.3844835
66036,28,20,11,18,10,2,89,38.22362974963509,-109.384214
66037,27,13,12,21,10,2,85,38.22362974963509,-109.3839445
66038,25,13,12,19,11,3,83,38.22362974963509,-109.383675
66039,23,16,11,17,11,3,81,38.22362974963509,-109.3834055
66040,23,21,11,16,10,3,84,38.22362974963509,-109.383136
66041,19,25,11,16,13,3,87,38.22362974963509,-109.3828665
66042,11,25,11,17,13,5,82,38.22362974963509,-109.382597
66043,7,27,11,18,13,5,81,38.22362974963509,-109.3823275
66044,7,28,11,18,13,4,81,38.22362974963509,-109.382058
66045,8,29,11,17,14,4,83,38.22362974963509,-109.3817885
66046,12,30,11,16,15,2,86,38.22362974963509,-109.381519
66047,10,31,11,18,15,2,87,38.22362974963509,-109.3812495
66048,12,31,11,18,14,2,88,38.22362974963509,-109.38098
66049,13,31,12,18,14,1,89,38.22362974963509,-109.3807105
66050,16,28,11,16,12,1,84,38.22362974963509,-109.380441
66051,17,26,11,18,12,1,85,38.22362974963509,-109.3801716
66052,14,27,11,21,14,2,89,38.22362974963509,-109.3799021
66053,11,28,11,22,15,2,89,38.22362974963509,-109.3796326
66054,12,28,11,23,15,1,90,38.22362974963509,-109.3793631
66055,14,26,10,22,14,2,88,38.22362974963509,-109.3790936
66056,16,22,10,24,15,1,88,38.22362974963509,-109.3788241
66057,16,22,9,25,17,1,90,38.22362974963509,-109.3785546
66058,16,22,9,25,18,1,91,38.22362974963509,-109.3782851
66059,14,22,9,27,17,1,90,38.22362974963509,-109.3780156
66060,17,23,9,25,15,1,90,38.22362974963509,-109.3777461
66061,19,25,10,18,14,1,87,38.22362974963509,-109.3774766
66062,20,25,11,15,12,1,84,38.22362974963509,-109.3772071
66063,20,24,11,17,14,2,88,38.22362974963509,-109.3769376
66064,13,22,11,23,16,2,87,38.22362974963509,-109.3766681
66065,12,26,10,21,16,2,87,38.22362974963509,-109.3763986
66066,12,23,10,20,18,2,85,38.22362974963509,-109.3761291
66067,9,21,10,21,19,4,84,38.22362974963509,-109.3758596
66068,3,22,9,23,18,3,78,38.22362974963509,-109.3755901
66069,2,25,8,20,17,1,73,38.22362974963509,-109.3753206
66070,5,23,10,25,16,1,80,38.22362974963509,-109.3750512
66071,14,18,10,27,15,2,86,38.22362974963509,-109.3747817
66072,20,18,10,25,15,2,90,38.22362974963509,-109.3745122
66073,23,19,10,25,12,1,90,38.22362974963509,-109.3742427
66074,26,20,10,24,9,1,90,38.22362974963509,-109.3739732
66075,29,20,10,22,9,1,91,38.22362974963509,-109.3737037
66076,2,25,10,10,12,4,63,38.223360255049855,-109.4114329
66077,7,24,10,19,14,2,76,38.223360255049855,-109.4111634
66078,17,17,12,25,19,1,91,38.223360255049855,-109.4108939
66079,14,18,10,22,22,2,88,38.223360255049855,-109.4106244
66080,10,21,11,22,24,3,91,38.223360255049855,-109.4103549
66081,10,23,11,21,22,3,90,38.223360255049855,-109.4100855
66082,9,23,11,21,22,3,89,38.223360255049855,-109.409816
66083,10,21,11,21,24,3,90,38.223360255049855,-109.4095465
66084,10,18,11,23,24,4,90,38.223360255049855,-109.409277
66085,11,18,11,23,23,5,91,38.223360255049855,-109.4090075
66086,8,18,11,25,23,4,89,38.223360255049855,-109.408738
66087,7,17,11,27,24,4,90,38.223360255049855,-109.4084685
66088,8,14,11,28,25,5,91,38.223360255049855,-109.408199
66089,15,14,10,27,23,3,92,38.223360255049855,-109.4079295
66090,20,19,10,19,21,3,92,38.223360255049855,-109.40766
66091,18,22,11,17,21,4,93,38.223360255049855,-109.4073905
66092,15,21,10,20,23,4,93,38.223360255049855,-109.407121
66093,9,18,11,27,24,3,92,38.223360255049855,-109.4068515
66094,9,17,12,22,27,6,93,38.223360255049855,-109.406582
66095,8,19,12,21,26,4,90,38.223360255049855,-109.4063125
66096,4,21,10,23,15,3,76,38.223360255049855,-109.406043
66097,3,38,10,12,10,2,75,38.223360255049855,-109.4057735
66098,3,39,8,8,9,2,69,38.223360255049855,-109.405504
66099,4,33,10,11,14,2,74,38.223360255049855,-109.4052345
66100,7,35,13,16,15,2,88,38.223360255049855,-109.4049651
66101,9,35,13,18,14,2,91,38.223360255049855,-109.4046956
66102,9,31,13,18,14,4,89,38.223360255049855,-109.4044261
66103,9,29,13,19,15,4,89,38.223360255049855,-109.4041566
66104,8,29,13,19,16,3,88,38.223360255049855,-109.4038871
66105,7,29,13,21,16,4,90,38.223360255049855,-109.4036176
66106,7,28,13,23,15,3,89,38.223360255049855,-109.4033481
66107,7,25,13,28,15,3,91,38.223360255049855,-109.4030786
66108,7,23,13,29,18,3,93,38.223360255049855,-109.4028091
66109,13,22,12,30,16,1,94,38.223360255049855,-109.4025396
66110,15,24,12,28,12,1,92,38.223360255049855,-109.4022701
66111,14,29,12,20,13,1,89,38.223360255049855,-109.4020006
66112,5,34,12,16,12,3,82,38.223360255049855,-109.4017311
66113,2,38,9,8,10,4,71,38.223360255049855,-109.4014616
66114,2,39,7,5,8,5,66,38.223360255049855,-109.4011921
66115,2,44,6,5,7,3,67,38.223360255049855,-109.4009226
66116,4,44,6,5,8,2,69,38.223360255049855,-109.4006531
66117,2,43,7,4,9,3,68,38.223360255049855,-109.4003836
66118,4,40,8,5,9,3,69,38.223360255049855,-109.4001142
66119,3,35,8,5,10,3,64,38.223360255049855,-109.3998447
66120,2,33,8,4,11,4,62,38.223360255049855,-109.3995752
66121,3,35,8,4,10,4,64,38.223360255049855,-109.3993057
66122,3,34,8,4,11,3,63,38.223360255049855,-109.3990362
66123,3,39,7,4,9,3,65,38.223360255049855,-109.3987667
66124,3,42,7,4,8,2,66,38.223360255049855,-109.3984972
66125,3,37,7,5,10,3,65,38.223360255049855,-109.3982277
66126,6,29,9,7,12,4,67,38.223360255049855,-109.3979582
66127,8,21,10,11,13,5,68,38.223360255049855,-109.3976887
66128,5,31,9,6,12,4,67,38.223360255049855,-109.3974192
66129,4,43,6,6,7,3,69,38.223360255049855,-109.3971497
66130,5,49,5,6,6,1,72,38.223360255049855,-109.3968802
66131,2,48,5,6,5,2,68,38.223360255049855,-109.3966107
66132,2,48,5,5,6,2,68,38.223360255049855,-109.3963412
66133,2,44,5,5,6,2,64,38.223360255049855,-109.3960717
66134,3,41,6,6,7,3,66,38.223360255049855,-109.3958022
66135,3,44,6,6,7,2,68,38.223360255049855,-109.3955327
66136,2,43,6,5,7,2,65,38.223360255049855,-109.3952632
66137,2,40,7,5,8,3,65,38.223360255049855,-109.3949938
66138,2,37,7,5,9,3,63,38.223360255049855,-109.3947243
66139,3,36,9,6,11,3,68,38.223360255049855,-109.3944548
66140,4,42,11,12,13,1,83,38.223360255049855,-109.3941853
66141,11,38,12,18,14,1,94,38.223360255049855,-109.3939158
66142,20,27,11,23,11,1,93,38.223360255049855,-109.3936463
66143,21,24,9,25,11,1,91,38.223360255049855,-109.3933768
66144,15,28,10,25,13,1,92,38.223360255049855,-109.3931073
66145,13,30,10,19,15,1,88,38.223360255049855,-109.3928378
66146,17,24,11,21,14,1,88,38.223360255049855,-109.3925683
66147,19,20,11,22,15,1,88,38.223360255049855,-109.3922988
66148,18,17,11,19,19,2,86,38.223360255049855,-109.3920293
66149,17,18,11,18,21,2,87,38.223360255049855,-109.3917598
66150,14,20,11,23,18,2,88,38.223360255049855,-109.3914903
66151,12,23,11,21,17,3,87,38.223360255049855,-109.3912208
66152,14,24,12,21,16,3,90,38.223360255049855,-109.3909513
66153,18,21,12,22,15,2,90,38.223360255049855,-109.3906818
66154,25,19,11,22,13,1,91,38.223360255049855,-109.3904123
66155,29,17,10,22,13,1,92,38.223360255049855,-109.3901429
66156,29,17,10,23,12,1,92,38.223360255049855,-109.3898734
66157,30,16,10,23,12,1,92,38.223360255049855,-109.3896039
66158,32,16,10,21,13,1,93,38.223360255049855,-109.3893344
66159,33,15,9,20,14,1,92,38.223360255049855,-109.3890649
66160,33,15,8,18,17,1,92,38.223360255049855,-109.3887954
66161,31,17,8,17,18,1,92,38.223360255049855,-109.3885259
66162,31,18,9,17,15,1,91,38.223360255049855,-109.3882564
66163,32,16,10,18,10,2,88,38.223360255049855,-109.3879869
66164,33,12,10,23,9,2,89,38.223360255049855,-109.3877174
66165,25,12,11,27,11,2,88,38.223360255049855,-109.3874479
66166,20,11,13,27,13,3,87,38.223360255049855,-109.3871784
66167,19,10,13,26,16,4,88,38.223360255049855,-109.3869089
66168,23,9,11,26,15,4,88,38.223360255049855,-109.3866394
66169,25,10,11,25,14,3,88,38.223360255049855,-109.3863699
66170,28,11,11,23,16,3,92,38.223360255049855,-109.3861004
66171,31,14,10,20,16,2,93,38.223360255049855,-109.3858309
66172,32,18,10,19,14,1,94,38.223360255049855,-109.3855614
66173,32,22,10,16,12,1,93,38.223360255049855,-109.3852919
66174,32,25,10,18,10,0,95,38.223360255049855,-109.3850225
66175,30,24,10,20,8,0,92,38.223360255049855,-109.384753
66176,27,19,11,19,9,1,86,38.223360255049855,-109.3844835
66177,23,13,12,22,11,4,85,38.223360255049855,-109.384214
66178,24,9,11,24,10,6,84,38.223360255049855,-109.3839445
66179,24,14,13,20,12,2,85,38.223360255049855,-109.383675
66180,17,26,12,16,13,3,87,38.223360255049855,-109.3834055
66181,7,30,11,13,13,5,79,38.223360255049855,-109.383136
66182,1,28,10,7,11,10,67,38.223360255049855,-109.3828665
66183,2,29,8,8,9,6,62,38.223360255049855,-109.382597
66184,2,30,8,8,7,6,61,38.223360255049855,-109.3823275
66185,2,33,8,8,7,6,64,38.223360255049855,-109.382058
66186,1,33,8,7,9,7,65,38.223360255049855,-109.3817885
66187,2,32,9,8,10,6,67,38.223360255049855,-109.381519
66188,1,32,9,9,12,6,69,38.223360255049855,-109.3812495
66189,2,35,9,10,14,4,74,38.223360255049855,-109.38098
66190,5,34,10,14,16,2,81,38.223360255049855,-109.3807105
66191,12,32,12,17,15,2,90,38.223360255049855,-109.380441
66192,21,26,11,13,10,2,83,38.223360255049855,-109.3801716
66193,20,24,11,14,12,2,83,38.223360255049855,-109.3799021
66194,17,25,11,16,13,2,84,38.223360255049855,-109.3796326
66195,16,25,10,19,14,2,86,38.223360255049855,-109.3793631
66196,18,22,10,21,14,1,86,38.223360255049855,-109.3790936
66197,23,16,11,23,16,0,89,38.223360255049855,-109.3788241
66198,18,20,10,21,19,1,89,38.223360255049855,-109.3785546
66199,18,20,10,21,19,1,89,38.223360255049855,-109.3782851
66200,21,20,10,22,18,1,92,38.223360255049855,-109.3780156
66201,19,21,10,21,17,1,89,38.223360255049855,-109.3777461
66202,19,25,10,14,13,1,82,38.223360255049855,-109.3774766
66203,21,23,10,15,15,2,86,38.223360255049855,-109.3772071
66204,17,21,10,22,16,2,88,38.223360255049855,-109.3769376
66205,15,19,10,27,14,2,87,38.223360255049855,-109.3766681
66206,19,21,9,25,14,1,89,38.223360255049855,-109.3763986
66207,23,15,9,26,15,1,89,38.223360255049855,-109.3761291
66208,17,18,10,24,15,2,86,38.223360255049855,-109.3758596
66209,5,22,10,23,15,3,78,38.223360255049855,-109.3755901
66210,0,23,8,21,15,1,68,38.223360255049855,-109.3753206
66211,1,26,9,21,15,0,72,38.223360255049855,-109.3750512
66212,1,20,10,15,15,5,66,38.223360255049855,-109.3747817
66213,2,21,11,14,13,8,69,38.223360255049855,-109.3745122
66214,5,23,11,16,13,7,75,38.223360255049855,-109.3742427
66215,13,26,11,21,14,2,87,38.223360255049855,-109.3739732
66216,15,27,11,24,14,1,92,38.223360255049855,-109.3737037
66217,3,25,10,10,17,3,68,38.223090760464615,-109.4114329
66218,7,26,10,20,17,2,82,38.223090760464615,-109.4111634
66219,23,22,11,24,15,0,95,38.223090760464615,-109.4108939
66220,17,22,10,23,18,1,91,38.223090760464615,-109.4106244
66221,10,22,10,23,23,3,91,38.223090760464615,-109.4103549
66222,7,19,11,26,24,3,90,38.223090760464615,-109.4100855
66223,8,19,11,26,24,3,91,38.223090760464615,-109.409816
66224,11,20,11,22,24,3,91,38.223090760464615,-109.4095465
66225,11,18,11,21,24,4,89,38.223090760464615,-109.409277
66226,8,17,11,23,25,5,89,38.223090760464615,-109.4090075
66227,7,16,12,25,26,5,91,38.223090760464615,-109.408738
66228,6,17,13,22,27,6,91,38.223090760464615,-109.4084685
66229,8,20,12,20,25,6,91,38.223090760464615,-109.408199
66230,16,24,12,18,18,3,91,38.223090760464615,-109.4079295
66231,14,23,11,15,24,4,91,38.223090760464615,-109.40766
66232,14,20,12,13,28,6,93,38.223090760464615,-109.4073905
66233,19,21,11,13,26,3,93,38.223090760464615,-109.407121
66234,16,28,12,17,18,1,92,38.223090760464615,-109.4068515
66235,13,28,13,15,19,2,90,38.223090760464615,-109.406582
66236,7,27,11,24,16,1,86,38.223090760464615,-109.4063125
66237,3,30,10,16,13,3,75,38.223090760464615,-109.406043
66238,5,40,10,11,11,1,78,38.223090760464615,-109.4057735
66239,6,45,12,11,10,1,85,38.223090760464615,-109.405504
66240,6,37,13,20,13,1,90,38.223090760464615,-109.4052345
66241,10,31,14,21,13,1,90,38.223090760464615,-109.4049651
66242,9,30,13,19,16,3,90,38.223090760464615,-109.4046956
66243,7,31,13,17,17,5,90,38.223090760464615,-109.4044261
66244,7,31,13,17,17,5,90,38.223090760464615,-109.4041566
66245,7,31,14,18,16,4,90,38.223090760464615,-109.4038871
66246,7,30,14,19,17,3,90,38.223090760464615,-109.4036176
66247,7,30,13,22,16,2,90,38.223090760464615,-109.4033481
66248,6,28,13,28,14,2,91,38.223090760464615,-109.4030786
66249,8,25,13,29,14,2,91,38.223090760464615,-109.4028091
66250,10,23,12,29,15,2,91,38.223090760464615,-109.4025396
66251,15,22,11,31,11,1,91,38.223090760464615,-109.4022701
66252,17,27,12,25,10,1,92,38.223090760464615,-109.4020006
66253,13,35,13,15,12,2,90,38.223090760464615,-109.4017311
66254,5,34,11,13,12,3,78,38.223090760464615,-109.4014616
66255,4,32,9,9,11,4,69,38.223090760464615,-109.4011921
66256,3,36,7,5,9,4,64,38.223090760464615,-109.4009226
66257,2,39,7,5,8,4,65,38.223090760464615,-109.4006531
66258,2,37,8,4,9,4,64,38.223090760464615,-109.4003836
66259,4,31,8,5,12,4,64,38.223090760464615,-109.4001142
66260,4,30,9,6,12,3,64,38.223090760464615,-109.3998447
66261,4,29,9,6,13,3,64,38.223090760464615,-109.3995752
66262,5,28,9,6,13,3,64,38.223090760464615,-109.3993057
66263,8,30,9,8,13,2,70,38.223090760464615,-109.3990362
66264,5,32,7,5,10,3,62,38.223090760464615,-109.3987667
66265,4,37,6,5,8,3,63,38.223090760464615,-109.3984972
66266,4,35,7,5,10,3,64,38.223090760464615,-109.3982277
66267,8,30,10,10,14,2,74,38.223090760464615,-109.3979582
66268,17,26,13,15,15,1,87,38.223090760464615,-109.3976887
66269,12,26,12,19,15,1,85,38.223090760464615,-109.3974192
66270,9,25,11,14,13,2,74,38.223090760464615,-109.3971497
66271,7,29,9,7,11,3,66,38.223090760464615,-109.3968802
66272,3,42,6,6,7,3,67,38.223090760464615,-109.3966107
66273,3,45,5,5,6,2,66,38.223090760464615,-109.3963412
66274,3,36,7,5,9,3,63,38.223090760464615,-109.3960717
66275,4,31,8,6,11,4,64,38.223090760464615,-109.3958022
66276,4,35,8,6,11,3,67,38.223090760464615,-109.3955327
66277,4,44,7,6,8,2,71,38.223090760464615,-109.3952632
66278,2,36,7,5,9,3,62,38.223090760464615,-109.3949938
66279,2,29,8,6,12,5,62,38.223090760464615,-109.3947243
66280,2,27,10,11,14,4,68,38.223090760464615,-109.3944548
66281,5,31,11,16,16,2,81,38.223090760464615,-109.3941853
66282,12,33,12,19,15,1,92,38.223090760464615,-109.3939158
66283,14,28,11,23,13,1,90,38.223090760464615,-109.3936463
66284,13,26,11,26,13,1,90,38.223090760464615,-109.3933768
66285,12,27,11,25,14,1,90,38.223090760464615,-109.3931073
66286,15,27,10,23,14,1,90,38.223090760464615,-109.3928378
66287,18,23,11,26,12,1,91,38.223090760464615,-109.3925683
66288,17,21,11,28,13,1,91,38.223090760464615,-109.3922988
66289,16,20,10,28,16,1,91,38.223090760464615,-109.3920293
66290,15,21,10,26,16,1,89,38.223090760464615,-109.3917598
66291,15,25,11,25,14,1,91,38.223090760464615,-109.3914903
66292,12,26,11,22,15,1,87,38.223090760464615,-109.3912208
66293,13,26,12,24,16,1,92,38.223090760464615,-109.3909513
66294,18,22,11,27,15,0,93,38.223090760464615,-109.3906818
66295,25,19,9,27,14,0,94,38.223090760464615,-109.3904123
66296,32,18,9,21,14,0,94,38.223090760464615,-109.3901429
66297,33,20,10,20,13,0,96,38.223090760464615,-109.3898734
66298,37,22,10,17,10,0,96,38.223090760464615,-109.3896039
66299,39,25,9,16,8,0,97,38.223090760464615,-109.3893344
66300,37,26,9,17,7,0,96,38.223090760464615,-109.3890649
66301,36,22,9,19,9,0,95,38.223090760464615,-109.3887954
66302,36,18,9,20,12,1,96,38.223090760464615,-109.3885259
66303,36,16,9,19,12,1,93,38.223090760464615,-109.3882564
66304,37,17,9,20,11,1,95,38.223090760464615,-109.3879869
66305,40,14,10,21,7,2,94,38.223090760464615,-109.3877174
66306,37,14,10,21,7,2,91,38.223090760464615,-109.3874479
66307,35,15,11,19,9,2,91,38.223090760464615,-109.3871784
66308,33,15,11,19,9,2,89,38.223090760464615,-109.3869089
66309,33,14,11,21,8,2,89,38.223090760464615,-109.3866394
66310,33,13,10,23,10,2,91,38.223090760464615,-109.3863699
66311,35,13,10,23,11,2,94,38.223090760464615,-109.3861004
66312,36,14,10,22,11,1,94,38.223090760464615,-109.3858309
66313,38,16,10,19,9,2,94,38.223090760464615,-109.3855614
66314,38,18,10,18,6,2,92,38.223090760464615,-109.3852919
66315,30,19,9,17,5,1,81,38.223090760464615,-109.3850225
66316,27,16,10,18,5,3,79,38.223090760464615,-109.384753
66317,28,11,11,20,9,5,84,38.223090760464615,-109.3844835
66318,21,8,11,21,18,10,89,38.223090760464615,-109.384214
66319,21,11,12,14,21,11,90,38.223090760464615,-109.3839445
66320,14,21,12,21,12,4,84,38.223090760464615,-109.383675
66321,4,27,10,9,13,7,70,38.223090760464615,-109.3834055
66322,2,36,9,5,10,7,69,38.223090760464615,-109.383136
66323,2,37,8,6,9,5,67,38.223090760464615,-109.3828665
66324,3,41,7,8,5,4,68,38.223090760464615,-109.382597
66325,2,47,6,8,5,3,71,38.223090760464615,-109.3823275
66326,2,47,6,8,5,3,71,38.223090760464615,-109.382058
66327,2,45,6,7,5,3,68,38.223090760464615,-109.3817885
66328,2,40,7,6,6,5,66,38.223090760464615,-109.381519
66329,2,39,7,6,6,5,65,38.223090760464615,-109.3812495
66330,2,37,8,7,8,5,67,38.223090760464615,-109.38098
66331,2,35,9,7,12,4,69,38.223090760464615,-109.3807105
66332,3,31,10,13,15,3,75,38.223090760464615,-109.380441
66333,11,26,11,21,15,2,86,38.223090760464615,-109.3801716
66334,16,23,11,20,16,1,87,38.223090760464615,-109.3799021
66335,24,20,11,16,16,1,88,38.223090760464615,-109.3796326
66336,25,19,10,15,14,1,84,38.223090760464615,-109.3793631
66337,23,20,10,14,13,2,82,38.223090760464615,-109.3790936
66338,25,20,10,12,15,2,84,38.223090760464615,-109.3788241
66339,21,24,9,12,13,2,81,38.223090760464615,-109.3785546
66340,22,24,10,13,10,2,81,38.223090760464615,-109.3782851
66341,21,23,10,14,9,2,79,38.223090760464615,-109.3780156
66342,22,21,9,16,12,2,82,38.223090760464615,-109.3777461
66343,24,19,9,16,14,2,84,38.223090760464615,-109.3774766
66344,25,20,10,19,15,2,91,38.223090760464615,-109.3772071
66345,25,18,10,23,14,2,92,38.223090760464615,-109.3769376
66346,24,15,9,26,14,1,89,38.223090760464615,-109.3766681
66347,24,16,9,26,15,2,92,38.223090760464615,-109.3763986
66348,22,17,10,26,14,2,91,38.223090760464615,-109.3761291
66349,12,22,11,21,15,2,83,38.223090760464615,-109.3758596
66350,2,25,9,18,15,3,72,38.223090760464615,-109.3755901
66351,0,27,9,18,12,1,67,38.223090760464615,-109.3753206
66352,1,27,7,20,10,1,66,38.223090760464615,-109.3750512
66353,0,28,8,13,9,3,61,38.223090760464615,-109.3747817
66354,0,31,9,7,10,6,63,38.223090760464615,-109.3745122
66355,0,32,9,6,11,7,65,38.223090760464615,-109.3742427
66356,1,29,9,8,12,6,65,38.223090760464615,-109.3739732
66357,1,28,10,11,12,6,68,38.223090760464615,-109.3737037
66358,5,25,11,13,18,3,75,38.22282126587938,-109.4114329
66359,8,23,11,24,18,2,86,38.22282126587938,-109.4111634
66360,17,19,10,23,21,2,92,38.22282126587938,-109.4108939
66361,14,25,10,21,19,1,90,38.22282126587938,-109.4106244
66362,7,22,11,23,22,3,88,38.22282126587938,-109.4103549
66363,6,19,11,28,23,3,90,38.22282126587938,-109.4100855
66364,10,21,11,25,22,4,93,38.22282126587938,-109.409816
66365,14,24,11,20,20,3,92,38.22282126587938,-109.4095465
66366,20,23,11,18,18,2,92,38.22282126587938,-109.409277
66367,15,17,10,21,25,4,92,38.22282126587938,-109.4090075
66368,7,15,12,26,26,5,91,38.22282126587938,-109.408738
66369,9,18,11,23,24,5,90,38.22282126587938,-109.4084685
66370,13,23,12,17,21,5,91,38.22282126587938,-109.408199
66371,16,23,12,14,19,5,89,38.22282126587938,-109.4079295
66372,8,19,12,19,27,3,88,38.22282126587938,-109.40766
66373,8,20,12,25,22,2,89,38.22282126587938,-109.4073905
66374,9,24,11,26,17,2,89,38.22282126587938,-109.407121
66375,10,32,13,20,17,1,93,38.22282126587938,-109.4068515
66376,5,40,12,15,15,1,88,38.22282126587938,-109.406582
66377,3,39,11,16,13,1,83,38.22282126587938,-109.4063125
66378,4,41,12,16,12,1,86,38.22282126587938,-109.406043
66379,4,42,13,18,12,1,90,38.22282126587938,-109.4057735
66380,6,38,14,22,13,1,94,38.22282126587938,-109.405504
66381,7,34,14,23,14,1,93,38.22282126587938,-109.4052345
66382,7,30,13,24,15,2,91,38.22282126587938,-109.4049651
66383,7,28,13,23,16,3,90,38.22282126587938,-109.4046956
66384,5,28,14,19,18,4,88,38.22282126587938,-109.4044261
66385,5,30,14,16,18,5,88,38.22282126587938,-109.4041566
66386,6,30,14,20,17,3,90,38.22282126587938,-109.4038871
66387,6,31,14,21,16,3,91,38.22282126587938,-109.4036176
66388,6,32,13,21,16,2,90,38.22282126587938,-109.4033481
66389,7,31,13,21,15,2,89,38.22282126587938,-109.4030786
66390,7,31,13,22,14,2,89,38.22282126587938,-109.4028091
66391,9,29,13,24,14,2,91,38.22282126587938,-109.4025396
66392,11,26,12,27,14,1,91,38.22282126587938,-109.4022701
66393,13,23,11,32,12,2,93,38.22282126587938,-109.4020006
66394,13,22,11,32,12,2,92,38.22282126587938,-109.4017311
66395,15,26,12,23,13,2,91,38.22282126587938,-109.4014616
66396,13,29,12,16,14,1,85,38.22282126587938,-109.4011921
66397,5,33,10,11,13,3,75,38.22282126587938,-109.4009226
66398,4,31,9,6,12,4,66,38.22282126587938,-109.4006531
66399,6,27,10,8,12,4,67,38.22282126587938,-109.4003836
66400,8,24,12,11,13,3,71,38.22282126587938,-109.4001142
66401,11,27,12,14,12,2,78,38.22282126587938,-109.3998447
66402,13,32,13,15,11,1,85,38.22282126587938,-109.3995752
66403,14,34,13,18,10,1,90,38.22282126587938,-109.3993057
66404,18,30,13,20,8,1,90,38.22282126587938,-109.3990362
66405,12,29,11,13,13,1,79,38.22282126587938,-109.3987667
66406,9,30,10,9,13,2,73,38.22282126587938,-109.3984972
66407,8,33,10,11,13,2,77,38.22282126587938,-109.3982277
66408,11,36,13,18,12,1,91,38.22282126587938,-109.3979582
66409,22,25,13,23,10,1,94,38.22282126587938,-109.3976887
66410,16,24,12,25,15,1,93,38.22282126587938,-109.3974192
66411,11,25,12,24,15,2,89,38.22282126587938,-109.3971497
66412,9,23,11,19,13,3,78,38.22282126587938,-109.3968802
66413,5,24,9,10,12,5,65,38.22282126587938,-109.3966107
66414,3,31,8,7,11,3,63,38.22282126587938,-109.3963412
66415,5,28,9,9,14,3,68,38.22282126587938,-109.3960717
66416,6,25,11,13,16,2,73,38.22282126587938,-109.3958022
66417,6,26,11,16,16,2,77,38.22282126587938,-109.3955327
66418,8,31,11,13,14,1,78,38.22282126587938,-109.3952632
66419,6,34,10,13,13,2,78,38.22282126587938,-109.3949938
66420,5,28,10,16,15,2,76,38.22282126587938,-109.3947243
66421,9,26,12,19,16,2,84,38.22282126587938,-109.3944548
66422,12,30,13,18,15,2,90,38.22282126587938,-109.3941853
66423,9,35,12,19,14,2,91,38.22282126587938,-109.3939158
66424,8,35,13,21,14,1,92,38.22282126587938,-109.3936463
66425,7,36,12,22,14,1,92,38.22282126587938,-109.3933768
66426,8,35,12,22,14,1,92,38.22282126587938,-109.3931073
66427,11,30,11,22,15,1,90,38.22282126587938,-109.3928378
66428,11,30,12,24,14,1,92,38.22282126587938,-109.3925683
66429,9,29,12,25,15,1,91,38.22282126587938,-109.3922988
66430,9,29,12,25,15,1,91,38.22282126587938,-109.3920293
66431,9,29,12,21,16,1,88,38.22282126587938,-109.3917598
66432,8,31,11,21,15,1,87,38.22282126587938,-109.3914903
66433,10,28,11,22,16,1,88,38.22282126587938,-109.3912208
66434,15,24,11,26,15,0,91,38.22282126587938,-109.3909513
66435,24,18,10,29,13,0,94,38.22282126587938,-109.3906818
66436,32,17,9,25,12,1,96,38.22282126587938,-109.3904123
66437,34,18,9,23,12,0,96,38.22282126587938,-109.3901429
66438,37,21,9,19,10,0,96,38.22282126587938,-109.3898734
66439,37,28,9,18,8,0,100,38.22282126587938,-109.3896039
66440,36,33,8,14,5,0,96,38.22282126587938,-109.3893344
66441,32,32,7,13,5,0,89,38.22282126587938,-109.3890649
66442,34,28,9,17,6,0,94,38.22282126587938,-109.3887954
66443,41,23,9,17,7,0,97,38.22282126587938,-109.3885259
66444,42,22,9,17,6,0,96,38.22282126587938,-109.3882564
66445,38,25,9,19,7,0,98,38.22282126587938,-109.3879869
66446,36,25,10,18,8,0,97,38.22282126587938,-109.3877174
66447,31,29,10,19,9,0,98,38.22282126587938,-109.3874479
66448,28,32,9,19,8,0,96,38.22282126587938,-109.3871784
66449,31,27,10,17,7,0,92,38.22282126587938,-109.3869089
66450,36,16,10,17,7,1,87,38.22282126587938,-109.3866394
66451,39,13,10,20,6,2,90,38.22282126587938,-109.3863699
66452,42,11,10,21,8,2,94,38.22282126587938,-109.3861004
66453,40,9,10,22,7,2,90,38.22282126587938,-109.3858309
66454,34,9,9,21,5,4,82,38.22282126587938,-109.3855614
66455,26,11,8,18,4,3,70,38.22282126587938,-109.3852919
66456,22,10,9,18,5,4,68,38.22282126587938,-109.3850225
66457,22,9,11,19,9,4,74,38.22282126587938,-109.384753
66458,23,12,12,20,15,2,84,38.22282126587938,-109.3844835
66459,22,16,12,23,18,1,92,38.22282126587938,-109.384214
66460,15,23,12,21,13,3,87,38.22282126587938,-109.3839445
66461,6,24,12,11,11,8,72,38.22282126587938,-109.383675
66462,2,31,10,5,10,10,68,38.22282126587938,-109.3834055
66463,1,37,9,3,12,8,70,38.22282126587938,-109.383136
66464,2,38,8,4,12,6,70,38.22282126587938,-109.3828665
66465,2,41,7,6,6,5,67,38.22282126587938,-109.382597
66466,2,43,6,7,6,3,67,38.22282126587938,-109.3823275
66467,2,44,7,7,6,2,68,38.22282126587938,-109.382058
66468,2,45,7,6,8,2,70,38.22282126587938,-109.3817885
66469,2,45,7,6,8,2,70,38.22282126587938,-109.381519
66470,2,42,7,6,5,4,66,38.22282126587938,-109.3812495
66471,2,41,6,6,5,4,64,38.22282126587938,-109.38098
66472,2,39,7,7,8,4,67,38.22282126587938,-109.3807105
66473,2,35,8,7,10,4,66,38.22282126587938,-109.380441
66474,2,30,9,6,12,6,65,38.22282126587938,-109.3801716
66475,4,25,11,15,15,4,74,38.22282126587938,-109.3799021
66476,12,24,11,19,16,2,84,38.22282126587938,-109.3796326
66477,19,24,12,20,14,2,91,38.22282126587938,-109.3793631
66478,27,22,11,17,13,1,91,38.22282126587938,-109.3790936
66479,25,22,11,16,16,1,91,38.22282126587938,-109.3788241
66480,24,22,11,18,15,0,90,38.22282126587938,-109.3785546
66481,24,23,11,18,12,1,89,38.22282126587938,-109.3782851
66482,24,23,11,17,10,1,86,38.22282126587938,-109.3780156
66483,26,22,10,18,10,1,87,38.22282126587938,-109.3777461
66484,30,21,10,19,10,0,90,38.22282126587938,-109.3774766
66485,30,22,10,19,11,1,93,38.22282126587938,-109.3772071
66486,27,22,10,20,12,2,93,38.22282126587938,-109.3769376
66487,21,22,10,22,13,2,90,38.22282126587938,-109.3766681
66488,8,24,11,18,14,4,79,38.22282126587938,-109.3763986
66489,6,26,11,15,14,4,76,38.22282126587938,-109.3761291
66490,2,27,10,11,13,5,68,38.22282126587938,-109.3758596
66491,1,30,9,11,11,5,67,38.22282126587938,-109.3755901
66492,1,34,8,13,8,2,66,38.22282126587938,-109.3753206
66493,1,32,6,17,5,1,62,38.22282126587938,-109.3750512
66494,0,30,6,14,6,2,58,38.22282126587938,-109.3747817
66495,1,33,8,11,11,2,66,38.22282126587938,-109.3745122
66496,1,40,9,6,13,3,72,38.22282126587938,-109.3742427
66497,1,42,8,5,13,4,73,38.22282126587938,-109.3739732
66498,1,43,8,4,13,4,73,38.22282126587938,-109.3737037
66499,6,27,11,14,17,2,77,38.22255177129415,-109.4114329
66500,6,21,10,26,20,2,85,38.22255177129415,-109.4111634
66501,7,19,12,21,26,4,89,38.22255177129415,-109.4108939
66502,11,24,10,20,22,3,90,38.22255177129415,-109.4106244
66503,9,23,10,22,20,2,86,38.22255177129415,-109.4103549
66504,6,20,11,27,23,3,90,38.22255177129415,-109.4100855
66505,10,22,12,23,21,4,92,38.22255177129415,-109.409816
66506,13,26,12,17,18,4,90,38.22255177129415,-109.4095465
66507,12,32,12,15,16,1,88,38.22255177129415,-109.409277
66508,14,25,12,18,16,3,88,38.22255177129415,-109.4090075
66509,18,22,12,18,17,4,91,38.22255177129415,-109.408738
66510,16,21,12,18,18,4,89,38.22255177129415,-109.4084685
66511,11,21,12,17,19,3,83,38.22255177129415,-109.408199
66512,9,23,12,21,14,4,83,38.22255177129415,-109.4079295
66513,1,26,10,12,11,8,68,38.22255177129415,-109.40766
66514,4,31,10,14,12,2,73,38.22255177129415,-109.4073905
66515,4,32,10,13,13,2,74,38.22255177129415,-109.407121
66516,3,34,10,9,13,4,73,38.22255177129415,-109.4068515
66517,3,44,10,10,13,1,81,38.22255177129415,-109.406582
66518,4,42,11,15,13,1,86,38.22255177129415,-109.4063125
66519,5,35,13,19,14,1,87,38.22255177129415,-109.406043
66520,7,32,13,24,15,1,92,38.22255177129415,-109.4057735
66521,8,30,13,24,14,1,90,38.22255177129415,-109.405504
66522,7,30,12,28,13,1,91,38.22255177129415,-109.4052345
66523,6,31,12,27,14,1,91,38.22255177129415,-109.4049651
66524,5,29,12,27,15,1,89,38.22255177129415,-109.4046956
66525,4,29,13,25,17,2,90,38.22255177129415,-109.4044261
66526,5,29,14,21,18,3,90,38.22255177129415,-109.4041566
66527,4,29,15,18,18,5,89,38.22255177129415,-109.4038871
66528,5,29,15,16,18,6,89,38.22255177129415,-109.4036176
66529,5,30,14,18,17,5,89,38.22255177129415,-109.4033481
66530,6,30,14,20,16,4,90,38.22255177129415,-109.4030786
66531,8,32,13,22,14,2,91,38.22255177129415,-109.4028091
66532,8,30,13,23,14,1,89,38.22255177129415,-109.4025396
66533,8,26,13,26,14,2,89,38.22255177129415,-109.4022701
66534,6,22,13,29,17,4,91,38.22255177129415,-109.4020006
66535,5,19,12,29,21,4,90,38.22255177129415,-109.4017311
66536,13,19,11,30,17,3,93,38.22255177129415,-109.4014616
66537,18,26,13,25,11,1,94,38.22255177129415,-109.4011921
66538,9,33,12,15,14,1,84,38.22255177129415,-109.4009226
66539,7,31,11,11,15,2,77,38.22255177129415,-109.4006531
66540,8,22,12,11,17,3,73,38.22255177129415,-109.4003836
66541,23,21,15,10,13,1,83,38.22255177129415,-109.4001142
66542,20,17,12,11,8,0,68,38.22255177129415,-109.3998447
66543,18,16,10,14,6,0,64,38.22255177129415,-109.3995752
66544,23,21,10,19,6,0,79,38.22255177129415,-109.3993057
66545,30,22,11,24,5,1,93,38.22255177129415,-109.3990362
66546,25,25,12,23,7,1,93,38.22255177129415,-109.3987667
66547,21,27,13,23,9,1,94,38.22255177129415,-109.3984972
66548,20,28,13,23,9,1,94,38.22255177129415,-109.3982277
66549,23,27,12,23,7,1,93,38.22255177129415,-109.3979582
66550,22,23,11,26,9,1,92,38.22255177129415,-109.3976887
66551,18,22,11,27,13,1,92,38.22255177129415,-109.3974192
66552,14,22,11,26,16,2,91,38.22255177129415,-109.3971497
66553,13,23,11,24,14,2,87,38.22255177129415,-109.3968802
66554,12,24,11,20,14,2,83,38.22255177129415,-109.3966107
66555,7,26,11,19,14,2,79,38.22255177129415,-109.3963412
66556,10,27,12,19,16,1,85,38.22255177129415,-109.3960717
66557,14,28,12,21,15,1,91,38.22255177129415,-109.3958022
66558,13,28,12,23,14,1,91,38.22255177129415,-109.3955327
66559,12,25,11,26,14,1,89,38.22255177129415,-109.3952632
66560,12,27,11,20,13,1,84,38.22255177129415,-109.3949938
66561,12,30,12,19,14,1,88,38.22255177129415,-109.3947243
66562,12,31,13,20,15,1,92,38.22255177129415,-109.3944548
66563,11,34,12,20,14,1,92,38.22255177129415,-109.3941853
66564,6,39,13,19,13,1,91,38.22255177129415,-109.3939158
66565,5,40,13,20,13,1,92,38.22255177129415,-109.3936463
66566,5,39,13,22,13,1,93,38.22255177129415,-109.3933768
66567,6,37,12,23,14,1,93,38.22255177129415,-109.3931073
66568,8,32,12,22,15,1,90,38.22255177129415,-109.3928378
66569,8,33,12,20,15,1,89,38.22255177129415,-109.3925683
66570,8,33,12,20,15,1,89,38.22255177129415,-109.3922988
66571,8,31,12,20,16,1,88,38.22255177129415,-109.3920293
66572,9,29,12,20,16,1,87,38.22255177129415,-109.3917598
66573,9,27,11,22,16,1,86,38.22255177129415,-109.3914903
66574,9,24,11,23,17,2,86,38.22255177129415,-109.3912208
66575,17,19,11,24,17,2,90,38.22255177129415,-109.3909513
66576,28,16,9,23,16,1,93,38.22255177129415,-109.3906818
66577,34,16,9,22,12,1,94,38.22255177129415,-109.3904123
66578,37,18,9,21,10,0,95,38.22255177129415,-109.3901429
66579,40,20,10,17,9,0,96,38.22255177129415,-109.3898734
66580,41,24,9,16,6,0,96,38.22255177129415,-109.3896039
66581,40,29,8,14,4,0,95,38.22255177129415,-109.3893344
66582,37,31,7,13,4,0,92,38.22255177129415,-109.3890649
66583,38,30,8,14,4,0,94,38.22255177129415,-109.3887954
66584,44,26,8,13,5,0,96,38.22255177129415,-109.3885259
66585,43,24,8,12,5,0,92,38.22255177129415,-109.3882564
66586,37,27,7,13,4,0,88,38.22255177129415,-109.3879869
66587,31,28,7,12,5,0,83,38.22255177129415,-109.3877174
66588,32,30,8,15,6,0,91,38.22255177129415,-109.3874479
66589,32,25,9,18,6,0,90,38.22255177129415,-109.3871784
66590,35,17,10,19,6,1,88,38.22255177129415,-109.3869089
66591,33,11,9,20,4,2,79,38.22255177129415,-109.3866394
66592,33,9,7,17,2,2,70,38.22255177129415,-109.3863699
66593,30,6,7,15,3,2,63,38.22255177129415,-109.3861004
66594,26,5,5,13,2,4,55,38.22255177129415,-109.3858309
66595,25,5,5,15,2,4,56,38.22255177129415,-109.3855614
66596,26,8,8,18,4,4,68,38.22255177129415,-109.3852919
66597,27,10,9,15,6,1,68,38.22255177129415,-109.3850225
66598,24,19,10,16,8,1,78,38.22255177129415,-109.384753
66599,18,31,13,16,14,1,93,38.22255177129415,-109.3844835
66600,7,33,12,13,14,3,82,38.22255177129415,-109.384214
66601,7,38,10,8,13,2,78,38.22255177129415,-109.3839445
66602,3,34,9,5,11,6,68,38.22255177129415,-109.383675
66603,2,34,10,5,11,7,69,38.22255177129415,-109.3834055
66604,2,35,10,5,12,7,71,38.22255177129415,-109.383136
66605,2,35,10,5,13,6,71,38.22255177129415,-109.3828665
66606,2,33,9,5,9,7,65,38.22255177129415,-109.382597
66607,2,39,7,6,7,5,66,38.22255177129415,-109.3823275
66608,2,41,7,6,7,3,66,38.22255177129415,-109.382058
66609,2,43,7,6,8,2,68,38.22255177129415,-109.3817885
66610,2,43,7,6,8,2,68,38.22255177129415,-109.381519
66611,3,42,7,5,6,3,66,38.22255177129415,-109.3812495
66612,7,29,10,18,15,2,81,38.22228227670891,-109.4114329
66613,5,22,11,23,22,2,85,38.22228227670891,-109.4111634
66614,5,21,11,18,28,6,89,38.22228227670891,-109.4108939
66615,6,24,11,22,24,3,90,38.22228227670891,-109.4106244
66616,8,22,10,23,20,3,86,38.22228227670891,-109.4103549
66617,8,22,11,23,23,3,90,38.22228227670891,-109.4100855
66618,9,23,11,22,23,4,92,38.22228227670891,-109.409816
66619,12,27,12,19,19,3,92,38.22228227670891,-109.4095465
66620,11,33,13,16,16,1,90,38.22228227670891,-109.409277
66621,12,28,12,15,13,2,82,38.22228227670891,-109.4090075
66622,14,28,13,16,13,2,86,38.22228227670891,-109.408738
66623,14,26,12,17,17,2,88,38.22228227670891,-109.4084685
66624,9,22,11,19,18,2,81,38.22228227670891,-109.408199
66625,1,29,10,18,12,2,72,38.22228227670891,-109.4079295
66626,1,41,7,7,7,4,67,38.22228227670891,-109.40766
66627,2,37,8,9,10,3,69,38.22228227670891,-109.4073905
66628,3,33,9,10,11,2,68,38.22228227670891,-109.407121
66629,4,33,9,9,11,3,69,38.22228227670891,-109.4068515
66630,4,39,9,13,10,2,77,38.22228227670891,-109.406582
66631,4,36,11,15,12,1,79,38.22228227670891,-109.4063125
66632,6,34,14,18,15,1,88,38.22228227670891,-109.406043
66633,7,32,13,20,16,2,90,38.22228227670891,-109.4057735
66634,8,34,13,22,13,1,91,38.22228227670891,-109.405504
66635,6,33,13,25,14,1,92,38.22228227670891,-109.4052345
66636,7,31,13,27,13,1,92,38.22228227670891,-109.4049651
66637,6,29,12,28,14,1,90,38.22228227670891,-109.4046956
66638,6,29,13,27,15,1,91,38.22228227670891,-109.4044261
66639,5,28,13,24,16,2,88,38.22228227670891,-109.4041566
66640,4,29,15,17,18,6,89,38.22228227670891,-109.4038871
66641,4,29,15,16,19,6,89,38.22228227670891,-109.4036176
66642,5,30,14,19,18,5,91,38.22228227670891,-109.4033481
66643,6,31,14,23,15,3,92,38.22228227670891,-109.4030786
66644,8,33,14,23,13,1,92,38.22228227670891,-109.4028091
66645,8,32,14,25,13,1,93,38.22228227670891,-109.4025396
66646,8,29,13,26,14,1,91,38.22228227670891,-109.4022701
66647,8,26,13,28,14,2,91,38.22228227670891,-109.4020006
66648,9,23,12,31,15,3,93,38.22228227670891,-109.4017311
66649,15,21,11,31,12,1,91,38.22228227670891,-109.4014616
66650,15,30,13,23,11,1,93,38.22228227670891,-109.4011921
66651,8,36,12,16,13,1,86,38.22228227670891,-109.4009226
66652,4,36,11,11,15,2,79,38.22228227670891,-109.4006531
66653,7,30,12,12,17,2,80,38.22228227670891,-109.4003836
66654,19,25,13,10,13,0,80,38.22228227670891,-109.4001142
66655,16,15,9,13,8,0,61,38.22228227670891,-109.3998447
66656,21,16,10,18,7,2,74,38.22228227670891,-109.3995752
66657,26,18,10,27,7,2,90,38.22228227670891,-109.3993057
66658,26,18,9,31,7,1,92,38.22228227670891,-109.3990362
66659,20,22,10,31,8,1,92,38.22228227670891,-109.3987667
66660,15,23,11,30,11,1,91,38.22228227670891,-109.3984972
66661,14,25,12,26,13,1,91,38.22228227670891,-109.3982277
66662,15,26,12,24,13,1,91,38.22228227670891,-109.3979582
66663,15,24,12,27,12,1,91,38.22228227670891,-109.3976887
66664,14,25,11,24,14,2,90,38.22228227670891,-109.3974192
66665,13,24,11,24,14,3,89,38.22228227670891,-109.3971497
66666,12,24,11,25,13,3,88,38.22228227670891,-109.3968802
66667,12,26,11,23,14,2,88,38.22228227670891,-109.3966107
66668,12,27,11,24,14,1,89,38.22228227670891,-109.3963412
66669,13,27,11,25,13,1,90,38.22228227670891,-109.3960717
66670,12,27,11,26,14,1,91,38.22228227670891,-109.3958022
66671,11,27,11,26,14,2,91,38.22228227670891,-109.3955327
66672,10,27,12,25,13,2,89,38.22228227670891,-109.3952632
66673,9,31,12,22,13,2,89,38.22228227670891,-109.3949938
66674,9,34,12,20,13,2,90,38.22228227670891,-109.3947243
66675,7,37,13,19,13,1,90,38.22228227670891,-109.3944548
66676,5,41,13,19,12,1,91,38.22228227670891,-109.3941853
66677,4,44,13,18,12,1,92,38.22228227670891,-109.3939158
66678,4,42,13,18,12,1,90,38.22228227670891,-109.3936463
66679,4,40,13,20,12,1,90,38.22228227670891,-109.3933768
66680,5,37,12,22,13,1,90,38.22228227670891,-109.3931073
66681,8,34,12,21,15,1,91,38.22228227670891,-109.3928378
66682,10,32,12,20,15,1,90,38.22228227670891,-109.3925683
66683,11,29,11,20,15,1,87,38.22228227670891,-109.3922988
66684,12,26,11,21,15,1,86,38.22228227670891,-109.3920293
66685,15,22,11,23,15,2,88,38.22228227670891,-109.3917598
66686,20,19,11,24,13,2,89,38.22228227670891,-109.3914903
66687,30,19,10,21,12,1,93,38.22228227670891,-109.3912208
66688,40,15,9,19,12,1,96,38.22228227670891,-109.3909513
66689,43,13,10,19,11,1,97,38.22228227670891,-109.3906818
66690,42,14,11,17,9,2,95,38.22228227670891,-109.3904123
66691,38,16,11,18,7,3,93,38.22228227670891,-109.3901429
66692,36,19,11,16,5,3,90,38.22228227670891,-109.3898734
66693,36,22,10,14,5,1,88,38.22228227670891,-109.3896039
66694,40,24,9,14,3,1,91,38.22228227670891,-109.3893344
66695,42,25,9,16,2,0,94,38.22228227670891,-109.3890649
66696,43,25,8,15,2,0,93,38.22228227670891,-109.3887954
66697,43,23,8,14,3,0,91,38.22228227670891,-109.3885259
66698,42,21,7,13,3,0,86,38.22228227670891,-109.3882564
66699,38,20,7,11,2,0,78,38.22228227670891,-109.3879869
66700,35,22,7,7,3,0,74,38.22228227670891,-109.3877174
66701,30,22,9,13,5,1,80,38.22228227670891,-109.3874479
66702,31,17,10,18,5,1,82,38.22228227670891,-109.3871784
66703,29,12,11,20,5,2,79,38.22228227670891,-109.3869089
66704,28,11,10,20,5,2,76,38.22228227670891,-109.3866394
66705,31,8,9,18,4,4,74,38.22228227670891,-109.3863699
66706,28,8,8,16,4,4,68,38.22228227670891,-109.3861004
66707,32,10,9,16,5,4,76,38.22228227670891,-109.3858309
66708,35,14,11,17,7,3,87,38.22228227670891,-109.3855614
66709,35,14,11,18,10,2,90,38.22228227670891,-109.3852919
66710,31,17,11,22,13,1,95,38.22228227670891,-109.3850225
66711,21,24,14,18,13,2,92,38.22228227670891,-109.384753
66712,9,29,12,14,13,4,81,38.22228227670891,-109.3844835
66713,3,36,10,8,13,4,74,38.22228227670891,-109.384214
66714,2,38,9,4,12,6,71,38.22228227670891,-109.3839445
66715,2,36,9,4,12,6,69,38.22228227670891,-109.383675
66716,2,38,10,5,12,5,72,38.22228227670891,-109.3834055
66717,3,39,10,6,12,4,74,38.22228227670891,-109.383136
66718,2,35,9,5,10,7,68,38.22228227670891,-109.3828665
66719,3,35,10,4,8,8,68,38.22228227670891,-109.382597
66720,3,37,8,6,8,5,67,38.22228227670891,-109.3823275
66721,4,40,8,7,7,4,70,38.22228227670891,-109.382058
66722,4,42,8,8,7,3,72,38.22228227670891,-109.3817885
66723,3,44,7,7,6,2,69,38.22228227670891,-109.381519
66724,3,42,7,6,6,3,67,38.22228227670891,-109.3812495
66725,9,23,12,23,20,1,88,38.22201278212367,-109.4114329
66726,8,18,10,22,25,5,88,38.22201278212367,-109.4111634
66727,3,20,10,19,28,8,88,38.22201278212367,-109.4108939
66728,5,24,11,22,25,3,90,38.22201278212367,-109.4106244
66729,13,23,10,20,20,2,88,38.22201278212367,-109.4103549
66730,12,21,10,23,20,2,88,38.22201278212367,-109.4100855
66731,10,22,11,23,22,3,91,38.22201278212367,-109.409816
66732,10,25,12,22,19,4,92,38.22201278212367,-109.4095465
66733,10,29,12,15,16,2,84,38.22201278212367,-109.409277
66734,8,28,11,13,15,3,78,38.22201278212367,-109.4090075
66735,10,29,12,18,16,1,86,38.22201278212367,-109.408738
66736,9,28,12,21,18,1,89,38.22201278212367,-109.4084685
66737,4,23,10,19,16,3,75,38.22201278212367,-109.408199
66738,1,36,9,8,9,5,68,38.22201278212367,-109.4079295
66739,4,39,7,6,10,2,68,38.22201278212367,-109.40766
66740,4,29,11,15,14,2,75,38.22201278212367,-109.4073905
66741,6,30,13,20,14,2,85,38.22201278212367,-109.407121
66742,5,32,12,19,13,2,83,38.22201278212367,-109.4068515
66743,3,35,10,15,10,2,75,38.22201278212367,-109.406582
66744,4,32,12,21,11,1,81,38.22201278212367,-109.4063125
66745,5,32,13,26,13,1,90,38.22201278212367,-109.406043
66746,7,35,13,22,15,1,93,38.22201278212367,-109.4057735
66747,6,36,13,21,14,1,91,38.22201278212367,-109.405504
66748,6,35,13,19,16,1,90,38.22201278212367,-109.4052345
66749,6,33,13,25,15,1,93,38.22201278212367,-109.4049651
66750,5,30,13,27,15,1,91,38.22201278212367,-109.4046956
66751,5,29,13,24,17,2,90,38.22201278212367,-109.4044261
66752,4,29,14,21,18,4,90,38.22201278212367,-109.4041566
66753,4,29,14,22,17,4,90,38.22201278212367,-109.4038871
66754,5,29,13,22,18,3,90,38.22201278212367,-109.4036176
66755,6,29,13,24,17,3,92,38.22201278212367,-109.4033481
66756,6,30,14,26,15,2,93,38.22201278212367,-109.4030786
66757,7,31,14,26,13,1,92,38.22201278212367,-109.4028091
66758,7,30,13,26,13,1,90,38.22201278212367,-109.4025396
66759,6,29,13,27,13,1,89,38.22201278212367,-109.4022701
66760,7,27,13,29,13,1,90,38.22201278212367,-109.4020006
66761,11,23,11,32,11,2,90,38.22201278212367,-109.4017311
66762,14,25,12,25,10,3,89,38.22201278212367,-109.4014616
66763,11,33,12,22,12,1,91,38.22201278212367,-109.4011921
66764,6,40,12,21,12,1,92,38.22201278212367,-109.4009226
66765,3,39,11,15,14,1,83,38.22201278212367,-109.4006531
66766,4,42,10,11,14,1,82,38.22201278212367,-109.4003836
66767,12,39,13,18,11,0,93,38.22201278212367,-109.4001142
66768,19,29,12,17,8,0,85,38.22201278212367,-109.3998447
66769,22,22,11,27,8,2,92,38.22201278212367,-109.3995752
66770,16,20,10,30,12,2,90,38.22201278212367,-109.3993057
66771,12,23,12,31,13,2,93,38.22201278212367,-109.3990362
66772,9,28,12,27,14,1,91,38.22201278212367,-109.3987667
66773,9,30,12,24,14,1,90,38.22201278212367,-109.3984972
66774,10,30,12,22,15,1,90,38.22201278212367,-109.3982277
66775,12,30,12,20,14,2,90,38.22201278212367,-109.3979582
66776,11,28,12,23,15,1,90,38.22201278212367,-109.3976887
66777,9,30,12,22,14,1,88,38.22201278212367,-109.3974192
66778,9,31,12,22,13,2,89,38.22201278212367,-109.3971497
66779,10,31,12,22,13,1,89,38.22201278212367,-109.3968802
66780,11,31,12,20,14,1,89,38.22201278212367,-109.3966107
66781,10,30,12,23,14,1,90,38.22201278212367,-109.3963412
66782,10,30,12,24,14,1,91,38.22201278212367,-109.3960717
66783,9,31,12,24,14,1,91,38.22201278212367,-109.3958022
66784,8,34,13,22,14,1,92,38.22201278212367,-109.3955327
66785,7,37,13,19,13,1,90,38.22201278212367,-109.3952632
66786,5,36,12,20,13,2,88,38.22201278212367,-109.3949938
66787,5,37,12,20,13,2,89,38.22201278212367,-109.3947243
66788,5,40,12,19,12,2,90,38.22201278212367,-109.3944548
66789,4,43,13,18,12,1,91,38.22201278212367,-109.3941853
66790,3,44,13,19,12,1,92,38.22201278212367,-109.3939158
66791,3,41,12,18,13,2,89,38.22201278212367,-109.3936463
66792,3,38,12,19,13,2,87,38.22201278212367,-109.3933768
66793,5,36,12,19,14,1,87,38.22201278212367,-109.3931073
66794,7,33,12,18,16,1,87,38.22201278212367,-109.3928378
66795,13,29,11,19,14,1,87,38.22201278212367,-109.3925683
66796,23,29,11,17,12,0,92,38.22201278212367,-109.3922988
66797,33,27,10,14,11,0,95,38.22201278212367,-109.3920293
66798,40,24,10,13,11,0,98,38.22201278212367,-109.3917598
66799,47,20,9,12,8,0,96,38.22201278212367,-109.3914903
66800,47,20,9,15,5,1,97,38.22201278212367,-109.3912208
66801,46,17,10,17,3,1,94,38.22201278212367,-109.3909513
66802,46,15,9,18,2,3,93,38.22201278212367,-109.3906818
66803,38,15,11,22,5,4,95,38.22201278212367,-109.3904123
66804,36,14,11,21,7,3,92,38.22201278212367,-109.3901429
66805,33,19,12,18,7,2,91,38.22201278212367,-109.3898734
66806,29,24,11,18,11,1,94,38.22201278212367,-109.3896039
66807,20,29,12,17,14,0,92,38.22201278212367,-109.3893344
66808,18,31,12,17,15,0,93,38.22201278212367,-109.3890649
66809,30,25,10,17,13,0,95,38.22201278212367,-109.3887954
66810,32,22,10,17,12,1,94,38.22201278212367,-109.3885259
66811,32,19,11,17,11,2,92,38.22201278212367,-109.3882564
66812,27,18,11,20,9,2,87,38.22201278212367,-109.3879869
66813,18,24,13,19,12,2,88,38.22201278212367,-109.3877174
66814,14,26,12,16,15,2,85,38.22201278212367,-109.3874479
66815,20,27,12,16,15,1,91,38.22201278212367,-109.3871784
66816,28,22,11,17,11,2,91,38.22201278212367,-109.3869089
66817,32,22,11,16,9,1,91,38.22201278212367,-109.3866394
66818,31,20,11,18,11,2,93,38.22201278212367,-109.3863699
66819,25,26,12,16,12,1,92,38.22201278212367,-109.3861004
66820,19,31,13,15,13,1,92,38.22201278212367,-109.3858309
66821,12,30,12,15,13,1,83,38.22201278212367,-109.3855614
66822,5,32,11,14,14,2,78,38.22201278212367,-109.3852919
66823,8,35,11,12,14,1,81,38.22201278212367,-109.3850225
66824,7,33,10,10,14,2,76,38.22201278212367,-109.384753
66825,4,32,10,9,14,4,73,38.22201278212367,-109.3844835
66826,3,35,9,8,13,4,72,38.22201278212367,-109.384214
66827,2,41,8,6,11,4,72,38.22201278212367,-109.3839445
66828,2,44,9,6,14,3,78,38.22201278212367,-109.383675
66829,2,43,10,6,15,3,79,38.22201278212367,-109.3834055
66830,2,40,10,5,13,5,75,38.22201278212367,-109.383136
66831,2,33,9,4,9,10,67,38.22201278212367,-109.3828665
66832,1,36,8,3,6,10,64,38.22201278212367,-109.382597
66833,2,40,7,6,6,6,67,38.22201278212367,-109.3823275
66834,3,44,7,6,6,4,70,38.22201278212367,-109.382058
66835,3,45,7,6,6,3,70,38.22201278212367,-109.3817885
66836,3,44,7,6,6,3,69,38.22201278212367,-109.381519
66837,3,42,7,6,6,3,67,38.22201278212367,-109.3812495
66838,11,18,11,27,20,2,89,38.22174328753844,-109.4114329
66839,7,17,10,24,26,6,90,38.22174328753844,-109.4111634
66840,5,18,10,24,26,6,89,38.22174328753844,-109.4108939
66841,4,22,11,24,26,3,90,38.22174328753844,-109.4106244
66842,11,26,10,19,19,3,88,38.22174328753844,-109.4103549
66843,12,23,10,25,17,2,89,38.22174328753844,-109.4100855
66844,7,24,11,22,22,3,89,38.22174328753844,-109.409816
66845,6,26,12,17,22,5,88,38.22174328753844,-109.4095465
66846,9,27,12,17,19,4,88,38.22174328753844,-109.409277
66847,8,25,11,16,18,2,80,38.22174328753844,-109.4090075
66848,10,24,12,19,16,1,82,38.22174328753844,-109.408738
66849,5,25,11,22,15,2,80,38.22174328753844,-109.4084685
66850,1,33,9,15,12,2,72,38.22174328753844,-109.408199
66851,2,42,7,8,8,3,70,38.22174328753844,-109.4079295
66852,4,37,8,8,12,2,71,38.22174328753844,-109.40766
66853,5,27,11,20,16,2,81,38.22174328753844,-109.4073905
66854,11,26,12,23,14,1,87,38.22174328753844,-109.407121
66855,12,31,12,23,14,1,93,38.22174328753844,-109.4068515
66856,9,31,12,24,15,1,92,38.22174328753844,-109.406582
66857,9,26,12,26,16,1,90,38.22174328753844,-109.4063125
66858,9,24,12,26,17,1,89,38.22174328753844,-109.406043
66859,9,28,12,25,16,1,91,38.22174328753844,-109.4057735
66860,7,34,12,23,15,1,92,38.22174328753844,-109.405504
66861,7,36,13,22,14,1,93,38.22174328753844,-109.4052345
66862,7,34,13,23,14,1,92,38.22174328753844,-109.4049651
66863,7,31,12,25,15,2,92,38.22174328753844,-109.4046956
66864,6,30,13,24,16,3,92,38.22174328753844,-109.4044261
66865,4,30,13,22,18,3,90,38.22174328753844,-109.4041566
66866,5,28,13,26,16,3,91,38.22174328753844,-109.4038871
66867,6,30,13,23,16,2,90,38.22174328753844,-109.4036176
66868,6,31,13,24,16,1,91,38.22174328753844,-109.4033481
66869,6,31,13,26,14,1,91,38.22174328753844,-109.4030786
66870,6,31,13,25,14,1,90,38.22174328753844,-109.4028091
66871,7,31,13,25,13,2,91,38.22174328753844,-109.4025396
66872,6,27,12,29,12,2,88,38.22174328753844,-109.4022701
66873,5,26,11,30,14,1,87,38.22174328753844,-109.4020006
66874,3,26,12,24,17,2,84,38.22174328753844,-109.4017311
66875,3,29,10,24,13,2,81,38.22174328753844,-109.4014616
66876,3,33,10,28,11,1,86,38.22174328753844,-109.4011921
66877,2,32,10,29,13,0,86,38.22174328753844,-109.4009226
66878,2,35,10,22,12,1,82,38.22174328753844,-109.4006531
66879,3,40,10,11,13,3,80,38.22174328753844,-109.4003836
66880,9,41,13,19,11,0,93,38.22174328753844,-109.4001142
66881,16,31,13,23,7,0,90,38.22174328753844,-109.3998447
66882,20,26,12,27,8,1,94,38.22174328753844,-109.3995752
66883,12,25,12,30,11,1,91,38.22174328753844,-109.3993057
66884,10,29,13,28,12,1,93,38.22174328753844,-109.3990362
66885,8,32,13,25,13,1,92,38.22174328753844,-109.3987667
66886,9,31,13,24,14,1,92,38.22174328753844,-109.3984972
66887,9,32,12,22,14,1,90,38.22174328753844,-109.3982277
66888,9,34,12,20,14,1,90,38.22174328753844,-109.3979582
66889,9,34,13,21,14,0,91,38.22174328753844,-109.3976887
66890,7,36,12,21,14,1,91,38.22174328753844,-109.3974192
66891,7,35,12,21,14,1,90,38.22174328753844,-109.3971497
66892,8,35,13,21,14,1,92,38.22174328753844,-109.3968802
66893,8,35,13,21,13,0,90,38.22174328753844,-109.3966107
66894,7,36,13,22,14,1,93,38.22174328753844,-109.3963412
66895,7,37,13,22,14,1,94,38.22174328753844,-109.3960717
66896,7,37,13,21,14,1,93,38.22174328753844,-109.3958022
66897,7,37,13,20,14,1,92,38.22174328753844,-109.3955327
66898,7,38,13,20,13,0,91,38.22174328753844,-109.3952632
66899,5,36,12,22,13,1,89,38.22174328753844,-109.3949938
66900,5,36,12,20,14,1,88,38.22174328753844,-109.3947243
66901,4,38,12,18,13,2,87,38.22174328753844,-109.3944548
66902,3,40,12,17,12,2,86,38.22174328753844,-109.3941853
66903,3,40,12,17,13,2,87,38.22174328753844,-109.3939158
66904,4,37,12,17,14,2,86,38.22174328753844,-109.3936463
66905,5,35,12,18,15,2,87,38.22174328753844,-109.3933768
66906,8,33,12,20,16,1,90,38.22174328753844,-109.3931073
66907,11,29,11,21,15,2,89,38.22174328753844,-109.3928378
66908,22,26,11,21,11,1,92,38.22174328753844,-109.3925683
66909,37,28,9,14,8,0,96,38.22174328753844,-109.3922988
66910,46,26,8,12,7,0,99,38.22174328753844,-109.3920293
66911,48,22,9,14,7,0,100,38.22174328753844,-109.3917598
66912,42,19,9,15,4,0,89,38.22174328753844,-109.3914903
66913,38,17,8,13,2,1,79,38.22174328753844,-109.3912208
66914,39,17,8,10,1,1,76,38.22174328753844,-109.3909513
66915,39,18,9,12,3,1,82,38.22174328753844,-109.3906818
66916,34,22,12,16,6,2,92,38.22174328753844,-109.3904123
66917,29,24,12,20,9,1,95,38.22174328753844,-109.3901429
66918,13,30,12,14,15,2,86,38.22174328753844,-109.3898734
66919,5,34,11,12,15,3,80,38.22174328753844,-109.3896039
66920,3,35,10,10,16,4,78,38.22174328753844,-109.3893344
66921,3,33,10,7,14,6,73,38.22174328753844,-109.3890649
66922,2,32,10,6,12,9,71,38.22174328753844,-109.3887954
66923,1,28,11,8,10,11,69,38.22174328753844,-109.3885259
66924,1,25,11,12,11,10,70,38.22174328753844,-109.3882564
66925,2,25,10,15,14,6,72,38.22174328753844,-109.3879869
66926,4,31,10,12,15,3,75,38.22174328753844,-109.3877174
66927,2,33,10,11,14,4,74,38.22174328753844,-109.3874479
66928,6,33,12,14,14,2,81,38.22174328753844,-109.3871784
66929,14,34,13,13,15,2,91,38.22174328753844,-109.3869089
66930,16,31,13,12,14,4,90,38.22174328753844,-109.3866394
66931,9,34,13,12,14,4,86,38.22174328753844,-109.3863699
66932,5,37,12,10,16,2,82,38.22174328753844,-109.3861004
66933,4,41,11,8,16,1,81,38.22174328753844,-109.3858309
66934,4,41,10,8,15,1,79,38.22174328753844,-109.3855614
66935,4,41,10,8,14,1,78,38.22174328753844,-109.3852919
66936,4,40,10,8,14,1,77,38.22174328753844,-109.3850225
66937,4,42,10,8,13,1,78,38.22174328753844,-109.384753
66938,4,38,10,7,13,3,75,38.22174328753844,-109.3844835
66939,2,36,9,6,12,4,69,38.22174328753844,-109.384214
66940,2,40,8,6,11,4,71,38.22174328753844,-109.3839445
66941,2,39,10,7,15,3,76,38.22174328753844,-109.383675
66942,2,36,10,7,14,5,74,38.22174328753844,-109.3834055
66943,2,34,9,6,10,7,68,38.22174328753844,-109.383136
66944,2,38,8,5,6,7,66,38.22174328753844,-109.3828665
66945,2,42,7,6,4,5,66,38.22174328753844,-109.382597
66946,3,46,6,9,6,2,72,38.22174328753844,-109.3823275
66947,2,45,6,7,6,3,69,38.22174328753844,-109.382058
66948,2,44,7,7,7,2,69,38.22174328753844,-109.3817885
66949,2,44,7,6,8,2,69,38.22174328753844,-109.381519
66950,2,43,8,5,10,3,71,38.22174328753844,-109.3812495
66951,11,19,11,26,22,2,91,38.221473792953205,-109.4114329
66952,8,16,10,27,25,6,92,38.221473792953205,-109.4111634
66953,6,16,11,27,25,6,91,38.221473792953205,-109.4108939
66954,4,18,11,28,24,3,88,38.221473792953205,-109.4106244
66955,12,24,10,19,21,2,88,38.221473792953205,-109.4103549
66956,11,24,10,22,19,2,88,38.221473792953205,-109.4100855
66957,7,25,11,22,21,2,88,38.221473792953205,-109.409816
66958,5,25,12,22,23,3,90,38.221473792953205,-109.4095465
66959,4,25,12,21,23,3,88,38.221473792953205,-109.409277
66960,6,24,12,21,22,3,88,38.221473792953205,-109.4090075
66961,11,22,11,18,21,2,85,38.221473792953205,-109.408738
66962,7,20,12,23,15,2,79,38.221473792953205,-109.4084685
66963,4,25,11,19,15,2,76,38.221473792953205,-109.408199
66964,6,30,9,14,14,2,75,38.221473792953205,-109.4079295
66965,9,30,12,13,16,2,82,38.221473792953205,-109.40766
66966,12,21,12,20,16,3,84,38.221473792953205,-109.4073905
66967,12,18,11,23,21,3,88,38.221473792953205,-109.407121
66968,15,15,12,23,19,6,90,38.221473792953205,-109.4068515
66969,14,14,12,18,23,9,90,38.221473792953205,-109.406582
66970,12,10,10,23,25,9,89,38.221473792953205,-109.4063125
66971,11,11,10,26,23,8,89,38.221473792953205,-109.406043
66972,10,16,12,25,21,4,88,38.221473792953205,-109.4057735
66973,10,27,12,24,14,2,89,38.221473792953205,-109.405504
66974,8,35,13,20,14,2,92,38.221473792953205,-109.4052345
66975,7,36,13,22,13,2,93,38.221473792953205,-109.4049651
66976,7,33,12,24,13,1,90,38.221473792953205,-109.4046956
66977,6,29,12,26,15,1,89,38.221473792953205,-109.4044261
66978,5,30,13,27,16,2,93,38.221473792953205,-109.4041566
66979,5,29,13,26,16,1,90,38.221473792953205,-109.4038871
66980,6,33,13,24,15,1,92,38.221473792953205,-109.4036176
66981,6,36,14,21,15,1,93,38.221473792953205,-109.4033481
66982,7,36,14,21,15,1,94,38.221473792953205,-109.4030786
66983,7,36,14,23,13,1,94,38.221473792953205,-109.4028091
66984,7,34,13,21,13,2,90,38.221473792953205,-109.4025396
66985,4,27,11,26,14,2,84,38.221473792953205,-109.4022701
66986,5,26,10,21,17,1,80,38.221473792953205,-109.4020006
66987,5,38,9,16,12,0,80,38.221473792953205,-109.4017311
66988,6,44,8,9,8,1,76,38.221473792953205,-109.4014616
66989,4,41,8,10,8,2,73,38.221473792953205,-109.4011921
66990,3,36,8,11,8,3,69,38.221473792953205,-109.4009226
66991,2,36,9,11,10,3,71,38.221473792953205,-109.4006531
66992,3,36,9,10,11,3,72,38.221473792953205,-109.4003836
66993,9,36,12,17,11,1,86,38.221473792953205,-109.4001142
66994,19,34,13,22,7,0,95,38.221473792953205,-109.3998447
66995,20,31,13,23,8,0,95,38.221473792953205,-109.3995752
66996,14,30,13,26,11,1,95,38.221473792953205,-109.3993057
66997,12,30,13,25,12,1,93,38.221473792953205,-109.3990362
66998,11,29,12,24,14,1,91,38.221473792953205,-109.3987667
66999,9,30,12,24,14,1,90,38.221473792953205,-109.3984972
67000,8,32,12,23,14,1,90,38.221473792953205,-109.3982277
67001,7,36,12,21,13,1,90,38.221473792953205,-109.3979582
67002,7,35,13,21,13,1,90,38.221473792953205,-109.3976887
67003,6,37,13,21,13,1,91,38.221473792953205,-109.3974192
67004,5,38,13,22,13,1,92,38.221473792953205,-109.3971497
67005,6,37,13,22,13,1,92,38.221473792953205,-109.3968802
67006,6,37,13,22,13,1,92,38.221473792953205,-109.3966107
67007,6,38,14,22,13,0,93,38.221473792953205,-109.3963412
67008,5,38,13,23,13,0,92,38.221473792953205,-109.3960717
67009,6,37,13,23,13,0,92,38.221473792953205,-109.3958022
67010,7,36,13,22,13,0,91,38.221473792953205,-109.3955327
67011,7,36,13,21,14,1,92,38.221473792953205,-109.3952632
67012,7,34,12,22,14,1,90,38.221473792953205,-109.3949938
67013,7,32,12,21,15,1,88,38.221473792953205,-109.3947243
67014,5,33,12,20,15,2,87,38.221473792953205,-109.3944548
67015,3,34,11,19,15,2,84,38.221473792953205,-109.3941853
67016,3,34,11,19,15,2,84,38.221473792953205,-109.3939158
67017,5,33,12,18,15,2,85,38.221473792953205,-109.3936463
67018,7,32,11,18,16,2,86,38.221473792953205,-109.3933768
67019,11,29,11,21,16,2,90,38.221473792953205,-109.3931073
67020,16,23,11,23,15,1,89,38.221473792953205,-109.3928378
67021,24,20,12,22,11,1,90,38.221473792953205,-109.3925683
67022,46,21,10,16,6,1,100,38.221473792953205,-109.3922988
67023,52,20,9,14,3,0,98,38.221473792953205,-109.3920293
67024,46,18,9,13,2,0,88,38.221473792953205,-109.3917598
67025,38,17,8,12,2,0,77,38.221473792953205,-109.3914903
67026,36,17,6,7,1,1,68,38.221473792953205,-109.3912208
67027,35,18,7,8,2,0,70,38.221473792953205,-109.3909513
67028,36,23,10,12,4,0,85,38.221473792953205,-109.3906818
67029,28,29,11,18,7,0,93,38.221473792953205,-109.3904123
67030,12,34,13,13,11,3,86,38.221473792953205,-109.3901429
67031,4,31,10,13,12,4,74,38.221473792953205,-109.3898734
67032,1,29,10,9,12,7,68,38.221473792953205,-109.3896039
67033,1,32,10,6,11,8,68,38.221473792953205,-109.3893344
67034,1,39,9,3,11,8,71,38.221473792953205,-109.3890649
67035,1,37,9,4,12,7,70,38.221473792953205,-109.3887954
67036,1,41,9,3,12,7,73,38.221473792953205,-109.3885259
67037,2,39,9,7,10,5,72,38.221473792953205,-109.3882564
67038,2,35,9,9,11,4,70,38.221473792953205,-109.3879869
67039,3,34,10,10,13,4,74,38.221473792953205,-109.3877174
67040,2,33,10,9,12,6,72,38.221473792953205,-109.3874479
67041,2,31,10,8,12,7,70,38.221473792953205,-109.3871784
67042,1,27,10,9,10,9,66,38.221473792953205,-109.3869089
67043,2,30,10,5,10,10,67,38.221473792953205,-109.3866394
67044,3,40,9,4,12,6,74,38.221473792953205,-109.3863699
67045,3,43,9,6,15,3,79,38.221473792953205,-109.3861004
67046,3,44,10,7,15,2,81,38.221473792953205,-109.3858309
67047,3,45,10,7,15,2,82,38.221473792953205,-109.3855614
67048,3,45,10,7,15,2,82,38.221473792953205,-109.3852919
67049,3,45,10,7,15,2,82,38.221473792953205,-109.3850225
67050,3,44,11,8,15,2,83,38.221473792953205,-109.384753
67051,4,44,10,8,15,2,83,38.221473792953205,-109.3844835
67052,3,41,9,7,12,3,75,38.221473792953205,-109.384214
67053,2,36,8,5,10,6,67,38.221473792953205,-109.3839445
67054,2,36,9,6,13,5,71,38.221473792953205,-109.383675
67055,3,34,8,6,11,5,67,38.221473792953205,-109.3834055
67056,3,36,8,7,9,4,67,38.221473792953205,-109.383136
67057,3,46,7,8,5,2,71,38.221473792953205,-109.3828665
67058,2,47,6,8,5,3,71,38.221473792953205,-109.382597
67059,2,52,7,7,8,1,77,38.221473792953205,-109.3823275
67060,2,54,7,6,9,1,79,38.221473792953205,-109.382058
67061,2,53,8,5,10,1,79,38.221473792953205,-109.3817885
67062,2,53,8,5,9,2,79,38.221473792953205,-109.381519
67063,1,52,9,7,10,1,80,38.221473792953205,-109.3812495
67064,11,20,11,25,20,2,89,38.221204298367965,-109.4114329
67065,11,17,9,24,25,5,91,38.221204298367965,-109.4111634
67066,7,17,11,29,23,5,92,38.221204298367965,-109.4108939
67067,6,18,10,31,23,3,91,38.221204298367965,-109.4106244
67068,12,22,10,21,24,2,91,38.221204298367965,-109.4103549
67069,14,23,9,21,18,2,87,38.221204298367965,-109.4100855
67070,11,24,10,23,19,2,89,38.221204298367965,-109.409816
67071,7,25,11,24,20,2,89,38.221204298367965,-109.4095465
67072,4,25,11,25,21,2,88,38.221204298367965,-109.409277
67073,4,25,11,23,24,2,89,38.221204298367965,-109.4090075
67074,5,20,10,27,23,3,88,38.221204298367965,-109.408738
67075,8,18,11,22,24,3,86,38.221204298367965,-109.4084685
67076,16,20,11,16,22,3,88,38.221204298367965,-109.408199
67077,14,22,12,15,19,3,85,38.221204298367965,-109.4079295
67078,12,21,10,21,20,4,88,38.221204298367965,-109.40766
67079,10,19,10,23,20,4,86,38.221204298367965,-109.4073905
67080,14,20,11,19,19,4,87,38.221204298367965,-109.407121
67081,17,21,11,15,19,5,88,38.221204298367965,-109.4068515
67082,15,19,12,15,21,5,87,38.221204298367965,-109.406582
67083,14,20,10,19,21,3,87,38.221204298367965,-109.4063125
67084,11,17,10,21,22,6,87,38.221204298367965,-109.406043
67085,10,18,11,21,22,7,89,38.221204298367965,-109.4057735
67086,13,23,11,21,19,3,90,38.221204298367965,-109.405504
67087,8,34,12,23,14,1,92,38.221204298367965,-109.4052345
67088,7,36,13,19,15,2,92,38.221204298367965,-109.4049651
67089,7,35,13,19,16,2,92,38.221204298367965,-109.4046956
67090,7,33,13,20,16,2,91,38.221204298367965,-109.4044261
67091,6,32,13,18,17,3,89,38.221204298367965,-109.4041566
67092,6,31,13,20,17,2,89,38.221204298367965,-109.4038871
67093,7,32,13,18,17,3,90,38.221204298367965,-109.4036176
67094,6,35,13,15,17,3,89,38.221204298367965,-109.4033481
67095,6,39,13,15,16,2,91,38.221204298367965,-109.4030786
67096,6,39,14,20,14,1,94,38.221204298367965,-109.4028091
67097,6,36,13,21,14,1,91,38.221204298367965,-109.4025396
67098,7,27,11,28,13,1,87,38.221204298367965,-109.4022701
67099,9,25,10,26,12,1,83,38.221204298367965,-109.4020006
67100,5,34,9,12,13,2,75,38.221204298367965,-109.4017311
67101,4,36,9,8,10,2,69,38.221204298367965,-109.4014616
67102,4,38,7,9,10,2,70,38.221204298367965,-109.4011921
67103,3,39,7,8,9,3,69,38.221204298367965,-109.4009226
67104,3,41,7,8,9,2,70,38.221204298367965,-109.4006531
67105,4,38,8,8,9,2,69,38.221204298367965,-109.4003836
67106,5,35,9,12,10,2,73,38.221204298367965,-109.4001142
67107,10,36,11,19,9,1,86,38.221204298367965,-109.3998447
67108,12,36,13,21,11,0,93,38.221204298367965,-109.3995752
67109,13,33,13,22,13,0,94,38.221204298367965,-109.3993057
67110,12,31,12,23,13,0,91,38.221204298367965,-109.3990362
67111,11,30,12,21,15,1,90,38.221204298367965,-109.3987667
67112,8,29,11,22,15,1,86,38.221204298367965,-109.3984972
67113,7,31,12,23,14,1,88,38.221204298367965,-109.3982277
67114,6,35,12,22,13,1,89,38.221204298367965,-109.3979582
67115,7,36,12,22,13,1,91,38.221204298367965,-109.3976887
67116,6,38,13,21,12,1,91,38.221204298367965,-109.3974192
67117,5,39,13,20,12,1,90,38.221204298367965,-109.3971497
67118,5,40,13,20,12,1,91,38.221204298367965,-109.3968802
67119,4,40,14,21,12,1,92,38.221204298367965,-109.3966107
67120,4,41,14,22,11,1,93,38.221204298367965,-109.3963412
67121,5,40,13,23,12,0,93,38.221204298367965,-109.3960717
67122,5,37,13,24,12,0,91,38.221204298367965,-109.3958022
67123,5,35,12,24,13,1,90,38.221204298367965,-109.3955327
67124,5,35,12,22,14,1,89,38.221204298367965,-109.3952632
67125,7,30,12,24,14,1,88,38.221204298367965,-109.3949938
67126,9,27,12,24,14,1,87,38.221204298367965,-109.3947243
67127,7,28,12,23,15,1,86,38.221204298367965,-109.3944548
67128,5,30,11,22,15,2,85,38.221204298367965,-109.3941853
67129,4,31,11,20,15,2,83,38.221204298367965,-109.3939158
67130,7,30,11,20,16,2,86,38.221204298367965,-109.3936463
67131,11,29,11,20,15,1,87,38.221204298367965,-109.3933768
67132,13,25,10,22,15,2,87,38.221204298367965,-109.3931073
67133,19,20,11,23,13,2,88,38.221204298367965,-109.3928378
67134,22,16,12,23,12,1,86,38.221204298367965,-109.3925683
67135,34,16,11,20,9,2,92,38.221204298367965,-109.3922988
67136,41,21,9,11,3,2,87,38.221204298367965,-109.3920293
67137,36,22,7,5,2,0,72,38.221204298367965,-109.3917598
67138,39,22,7,3,2,0,73,38.221204298367965,-109.3914903
67139,40,25,9,5,2,0,81,38.221204298367965,-109.3912208
67140,37,28,11,13,4,0,93,38.221204298367965,-109.3909513
67141,31,30,11,18,5,0,95,38.221204298367965,-109.3906818
67142,22,34,12,18,9,0,95,38.221204298367965,-109.3904123
67143,7,35,12,11,12,4,81,38.221204298367965,-109.3901429
67144,4,29,10,8,11,6,68,38.221204298367965,-109.3898734
67145,2,33,9,3,10,9,66,38.221204298367965,-109.3896039
67146,1,40,9,3,11,7,71,38.221204298367965,-109.3893344
67147,2,41,9,6,12,3,73,38.221204298367965,-109.3890649
67148,3,43,9,12,11,1,79,38.221204298367965,-109.3887954
67149,3,44,9,10,10,1,77,38.221204298367965,-109.3885259
67150,2,47,9,9,9,1,77,38.221204298367965,-109.3882564
67151,2,48,8,10,8,1,77,38.221204298367965,-109.3879869
67152,2,49,8,11,8,1,79,38.221204298367965,-109.3877174
67153,2,45,9,11,10,1,78,38.221204298367965,-109.3874479
67154,2,41,8,8,9,3,71,38.221204298367965,-109.3871784
67155,2,40,8,8,8,4,70,38.221204298367965,-109.3869089
67156,2,40,8,8,8,4,70,38.221204298367965,-109.3866394
67157,1,36,8,8,10,4,67,38.221204298367965,-109.3863699
67158,1,35,9,4,11,7,67,38.221204298367965,-109.3861004
67159,2,37,10,4,12,7,72,38.221204298367965,-109.3858309
67160,3,39,10,5,14,5,76,38.221204298367965,-109.3855614
67161,3,40,10,6,15,3,77,38.221204298367965,-109.3852919
67162,4,43,10,8,14,1,80,38.221204298367965,-109.3850225
67163,3,43,10,7,14,2,79,38.221204298367965,-109.384753
67164,3,44,10,7,13,2,79,38.221204298367965,-109.3844835
67165,3,41,10,7,13,2,76,38.221204298367965,-109.384214
67166,1,36,8,5,10,6,66,38.221204298367965,-109.3839445
67167,1,42,7,6,7,5,68,38.221204298367965,-109.383675
67168,2,44,7,6,5,4,68,38.221204298367965,-109.3834055
67169,2,44,6,7,5,4,68,38.221204298367965,-109.383136
67170,2,47,6,6,7,3,71,38.221204298367965,-109.3828665
67171,2,53,7,5,9,2,78,38.221204298367965,-109.382597
67172,1,57,7,3,11,1,80,38.221204298367965,-109.3823275
67173,1,58,8,5,12,0,84,38.221204298367965,-109.382058
67174,1,59,8,5,12,0,85,38.221204298367965,-109.3817885
67175,1,58,8,5,10,1,83,38.221204298367965,-109.381519
67176,1,55,8,9,9,1,83,38.221204298367965,-109.3812495
67177,13,23,11,20,18,2,87,38.22093480378273,-109.4114329
67178,15,22,9,19,19,3,87,38.22093480378273,-109.4111634
67179,14,21,9,24,21,2,91,38.22093480378273,-109.4108939
67180,7,20,10,29,22,2,90,38.22093480378273,-109.4106244
67181,8,22,10,26,23,2,91,38.22093480378273,-109.4103549
67182,17,22,9,22,18,1,89,38.22093480378273,-109.4100855
67183,16,22,9,24,16,1,88,38.22093480378273,-109.409816
67184,13,24,10,25,17,1,90,38.22093480378273,-109.4095465
67185,9,27,11,26,17,1,91,38.22093480378273,-109.409277
67186,6,26,11,24,21,2,90,38.22093480378273,-109.4090075
67187,7,22,11,23,24,3,90,38.22093480378273,-109.408738
67188,11,19,11,21,23,3,88,38.22093480378273,-109.4084685
67189,16,19,10,20,19,3,87,38.22093480378273,-109.408199
67190,12,20,11,21,15,2,81,38.22093480378273,-109.4079295
67191,12,21,11,19,19,2,84,38.22093480378273,-109.40766
67192,13,21,11,17,20,5,87,38.22093480378273,-109.4073905
67193,11,23,12,14,20,7,87,38.22093480378273,-109.407121
67194,12,25,12,15,18,6,88,38.22093480378273,-109.4068515
67195,15,20,12,15,17,4,83,38.22093480378273,-109.406582
67196,13,20,10,21,19,3,86,38.22093480378273,-109.4063125
67197,11,23,10,21,17,3,85,38.22093480378273,-109.406043
67198,10,23,10,21,18,3,85,38.22093480378273,-109.4057735
67199,11,21,11,18,20,3,84,38.22093480378273,-109.405504
67200,11,24,11,20,18,2,86,38.22093480378273,-109.4052345
67201,9,32,12,19,15,2,89,38.22093480378273,-109.4049651
67202,7,33,12,19,16,2,89,38.22093480378273,-109.4046956
67203,7,33,13,18,17,2,90,38.22093480378273,-109.4044261
67204,6,33,12,21,16,1,89,38.22093480378273,-109.4041566
67205,7,33,13,22,16,1,92,38.22093480378273,-109.4038871
67206,6,33,12,20,16,2,89,38.22093480378273,-109.4036176
67207,6,33,13,19,16,2,89,38.22093480378273,-109.4033481
67208,6,34,13,20,16,1,90,38.22093480378273,-109.4030786
67209,6,35,13,22,15,1,92,38.22093480378273,-109.4028091
67210,6,35,13,22,16,1,93,38.22093480378273,-109.4025396
67211,7,29,12,26,15,1,90,38.22093480378273,-109.4022701
67212,10,27,11,29,13,1,91,38.22093480378273,-109.4020006
67213,11,32,11,24,11,1,90,38.22093480378273,-109.4017311
67214,8,37,12,21,10,1,89,38.22093480378273,-109.4014616
67215,7,38,11,18,11,1,86,38.22093480378273,-109.4011921
67216,5,37,9,13,12,1,77,38.22093480378273,-109.4009226
67217,3,36,8,8,11,2,68,38.22093480378273,-109.4006531
67218,3,35,7,6,9,3,63,38.22093480378273,-109.4003836
67219,5,34,10,9,11,2,71,38.22093480378273,-109.4001142
67220,8,37,12,17,10,1,85,38.22093480378273,-109.3998447
67221,11,39,14,21,10,0,95,38.22093480378273,-109.3995752
67222,12,36,13,22,12,0,95,38.22093480378273,-109.3993057
67223,10,33,12,23,14,0,92,38.22093480378273,-109.3990362
67224,10,30,12,22,15,1,90,38.22093480378273,-109.3987667
67225,8,30,12,23,15,1,89,38.22093480378273,-109.3984972
67226,7,32,12,24,14,1,90,38.22093480378273,-109.3982277
67227,6,34,12,25,13,0,90,38.22093480378273,-109.3979582
67228,6,37,13,24,13,0,93,38.22093480378273,-109.3976887
67229,6,38,13,22,12,1,92,38.22093480378273,-109.3974192
67230,5,38,13,20,12,1,89,38.22093480378273,-109.3971497
67231,5,39,13,21,12,1,91,38.22093480378273,-109.3968802
67232,4,39,13,22,11,1,90,38.22093480378273,-109.3966107
67233,3,40,13,21,11,1,89,38.22093480378273,-109.3963412
67234,3,39,13,22,12,1,90,38.22093480378273,-109.3960717
67235,3,36,12,23,13,1,88,38.22093480378273,-109.3958022
67236,4,34,12,23,14,1,88,38.22093480378273,-109.3955327
67237,4,33,12,23,15,1,88,38.22093480378273,-109.3952632
67238,8,28,12,26,14,1,89,38.22093480378273,-109.3949938
67239,12,23,12,27,14,2,90,38.22093480378273,-109.3947243
67240,11,26,12,25,13,1,88,38.22093480378273,-109.3944548
67241,7,31,11,21,14,1,85,38.22093480378273,-109.3941853
67242,7,34,11,18,14,1,85,38.22093480378273,-109.3939158
67243,10,33,10,19,14,1,87,38.22093480378273,-109.3936463
67244,12,30,11,21,14,1,89,38.22093480378273,-109.3933768
67245,14,26,11,21,14,2,88,38.22093480378273,-109.3931073
67246,17,21,11,21,13,2,85,38.22093480378273,-109.3928378
67247,19,19,12,23,13,2,88,38.22093480378273,-109.3925683
67248,25,23,12,17,10,3,90,38.22093480378273,-109.3922988
67249,24,32,11,14,6,1,88,38.22093480378273,-109.3920293
67250,29,34,10,9,5,0,87,38.22093480378273,-109.3917598
67251,35,33,10,9,6,0,93,38.22093480378273,-109.3914903
67252,22,35,12,18,8,0,95,38.22093480378273,-109.3912208
67253,16,37,13,17,11,0,94,38.22093480378273,-109.3909513
67254,13,38,13,17,13,1,95,38.22093480378273,-109.3906818
67255,10,35,13,16,13,1,88,38.22093480378273,-109.3904123
67256,6,33,11,10,11,6,77,38.22093480378273,-109.3901429
67257,4,29,10,12,12,4,71,38.22093480378273,-109.3898734
67258,2,31,9,7,11,6,66,38.22093480378273,-109.3896039
67259,2,39,9,6,11,4,71,38.22093480378273,-109.3893344
67260,4,43,10,11,12,1,81,38.22093480378273,-109.3890649
67261,5,45,11,10,13,1,85,38.22093480378273,-109.3887954
67262,4,47,11,8,15,1,86,38.22093480378273,-109.3885259
67263,3,52,10,5,16,0,86,38.22093480378273,-109.3882564
67264,2,54,9,4,15,0,84,38.22093480378273,-109.3879869
67265,2,53,9,4,15,1,84,38.22093480378273,-109.3877174
67266,3,54,9,4,13,2,85,38.22093480378273,-109.3874479
67267,3,51,9,4,13,2,82,38.22093480378273,-109.3871784
67268,2,49,9,3,14,2,79,38.22093480378273,-109.3869089
67269,2,46,9,5,13,2,77,38.22093480378273,-109.3866394
67270,2,47,8,6,10,2,75,38.22093480378273,-109.3863699
67271,2,49,8,8,9,1,77,38.22093480378273,-109.3861004
67272,3,45,9,7,11,2,77,38.22093480378273,-109.3858309
67273,2,40,9,6,11,3,71,38.22093480378273,-109.3855614
67274,2,38,9,6,11,3,69,38.22093480378273,-109.3852919
67275,4,41,9,7,11,2,74,38.22093480378273,-109.3850225
67276,3,44,9,7,12,2,77,38.22093480378273,-109.384753
67277,3,43,10,7,13,2,78,38.22093480378273,-109.3844835
67278,3,39,10,7,13,3,75,38.22093480378273,-109.384214
67279,2,36,9,5,11,5,68,38.22093480378273,-109.3839445
67280,2,41,8,3,9,6,69,38.22093480378273,-109.383675
67281,1,41,8,5,9,5,69,38.22093480378273,-109.3834055
67282,2,44,8,5,10,3,72,38.22093480378273,-109.383136
67283,2,49,8,5,10,2,76,38.22093480378273,-109.3828665
67284,2,57,8,5,10,0,82,38.22093480378273,-109.382597
67285,1,56,8,5,13,1,84,38.22093480378273,-109.3823275
67286,1,55,8,2,14,1,81,38.22093480378273,-109.382058
67287,1,58,8,2,13,1,83,38.22093480378273,-109.3817885
67288,1,60,8,4,12,1,86,38.22093480378273,-109.381519
67289,2,59,8,7,9,0,85,38.22093480378273,-109.3812495
67290,13,24,10,14,19,4,84,38.22066530919749,-109.4114329
67291,12,25,9,19,16,2,83,38.22066530919749,-109.4111634
67292,17,24,9,21,16,1,88,38.22066530919749,-109.4108939
67293,16,23,10,21,19,1,90,38.22066530919749,-109.4106244
67294,8,24,11,28,20,2,93,38.22066530919749,-109.4103549
67295,14,23,10,25,19,2,93,38.22066530919749,-109.4100855
67296,17,23,10,24,17,1,92,38.22066530919749,-109.409816
67297,17,25,10,22,17,0,91,38.22066530919749,-109.4095465
67298,13,27,10,23,17,0,90,38.22066530919749,-109.409277
67299,10,28,10,24,16,1,89,38.22066530919749,-109.4090075
67300,13,26,10,23,17,0,89,38.22066530919749,-109.408738
67301,13,24,9,22,19,1,88,38.22066530919749,-109.4084685
67302,12,21,10,23,19,2,87,38.22066530919749,-109.408199
67303,12,20,10,24,20,2,88,38.22066530919749,-109.4079295
67304,15,23,9,27,14,1,89,38.22066530919749,-109.40766
67305,16,21,9,25,17,1,89,38.22066530919749,-109.4073905
67306,14,21,10,23,19,2,89,38.22066530919749,-109.407121
67307,13,24,11,18,19,4,89,38.22066530919749,-109.4068515
67308,12,25,12,15,17,4,85,38.22066530919749,-109.406582
67309,15,19,11,18,19,2,84,38.22066530919749,-109.4063125
67310,11,23,11,20,19,2,86,38.22066530919749,-109.406043
67311,11,25,10,22,18,1,87,38.22066530919749,-109.4057735
67312,12,24,9,21,19,2,87,38.22066530919749,-109.405504
67313,10,20,10,21,20,3,84,38.22066530919749,-109.4052345
67314,10,25,11,21,17,2,86,38.22066530919749,-109.4049651
67315,7,30,12,23,16,2,90,38.22066530919749,-109.4046956
67316,6,31,12,22,17,2,90,38.22066530919749,-109.4044261
67317,6,32,12,23,16,1,90,38.22066530919749,-109.4041566
67318,5,34,13,20,16,1,89,38.22066530919749,-109.4038871
67319,5,36,13,18,16,1,89,38.22066530919749,-109.4036176
67320,5,37,13,19,16,1,91,38.22066530919749,-109.4033481
67321,6,36,13,19,16,1,91,38.22066530919749,-109.4030786
67322,7,33,14,18,16,2,90,38.22066530919749,-109.4028091
67323,7,32,13,21,15,1,89,38.22066530919749,-109.4025396
67324,8,29,12,25,15,1,90,38.22066530919749,-109.4022701
67325,9,28,11,27,14,1,90,38.22066530919749,-109.4020006
67326,9,29,11,27,13,1,90,38.22066530919749,-109.4017311
67327,11,32,12,26,12,1,94,38.22066530919749,-109.4014616
67328,11,33,13,25,11,0,93,38.22066530919749,-109.4011921
67329,8,36,13,23,10,1,91,38.22066530919749,-109.4009226
67330,7,38,12,19,11,1,88,38.22066530919749,-109.4006531
67331,6,37,11,17,12,1,84,38.22066530919749,-109.4003836
67332,9,36,12,21,10,1,89,38.22066530919749,-109.4001142
67333,12,34,14,22,12,0,94,38.22066530919749,-109.3998447
67334,12,32,13,25,13,0,95,38.22066530919749,-109.3995752
67335,10,31,12,26,14,0,93,38.22066530919749,-109.3993057
67336,10,30,12,26,14,1,93,38.22066530919749,-109.3990362
67337,10,29,12,24,15,1,91,38.22066530919749,-109.3987667
67338,6,30,11,24,15,1,87,38.22066530919749,-109.3984972
67339,5,33,12,25,14,1,90,38.22066530919749,-109.3982277
67340,5,36,13,25,13,1,93,38.22066530919749,-109.3979582
67341,5,38,13,24,13,1,94,38.22066530919749,-109.3976887
67342,5,37,13,24,13,1,93,38.22066530919749,-109.3974192
67343,5,37,13,22,13,1,91,38.22066530919749,-109.3971497
67344,5,37,13,22,13,1,91,38.22066530919749,-109.3968802
67345,4,37,12,22,12,1,88,38.22066530919749,-109.3966107
67346,4,37,12,20,13,1,87,38.22066530919749,-109.3963412
67347,3,36,12,22,13,1,87,38.22066530919749,-109.3960717
67348,4,35,12,23,14,1,89,38.22066530919749,-109.3958022
67349,4,33,11,23,14,1,86,38.22066530919749,-109.3955327
67350,5,32,12,26,15,1,91,38.22066530919749,-109.3952632
67351,8,27,12,27,15,1,90,38.22066530919749,-109.3949938
67352,11,24,12,26,14,2,89,38.22066530919749,-109.3947243
67353,11,25,11,23,13,2,85,38.22066530919749,-109.3944548
67354,11,31,11,19,14,1,87,38.22066530919749,-109.3941853
67355,13,37,10,16,12,0,88,38.22066530919749,-109.3939158
67356,15,36,10,17,12,0,90,38.22066530919749,-109.3936463
67357,14,35,11,17,13,1,91,38.22066530919749,-109.3933768
67358,15,36,11,16,14,1,93,38.22066530919749,-109.3931073
67359,17,38,11,15,12,1,94,38.22066530919749,-109.3928378
67360,17,37,11,16,12,1,94,38.22066530919749,-109.3925683
67361,17,41,11,15,10,0,94,38.22066530919749,-109.3922988
67362,17,41,11,16,9,0,94,38.22066530919749,-109.3920293
67363,16,40,12,18,9,0,95,38.22066530919749,-109.3917598
67364,14,38,12,18,12,0,94,38.22066530919749,-109.3914903
67365,6,40,12,14,13,2,87,38.22066530919749,-109.3912208
67366,6,39,13,15,14,1,88,38.22066530919749,-109.3909513
67367,6,38,12,15,15,1,87,38.22066530919749,-109.3906818
67368,4,35,12,13,14,3,81,38.22066530919749,-109.3904123
67369,2,33,10,5,12,8,70,38.22066530919749,-109.3901429
67370,3,35,9,4,12,7,70,38.22066530919749,-109.3898734
67371,4,38,9,7,14,3,75,38.22066530919749,-109.3896039
67372,5,40,10,8,15,1,79,38.22066530919749,-109.3893344
67373,5,43,11,9,14,1,83,38.22066530919749,-109.3890649
67374,6,47,12,10,14,1,90,38.22066530919749,-109.3887954
67375,6,46,12,9,16,1,90,38.22066530919749,-109.3885259
67376,3,49,10,4,17,1,84,38.22066530919749,-109.3882564
67377,3,51,9,2,16,1,82,38.22066530919749,-109.3879869
67378,3,49,10,6,16,1,85,38.22066530919749,-109.3877174
67379,5,50,11,6,16,1,89,38.22066530919749,-109.3874479
67380,4,48,11,5,17,2,87,38.22066530919749,-109.3871784
67381,3,47,11,3,17,3,84,38.22066530919749,-109.3869089
67382,2,46,10,1,16,5,80,38.22066530919749,-109.3866394
67383,1,50,9,0,16,3,79,38.22066530919749,-109.3863699
67384,1,55,9,4,15,1,85,38.22066530919749,-109.3861004
67385,3,52,10,6,15,1,87,38.22066530919749,-109.3858309
67386,3,47,10,8,13,1,82,38.22066530919749,-109.3855614
67387,4,44,10,8,12,1,79,38.22066530919749,-109.3852919
67388,3,44,10,8,12,2,79,38.22066530919749,-109.3850225
67389,3,50,10,7,12,1,83,38.22066530919749,-109.384753
67390,3,42,10,6,13,2,76,38.22066530919749,-109.3844835
67391,3,36,9,7,12,3,70,38.22066530919749,-109.384214
67392,3,42,8,9,9,2,73,38.22066530919749,-109.3839445
67393,2,41,8,7,10,3,71,38.22066530919749,-109.383675
67394,2,45,9,6,11,2,75,38.22066530919749,-109.3834055
67395,1,47,8,6,10,2,74,38.22066530919749,-109.383136
67396,1,50,8,6,9,2,76,38.22066530919749,-109.3828665
67397,1,54,8,7,9,1,80,38.22066530919749,-109.382597
67398,1,56,9,5,13,1,85,38.22066530919749,-109.3823275
67399,1,54,8,4,13,1,81,38.22066530919749,-109.382058
67400,1,54,8,4,13,1,81,38.22066530919749,-109.3817885
67401,1,56,9,5,12,1,84,38.22066530919749,-109.381519
67402,1,59,8,7,10,1,86,38.22066530919749,-109.3812495
67403,15,23,10,15,18,4,85,38.22039581461226,-109.4114329
67404,13,26,10,20,15,2,86,38.22039581461226,-109.4111634
67405,15,25,9,23,14,1,87,38.22039581461226,-109.4108939
67406,18,23,9,22,17,1,90,38.22039581461226,-109.4106244
67407,11,22,10,28,19,2,92,38.22039581461226,-109.4103549
67408,7,24,11,26,21,3,92,38.22039581461226,-109.4100855
67409,12,24,11,25,19,2,93,38.22039581461226,-109.409816
67410,17,23,10,26,16,1,93,38.22039581461226,-109.4095465
67411,19,24,10,25,15,0,93,38.22039581461226,-109.409277
67412,15,28,10,24,15,0,92,38.22039581461226,-109.4090075
67413,12,29,10,25,15,0,91,38.22039581461226,-109.408738
67414,11,29,10,24,16,1,91,38.22039581461226,-109.4084685
67415,11,26,10,24,16,1,88,38.22039581461226,-109.408199
67416,14,22,10,25,15,1,87,38.22039581461226,-109.4079295
67417,13,30,11,24,14,1,93,38.22039581461226,-109.40766
67418,9,32,11,22,15,1,90,38.22039581461226,-109.4073905
67419,10,29,11,20,17,1,88,38.22039581461226,-109.407121
67420,12,27,11,20,19,1,90,38.22039581461226,-109.4068515
67421,11,28,11,18,19,2,89,38.22039581461226,-109.406582
67422,13,27,12,15,18,2,87,38.22039581461226,-109.4063125
67423,16,23,11,18,19,1,88,38.22039581461226,-109.406043
67424,15,23,10,22,18,1,89,38.22039581461226,-109.4057735
67425,16,22,9,21,19,2,89,38.22039581461226,-109.405504
67426,14,19,10,20,23,5,91,38.22039581461226,-109.4052345
67427,13,21,10,17,22,4,87,38.22039581461226,-109.4049651
67428,11,26,11,20,18,3,89,38.22039581461226,-109.4046956
67429,8,31,12,22,16,1,90,38.22039581461226,-109.4044261
67430,6,34,13,21,16,1,91,38.22039581461226,-109.4041566
67431,6,36,13,19,16,1,91,38.22039581461226,-109.4038871
67432,6,37,13,19,16,1,92,38.22039581461226,-109.4036176
67433,6,38,13,18,17,1,93,38.22039581461226,-109.4033481
67434,6,39,14,17,17,1,94,38.22039581461226,-109.4030786
67435,7,37,13,18,16,1,92,38.22039581461226,-109.4028091
67436,8,36,13,17,15,2,91,38.22039581461226,-109.4025396
67437,8,33,13,20,15,1,90,38.22039581461226,-109.4022701
67438,8,31,13,22,14,2,90,38.22039581461226,-109.4020006
67439,8,31,12,22,14,2,89,38.22039581461226,-109.4017311
67440,8,32,12,24,14,1,91,38.22039581461226,-109.4014616
67441,8,31,12,25,14,1,91,38.22039581461226,-109.4011921
67442,9,34,14,21,14,1,93,38.22039581461226,-109.4009226
67443,9,38,14,18,14,1,94,38.22039581461226,-109.4006531
67444,9,39,14,19,13,0,94,38.22039581461226,-109.4003836
67445,11,32,13,24,13,1,94,38.22039581461226,-109.4001142
67446,12,29,12,25,13,1,92,38.22039581461226,-109.3998447
67447,10,28,11,26,14,1,90,38.22039581461226,-109.3995752
67448,11,26,11,26,15,1,90,38.22039581461226,-109.3993057
67449,13,24,10,25,14,2,88,38.22039581461226,-109.3990362
67450,11,25,10,25,14,2,87,38.22039581461226,-109.3987667
67451,5,28,10,24,15,1,83,38.22039581461226,-109.3984972
67452,4,32,11,21,15,2,85,38.22039581461226,-109.3982277
67453,4,36,12,20,14,1,87,38.22039581461226,-109.3979582
67454,4,37,12,20,14,1,88,38.22039581461226,-109.3976887
67455,4,38,11,20,14,1,88,38.22039581461226,-109.3974192
67456,4,35,11,20,15,1,86,38.22039581461226,-109.3971497
67457,5,34,11,21,14,1,86,38.22039581461226,-109.3968802
67458,5,35,11,21,14,1,87,38.22039581461226,-109.3966107
67459,4,34,11,21,14,1,85,38.22039581461226,-109.3963412
67460,4,34,11,23,14,1,87,38.22039581461226,-109.3960717
67461,4,33,11,23,14,1,86,38.22039581461226,-109.3958022
67462,5,32,11,25,14,1,88,38.22039581461226,-109.3955327
67463,6,31,11,26,14,0,88,38.22039581461226,-109.3952632
67464,7,28,11,27,15,1,89,38.22039581461226,-109.3949938
67465,7,27,11,26,14,2,87,38.22039581461226,-109.3947243
67466,8,28,11,23,14,2,86,38.22039581461226,-109.3944548
67467,11,32,10,19,13,1,86,38.22039581461226,-109.3941853
67468,12,40,10,16,12,1,91,38.22039581461226,-109.3939158
67469,12,41,10,16,12,0,91,38.22039581461226,-109.3936463
67470,13,43,10,17,11,0,94,38.22039581461226,-109.3933768
67471,12,45,10,16,10,0,93,38.22039581461226,-109.3931073
67472,9,48,10,14,11,0,92,38.22039581461226,-109.3928378
67473,10,46,11,16,11,0,94,38.22039581461226,-109.3925683
67474,11,46,10,16,10,0,93,38.22039581461226,-109.3922988
67475,10,43,11,17,12,0,93,38.22039581461226,-109.3920293
67476,8,40,12,17,13,0,90,38.22039581461226,-109.3917598
67477,6,40,12,15,14,1,88,38.22039581461226,-109.3914903
67478,4,40,11,12,14,1,82,38.22039581461226,-109.3912208
67479,5,40,12,12,15,1,85,38.22039581461226,-109.3909513
67480,5,40,11,12,16,1,85,38.22039581461226,-109.3906818
67481,4,37,11,10,16,2,80,38.22039581461226,-109.3904123
67482,2,30,10,8,12,7,69,38.22039581461226,-109.3901429
67483,3,36,10,9,13,4,75,38.22039581461226,-109.3898734
67484,4,40,11,10,15,2,82,38.22039581461226,-109.3896039
67485,5,43,11,10,14,1,84,38.22039581461226,-109.3893344
67486,5,46,11,10,13,1,86,38.22039581461226,-109.3890649
67487,5,48,12,11,13,2,91,38.22039581461226,-109.3887954
67488,5,46,12,10,13,1,87,38.22039581461226,-109.3885259
67489,3,50,10,6,15,1,85,38.22039581461226,-109.3882564
67490,3,49,9,4,16,1,82,38.22039581461226,-109.3879869
67491,4,45,10,8,15,1,83,38.22039581461226,-109.3877174
67492,7,41,12,10,15,1,86,38.22039581461226,-109.3874479
67493,6,43,12,9,15,1,86,38.22039581461226,-109.3871784
67494,5,43,11,7,16,2,84,38.22039581461226,-109.3869089
67495,3,43,11,5,16,3,81,38.22039581461226,-109.3866394
67496,3,45,10,6,15,2,81,38.22039581461226,-109.3863699
67497,2,49,9,3,15,3,81,38.22039581461226,-109.3861004
67498,3,50,9,5,15,2,84,38.22039581461226,-109.3858309
67499,4,54,10,6,15,1,90,38.22039581461226,-109.3855614
67500,4,56,10,6,15,1,92,38.22039581461226,-109.3852919
67501,4,53,10,8,14,1,90,38.22039581461226,-109.3850225
67502,5,53,10,7,13,1,89,38.22039581461226,-109.384753
67503,4,46,10,9,13,1,83,38.22039581461226,-109.3844835
67504,3,43,10,8,11,2,77,38.22039581461226,-109.384214
67505,3,43,9,8,11,2,76,38.22039581461226,-109.3839445
67506,2,43,9,9,10,2,75,38.22039581461226,-109.383675
67507,2,46,9,8,10,2,77,38.22039581461226,-109.3834055
67508,1,48,9,8,10,1,77,38.22039581461226,-109.383136
67509,1,49,9,8,9,1,77,38.22039581461226,-109.3828665
67510,1,50,9,5,10,2,77,38.22039581461226,-109.382597
67511,1,53,9,2,14,3,82,38.22039581461226,-109.3823275
67512,1,52,8,1,13,4,79,38.22039581461226,-109.382058
67513,1,52,8,2,13,3,79,38.22039581461226,-109.3817885
67514,1,55,8,4,11,1,80,38.22039581461226,-109.381519
67515,1,57,8,6,10,1,83,38.22039581461226,-109.3812495
67516,16,23,9,19,18,3,88,38.22012632002702,-109.4114329
67517,13,24,10,21,16,2,86,38.22012632002702,-109.4111634
67518,13,25,10,20,17,2,87,38.22012632002702,-109.4108939
67519,13,25,10,22,19,2,91,38.22012632002702,-109.4106244
67520,13,23,10,26,19,3,94,38.22012632002702,-109.4103549
67521,8,24,12,23,22,3,92,38.22012632002702,-109.4100855
67522,7,24,12,24,22,3,92,38.22012632002702,-109.409816
67523,9,21,10,28,21,2,91,38.22012632002702,-109.4095465
67524,17,18,9,29,18,1,92,38.22012632002702,-109.409277
67525,16,21,9,28,18,1,93,38.22012632002702,-109.4090075
67526,13,24,9,31,15,0,92,38.22012632002702,-109.408738
67527,13,26,10,29,14,0,92,38.22012632002702,-109.4084685
67528,12,26,10,26,17,0,91,38.22012632002702,-109.408199
67529,10,25,10,25,18,1,89,38.22012632002702,-109.4079295
67530,14,29,10,23,13,1,90,38.22012632002702,-109.40766
67531,9,31,11,22,16,1,90,38.22012632002702,-109.4073905
67532,9,30,11,22,17,1,90,38.22012632002702,-109.407121
67533,10,29,11,21,18,0,89,38.22012632002702,-109.4068515
67534,10,28,11,20,19,1,89,38.22012632002702,-109.406582
67535,12,28,11,20,17,1,89,38.22012632002702,-109.4063125
67536,14,26,11,19,18,1,89,38.22012632002702,-109.406043
67537,16,22,10,18,19,2,87,38.22012632002702,-109.4057735
67538,18,20,9,20,20,2,89,38.22012632002702,-109.405504
67539,18,15,9,22,23,5,92,38.22012632002702,-109.4052345
67540,11,20,10,21,22,4,88,38.22012632002702,-109.4049651
67541,11,22,10,22,20,3,88,38.22012632002702,-109.4046956
67542,9,27,11,22,17,2,88,38.22012632002702,-109.4044261
67543,9,33,12,20,16,1,91,38.22012632002702,-109.4041566
67544,7,34,12,21,16,1,91,38.22012632002702,-109.4038871
67545,7,35,13,21,16,1,93,38.22012632002702,-109.4036176
67546,7,37,13,19,16,1,93,38.22012632002702,-109.4033481
67547,6,40,14,17,16,1,94,38.22012632002702,-109.4030786
67548,5,42,14,18,15,1,95,38.22012632002702,-109.4028091
67549,6,40,14,17,15,1,93,38.22012632002702,-109.4025396
67550,6,39,13,19,14,1,92,38.22012632002702,-109.4022701
67551,6,38,13,20,14,1,92,38.22012632002702,-109.4020006
67552,7,36,12,20,14,2,91,38.22012632002702,-109.4017311
67553,8,31,12,25,13,1,90,38.22012632002702,-109.4014616
67554,8,32,12,22,14,1,89,38.22012632002702,-109.4011921
67555,7,35,13,23,14,1,93,38.22012632002702,-109.4009226
67556,6,36,13,21,13,1,90,38.22012632002702,-109.4006531
67557,6,39,12,19,13,1,90,38.22012632002702,-109.4003836
67558,7,35,13,22,14,1,92,38.22012632002702,-109.4001142
67559,8,31,12,23,14,2,90,38.22012632002702,-109.3998447
67560,11,27,11,22,15,2,88,38.22012632002702,-109.3995752
67561,12,23,11,23,16,3,88,38.22012632002702,-109.3993057
67562,11,20,10,25,16,3,85,38.22012632002702,-109.3990362
67563,8,24,10,25,14,2,83,38.22012632002702,-109.3987667
67564,6,27,11,22,16,2,84,38.22012632002702,-109.3984972
67565,5,31,11,18,15,2,82,38.22012632002702,-109.3982277
67566,5,35,10,16,15,2,83,38.22012632002702,-109.3979582
67567,4,36,10,17,16,2,85,38.22012632002702,-109.3976887
67568,4,37,10,17,16,1,85,38.22012632002702,-109.3974192
67569,5,33,11,18,15,2,84,38.22012632002702,-109.3971497
67570,5,32,11,19,14,2,83,38.22012632002702,-109.3968802
67571,5,33,11,20,14,1,84,38.22012632002702,-109.3966107
67572,6,34,12,20,14,2,88,38.22012632002702,-109.3963412
67573,8,32,12,23,14,1,90,38.22012632002702,-109.3960717
67574,8,31,12,24,14,1,90,38.22012632002702,-109.3958022
67575,9,29,12,25,14,1,90,38.22012632002702,-109.3955327
67576,9,29,11,26,14,0,89,38.22012632002702,-109.3952632
67577,9,29,11,25,15,1,90,38.22012632002702,-109.3949938
67578,8,29,11,25,15,1,89,38.22012632002702,-109.3947243
67579,9,29,11,21,14,1,85,38.22012632002702,-109.3944548
67580,12,35,10,16,12,1,86,38.22012632002702,-109.3941853
67581,10,44,10,15,11,0,90,38.22012632002702,-109.3939158
67582,11,47,9,15,10,0,92,38.22012632002702,-109.3936463
67583,11,45,10,16,10,0,92,38.22012632002702,-109.3933768
67584,9,45,11,15,11,0,91,38.22012632002702,-109.3931073
67585,6,49,11,14,12,0,92,38.22012632002702,-109.3928378
67586,7,43,12,18,13,0,93,38.22012632002702,-109.3925683
67587,6,41,12,16,14,1,90,38.22012632002702,-109.3922988
67588,5,40,11,12,14,1,83,38.22012632002702,-109.3920293
67589,4,42,10,11,14,1,82,38.22012632002702,-109.3917598
67590,4,43,11,10,15,1,84,38.22012632002702,-109.3914903
67591,4,42,11,10,15,1,83,38.22012632002702,-109.3912208
67592,4,40,11,8,15,2,80,38.22012632002702,-109.3909513
67593,3,39,10,8,15,3,78,38.22012632002702,-109.3906818
67594,3,40,10,7,16,3,79,38.22012632002702,-109.3904123
67595,3,42,10,6,16,3,80,38.22012632002702,-109.3901429
67596,3,42,10,6,15,3,79,38.22012632002702,-109.3898734
67597,4,42,10,8,14,2,80,38.22012632002702,-109.3896039
67598,4,43,10,8,13,2,80,38.22012632002702,-109.3893344
67599,3,46,11,9,13,2,84,38.22012632002702,-109.3890649
67600,4,47,12,11,12,2,88,38.22012632002702,-109.3887954
67601,5,45,12,11,13,2,88,38.22012632002702,-109.3885259
67602,4,46,11,9,13,2,85,38.22012632002702,-109.3882564
67603,4,48,10,8,14,1,85,38.22012632002702,-109.3879869
67604,4,48,10,8,13,1,84,38.22012632002702,-109.3877174
67605,4,44,10,8,14,1,81,38.22012632002702,-109.3874479
67606,7,40,12,11,15,1,86,38.22012632002702,-109.3871784
67607,8,40,13,12,15,1,89,38.22012632002702,-109.3869089
67608,8,41,13,11,16,0,89,38.22012632002702,-109.3866394
67609,7,43,12,10,16,1,89,38.22012632002702,-109.3863699
67610,4,46,11,8,15,1,85,38.22012632002702,-109.3861004
67611,4,50,10,7,14,1,86,38.22012632002702,-109.3858309
67612,4,53,10,6,14,1,88,38.22012632002702,-109.3855614
67613,4,54,10,5,15,1,89,38.22012632002702,-109.3852919
67614,6,47,12,10,15,1,91,38.22012632002702,-109.3850225
67615,5,48,11,9,13,2,88,38.22012632002702,-109.384753
67616,4,52,10,7,13,1,87,38.22012632002702,-109.3844835
67617,4,52,10,7,13,1,87,38.22012632002702,-109.384214
67618,3,48,10,7,13,1,82,38.22012632002702,-109.3839445
67619,2,46,10,7,11,2,78,38.22012632002702,-109.383675
67620,2,46,10,7,11,2,78,38.22012632002702,-109.3834055
67621,2,47,10,8,10,2,79,38.22012632002702,-109.383136
67622,2,47,10,8,12,1,80,38.22012632002702,-109.3828665
67623,2,49,10,6,14,2,83,38.22012632002702,-109.382597
67624,5,49,11,7,15,1,88,38.22012632002702,-109.3823275
67625,3,49,10,6,15,2,85,38.22012632002702,-109.382058
67626,3,48,10,5,15,2,83,38.22012632002702,-109.3817885
67627,3,49,10,6,15,1,84,38.22012632002702,-109.381519
67628,2,53,9,9,12,0,85,38.22012632002702,-109.3812495
67629,19,19,9,22,17,3,89,38.21985682544179,-109.4114329
67630,17,23,9,20,17,3,89,38.21985682544179,-109.4111634
67631,14,24,9,21,16,3,87,38.21985682544179,-109.4108939
67632,13,24,9,25,16,1,88,38.21985682544179,-109.4106244
67633,18,25,8,24,16,1,92,38.21985682544179,-109.4103549
67634,12,24,10,22,20,2,90,38.21985682544179,-109.4100855
67635,10,24,11,24,22,2,93,38.21985682544179,-109.409816
67636,9,23,11,25,22,3,93,38.21985682544179,-109.4095465
67637,10,20,10,30,20,2,92,38.21985682544179,-109.409277
67638,12,20,9,32,18,2,93,38.21985682544179,-109.4090075
67639,15,23,9,27,18,2,94,38.21985682544179,-109.408738
67640,9,26,10,25,19,1,90,38.21985682544179,-109.4084685
67641,6,26,11,24,20,1,88,38.21985682544179,-109.408199
67642,7,26,10,22,20,1,86,38.21985682544179,-109.4079295
67643,8,27,10,19,19,2,85,38.21985682544179,-109.40766
67644,10,28,9,19,19,2,87,38.21985682544179,-109.4073905
67645,11,26,10,19,20,1,87,38.21985682544179,-109.407121
67646,9,26,10,21,20,1,87,38.21985682544179,-109.4068515
67647,7,26,11,22,20,1,87,38.21985682544179,-109.406582
67648,10,24,11,21,21,3,90,38.21985682544179,-109.4063125
67649,13,25,11,18,18,2,87,38.21985682544179,-109.406043
67650,15,25,11,19,19,2,91,38.21985682544179,-109.4057735
67651,19,22,9,20,20,1,91,38.21985682544179,-109.405504
67652,17,20,9,19,22,2,89,38.21985682544179,-109.4052345
67653,12,22,9,18,23,3,87,38.21985682544179,-109.4049651
67654,12,22,10,19,21,3,87,38.21985682544179,-109.4046956
67655,13,22,10,21,20,2,88,38.21985682544179,-109.4044261
67656,12,23,10,23,19,1,88,38.21985682544179,-109.4041566
67657,11,25,11,22,18,2,89,38.21985682544179,-109.4038871
67658,10,29,12,19,17,3,90,38.21985682544179,-109.4036176
67659,8,32,12,20,17,1,90,38.21985682544179,-109.4033481
67660,5,36,13,19,16,1,90,38.21985682544179,-109.4030786
67661,4,41,13,15,16,1,90,38.21985682544179,-109.4028091
67662,6,39,13,16,16,1,91,38.21985682544179,-109.4025396
67663,5,38,13,17,16,1,90,38.21985682544179,-109.4022701
67664,5,38,13,18,16,1,91,38.21985682544179,-109.4020006
67665,6,38,13,18,15,1,91,38.21985682544179,-109.4017311
67666,7,36,13,20,15,1,92,38.21985682544179,-109.4014616
67667,6,34,12,24,13,1,90,38.21985682544179,-109.4011921
67668,6,32,12,24,13,1,88,38.21985682544179,-109.4009226
67669,5,33,11,23,13,1,86,38.21985682544179,-109.4006531
67670,6,35,12,22,13,1,89,38.21985682544179,-109.4003836
67671,6,32,12,25,14,1,90,38.21985682544179,-109.4001142
67672,9,28,11,24,15,1,88,38.21985682544179,-109.3998447
67673,11,23,11,24,17,2,88,38.21985682544179,-109.3995752
67674,12,20,10,25,16,3,86,38.21985682544179,-109.3993057
67675,11,20,10,23,16,3,83,38.21985682544179,-109.3990362
67676,9,24,10,23,14,3,83,38.21985682544179,-109.3987667
67677,7,27,11,21,15,2,83,38.21985682544179,-109.3984972
67678,5,30,11,19,16,2,83,38.21985682544179,-109.3982277
67679,5,31,11,20,16,2,85,38.21985682544179,-109.3979582
67680,5,31,11,20,16,1,84,38.21985682544179,-109.3976887
67681,6,30,11,18,17,2,84,38.21985682544179,-109.3974192
67682,5,29,10,19,15,3,81,38.21985682544179,-109.3971497
67683,5,29,10,20,15,2,81,38.21985682544179,-109.3968802
67684,5,32,11,19,15,2,84,38.21985682544179,-109.3966107
67685,8,36,12,17,14,1,88,38.21985682544179,-109.3963412
67686,12,34,12,17,14,1,90,38.21985682544179,-109.3960717
67687,14,31,12,19,14,1,91,38.21985682544179,-109.3958022
67688,15,29,12,20,14,1,91,38.21985682544179,-109.3955327
67689,16,30,11,20,13,0,90,38.21985682544179,-109.3952632
67690,15,32,11,18,14,1,91,38.21985682544179,-109.3949938
67691,12,32,11,18,14,1,88,38.21985682544179,-109.3947243
67692,10,38,10,15,13,1,87,38.21985682544179,-109.3944548
67693,10,46,9,14,10,0,89,38.21985682544179,-109.3941853
67694,10,52,9,13,9,0,93,38.21985682544179,-109.3939158
67695,12,47,10,14,9,0,92,38.21985682544179,-109.3936463
67696,9,42,11,16,13,0,91,38.21985682544179,-109.3933768
67697,6,40,12,15,14,1,88,38.21985682544179,-109.3931073
67698,5,43,11,13,14,1,87,38.21985682544179,-109.3928378
67699,6,42,12,16,14,1,91,38.21985682544179,-109.3925683
67700,5,39,12,15,14,1,86,38.21985682544179,-109.3922988
67701,4,38,11,11,15,2,81,38.21985682544179,-109.3920293
67702,3,39,10,10,15,2,79,38.21985682544179,-109.3917598
67703,4,45,11,8,16,1,85,38.21985682544179,-109.3914903
67704,4,45,11,7,16,2,85,38.21985682544179,-109.3912208
67705,3,43,10,8,15,2,81,38.21985682544179,-109.3909513
67706,3,43,11,8,15,2,82,38.21985682544179,-109.3906818
67707,4,45,11,8,15,2,85,38.21985682544179,-109.3904123
67708,4,47,11,8,15,1,86,38.21985682544179,-109.3901429
67709,3,46,10,8,14,2,83,38.21985682544179,-109.3898734
67710,4,48,10,9,13,1,85,38.21985682544179,-109.3896039
67711,4,47,10,10,12,1,84,38.21985682544179,-109.3893344
67712,4,44,11,10,13,2,84,38.21985682544179,-109.3890649
67713,6,44,12,12,13,1,88,38.21985682544179,-109.3887954
67714,4,48,11,10,12,2,87,38.21985682544179,-109.3885259
67715,4,48,11,10,13,1,87,38.21985682544179,-109.3882564
67716,4,47,11,10,13,1,86,38.21985682544179,-109.3879869
67717,4,48,11,9,14,1,87,38.21985682544179,-109.3877174
67718,3,46,9,6,14,1,79,38.21985682544179,-109.3874479
67719,5,43,11,9,14,1,83,38.21985682544179,-109.3871784
67720,8,41,12,12,15,0,88,38.21985682544179,-109.3869089
67721,11,40,13,13,15,0,92,38.21985682544179,-109.3866394
67722,10,40,13,12,14,1,90,38.21985682544179,-109.3863699
67723,8,41,13,12,14,1,89,38.21985682544179,-109.3861004
67724,5,45,12,10,14,1,87,38.21985682544179,-109.3858309
67725,3,50,10,8,13,2,86,38.21985682544179,-109.3855614
67726,3,52,10,7,13,1,86,38.21985682544179,-109.3852919
67727,5,46,11,10,14,1,87,38.21985682544179,-109.3850225
67728,6,47,12,10,13,2,90,38.21985682544179,-109.384753
67729,4,52,10,7,13,2,88,38.21985682544179,-109.3844835
67730,3,53,10,7,13,1,87,38.21985682544179,-109.384214
67731,3,50,10,10,12,1,86,38.21985682544179,-109.3839445
67732,4,50,10,10,12,1,87,38.21985682544179,-109.383675
67733,3,48,10,8,13,1,83,38.21985682544179,-109.3834055
67734,3,47,10,7,13,2,82,38.21985682544179,-109.383136
67735,3,48,10,8,13,1,83,38.21985682544179,-109.3828665
67736,4,51,11,8,12,2,88,38.21985682544179,-109.382597
67737,6,51,11,8,13,2,91,38.21985682544179,-109.3823275
67738,5,49,11,8,13,2,88,38.21985682544179,-109.382058
67739,4,48,11,8,13,2,86,38.21985682544179,-109.3817885
67740,5,48,12,9,14,1,89,38.21985682544179,-109.381519
67741,6,50,12,9,14,0,91,38.21985682544179,-109.3812495
67742,15,15,10,27,20,3,90,38.219587330856555,-109.4114329
67743,18,19,8,23,18,4,90,38.219587330856555,-109.4111634
67744,14,22,9,21,17,3,86,38.219587330856555,-109.4108939
67745,14,24,10,19,16,3,86,38.219587330856555,-109.4106244
67746,15,25,10,19,17,3,89,38.219587330856555,-109.4103549
67747,14,25,9,19,20,1,88,38.219587330856555,-109.4100855
67748,11,25,10,22,21,1,90,38.219587330856555,-109.409816
67749,9,24,11,23,22,2,91,38.219587330856555,-109.4095465
67750,8,24,11,23,23,3,92,38.219587330856555,-109.409277
67751,8,25,11,22,23,3,92,38.219587330856555,-109.4090075
67752,14,25,10,23,20,2,94,38.219587330856555,-109.408738
67753,10,26,10,26,19,1,92,38.219587330856555,-109.4084685
67754,9,26,10,26,19,1,91,38.219587330856555,-109.408199
67755,12,26,9,25,17,0,89,38.219587330856555,-109.4079295
67756,10,27,9,20,20,1,87,38.219587330856555,-109.40766
67757,15,26,9,18,22,1,91,38.219587330856555,-109.4073905
67758,19,23,8,20,21,1,92,38.219587330856555,-109.407121
67759,21,20,8,22,19,1,91,38.219587330856555,-109.4068515
67760,21,19,8,22,19,1,90,38.219587330856555,-109.406582
67761,7,23,10,25,21,3,89,38.219587330856555,-109.4063125
67762,10,25,11,21,18,2,87,38.219587330856555,-109.406043
67763,11,27,11,19,18,2,88,38.219587330856555,-109.4057735
67764,13,26,11,18,19,2,89,38.219587330856555,-109.405504
67765,11,24,10,19,21,3,88,38.219587330856555,-109.4052345
67766,10,22,10,20,24,2,88,38.219587330856555,-109.4049651
67767,10,21,10,20,23,3,87,38.219587330856555,-109.4046956
67768,9,21,10,21,23,3,87,38.219587330856555,-109.4044261
67769,6,21,11,21,24,3,86,38.219587330856555,-109.4041566
67770,10,22,11,17,23,4,87,38.219587330856555,-109.4038871
67771,13,20,10,20,21,3,87,38.219587330856555,-109.4036176
67772,11,23,10,22,19,3,88,38.219587330856555,-109.4033481
67773,8,29,12,22,16,2,89,38.219587330856555,-109.4030786
67774,7,37,13,17,17,1,92,38.219587330856555,-109.4028091
67775,6,38,13,17,17,1,92,38.219587330856555,-109.4025396
67776,5,38,13,16,17,2,91,38.219587330856555,-109.4022701
67777,5,38,13,17,16,2,91,38.219587330856555,-109.4020006
67778,5,37,13,18,16,1,90,38.219587330856555,-109.4017311
67779,5,36,13,19,16,2,91,38.219587330856555,-109.4014616
67780,6,32,13,25,14,1,91,38.219587330856555,-109.4011921
67781,6,31,12,27,13,1,90,38.219587330856555,-109.4009226
67782,6,30,11,26,13,1,87,38.219587330856555,-109.4006531
67783,8,30,11,25,14,1,89,38.219587330856555,-109.4003836
67784,9,26,10,25,15,2,87,38.219587330856555,-109.4001142
67785,11,22,10,25,17,2,87,38.219587330856555,-109.3998447
67786,12,19,10,26,16,2,85,38.219587330856555,-109.3995752
67787,12,19,10,26,15,2,84,38.219587330856555,-109.3993057
67788,13,21,10,25,15,2,86,38.219587330856555,-109.3990362
67789,9,24,11,27,13,2,86,38.219587330856555,-109.3987667
67790,7,25,11,25,15,2,85,38.219587330856555,-109.3984972
67791,7,27,11,24,15,2,86,38.219587330856555,-109.3982277
67792,7,28,11,22,15,2,85,38.219587330856555,-109.3979582
67793,7,28,11,20,16,2,84,38.219587330856555,-109.3976887
67794,8,28,11,19,15,3,84,38.219587330856555,-109.3974192
67795,7,27,10,20,15,3,82,38.219587330856555,-109.3971497
67796,6,27,10,21,15,2,81,38.219587330856555,-109.3968802
67797,7,29,11,20,15,2,84,38.219587330856555,-109.3966107
67798,9,37,11,16,14,1,88,38.219587330856555,-109.3963412
67799,11,39,11,15,13,0,89,38.219587330856555,-109.3960717
67800,13,37,12,14,13,0,89,38.219587330856555,-109.3958022
67801,15,37,11,13,13,1,90,38.219587330856555,-109.3955327
67802,14,39,11,13,13,0,90,38.219587330856555,-109.3952632
67803,12,42,11,14,12,0,91,38.219587330856555,-109.3949938
67804,11,47,10,13,10,0,91,38.219587330856555,-109.3947243
67805,10,53,9,12,9,0,93,38.219587330856555,-109.3944548
67806,9,56,8,12,8,0,93,38.219587330856555,-109.3941853
67807,10,54,9,13,8,0,94,38.219587330856555,-109.3939158
67808,10,50,10,13,9,0,92,38.219587330856555,-109.3936463
67809,7,44,11,11,14,1,88,38.219587330856555,-109.3933768
67810,5,44,11,9,14,2,85,38.219587330856555,-109.3931073
67811,4,47,10,7,15,2,85,38.219587330856555,-109.3928378
67812,3,49,11,8,14,1,86,38.219587330856555,-109.3925683
67813,3,46,11,9,14,2,85,38.219587330856555,-109.3922988
67814,4,42,11,10,14,1,82,38.219587330856555,-109.3920293
67815,4,41,11,10,15,1,82,38.219587330856555,-109.3917598
67816,4,44,11,9,16,1,85,38.219587330856555,-109.3914903
67817,3,46,11,7,16,3,86,38.219587330856555,-109.3912208
67818,3,48,11,8,15,1,86,38.219587330856555,-109.3909513
67819,4,50,11,9,14,1,89,38.219587330856555,-109.3906818
67820,4,50,11,9,14,2,90,38.219587330856555,-109.3904123
67821,4,48,11,11,13,1,88,38.219587330856555,-109.3901429
67822,4,50,10,9,13,1,87,38.219587330856555,-109.3898734
67823,3,51,10,9,12,1,86,38.219587330856555,-109.3896039
67824,4,50,10,10,12,1,87,38.219587330856555,-109.3893344
67825,5,47,11,11,13,1,88,38.219587330856555,-109.3890649
67826,7,45,12,12,14,1,91,38.219587330856555,-109.3887954
67827,5,48,12,11,13,1,90,38.219587330856555,-109.3885259
67828,5,47,13,11,13,1,90,38.219587330856555,-109.3882564
67829,7,44,13,12,14,1,91,38.219587330856555,-109.3879869
67830,8,41,13,12,14,1,89,38.219587330856555,-109.3877174
67831,8,42,12,11,14,0,87,38.219587330856555,-109.3874479
67832,5,44,11,9,15,1,85,38.219587330856555,-109.3871784
67833,6,43,11,10,15,1,86,38.219587330856555,-109.3869089
67834,9,41,12,11,15,1,89,38.219587330856555,-109.3866394
67835,12,38,14,13,15,1,93,38.219587330856555,-109.3863699
67836,9,35,13,13,14,1,85,38.219587330856555,-109.3861004
67837,8,37,13,11,13,1,83,38.219587330856555,-109.3858309
67838,7,44,12,9,13,1,86,38.219587330856555,-109.3855614
67839,6,48,12,8,14,1,89,38.219587330856555,-109.3852919
67840,8,45,12,10,15,1,91,38.219587330856555,-109.3850225
67841,6,47,11,10,13,2,89,38.219587330856555,-109.384753
67842,5,50,11,7,13,2,88,38.219587330856555,-109.3844835
67843,8,46,11,11,13,1,90,38.219587330856555,-109.384214
67844,11,41,12,12,13,1,90,38.219587330856555,-109.3839445
67845,10,44,12,12,13,1,92,38.219587330856555,-109.383675
67846,6,46,11,10,12,2,87,38.219587330856555,-109.3834055
67847,5,46,11,10,12,2,86,38.219587330856555,-109.383136
67848,6,45,12,11,13,2,89,38.219587330856555,-109.3828665
67849,8,46,12,10,13,1,90,38.219587330856555,-109.382597
67850,9,45,13,11,13,1,92,38.219587330856555,-109.3823275
67851,7,45,12,10,13,2,89,38.219587330856555,-109.382058
67852,5,46,12,10,13,2,88,38.219587330856555,-109.3817885
67853,5,45,12,9,13,2,86,38.219587330856555,-109.381519
67854,6,46,13,10,14,1,90,38.219587330856555,-109.3812495
67855,9,16,11,23,25,3,87,38.219317836271316,-109.4114329
67856,10,15,10,28,20,5,88,38.219317836271316,-109.4111634
67857,17,18,9,25,17,4,90,38.219317836271316,-109.4108939
67858,18,21,9,22,16,2,88,38.219317836271316,-109.4106244
67859,17,22,9,22,17,2,89,38.219317836271316,-109.4103549
67860,17,22,9,21,19,1,89,38.219317836271316,-109.4100855
67861,16,23,8,23,19,1,90,38.219317836271316,-109.409816
67862,13,24,9,22,19,2,89,38.219317836271316,-109.4095465
67863,11,24,9,22,20,2,88,38.219317836271316,-109.409277
67864,8,23,10,21,24,2,88,38.219317836271316,-109.4090075
67865,9,26,10,20,22,2,89,38.219317836271316,-109.408738
67866,11,27,9,20,21,2,90,38.219317836271316,-109.4084685
67867,12,26,9,21,20,2,90,38.219317836271316,-109.408199
67868,13,25,9,21,19,2,89,38.219317836271316,-109.4079295
67869,11,26,9,22,20,1,89,38.219317836271316,-109.40766
67870,16,25,9,21,18,1,90,38.219317836271316,-109.4073905
67871,21,24,8,20,18,1,92,38.219317836271316,-109.407121
67872,22,23,8,19,19,1,92,38.219317836271316,-109.4068515
67873,15,22,9,20,23,2,91,38.219317836271316,-109.406582
67874,5,23,10,22,24,4,88,38.219317836271316,-109.4063125
67875,10,26,11,19,19,2,87,38.219317836271316,-109.406043
67876,12,27,11,22,16,1,89,38.219317836271316,-109.4057735
67877,14,26,10,21,18,1,90,38.219317836271316,-109.405504
67878,8,22,10,23,24,2,89,38.219317836271316,-109.4052345
67879,9,21,10,22,24,2,88,38.219317836271316,-109.4049651
67880,8,20,9,25,23,2,87,38.219317836271316,-109.4046956
67881,9,20,8,26,23,2,88,38.219317836271316,-109.4044261
67882,12,20,8,24,23,1,88,38.219317836271316,-109.4041566
67883,12,20,9,19,24,3,87,38.219317836271316,-109.4038871
67884,13,18,9,23,22,4,89,38.219317836271316,-109.4036176
67885,17,16,10,24,20,3,90,38.219317836271316,-109.4033481
67886,16,19,9,24,20,2,90,38.219317836271316,-109.4030786
67887,11,23,11,22,19,2,88,38.219317836271316,-109.4028091
67888,10,27,12,20,17,2,88,38.219317836271316,-109.4025396
67889,10,29,12,19,17,2,89,38.219317836271316,-109.4022701
67890,7,30,12,19,17,2,87,38.219317836271316,-109.4020006
67891,6,30,12,20,16,2,86,38.219317836271316,-109.4017311
67892,7,31,12,23,15,1,89,38.219317836271316,-109.4014616
67893,7,29,11,27,14,1,89,38.219317836271316,-109.4011921
67894,7,30,11,25,15,1,89,38.219317836271316,-109.4009226
67895,8,29,11,24,16,2,90,38.219317836271316,-109.4006531
67896,10,25,10,25,15,2,87,38.219317836271316,-109.4003836
67897,16,20,10,22,17,2,87,38.219317836271316,-109.4001142
67898,14,20,10,23,16,2,85,38.219317836271316,-109.3998447
67899,13,20,10,24,15,2,84,38.219317836271316,-109.3995752
67900,11,21,10,25,15,2,84,38.219317836271316,-109.3993057
67901,9,23,10,26,15,2,85,38.219317836271316,-109.3990362
67902,8,24,10,30,14,1,87,38.219317836271316,-109.3987667
67903,8,25,10,29,15,1,88,38.219317836271316,-109.3984972
67904,8,27,11,28,14,1,89,38.219317836271316,-109.3982277
67905,9,29,11,26,14,1,90,38.219317836271316,-109.3979582
67906,8,31,11,22,14,2,88,38.219317836271316,-109.3976887
67907,9,30,11,22,14,2,88,38.219317836271316,-109.3974192
67908,9,28,10,25,14,2,88,38.219317836271316,-109.3971497
67909,10,27,10,24,14,2,87,38.219317836271316,-109.3968802
67910,13,30,11,18,15,1,88,38.219317836271316,-109.3966107
67911,12,40,11,13,13,1,90,38.219317836271316,-109.3963412
67912,9,42,11,16,13,0,91,38.219317836271316,-109.3960717
67913,9,42,11,16,13,0,91,38.219317836271316,-109.3958022
67914,8,42,11,14,13,1,89,38.219317836271316,-109.3955327
67915,7,43,11,13,14,1,89,38.219317836271316,-109.3952632
67916,9,47,10,13,11,0,90,38.219317836271316,-109.3949938
67917,10,50,9,13,9,0,91,38.219317836271316,-109.3947243
67918,9,53,9,12,9,0,92,38.219317836271316,-109.3944548
67919,7,53,10,11,10,0,91,38.219317836271316,-109.3941853
67920,7,51,11,12,12,0,93,38.219317836271316,-109.3939158
67921,6,54,11,11,12,0,94,38.219317836271316,-109.3936463
67922,4,50,10,9,13,1,87,38.219317836271316,-109.3933768
67923,4,48,10,7,14,2,85,38.219317836271316,-109.3931073
67924,3,48,10,7,14,2,84,38.219317836271316,-109.3928378
67925,4,51,10,7,12,1,85,38.219317836271316,-109.3925683
67926,4,48,10,8,13,1,84,38.219317836271316,-109.3922988
67927,5,43,10,9,14,1,82,38.219317836271316,-109.3920293
67928,5,41,11,9,14,1,81,38.219317836271316,-109.3917598
67929,4,44,11,9,14,1,83,38.219317836271316,-109.3914903
67930,4,51,11,8,14,1,89,38.219317836271316,-109.3912208
67931,4,52,11,9,13,1,90,38.219317836271316,-109.3909513
67932,4,53,11,9,13,1,91,38.219317836271316,-109.3906818
67933,4,53,10,8,13,2,90,38.219317836271316,-109.3904123
67934,3,49,10,8,13,1,84,38.219317836271316,-109.3901429
67935,3,46,9,7,12,2,79,38.219317836271316,-109.3898734
67936,3,44,9,8,12,2,78,38.219317836271316,-109.3896039
67937,5,43,10,8,12,2,80,38.219317836271316,-109.3893344
67938,7,41,10,9,12,1,80,38.219317836271316,-109.3890649
67939,6,44,11,12,13,1,87,38.219317836271316,-109.3887954
67940,5,47,12,10,12,1,87,38.219317836271316,-109.3885259
67941,6,44,13,13,13,1,90,38.219317836271316,-109.3882564
67942,8,42,14,14,14,1,93,38.219317836271316,-109.3879869
67943,11,40,13,14,14,1,93,38.219317836271316,-109.3877174
67944,10,41,13,14,15,0,93,38.219317836271316,-109.3874479
67945,6,46,11,10,16,0,89,38.219317836271316,-109.3871784
67946,6,46,11,9,16,1,89,38.219317836271316,-109.3869089
67947,8,43,12,10,14,1,88,38.219317836271316,-109.3866394
67948,13,39,13,11,14,1,91,38.219317836271316,-109.3863699
67949,15,36,14,12,14,0,91,38.219317836271316,-109.3861004
67950,11,36,13,11,14,1,86,38.219317836271316,-109.3858309
67951,9,38,13,11,13,1,85,38.219317836271316,-109.3855614
67952,8,40,12,9,13,2,84,38.219317836271316,-109.3852919
67953,5,43,11,7,13,3,82,38.219317836271316,-109.3850225
67954,5,49,11,8,14,1,88,38.219317836271316,-109.384753
67955,8,45,12,11,14,1,91,38.219317836271316,-109.3844835
67956,12,40,13,13,12,1,91,38.219317836271316,-109.384214
67957,17,37,12,13,11,1,91,38.219317836271316,-109.3839445
67958,15,40,11,13,11,1,91,38.219317836271316,-109.383675
67959,13,40,12,13,11,1,90,38.219317836271316,-109.3834055
67960,12,39,12,15,11,1,90,38.219317836271316,-109.383136
67961,12,38,12,14,11,1,88,38.219317836271316,-109.3828665
67962,14,37,13,14,11,1,90,38.219317836271316,-109.382597
67963,13,38,13,14,12,1,91,38.219317836271316,-109.3823275
67964,12,41,13,12,13,1,92,38.219317836271316,-109.382058
67965,10,41,13,12,13,1,90,38.219317836271316,-109.3817885
67966,8,41,13,12,13,2,89,38.219317836271316,-109.381519
67967,6,43,12,10,13,3,87,38.219317836271316,-109.3812495
67968,10,20,13,17,25,2,87,38.219048341686076,-109.4114329
67969,8,19,10,29,20,1,87,38.219048341686076,-109.4111634
67970,8,19,10,27,19,2,85,38.219048341686076,-109.4108939
67971,11,19,9,22,19,5,85,38.219048341686076,-109.4106244
67972,16,20,9,21,19,4,89,38.219048341686076,-109.4103549
67973,15,19,8,19,21,4,86,38.219048341686076,-109.4100855
67974,16,21,8,20,21,3,89,38.219048341686076,-109.409816
67975,14,23,8,22,20,2,89,38.219048341686076,-109.4095465
67976,14,23,8,24,20,2,91,38.219048341686076,-109.409277
67977,14,20,8,26,21,2,91,38.219048341686076,-109.4090075
67978,14,21,8,25,21,1,90,38.219048341686076,-109.408738
67979,17,22,8,25,18,1,91,38.219048341686076,-109.4084685
67980,19,22,8,22,20,1,92,38.219048341686076,-109.408199
67981,21,21,8,21,20,1,92,38.219048341686076,-109.4079295
67982,18,22,9,19,22,1,91,38.219048341686076,-109.40766
67983,19,23,9,20,20,1,92,38.219048341686076,-109.4073905
67984,25,21,8,20,18,1,93,38.219048341686076,-109.407121
67985,25,21,8,20,18,2,94,38.219048341686076,-109.4068515
67986,14,23,9,22,22,3,93,38.219048341686076,-109.406582
67987,4,23,12,20,26,4,89,38.219048341686076,-109.4063125
67988,7,26,12,16,21,5,87,38.219048341686076,-109.406043
67989,7,27,11,18,19,2,84,38.219048341686076,-109.4057735
67990,9,23,11,23,19,2,87,38.219048341686076,-109.405504
67991,4,19,10,28,24,3,88,38.219048341686076,-109.4052345
67992,7,18,9,26,23,5,88,38.219048341686076,-109.4049651
67993,10,18,8,24,22,6,88,38.219048341686076,-109.4046956
67994,13,18,8,23,22,5,89,38.219048341686076,-109.4044261
67995,14,19,8,22,22,4,89,38.219048341686076,-109.4041566
67996,10,23,9,19,24,3,88,38.219048341686076,-109.4038871
67997,12,17,9,23,24,6,91,38.219048341686076,-109.4036176
67998,12,12,9,28,22,8,91,38.219048341686076,-109.4033481
67999,10,12,9,28,22,8,89,38.219048341686076,-109.4030786
68000,7,17,9,26,23,7,89,38.219048341686076,-109.4028091
68001,4,19,11,22,25,7,88,38.219048341686076,-109.4025396
68002,9,20,9,23,21,3,85,38.219048341686076,-109.4022701
68003,10,21,10,22,19,3,85,38.219048341686076,-109.4020006
68004,10,23,10,21,16,3,83,38.219048341686076,-109.4017311
68005,12,23,11,23,14,3,86,38.219048341686076,-109.4014616
68006,10,25,11,26,16,2,90,38.219048341686076,-109.4011921
68007,10,25,11,23,17,2,88,38.219048341686076,-109.4009226
68008,12,24,10,23,17,2,88,38.219048341686076,-109.4006531
68009,16,22,10,23,14,2,87,38.219048341686076,-109.4003836
68010,18,19,10,22,15,2,86,38.219048341686076,-109.4001142
68011,12,22,10,23,15,2,84,38.219048341686076,-109.3998447
68012,9,23,10,24,16,2,84,38.219048341686076,-109.3995752
68013,8,24,10,26,16,2,86,38.219048341686076,-109.3993057
68014,5,24,10,31,16,1,87,38.219048341686076,-109.3990362
68015,4,23,10,35,15,1,88,38.219048341686076,-109.3987667
68016,4,24,11,33,16,1,89,38.219048341686076,-109.3984972
68017,7,27,10,31,15,0,90,38.219048341686076,-109.3982277
68018,9,28,11,29,13,0,90,38.219048341686076,-109.3979582
68019,10,29,11,26,13,1,90,38.219048341686076,-109.3976887
68020,10,29,11,27,13,1,91,38.219048341686076,-109.3974192
68021,10,27,10,28,13,1,89,38.219048341686076,-109.3971497
68022,14,29,10,25,14,0,92,38.219048341686076,-109.3968802
68023,18,34,11,15,13,0,91,38.219048341686076,-109.3966107
68024,10,43,12,14,12,0,91,38.219048341686076,-109.3963412
68025,7,41,12,18,14,0,92,38.219048341686076,-109.3960717
68026,5,43,12,15,14,1,90,38.219048341686076,-109.3958022
68027,5,44,12,14,15,1,91,38.219048341686076,-109.3955327
68028,5,44,12,14,14,1,90,38.219048341686076,-109.3952632
68029,5,48,12,13,13,1,92,38.219048341686076,-109.3949938
68030,6,51,11,11,13,0,92,38.219048341686076,-109.3947243
68031,5,52,11,10,12,1,91,38.219048341686076,-109.3944548
68032,5,53,11,10,13,1,93,38.219048341686076,-109.3941853
68033,4,56,11,9,13,1,94,38.219048341686076,-109.3939158
68034,4,57,10,8,12,0,91,38.219048341686076,-109.3936463
68035,4,54,10,9,12,1,90,38.219048341686076,-109.3933768
68036,3,49,10,9,13,1,85,38.219048341686076,-109.3931073
68037,3,47,10,8,13,2,83,38.219048341686076,-109.3928378
68038,3,50,10,8,12,1,84,38.219048341686076,-109.3925683
68039,3,53,10,8,12,1,87,38.219048341686076,-109.3922988
68040,4,46,10,10,13,1,84,38.219048341686076,-109.3920293
68041,4,41,10,9,14,2,80,38.219048341686076,-109.3917598
68042,4,42,9,9,14,2,80,38.219048341686076,-109.3914903
68043,4,52,10,9,13,1,89,38.219048341686076,-109.3912208
68044,4,52,10,10,13,1,90,38.219048341686076,-109.3909513
68045,4,54,10,9,13,1,91,38.219048341686076,-109.3906818
68046,4,53,10,9,13,1,90,38.219048341686076,-109.3904123
68047,4,50,9,8,12,1,84,38.219048341686076,-109.3901429
68048,3,43,9,5,12,3,75,38.219048341686076,-109.3898734
68049,4,43,9,6,12,2,76,38.219048341686076,-109.3896039
68050,5,43,8,7,10,2,75,38.219048341686076,-109.3893344
68051,4,43,8,7,9,2,73,38.219048341686076,-109.3890649
68052,4,44,10,8,11,1,78,38.219048341686076,-109.3887954
68053,4,46,10,8,12,1,81,38.219048341686076,-109.3885259
68054,5,47,11,10,12,1,86,38.219048341686076,-109.3882564
68055,7,45,13,13,13,1,92,38.219048341686076,-109.3879869
68056,7,45,13,12,14,1,92,38.219048341686076,-109.3877174
68057,5,50,11,9,13,1,89,38.219048341686076,-109.3874479
68058,3,50,9,6,14,1,83,38.219048341686076,-109.3871784
68059,5,49,11,9,15,0,89,38.219048341686076,-109.3869089
68060,8,44,12,11,15,0,90,38.219048341686076,-109.3866394
68061,14,39,13,11,14,0,91,38.219048341686076,-109.3863699
68062,16,36,14,12,14,0,92,38.219048341686076,-109.3861004
68063,12,36,14,12,13,1,88,38.219048341686076,-109.3858309
68064,10,35,14,12,13,1,85,38.219048341686076,-109.3855614
68065,10,35,13,11,13,1,83,38.219048341686076,-109.3852919
68066,6,36,11,9,13,3,78,38.219048341686076,-109.3850225
68067,7,41,12,11,15,1,87,38.219048341686076,-109.384753
68068,8,41,13,12,14,1,89,38.219048341686076,-109.3844835
68069,11,40,13,14,13,1,92,38.219048341686076,-109.384214
68070,13,38,12,15,11,1,90,38.219048341686076,-109.3839445
68071,14,39,11,14,11,1,90,38.219048341686076,-109.383675
68072,17,33,10,14,10,1,85,38.219048341686076,-109.3834055
68073,15,30,9,14,10,2,80,38.219048341686076,-109.383136
68074,13,30,10,15,10,2,80,38.219048341686076,-109.3828665
68075,11,30,11,16,10,3,81,38.219048341686076,-109.382597
68076,11,32,12,18,10,2,85,38.219048341686076,-109.3823275
68077,10,34,13,19,10,2,88,38.219048341686076,-109.382058
68078,12,36,13,17,12,1,91,38.219048341686076,-109.3817885
68079,12,37,13,14,12,2,90,38.219048341686076,-109.381519
68080,8,40,13,12,12,3,88,38.219048341686076,-109.3812495
68081,2,26,12,22,13,5,80,38.21877884710084,-109.4114329
68082,4,26,11,24,16,2,83,38.21877884710084,-109.4111634
68083,8,21,11,25,18,1,84,38.21877884710084,-109.4108939
68084,8,17,11,25,22,2,85,38.21877884710084,-109.4106244
68085,8,14,10,18,23,9,82,38.21877884710084,-109.4103549
68086,8,15,7,16,21,8,75,38.21877884710084,-109.4100855
68087,13,19,8,17,23,5,85,38.21877884710084,-109.409816
68088,15,21,8,20,22,3,89,38.21877884710084,-109.4095465
68089,14,23,8,22,21,2,90,38.21877884710084,-109.409277
68090,13,24,8,21,22,2,90,38.21877884710084,-109.4090075
68091,12,23,8,25,20,1,89,38.21877884710084,-109.408738
68092,9,24,8,25,22,2,90,38.21877884710084,-109.4084685
68093,9,23,8,25,23,2,90,38.21877884710084,-109.408199
68094,13,21,8,27,22,2,93,38.21877884710084,-109.4079295
68095,17,21,7,26,20,1,92,38.21877884710084,-109.40766
68096,15,23,8,25,20,1,92,38.21877884710084,-109.4073905
68097,11,23,9,25,22,2,92,38.21877884710084,-109.407121
68098,10,23,9,26,21,3,92,38.21877884710084,-109.4068515
68099,10,23,9,27,20,3,92,38.21877884710084,-109.406582
68100,11,22,10,23,21,4,91,38.21877884710084,-109.4063125
68101,7,27,12,16,22,4,88,38.21877884710084,-109.406043
68102,8,28,11,15,19,3,84,38.21877884710084,-109.4057735
68103,9,24,11,19,18,2,83,38.21877884710084,-109.405504
68104,9,19,9,21,24,4,86,38.21877884710084,-109.4052345
68105,10,22,9,21,21,5,88,38.21877884710084,-109.4049651
68106,10,23,9,16,24,6,88,38.21877884710084,-109.4046956
68107,14,23,9,14,25,4,89,38.21877884710084,-109.4044261
68108,14,22,9,17,25,2,89,38.21877884710084,-109.4041566
68109,12,21,9,23,23,1,89,38.21877884710084,-109.4038871
68110,13,19,10,21,25,3,91,38.21877884710084,-109.4036176
68111,10,15,10,23,26,7,91,38.21877884710084,-109.4033481
68112,8,14,9,26,22,10,89,38.21877884710084,-109.4030786
68113,8,13,7,24,21,10,83,38.21877884710084,-109.4028091
68114,7,14,6,25,21,10,83,38.21877884710084,-109.4025396
68115,7,13,8,20,24,10,82,38.21877884710084,-109.4022701
68116,7,17,10,18,25,9,86,38.21877884710084,-109.4020006
68117,10,19,10,19,24,4,86,38.21877884710084,-109.4017311
68118,13,19,10,21,20,2,85,38.21877884710084,-109.4014616
68119,4,52,10,10,12,1,89,38.21877884710084,-109.3906818
68120,4,53,10,9,12,1,89,38.21877884710084,-109.3904123
68121,4,52,10,8,13,1,88,38.21877884710084,-109.3901429
68122,2,45,9,6,13,3,78,38.21877884710084,-109.3898734
68123,4,46,9,7,12,1,79,38.21877884710084,-109.3896039
68124,4,40,8,6,10,3,71,38.21877884710084,-109.3893344
68125,2,39,7,6,8,4,66,38.21877884710084,-109.3890649
68126,4,46,8,8,8,1,75,38.21877884710084,-109.3887954
68127,4,44,10,9,11,1,79,38.21877884710084,-109.3885259
68128,4,46,10,8,13,2,83,38.21877884710084,-109.3882564
68129,4,50,11,9,12,1,87,38.21877884710084,-109.3879869
68130,4,53,10,8,12,1,88,38.21877884710084,-109.3877174
68131,3,54,9,4,14,1,85,38.21877884710084,-109.3874479
68132,2,49,9,4,15,1,80,38.21877884710084,-109.3871784
68133,5,48,10,8,16,0,87,38.21877884710084,-109.3869089
68134,8,43,12,10,15,0,88,38.21877884710084,-109.3866394
68135,11,39,13,12,15,0,90,38.21877884710084,-109.3863699
68136,14,37,14,13,14,0,92,38.21877884710084,-109.3861004
68137,3,28,11,12,11,6,71,38.21850935251561,-109.4114329
68138,3,24,11,13,13,5,69,38.21850935251561,-109.4111634
68139,4,22,11,23,14,3,77,38.21850935251561,-109.4108939
68140,4,22,11,27,18,1,83,38.21850935251561,-109.4106244
68141,6,19,12,20,26,1,84,38.21850935251561,-109.4103549
68142,5,11,9,17,23,10,75,38.21850935251561,-109.4100855
68143,11,11,7,22,19,9,79,38.21850935251561,-109.409816
68144,14,16,8,22,20,6,86,38.21850935251561,-109.4095465
68145,16,21,9,19,20,2,87,38.21850935251561,-109.409277
68146,15,24,9,15,20,3,86,38.21850935251561,-109.4090075
68147,14,24,9,20,21,2,90,38.21850935251561,-109.408738
68148,13,22,8,23,22,3,91,38.21850935251561,-109.4084685
68149,10,22,8,27,22,3,92,38.21850935251561,-109.408199
68150,8,21,9,27,23,2,90,38.21850935251561,-109.4079295
68151,7,23,9,23,24,3,89,38.21850935251561,-109.40766
68152,8,23,10,23,25,3,92,38.21850935251561,-109.4073905
68153,8,24,11,19,25,4,91,38.21850935251561,-109.407121
68154,6,24,11,20,24,4,89,38.21850935251561,-109.4068515
68155,5,25,10,23,22,5,90,38.21850935251561,-109.406582
68156,5,24,9,25,21,5,89,38.21850935251561,-109.4063125
68157,5,26,11,18,23,5,88,38.21850935251561,-109.406043
68158,8,28,11,17,20,5,89,38.21850935251561,-109.4057735
68159,10,26,11,20,18,2,87,38.21850935251561,-109.405504
68160,13,22,10,22,18,3,88,38.21850935251561,-109.4052345
68161,8,25,10,19,23,3,88,38.21850935251561,-109.4049651
68162,10,25,9,20,22,2,88,38.21850935251561,-109.4046956
68163,15,24,8,21,21,1,90,38.21850935251561,-109.4044261
68164,18,22,8,22,23,1,94,38.21850935251561,-109.4041566
68165,13,22,9,20,25,2,91,38.21850935251561,-109.4038871
68166,12,20,9,24,24,2,91,38.21850935251561,-109.4036176
68167,12,18,9,23,26,2,90,38.21850935251561,-109.4033481
68168,9,18,10,22,27,5,91,38.21850935251561,-109.4030786
68169,5,16,9,20,27,9,86,38.21850935251561,-109.4028091
68170,8,16,9,19,27,10,89,38.21850935251561,-109.4025396
68171,8,16,9,21,26,9,89,38.21850935251561,-109.4022701
68172,10,17,10,22,25,6,90,38.21850935251561,-109.4020006
68173,12,17,10,22,23,4,88,38.21850935251561,-109.4017311
68174,13,18,9,19,23,4,86,38.21850935251561,-109.4014616
68175,4,48,9,7,12,1,81,38.21850935251561,-109.3906818
68176,3,53,9,7,13,1,86,38.21850935251561,-109.3904123
68177,2,54,9,6,13,1,85,38.21850935251561,-109.3901429
68178,3,48,9,6,13,2,81,38.21850935251561,-109.3898734
68179,3,42,8,5,12,3,73,38.21850935251561,-109.3896039
68180,3,36,8,5,13,4,69,38.21850935251561,-109.3893344
68181,4,36,8,7,12,4,71,38.21850935251561,-109.3890649
68182,6,39,9,8,11,2,75,38.21850935251561,-109.3887954
68183,4,43,10,8,13,2,80,38.21850935251561,-109.3885259
68184,5,48,11,8,14,1,87,38.21850935251561,-109.3882564
68185,5,51,12,8,16,0,92,38.21850935251561,-109.3879869
68186,5,50,12,7,17,0,91,38.21850935251561,-109.3877174
68187,4,50,11,6,16,0,87,38.21850935251561,-109.3874479
68188,3,46,10,7,15,1,82,38.21850935251561,-109.3871784
68189,4,46,10,8,16,0,84,38.21850935251561,-109.3869089
68190,7,43,12,10,16,0,88,38.21850935251561,-109.3866394
68191,10,38,13,12,15,0,88,38.21850935251561,-109.3863699
68192,17,35,14,12,14,0,92,38.21850935251561,-109.3861004
68193,13,31,12,12,14,1,83,38.21823985793037,-109.4114329
68194,7,24,12,13,12,3,71,38.21823985793037,-109.4111634
68195,5,26,11,16,14,3,75,38.21823985793037,-109.4108939
68196,3,26,11,19,15,3,77,38.21823985793037,-109.4106244
68197,3,22,12,18,15,6,76,38.21823985793037,-109.4103549
68198,6,18,13,21,24,1,83,38.21823985793037,-109.4100855
68199,5,12,11,24,23,7,82,38.21823985793037,-109.409816
68200,6,12,10,24,22,9,83,38.21823985793037,-109.4095465
68201,9,15,8,21,22,9,84,38.21823985793037,-109.409277
68202,13,18,8,16,24,8,87,38.21823985793037,-109.4090075
68203,16,19,9,19,23,5,91,38.21823985793037,-109.408738
68204,10,18,9,25,23,7,92,38.21823985793037,-109.4084685
68205,5,19,10,27,25,5,91,38.21823985793037,-109.408199
68206,5,21,10,24,26,5,91,38.21823985793037,-109.4079295
68207,7,21,10,20,27,5,90,38.21823985793037,-109.40766
68208,10,17,10,29,21,3,90,38.21823985793037,-109.4073905
68209,6,23,11,26,17,4,87,38.21823985793037,-109.407121
68210,5,26,11,25,17,4,88,38.21823985793037,-109.4068515
68211,6,26,10,26,17,2,87,38.21823985793037,-109.406582
68212,6,26,10,26,18,2,88,38.21823985793037,-109.4063125
68213,9,26,10,24,20,2,91,38.21823985793037,-109.406043
68214,11,26,10,24,19,2,92,38.21823985793037,-109.4057735
68215,12,26,10,23,17,1,89,38.21823985793037,-109.405504
68216,15,23,11,22,17,2,90,38.21823985793037,-109.4052345
68217,11,24,9,21,22,3,90,38.21823985793037,-109.4049651
68218,14,24,9,21,21,2,91,38.21823985793037,-109.4046956
68219,14,24,9,20,20,2,89,38.21823985793037,-109.4044261
68220,14,24,9,20,21,2,90,38.21823985793037,-109.4041566
68221,14,23,9,22,22,2,92,38.21823985793037,-109.4038871
68222,15,23,9,22,22,2,93,38.21823985793037,-109.4036176
68223,13,21,9,25,21,2,91,38.21823985793037,-109.4033481
68224,11,20,9,25,23,2,90,38.21823985793037,-109.4030786
68225,9,23,9,21,25,3,90,38.21823985793037,-109.4028091
68226,8,24,10,21,23,4,90,38.21823985793037,-109.4025396
68227,10,24,10,24,21,3,92,38.21823985793037,-109.4022701
68228,9,23,9,28,20,2,91,38.21823985793037,-109.4020006
68229,8,22,9,30,20,2,91,38.21823985793037,-109.4017311
68230,8,23,9,26,20,2,88,38.21823985793037,-109.4014616
68231,4,40,7,6,11,2,70,38.21823985793037,-109.3906818
68232,3,46,8,6,13,1,77,38.21823985793037,-109.3904123
68233,1,50,8,4,13,3,79,38.21823985793037,-109.3901429
68234,2,44,8,5,13,3,75,38.21823985793037,-109.3898734
68235,2,41,9,6,14,3,75,38.21823985793037,-109.3896039
68236,3,41,10,6,15,3,78,38.21823985793037,-109.3893344
68237,4,45,11,8,15,2,85,38.21823985793037,-109.3890649
68238,5,45,12,11,14,1,88,38.21823985793037,-109.3887954
68239,5,45,12,10,15,1,88,38.21823985793037,-109.3885259
68240,8,45,13,11,15,0,92,38.21823985793037,-109.3882564
68241,10,43,13,11,15,0,92,38.21823985793037,-109.3879869
68242,8,44,13,10,16,0,91,38.21823985793037,-109.3877174
68243,4,49,11,7,17,0,88,38.21823985793037,-109.3874479
68244,3,47,10,6,17,1,84,38.21823985793037,-109.3871784
68245,3,46,10,6,16,1,82,38.21823985793037,-109.3869089
68246,5,45,11,8,16,1,86,38.21823985793037,-109.3866394
68247,10,39,13,10,15,1,88,38.21823985793037,-109.3863699
68248,14,36,14,12,14,0,90,38.21823985793037,-109.3861004
68249,14,33,13,13,14,1,88,38.21797036334514,-109.4114329
68250,10,30,12,13,14,1,80,38.21797036334514,-109.4111634
68251,10,29,11,14,14,1,79,38.21797036334514,-109.4108939
68252,10,30,11,15,14,1,81,38.21797036334514,-109.4106244
68253,4,28,11,15,14,3,75,38.21797036334514,-109.4103549
68254,4,23,12,21,14,4,78,38.21797036334514,-109.4100855
68255,7,18,11,30,18,1,85,38.21797036334514,-109.409816
68256,6,16,11,31,22,2,88,38.21797036334514,-109.4095465
68257,6,13,10,33,22,6,90,38.21797036334514,-109.409277
68258,4,11,7,30,21,8,81,38.21797036334514,-109.4090075
68259,2,10,7,27,23,10,79,38.21797036334514,-109.408738
68260,0,11,7,26,28,8,80,38.21797036334514,-109.4084685
68261,2,16,10,28,29,5,90,38.21797036334514,-109.408199
68262,5,20,11,25,24,3,88,38.21797036334514,-109.4079295
68263,5,25,12,21,15,5,83,38.21797036334514,-109.40766
68264,4,24,11,17,13,5,74,38.21797036334514,-109.4073905
68265,3,27,10,17,13,4,74,38.21797036334514,-109.407121
68266,2,30,10,12,13,5,72,38.21797036334514,-109.4068515
68267,3,32,10,11,12,5,73,38.21797036334514,-109.406582
68268,6,31,10,12,12,4,75,38.21797036334514,-109.4063125
68269,7,33,12,9,12,5,78,38.21797036334514,-109.406043
68270,6,31,11,17,13,4,82,38.21797036334514,-109.4057735
68271,8,26,11,26,15,1,87,38.21797036334514,-109.405504
68272,17,21,10,19,22,2,91,38.21797036334514,-109.4052345
68273,13,19,11,19,24,5,91,38.21797036334514,-109.4049651
68274,14,20,12,18,24,3,91,38.21797036334514,-109.4046956
68275,18,22,11,16,21,3,91,38.21797036334514,-109.4044261
68276,17,23,11,18,18,3,90,38.21797036334514,-109.4041566
68277,13,24,10,19,19,3,88,38.21797036334514,-109.4038871
68278,18,23,9,22,19,2,93,38.21797036334514,-109.4036176
68279,17,23,9,23,19,2,93,38.21797036334514,-109.4033481
68280,17,21,9,25,18,2,92,38.21797036334514,-109.4030786
68281,16,23,9,25,17,2,92,38.21797036334514,-109.4028091
68282,11,25,11,23,17,3,90,38.21797036334514,-109.4025396
68283,7,27,10,28,14,1,87,38.21797036334514,-109.4022701
68284,8,27,10,29,15,0,89,38.21797036334514,-109.4020006
68285,7,28,11,25,18,2,91,38.21797036334514,-109.4017311
68286,4,27,12,24,19,3,89,38.21797036334514,-109.4014616
68287,4,34,8,6,13,2,67,38.21797036334514,-109.3906818
68288,3,41,9,6,13,2,74,38.21797036334514,-109.3904123
68289,2,46,8,4,12,3,75,38.21797036334514,-109.3901429
68290,2,47,9,5,14,3,80,38.21797036334514,-109.3898734
68291,4,47,10,9,15,1,86,38.21797036334514,-109.3896039
68292,4,48,11,9,15,1,88,38.21797036334514,-109.3893344
68293,4,50,11,9,14,1,89,38.21797036334514,-109.3890649
68294,5,48,12,11,13,1,90,38.21797036334514,-109.3887954
68295,7,43,13,13,14,1,91,38.21797036334514,-109.3885259
68296,8,42,14,14,14,1,93,38.21797036334514,-109.3882564
68297,8,42,14,13,15,1,93,38.21797036334514,-109.3879869
68298,8,43,13,13,15,1,93,38.21797036334514,-109.3877174
68299,7,48,12,10,15,0,92,38.21797036334514,-109.3874479
68300,5,49,11,6,16,0,87,38.21797036334514,-109.3871784
68301,4,48,10,6,16,1,85,38.21797036334514,-109.3869089
68302,6,47,11,9,16,0,89,38.21797036334514,-109.3866394
68303,12,40,13,11,15,0,91,38.21797036334514,-109.3863699
68304,15,36,14,12,14,0,91,38.21797036334514,-109.3861004
68305,15,35,13,13,13,0,89,38.21770087,-109.4114329
68306,15,35,13,12,14,0,89,38.21770087,-109.4111634
68307,16,33,12,12,14,1,88,38.21770087,-109.4108939
68308,12,33,11,11,14,1,82,38.21770087,-109.4106244
68309,7,31,10,10,13,2,73,38.21770087,-109.4103549
68310,4,28,10,13,13,3,71,38.21770087,-109.4100855
68311,6,24,12,23,15,2,82,38.21770087,-109.409816
68312,6,21,12,25,21,0,85,38.21770087,-109.4095465
68313,5,18,11,25,23,1,83,38.21770087,-109.409277
68314,5,15,8,25,24,3,80,38.21770087,-109.4090075
68315,2,9,8,34,20,5,78,38.21770087,-109.408738
68316,2,12,9,35,19,5,82,38.21770087,-109.4084685
68317,2,20,12,21,22,4,81,38.21770087,-109.408199
68318,2,24,13,14,15,7,75,38.21770087,-109.4079295
68319,2,31,10,10,11,4,68,38.21770087,-109.40766
68320,4,42,10,8,10,2,76,38.21770087,-109.4073905
68321,3,43,9,8,10,3,76,38.21770087,-109.407121
68322,2,41,9,6,9,4,71,38.21770087,-109.4068515
68323,2,41,8,5,8,5,69,38.21770087,-109.406582
68324,2,37,9,6,8,5,67,38.21770087,-109.4063125
68325,5,35,10,7,12,4,73,38.21770087,-109.406043
68326,7,34,12,13,13,2,81,38.21770087,-109.4057735
68327,11,30,13,20,14,1,89,38.21770087,-109.405504
68328,18,25,11,14,20,3,91,38.21770087,-109.4052345
68329,17,15,10,24,24,2,92,38.21770087,-109.4049651
68330,22,15,9,26,21,2,95,38.21770087,-109.4046956
68331,26,14,9,22,20,2,93,38.21770087,-109.4044261
68332,29,18,10,15,20,3,95,38.21770087,-109.4041566
68333,19,23,11,15,18,4,90,38.21770087,-109.4038871
68334,12,24,10,20,21,4,91,38.21770087,-109.4036176
68335,14,24,9,23,19,3,92,38.21770087,-109.4033481
68336,13,23,9,25,18,2,90,38.21770087,-109.4030786
68337,10,25,9,26,17,2,89,38.21770087,-109.4028091
68338,3,28,10,22,18,2,83,38.21770087,-109.4025396
68339,2,26,10,19,12,3,72,38.21770087,-109.4022701
68340,3,25,11,19,11,3,72,38.21770087,-109.4020006
68341,4,24,10,22,12,3,75,38.21770087,-109.4017311
68342,4,25,10,28,14,2,83,38.21770087,-109.4014616
68343,5,27,11,14,17,2,76,38.21770087,-109.3906818
68344,3,34,10,10,15,2,74,38.21770087,-109.3904123
68345,2,37,9,8,14,3,73,38.21770087,-109.3901429
68346,2,45,9,6,13,3,78,38.21770087,-109.3898734
68347,3,46,10,9,14,1,83,38.21770087,-109.3896039
68348,3,48,10,10,13,1,85,38.21770087,-109.3893344
68349,3,50,10,10,12,1,86,38.21770087,-109.3890649
68350,4,53,10,11,12,1,91,38.21770087,-109.3887954
68351,5,53,12,12,12,0,94,38.21770087,-109.3885259
68352,5,50,12,12,13,1,93,38.21770087,-109.3882564
68353,6,49,13,12,13,1,94,38.21770087,-109.3879869
68354,5,50,12,10,14,1,92,38.21770087,-109.3877174
68355,4,52,10,8,15,0,89,38.21770087,-109.3874479
68356,3,52,10,6,15,0,86,38.21770087,-109.3871784
68357,3,49,10,6,16,0,84,38.21770087,-109.3869089
68358,6,46,12,9,16,0,89,38.21770087,-109.3866394
68359,14,38,13,11,14,1,91,38.21770087,-109.3863699
68360,21,34,13,10,13,0,91,38.21770087,-109.3861004
68361,17,35,13,13,12,0,90,38.217431374174666,-109.4114329
68362,17,36,13,12,12,0,90,38.217431374174666,-109.4111634
68363,21,32,12,13,12,0,90,38.217431374174666,-109.4108939
68364,19,32,12,11,12,0,86,38.217431374174666,-109.4106244
68365,14,32,11,9,12,1,79,38.217431374174666,-109.4103549
68366,5,32,9,10,12,2,70,38.217431374174666,-109.4100855
68367,5,23,11,18,15,3,75,38.217431374174666,-109.409816
68368,4,27,11,25,15,1,83,38.217431374174666,-109.4095465
68369,2,26,11,25,18,0,82,38.217431374174666,-109.409277
68370,1,27,11,21,19,2,81,38.217431374174666,-109.4090075
68371,0,26,11,18,19,2,76,38.217431374174666,-109.408738
68372,2,29,11,14,17,4,77,38.217431374174666,-109.4084685
68373,2,26,11,10,11,7,67,38.217431374174666,-109.408199
68374,2,29,10,7,8,6,62,38.217431374174666,-109.4079295
68375,4,40,9,9,8,3,73,38.217431374174666,-109.40766
68376,3,38,10,9,12,4,76,38.217431374174666,-109.4073905
68377,3,40,9,5,12,4,73,38.217431374174666,-109.407121
68378,2,40,9,6,10,4,71,38.217431374174666,-109.4068515
68379,2,42,8,8,8,3,71,38.217431374174666,-109.406582
68380,2,39,8,7,8,4,68,38.217431374174666,-109.4063125
68381,2,38,8,6,7,5,66,38.217431374174666,-109.406043
68382,4,27,10,12,12,3,68,38.217431374174666,-109.4057735
68383,7,21,11,28,14,1,82,38.217431374174666,-109.405504
68384,12,14,8,34,19,3,90,38.217431374174666,-109.4052345
68385,14,13,10,31,26,1,95,38.217431374174666,-109.4049651
68386,23,15,9,25,19,2,93,38.217431374174666,-109.4046956
68387,25,16,9,21,17,3,91,38.217431374174666,-109.4044261
68388,23,21,10,17,16,3,90,38.217431374174666,-109.4041566
68389,16,25,12,15,17,5,90,38.217431374174666,-109.4038871
68390,9,24,11,16,22,5,87,38.217431374174666,-109.4036176
68391,8,24,11,18,23,5,89,38.217431374174666,-109.4033481
68392,7,24,11,21,20,4,87,38.217431374174666,-109.4030786
68393,5,25,10,23,17,3,83,38.217431374174666,-109.4028091
68394,2,21,10,19,15,3,70,38.217431374174666,-109.4025396
68395,3,31,9,11,10,2,66,38.217431374174666,-109.4022701
68396,4,35,8,8,8,3,66,38.217431374174666,-109.4020006
68397,3,30,9,7,9,5,63,38.217431374174666,-109.4017311
68398,3,27,10,12,10,5,67,38.217431374174666,-109.4014616
68399,18,23,12,23,12,1,89,38.217431374174666,-109.3906818
68400,13,24,11,20,13,2,83,38.217431374174666,-109.3904123
68401,6,24,10,15,17,3,75,38.217431374174666,-109.3901429
68402,3,30,9,9,14,3,68,38.217431374174666,-109.3898734
68403,4,38,8,6,13,2,71,38.217431374174666,-109.3896039
68404,2,42,8,6,13,2,73,38.217431374174666,-109.3893344
68405,2,46,9,8,13,2,80,38.217431374174666,-109.3890649
68406,3,49,9,10,13,1,85,38.217431374174666,-109.3887954
68407,4,55,10,10,12,1,92,38.217431374174666,-109.3885259
68408,5,54,11,12,12,0,94,38.217431374174666,-109.3882564
68409,4,53,11,12,12,1,93,38.217431374174666,-109.3879869
68410,5,53,11,11,13,1,94,38.217431374174666,-109.3877174
68411,5,50,11,9,14,1,90,38.217431374174666,-109.3874479
68412,4,53,11,7,15,0,90,38.217431374174666,-109.3871784
68413,4,48,11,8,17,0,88,38.217431374174666,-109.3869089
68414,8,44,12,10,16,0,90,38.217431374174666,-109.3866394
68415,15,37,14,12,14,0,92,38.217431374174666,-109.3863699
68416,20,34,13,11,13,0,91,38.217431374174666,-109.3861004
68417,16,35,13,12,12,0,88,38.217161879589426,-109.4114329
68418,17,36,13,12,13,0,91,38.217161879589426,-109.4111634
68419,16,31,13,14,13,0,87,38.217161879589426,-109.4108939
68420,15,31,11,11,12,1,81,38.217161879589426,-109.4106244
68421,13,33,10,9,13,1,79,38.217161879589426,-109.4103549
68422,7,33,10,12,13,1,76,38.217161879589426,-109.4100855
68423,6,30,10,16,15,0,77,38.217161879589426,-109.409816
68424,4,33,10,14,14,2,77,38.217161879589426,-109.4095465
68425,3,35,9,10,12,3,72,38.217161879589426,-109.409277
68426,3,41,8,10,10,2,74,38.217161879589426,-109.4090075
68427,5,47,8,8,8,2,78,38.217161879589426,-109.408738
68428,2,37,8,7,6,5,65,38.217161879589426,-109.4084685
68429,3,36,9,7,6,5,66,38.217161879589426,-109.408199
68430,3,37,9,6,7,5,67,38.217161879589426,-109.4079295
68431,2,39,9,7,6,5,68,38.217161879589426,-109.40766
68432,3,35,9,9,10,3,69,38.217161879589426,-109.4073905
68433,2,36,9,7,10,5,69,38.217161879589426,-109.407121
68434,2,39,9,6,9,5,70,38.217161879589426,-109.4068515
68435,2,42,9,7,9,4,73,38.217161879589426,-109.406582
68436,2,42,9,8,9,3,73,38.217161879589426,-109.4063125
68437,2,42,7,5,7,3,66,38.217161879589426,-109.406043
68438,3,35,8,6,9,3,64,38.217161879589426,-109.4057735
68439,9,24,11,13,13,2,72,38.217161879589426,-109.405504
68440,17,17,10,30,14,1,89,38.217161879589426,-109.4052345
68441,19,10,9,30,28,1,97,38.217161879589426,-109.4049651
68442,13,13,9,33,26,1,95,38.217161879589426,-109.4046956
68443,15,19,10,24,22,2,92,38.217161879589426,-109.4044261
68444,19,24,11,17,17,2,90,38.217161879589426,-109.4041566
68445,14,29,12,16,17,1,89,38.217161879589426,-109.4038871
68446,14,27,12,16,18,3,90,38.217161879589426,-109.4036176
68447,11,24,11,17,21,5,89,38.217161879589426,-109.4033481
68448,9,24,11,19,23,5,91,38.217161879589426,-109.4030786
68449,9,22,10,25,19,3,88,38.217161879589426,-109.4028091
68450,7,19,10,26,13,2,77,38.217161879589426,-109.4025396
68451,7,31,10,10,12,2,72,38.217161879589426,-109.4022701
68452,5,30,9,8,11,3,66,38.217161879589426,-109.4020006
68453,5,28,10,9,11,4,67,38.217161879589426,-109.4017311
68454,6,28,10,9,11,4,68,38.217161879589426,-109.4014616
68455,17,20,10,25,15,2,89,38.217161879589426,-109.3906818
68456,17,21,10,24,15,2,89,38.217161879589426,-109.3904123
68457,16,19,11,20,15,3,84,38.217161879589426,-109.3901429
68458,10,21,12,13,16,3,75,38.217161879589426,-109.3898734
68459,3,34,9,9,15,2,72,38.217161879589426,-109.3896039
68460,2,42,9,8,13,2,76,38.217161879589426,-109.3893344
68461,2,44,9,8,13,2,78,38.217161879589426,-109.3890649
68462,2,45,9,8,13,1,78,38.217161879589426,-109.3887954
68463,3,48,9,10,13,1,84,38.217161879589426,-109.3885259
68464,4,44,10,10,13,1,82,38.217161879589426,-109.3882564
68465,4,48,10,11,12,1,86,38.217161879589426,-109.3879869
68466,4,51,10,11,12,1,89,38.217161879589426,-109.3877174
68467,6,51,11,10,14,0,92,38.217161879589426,-109.3874479
68468,5,52,10,9,15,0,91,38.217161879589426,-109.3871784
68469,4,49,11,8,16,0,88,38.217161879589426,-109.3869089
68470,5,47,11,10,15,0,88,38.217161879589426,-109.3866394
68471,10,43,13,11,14,0,91,38.217161879589426,-109.3863699
68472,16,36,14,12,13,0,91,38.217161879589426,-109.3861004
68473,17,37,13,13,12,0,92,38.21689238500419,-109.4114329
68474,17,36,14,14,12,0,93,38.21689238500419,-109.4111634
68475,12,33,12,11,12,1,81,38.21689238500419,-109.4108939
68476,11,31,10,10,12,1,75,38.21689238500419,-109.4106244
68477,11,27,11,11,12,1,73,38.21689238500419,-109.4103549
68478,9,30,12,21,11,1,84,38.21689238500419,-109.4100855
68479,10,33,11,15,14,0,83,38.21689238500419,-109.409816
68480,9,35,11,13,14,1,83,38.21689238500419,-109.4095465
68481,8,34,11,13,14,1,81,38.21689238500419,-109.409277
68482,5,33,11,13,14,1,77,38.21689238500419,-109.4090075
68483,3,33,10,11,14,2,73,38.21689238500419,-109.408738
68484,2,32,10,9,12,4,69,38.21689238500419,-109.4084685
68485,3,36,10,7,10,4,70,38.21689238500419,-109.408199
68486,4,43,8,8,7,2,72,38.21689238500419,-109.4079295
68487,4,47,8,7,7,3,76,38.21689238500419,-109.40766
68488,3,48,7,5,6,4,73,38.21689238500419,-109.4073905
68489,2,43,8,6,5,5,69,38.21689238500419,-109.407121
68490,2,41,9,6,6,5,69,38.21689238500419,-109.4068515
68491,3,41,9,6,7,5,71,38.21689238500419,-109.406582
68492,3,41,10,6,9,4,73,38.21689238500419,-109.4063125
68493,2,38,9,7,7,5,68,38.21689238500419,-109.406043
68494,3,37,9,6,10,4,69,38.21689238500419,-109.4057735
68495,5,24,11,14,15,3,72,38.21689238500419,-109.405504
68496,10,19,9,36,17,1,92,38.21689238500419,-109.4052345
68497,7,13,10,26,35,2,93,38.21689238500419,-109.4049651
68498,7,13,9,37,24,3,93,38.21689238500419,-109.4046956
68499,9,15,10,34,21,3,92,38.21689238500419,-109.4044261
68500,18,20,9,22,18,3,90,38.21689238500419,-109.4041566
68501,16,25,12,18,16,1,88,38.21689238500419,-109.4038871
68502,14,28,11,16,18,2,89,38.21689238500419,-109.4036176
68503,15,24,11,16,21,4,91,38.21689238500419,-109.4033481
68504,10,21,12,17,24,5,89,38.21689238500419,-109.4030786
68505,8,19,11,22,25,4,89,38.21689238500419,-109.4028091
68506,9,18,9,34,17,2,89,38.21689238500419,-109.4025396
68507,7,18,10,28,13,2,78,38.21689238500419,-109.4022701
68508,8,21,11,22,13,2,77,38.21689238500419,-109.4020006
68509,7,23,12,22,14,2,80,38.21689238500419,-109.4017311
68510,6,25,12,24,15,2,84,38.21689238500419,-109.4014616
68511,20,23,9,24,12,1,89,38.21689238500419,-109.3906818
68512,23,16,9,24,16,2,90,38.21689238500419,-109.3904123
68513,25,15,10,19,18,2,89,38.21689238500419,-109.3901429
68514,20,18,11,17,15,2,83,38.21689238500419,-109.3898734
68515,3,35,10,12,17,2,79,38.21689238500419,-109.3896039
68516,2,43,10,10,14,1,80,38.21689238500419,-109.3893344
68517,2,44,10,10,14,1,81,38.21689238500419,-109.3890649
68518,2,41,9,8,14,2,76,38.21689238500419,-109.3887954
68519,2,43,8,4,12,5,74,38.21689238500419,-109.3885259
68520,2,43,8,7,11,2,73,38.21689238500419,-109.3882564
68521,2,42,9,7,12,2,74,38.21689238500419,-109.3879869
68522,3,45,10,9,13,1,81,38.21689238500419,-109.3877174
68523,4,51,10,9,14,1,89,38.21689238500419,-109.3874479
68524,2,55,9,7,14,0,87,38.21689238500419,-109.3871784
68525,2,53,9,5,14,0,83,38.21689238500419,-109.3869089
68526,3,50,10,9,14,1,87,38.21689238500419,-109.3866394
68527,6,47,12,11,15,0,91,38.21689238500419,-109.3863699
68528,10,40,14,12,14,1,91,38.21689238500419,-109.3861004
68529,15,37,14,13,13,0,92,38.21662289041896,-109.4114329
68530,13,37,14,13,12,0,89,38.21662289041896,-109.4111634
68531,8,31,12,15,12,1,79,38.21662289041896,-109.4108939
68532,7,28,12,15,13,1,76,38.21662289041896,-109.4106244
68533,11,30,12,13,14,1,81,38.21662289041896,-109.4103549
68534,10,33,12,14,14,1,84,38.21662289041896,-109.4100855
68535,15,35,12,12,14,0,88,38.21662289041896,-109.409816
68536,18,35,12,11,13,0,89,38.21662289041896,-109.4095465
68537,17,35,12,11,13,0,88,38.21662289041896,-109.409277
68538,13,35,12,12,13,1,86,38.21662289041896,-109.4090075
68539,9,30,11,12,12,2,76,38.21662289041896,-109.408738
68540,6,32,10,9,13,3,73,38.21662289041896,-109.4084685
68541,4,34,10,8,13,3,72,38.21662289041896,-109.408199
68542,3,38,9,6,11,3,70,38.21662289041896,-109.4079295
68543,2,44,7,6,6,4,69,38.21662289041896,-109.40766
68544,2,43,6,5,5,5,66,38.21662289041896,-109.4073905
68545,2,44,7,6,5,4,68,38.21662289041896,-109.407121
68546,2,43,7,6,6,4,68,38.21662289041896,-109.4068515
68547,2,38,9,6,6,6,67,38.21662289041896,-109.406582
68548,3,32,11,6,9,6,67,38.21662289041896,-109.4063125
68549,2,31,11,6,11,7,68,38.21662289041896,-109.406043
68550,2,32,10,10,12,5,71,38.21662289041896,-109.4057735
68551,6,28,11,21,16,2,84,38.21662289041896,-109.405504
68552,10,22,10,21,28,1,92,38.21662289041896,-109.4052345
68553,4,19,10,31,24,4,92,38.21662289041896,-109.4049651
68554,8,21,10,23,25,3,90,38.21662289041896,-109.4046956
68555,18,19,9,24,22,2,94,38.21662289041896,-109.4044261
68556,20,20,9,22,20,3,94,38.21662289041896,-109.4041566
68557,16,23,11,17,19,4,90,38.21662289041896,-109.4038871
68558,21,24,11,15,19,3,93,38.21662289041896,-109.4036176
68559,17,26,12,13,20,5,93,38.21662289041896,-109.4033481
68560,14,25,11,15,22,5,92,38.21662289041896,-109.4030786
68561,10,22,11,19,25,4,91,38.21662289041896,-109.4028091
68562,4,21,12,21,28,5,91,38.21662289041896,-109.4025396
68563,9,17,10,29,22,3,90,38.21662289041896,-109.4022701
68564,7,19,10,29,21,4,90,38.21662289041896,-109.4020006
68565,4,21,11,26,23,5,90,38.21662289041896,-109.4017311
68566,3,21,11,26,24,4,89,38.21662289041896,-109.4014616
68567,13,43,9,14,11,0,90,38.21662289041896,-109.3906818
68568,15,33,10,15,14,1,88,38.21662289041896,-109.3904123
68569,21,20,10,18,16,2,87,38.21662289041896,-109.3901429
68570,21,14,11,21,17,3,87,38.21662289041896,-109.3898734
68571,10,23,11,19,17,2,82,38.21662289041896,-109.3896039
68572,3,34,10,13,16,2,78,38.21662289041896,-109.3893344
68573,2,38,9,10,15,2,76,38.21662289041896,-109.3890649
68574,2,37,9,9,14,3,74,38.21662289041896,-109.3887954
68575,2,42,9,8,13,3,77,38.21662289041896,-109.3885259
68576,4,50,9,8,12,1,84,38.21662289041896,-109.3882564
68577,4,49,9,10,12,1,85,38.21662289041896,-109.3879869
68578,4,48,10,11,13,1,87,38.21662289041896,-109.3877174
68579,4,48,11,10,15,1,89,38.21662289041896,-109.3874479
68580,5,50,10,11,14,0,90,38.21662289041896,-109.3871784
68581,3,52,10,9,15,0,89,38.21662289041896,-109.3869089
68582,3,52,10,8,15,0,88,38.21662289041896,-109.3866394
68583,3,50,10,9,14,1,87,38.21662289041896,-109.3863699
68584,6,47,11,11,14,1,90,38.21662289041896,-109.3861004
68585,18,37,13,12,12,0,92,38.21635339583372,-109.4114329
68586,13,38,14,13,13,0,91,38.21635339583372,-109.4111634
68587,10,34,13,15,14,1,87,38.21635339583372,-109.4108939
68588,9,33,12,16,14,0,84,38.21635339583372,-109.4106244
68589,11,34,12,16,14,0,87,38.21635339583372,-109.4103549
68590,13,34,13,15,14,0,89,38.21635339583372,-109.4100855
68591,18,33,13,13,13,0,90,38.21635339583372,-109.409816
68592,20,34,12,11,12,0,89,38.21635339583372,-109.4095465
68593,19,34,13,11,12,0,89,38.21635339583372,-109.409277
68594,17,34,13,14,12,0,90,38.21635339583372,-109.4090075
68595,16,32,12,14,11,0,85,38.21635339583372,-109.408738
68596,11,31,11,11,12,2,78,38.21635339583372,-109.4084685
68597,6,33,11,11,13,2,76,38.21635339583372,-109.408199
68598,3,33,11,8,13,4,72,38.21635339583372,-109.4079295
68599,2,35,10,6,12,5,70,38.21635339583372,-109.40766
68600,1,36,8,6,7,6,64,38.21635339583372,-109.4073905
68601,2,39,8,7,6,4,66,38.21635339583372,-109.407121
68602,3,42,8,8,6,3,70,38.21635339583372,-109.4068515
68603,3,39,9,8,7,4,70,38.21635339583372,-109.406582
68604,2,32,10,10,8,5,67,38.21635339583372,-109.4063125
68605,4,30,13,14,11,4,76,38.21635339583372,-109.406043
68606,3,27,13,18,11,4,76,38.21635339583372,-109.4057735
68607,5,25,12,23,14,3,82,38.21635339583372,-109.405504
68608,9,25,11,26,16,2,89,38.21635339583372,-109.4052345
68609,10,23,10,24,22,3,92,38.21635339583372,-109.4049651
68610,14,25,9,21,20,3,92,38.21635339583372,-109.4046956
68611,15,24,9,19,21,3,91,38.21635339583372,-109.4044261
68612,11,24,11,18,22,4,90,38.21635339583372,-109.4041566
68613,10,24,12,18,22,5,91,38.21635339583372,-109.4038871
68614,21,22,11,15,20,4,93,38.21635339583372,-109.4036176
68615,19,25,11,17,17,3,92,38.21635339583372,-109.4033481
68616,14,28,11,19,16,2,90,38.21635339583372,-109.4030786
68617,13,27,11,19,17,3,90,38.21635339583372,-109.4028091
68618,12,21,12,20,22,6,93,38.21635339583372,-109.4025396
68619,4,16,13,21,29,8,91,38.21635339583372,-109.4022701
68620,4,13,12,24,30,9,92,38.21635339583372,-109.4020006
68621,4,14,12,23,29,9,91,38.21635339583372,-109.4017311
68622,4,17,12,20,28,9,90,38.21635339583372,-109.4014616
68623,13,45,9,15,9,0,91,38.21635339583372,-109.3906818
68624,14,39,9,17,11,0,90,38.21635339583372,-109.3904123
68625,20,27,10,18,12,1,88,38.21635339583372,-109.3901429
68626,27,12,9,21,19,5,93,38.21635339583372,-109.3898734
68627,19,14,9,25,21,3,91,38.21635339583372,-109.3896039
68628,8,22,10,20,16,3,79,38.21635339583372,-109.3893344
68629,1,25,10,11,14,6,67,38.21635339583372,-109.3890649
68630,1,32,10,7,11,7,68,38.21635339583372,-109.3887954
68631,3,41,9,7,13,2,75,38.21635339583372,-109.3885259
68632,4,52,10,9,13,1,89,38.21635339583372,-109.3882564
68633,5,54,10,10,13,1,93,38.21635339583372,-109.3879869
68634,6,51,11,12,13,1,94,38.21635339583372,-109.3877174
68635,7,49,12,12,13,0,93,38.21635339583372,-109.3874479
68636,5,50,11,9,14,1,90,38.21635339583372,-109.3871784
68637,4,54,10,8,14,0,90,38.21635339583372,-109.3869089
68638,3,55,10,7,15,0,90,38.21635339583372,-109.3866394
68639,3,53,10,7,15,0,88,38.21635339583372,-109.3863699
68640,4,49,10,8,15,1,87,38.21635339583372,-109.3861004
68641,16,36,14,12,13,0,91,38.21608390124848,-109.4114329
68642,12,38,14,13,14,0,91,38.21608390124848,-109.4111634
68643,13,36,13,12,14,0,88,38.21608390124848,-109.4108939
68644,12,34,13,14,14,0,87,38.21608390124848,-109.4106244
68645,11,34,13,15,15,0,88,38.21608390124848,-109.4103549
68646,12,34,13,13,15,0,87,38.21608390124848,-109.4100855
68647,13,34,13,13,14,0,87,38.21608390124848,-109.409816
68648,15,34,13,12,13,1,88,38.21608390124848,-109.4095465
68649,18,34,13,12,12,0,89,38.21608390124848,-109.409277
68650,18,34,13,13,12,0,90,38.21608390124848,-109.4090075
68651,15,33,13,14,12,0,87,38.21608390124848,-109.408738
68652,11,33,12,15,12,1,84,38.21608390124848,-109.4084685
68653,12,34,13,15,13,0,87,38.21608390124848,-109.408199
68654,11,33,12,14,14,1,85,38.21608390124848,-109.4079295
68655,9,34,12,12,15,1,83,38.21608390124848,-109.40766
68656,9,35,11,9,17,1,82,38.21608390124848,-109.4073905
68657,5,31,11,10,16,2,75,38.21608390124848,-109.407121
68658,3,31,10,10,13,4,71,38.21608390124848,-109.4068515
68659,2,31,10,10,11,5,69,38.21608390124848,-109.406582
68660,2,29,10,10,9,6,66,38.21608390124848,-109.4063125
68661,2,29,10,9,8,5,63,38.21608390124848,-109.406043
68662,3,27,11,10,9,6,66,38.21608390124848,-109.4057735
68663,4,27,12,16,11,4,74,38.21608390124848,-109.405504
68664,9,28,13,20,13,3,86,38.21608390124848,-109.4052345
68665,12,23,12,21,20,2,90,38.21608390124848,-109.4049651
68666,13,23,9,20,21,3,89,38.21608390124848,-109.4046956
68667,10,25,10,18,21,4,88,38.21608390124848,-109.4044261
68668,9,26,11,19,21,4,90,38.21608390124848,-109.4041566
68669,8,24,11,21,21,4,89,38.21608390124848,-109.4038871
68670,8,23,10,21,25,3,90,38.21608390124848,-109.4036176
68671,13,22,11,21,20,4,91,38.21608390124848,-109.4033481
68672,16,25,12,18,15,3,89,38.21608390124848,-109.4030786
68673,17,27,12,15,15,2,88,38.21608390124848,-109.4028091
68674,23,24,11,14,16,2,90,38.21608390124848,-109.4025396
68675,20,20,11,15,20,5,91,38.21608390124848,-109.4022701
68676,18,20,12,17,19,4,90,38.21608390124848,-109.4020006
68677,18,21,12,18,18,4,91,38.21608390124848,-109.4017311
68678,14,21,11,20,18,4,88,38.21608390124848,-109.4014616
68679,12,44,8,14,10,0,88,38.21608390124848,-109.3906818
68680,13,38,9,17,12,0,89,38.21608390124848,-109.3904123
68681,22,27,9,17,13,2,90,38.21608390124848,-109.3901429
68682,24,12,9,22,18,7,92,38.21608390124848,-109.3898734
68683,21,10,10,26,20,6,93,38.21608390124848,-109.3896039
68684,10,20,9,27,16,3,85,38.21608390124848,-109.3893344
68685,0,21,10,17,13,7,68,38.21608390124848,-109.3890649
68686,1,31,9,7,11,6,65,38.21608390124848,-109.3887954
68687,2,40,8,6,10,4,70,38.21608390124848,-109.3885259
68688,4,46,9,10,13,1,83,38.21608390124848,-109.3882564
68689,4,50,10,11,12,1,88,38.21608390124848,-109.3879869
68690,4,51,10,12,12,1,90,38.21608390124848,-109.3877174
68691,4,51,11,12,12,1,91,38.21608390124848,-109.3874479
68692,4,54,11,11,13,0,93,38.21608390124848,-109.3871784
68693,3,52,10,8,14,1,88,38.21608390124848,-109.3869089
68694,3,50,10,6,15,1,85,38.21608390124848,-109.3866394
68695,3,49,10,6,15,1,84,38.21608390124848,-109.3863699
68696,3,46,10,7,15,1,82,38.21608390124848,-109.3861004
68697,10,38,14,11,15,0,88,38.21581440666325,-109.4114329
68698,9,40,14,11,15,0,89,38.21581440666325,-109.4111634
68699,11,37,13,12,16,0,89,38.21581440666325,-109.4108939
68700,13,34,13,13,15,0,88,38.21581440666325,-109.4106244
68701,14,33,13,14,14,0,88,38.21581440666325,-109.4103549
68702,14,34,13,14,14,0,89,38.21581440666325,-109.4100855
68703,18,33,13,11,14,0,89,38.21581440666325,-109.409816
68704,17,34,13,11,13,0,88,38.21581440666325,-109.4095465
68705,18,34,13,11,13,0,89,38.21581440666325,-109.409277
68706,18,33,13,12,12,0,88,38.21581440666325,-109.4090075
68707,16,33,13,14,13,0,89,38.21581440666325,-109.408738
68708,12,34,13,17,13,0,89,38.21581440666325,-109.4084685
68709,9,34,13,18,13,0,87,38.21581440666325,-109.408199
68710,12,33,13,15,14,0,87,38.21581440666325,-109.4079295
68711,18,30,12,12,14,0,86,38.21581440666325,-109.40766
68712,14,32,12,12,14,0,84,38.21581440666325,-109.4073905
68713,11,31,12,13,15,1,83,38.21581440666325,-109.407121
68714,8,32,11,13,14,1,79,38.21581440666325,-109.4068515
68715,6,31,11,12,13,3,76,38.21581440666325,-109.406582
68716,4,29,11,9,12,5,70,38.21581440666325,-109.4063125
68717,2,27,11,7,9,6,62,38.21581440666325,-109.406043
68718,2,30,10,6,6,6,60,38.21581440666325,-109.4057735
68719,4,30,11,9,9,5,68,38.21581440666325,-109.405504
68720,4,27,12,14,11,5,73,38.21581440666325,-109.4052345
68721,10,25,12,25,15,3,90,38.21581440666325,-109.4049651
68722,11,18,10,29,22,3,93,38.21581440666325,-109.4046956
68723,11,23,10,21,21,4,90,38.21581440666325,-109.4044261
68724,9,25,10,20,20,4,88,38.21581440666325,-109.4041566
68725,7,23,10,24,21,3,88,38.21581440666325,-109.4038871
68726,3,22,10,25,24,3,87,38.21581440666325,-109.4036176
68727,3,20,11,26,24,4,88,38.21581440666325,-109.4033481
68728,6,22,12,23,20,4,87,38.21581440666325,-109.4030786
68729,10,25,12,19,18,4,88,38.21581440666325,-109.4028091
68730,13,27,12,18,17,2,89,38.21581440666325,-109.4025396
68731,11,29,12,20,15,1,88,38.21581440666325,-109.4022701
68732,8,34,12,20,13,1,88,38.21581440666325,-109.4020006
68733,7,34,12,19,14,1,87,38.21581440666325,-109.4017311
68734,11,31,11,16,15,1,85,38.21581440666325,-109.4014616
68735,15,39,9,14,11,1,89,38.21581440666325,-109.3906818
68736,13,31,10,16,14,2,86,38.21581440666325,-109.3904123
68737,17,21,9,22,15,3,87,38.21581440666325,-109.3901429
68738,22,15,10,22,17,4,90,38.21581440666325,-109.3898734
68739,20,15,10,24,18,4,91,38.21581440666325,-109.3896039
68740,12,23,11,17,16,5,84,38.21581440666325,-109.3893344
68741,4,23,10,13,14,6,70,38.21581440666325,-109.3890649
68742,1,27,9,9,12,7,65,38.21581440666325,-109.3887954
68743,2,35,8,6,10,6,67,38.21581440666325,-109.3885259
68744,2,42,8,6,12,3,73,38.21581440666325,-109.3882564
68745,3,48,9,7,13,2,82,38.21581440666325,-109.3879869
68746,4,51,10,8,12,1,86,38.21581440666325,-109.3877174
68747,5,50,10,10,13,1,89,38.21581440666325,-109.3874479
68748,6,50,10,10,13,0,89,38.21581440666325,-109.3871784
68749,5,48,11,12,13,1,90,38.21581440666325,-109.3869089
68750,5,50,11,10,15,0,91,38.21581440666325,-109.3866394
68751,4,53,11,7,15,0,90,38.21581440666325,-109.3863699
68752,3,53,10,6,15,1,88,38.21581440666325,-109.3861004
68753,8,38,14,11,16,1,88,38.215544912078016,-109.4114329
68754,11,40,13,9,15,0,88,38.215544912078016,-109.4111634
68755,11,38,14,12,16,0,91,38.215544912078016,-109.4108939
68756,12,36,14,13,15,0,90,38.215544912078016,-109.4106244
68757,13,35,14,13,15,0,90,38.215544912078016,-109.4103549
68758,15,35,13,12,15,0,90,38.215544912078016,-109.4100855
68759,14,35,14,12,15,0,90,38.215544912078016,-109.409816
68760,15,37,13,10,14,0,89,38.215544912078016,-109.4095465
68761,18,36,13,10,12,0,89,38.215544912078016,-109.409277
68762,19,34,13,10,12,0,88,38.215544912078016,-109.4090075
68763,16,35,13,10,13,1,88,38.215544912078016,-109.408738
68764,17,34,12,13,13,0,89,38.215544912078016,-109.4084685
68765,17,33,13,13,13,0,89,38.215544912078016,-109.408199
68766,15,31,13,14,14,1,88,38.215544912078016,-109.4079295
68767,12,29,13,15,15,1,85,38.215544912078016,-109.40766
68768,12,31,12,14,14,1,84,38.215544912078016,-109.4073905
68769,11,32,12,13,13,1,82,38.215544912078016,-109.407121
68770,13,33,12,12,15,1,86,38.215544912078016,-109.4068515
68771,12,34,12,12,15,0,85,38.215544912078016,-109.406582
68772,11,34,12,13,13,1,84,38.215544912078016,-109.4063125
68773,3,25,12,11,12,6,69,38.215544912078016,-109.406043
68774,1,24,11,9,9,8,62,38.215544912078016,-109.4057735
68775,2,26,11,8,8,7,62,38.215544912078016,-109.405504
68776,3,25,12,11,9,6,66,38.215544912078016,-109.4052345
68777,11,26,15,17,13,3,85,38.215544912078016,-109.4049651
68778,11,19,11,30,21,2,94,38.215544912078016,-109.4046956
68779,11,19,10,31,19,3,93,38.215544912078016,-109.4044261
68780,8,21,9,30,19,3,90,38.215544912078016,-109.4041566
68781,3,21,10,29,21,3,87,38.215544912078016,-109.4038871
68782,3,22,10,26,24,3,88,38.215544912078016,-109.4036176
68783,3,21,10,26,26,3,89,38.215544912078016,-109.4033481
68784,2,21,10,27,24,3,87,38.215544912078016,-109.4030786
68785,2,22,11,25,24,3,87,38.215544912078016,-109.4028091
68786,2,23,11,22,26,3,87,38.215544912078016,-109.4025396
68787,3,24,11,23,24,3,88,38.215544912078016,-109.4022701
68788,8,28,11,19,17,2,85,38.215544912078016,-109.4020006
68789,9,31,12,19,15,1,87,38.215544912078016,-109.4017311
68790,10,30,11,19,15,1,86,38.215544912078016,-109.4014616
68791,21,33,9,13,11,1,88,38.215544912078016,-109.3906818
68792,18,25,9,19,14,3,88,38.215544912078016,-109.3904123
68793,18,19,10,22,17,2,88,38.215544912078016,-109.3901429
68794,20,18,10,23,15,3,89,38.215544912078016,-109.3898734
68795,20,21,10,18,16,4,89,38.215544912078016,-109.3896039
68796,9,26,11,13,15,6,80,38.215544912078016,-109.3893344
68797,3,26,11,10,13,8,71,38.215544912078016,-109.3890649
68798,1,27,10,6,11,9,64,38.215544912078016,-109.3887954
68799,0,39,8,2,10,8,67,38.215544912078016,-109.3885259
68800,2,44,8,5,13,3,75,38.215544912078016,-109.3882564
68801,4,53,9,7,13,1,87,38.215544912078016,-109.3879869
68802,5,56,10,7,13,1,92,38.215544912078016,-109.3877174
68803,5,52,10,7,13,2,89,38.215544912078016,-109.3874479
68804,6,51,11,8,15,0,91,38.215544912078016,-109.3871784
68805,5,53,10,7,15,0,90,38.215544912078016,-109.3869089
68806,5,52,10,8,14,0,89,38.215544912078016,-109.3866394
68807,4,53,9,7,14,1,88,38.215544912078016,-109.3863699
68808,3,55,9,5,14,1,87,38.215544912078016,-109.3861004
68809,7,38,14,12,17,1,89,38.21527541749278,-109.4114329
68810,8,37,14,12,17,1,89,38.21527541749278,-109.4111634
68811,11,38,14,12,16,0,91,38.21527541749278,-109.4108939
68812,11,38,14,11,16,0,90,38.21527541749278,-109.4106244
68813,12,37,13,10,15,0,87,38.21527541749278,-109.4103549
68814,13,36,13,10,15,1,88,38.21527541749278,-109.4100855
68815,12,38,14,10,15,1,90,38.21527541749278,-109.409816
68816,12,37,13,10,15,1,88,38.21527541749278,-109.4095465
68817,15,36,13,10,15,0,89,38.21527541749278,-109.409277
68818,14,36,13,10,15,0,88,38.21527541749278,-109.4090075
68819,11,38,13,9,14,2,87,38.21527541749278,-109.408738
68820,12,37,14,10,15,1,89,38.21527541749278,-109.4084685
68821,14,35,14,13,14,0,90,38.21527541749278,-109.408199
68822,13,33,14,15,15,0,90,38.21527541749278,-109.4079295
68823,11,32,13,17,14,0,87,38.21527541749278,-109.40766
68824,10,32,12,16,14,1,85,38.21527541749278,-109.4073905
68825,20,32,12,11,13,0,88,38.21527541749278,-109.407121
68826,19,34,12,10,13,0,88,38.21527541749278,-109.4068515
68827,16,36,12,9,13,1,87,38.21527541749278,-109.406582
68828,15,36,12,9,13,1,86,38.21527541749278,-109.4063125
68829,12,32,11,9,13,2,79,38.21527541749278,-109.406043
68830,4,26,10,8,10,5,63,38.21527541749278,-109.4057735
68831,2,23,10,8,7,6,56,38.21527541749278,-109.405504
68832,2,23,10,8,8,6,57,38.21527541749278,-109.4052345
68833,4,26,11,14,11,4,70,38.21527541749278,-109.4049651
68834,12,18,11,33,14,2,90,38.21527541749278,-109.4046956
68835,11,16,10,33,19,2,91,38.21527541749278,-109.4044261
68836,7,18,10,33,21,3,92,38.21527541749278,-109.4041566
68837,4,19,10,30,22,4,89,38.21527541749278,-109.4038871
68838,3,20,10,27,25,3,88,38.21527541749278,-109.4036176
68839,3,19,10,27,25,3,87,38.21527541749278,-109.4033481
68840,3,20,9,28,25,4,89,38.21527541749278,-109.4030786
68841,3,20,9,27,24,4,87,38.21527541749278,-109.4028091
68842,2,19,9,27,24,5,86,38.21527541749278,-109.4025396
68843,2,17,9,26,24,6,84,38.21527541749278,-109.4022701
68844,8,22,11,19,24,4,88,38.21527541749278,-109.4020006
68845,10,25,12,17,17,3,84,38.21527541749278,-109.4017311
68846,10,26,12,18,16,2,84,38.21527541749278,-109.4014616
68847,28,28,9,15,10,1,91,38.21527541749278,-109.3906818
68848,23,20,9,20,16,2,90,38.21527541749278,-109.3904123
68849,21,18,10,21,17,2,89,38.21527541749278,-109.3901429
68850,22,20,11,19,14,3,89,38.21527541749278,-109.3898734
68851,12,31,11,14,15,3,86,38.21527541749278,-109.3896039
68852,5,34,11,11,15,4,80,38.21527541749278,-109.3893344
68853,2,30,10,6,13,7,68,38.21527541749278,-109.3890649
68854,2,28,9,6,12,8,65,38.21527541749278,-109.3887954
68855,2,41,7,8,8,3,69,38.21527541749278,-109.3885259
68856,3,42,7,5,10,3,70,38.21527541749278,-109.3882564
68857,4,42,8,7,12,2,75,38.21527541749278,-109.3879869
68858,4,45,9,8,12,2,80,38.21527541749278,-109.3877174
68859,4,47,10,8,12,2,83,38.21527541749278,-109.3874479
68860,4,51,10,7,14,1,87,38.21527541749278,-109.3871784
68861,3,52,10,5,14,1,85,38.21527541749278,-109.3869089
68862,3,51,9,5,14,1,83,38.21527541749278,-109.3866394
68863,3,52,9,6,14,1,85,38.21527541749278,-109.3863699
68864,4,54,9,6,14,0,87,38.21527541749278,-109.3861004
68865,9,37,13,10,15,2,86,38.215005922907544,-109.4114329
68866,8,38,13,10,16,1,86,38.215005922907544,-109.4111634
68867,10,40,14,10,16,0,90,38.215005922907544,-109.4108939
68868,12,40,14,9,16,0,91,38.215005922907544,-109.4106244
68869,13,38,13,9,15,0,88,38.215005922907544,-109.4103549
68870,13,37,13,9,14,1,87,38.215005922907544,-109.4100855
68871,11,39,13,9,14,2,88,38.215005922907544,-109.409816
68872,11,37,13,9,14,3,87,38.215005922907544,-109.4095465
68873,13,36,13,9,14,2,87,38.215005922907544,-109.409277
68874,14,36,13,9,14,2,88,38.215005922907544,-109.4090075
68875,13,37,13,9,14,1,87,38.215005922907544,-109.408738
68876,13,39,14,9,15,1,91,38.215005922907544,-109.4084685
68877,15,36,14,11,15,0,91,38.215005922907544,-109.408199
68878,16,34,13,12,14,0,89,38.215005922907544,-109.4079295
68879,16,33,13,12,14,0,88,38.215005922907544,-109.40766
68880,15,32,13,12,15,0,87,38.215005922907544,-109.4073905
68881,16,34,13,11,14,0,88,38.215005922907544,-109.407121
68882,12,35,13,10,14,2,86,38.215005922907544,-109.4068515
68883,9,33,12,10,13,3,80,38.215005922907544,-109.406582
68884,7,29,12,11,12,4,75,38.215005922907544,-109.4063125
68885,8,27,11,11,12,3,72,38.215005922907544,-109.406043
68886,5,20,10,9,9,5,58,38.215005922907544,-109.4057735
68887,5,20,10,9,10,4,58,38.215005922907544,-109.405504
68888,4,25,10,11,9,4,63,38.215005922907544,-109.4052345
68889,2,24,11,13,10,6,66,38.215005922907544,-109.4049651
68890,2,22,12,16,12,8,72,38.215005922907544,-109.4046956
68891,6,22,12,22,18,4,84,38.215005922907544,-109.4044261
68892,4,20,10,27,22,3,86,38.215005922907544,-109.4041566
68893,3,19,10,29,23,4,88,38.215005922907544,-109.4038871
68894,3,19,10,24,26,4,86,38.215005922907544,-109.4036176
68895,3,17,10,30,22,4,86,38.215005922907544,-109.4033481
68896,4,17,10,31,23,4,89,38.215005922907544,-109.4030786
68897,4,17,9,29,23,6,88,38.215005922907544,-109.4028091
68898,1,16,8,26,24,6,81,38.215005922907544,-109.4025396
68899,0,13,7,21,25,6,72,38.215005922907544,-109.4022701
68900,3,18,11,23,26,5,86,38.215005922907544,-109.4020006
68901,9,24,12,20,18,3,86,38.215005922907544,-109.4017311
68902,10,28,12,21,16,1,88,38.215005922907544,-109.4014616
68903,29,27,9,15,11,1,92,38.215005922907544,-109.3906818
68904,24,22,9,17,16,2,90,38.215005922907544,-109.3904123
68905,24,20,10,17,16,2,89,38.215005922907544,-109.3901429
68906,25,25,11,15,13,2,91,38.215005922907544,-109.3898734
68907,14,35,12,11,14,2,88,38.215005922907544,-109.3896039
68908,4,37,11,8,15,3,78,38.215005922907544,-109.3893344
68909,2,37,10,4,14,6,73,38.215005922907544,-109.3890649
68910,4,34,10,5,12,5,70,38.215005922907544,-109.3887954
68911,4,40,8,7,8,3,70,38.215005922907544,-109.3885259
68912,2,38,8,7,10,4,69,38.215005922907544,-109.3882564
68913,3,40,7,6,9,4,69,38.215005922907544,-109.3879869
68914,3,43,8,5,10,3,72,38.215005922907544,-109.3877174
68915,3,43,9,7,13,3,78,38.215005922907544,-109.3874479
68916,5,44,10,8,15,1,83,38.215005922907544,-109.3871784
68917,7,48,11,9,15,0,90,38.215005922907544,-109.3869089
68918,6,50,11,8,15,1,91,38.215005922907544,-109.3866394
68919,7,50,11,8,15,0,91,38.215005922907544,-109.3863699
68920,8,49,11,9,14,0,91,38.215005922907544,-109.3861004
68921,9,35,12,9,15,2,82,38.214736428322304,-109.4114329
68922,8,36,13,9,15,2,83,38.214736428322304,-109.4111634
68923,9,38,15,12,16,0,90,38.214736428322304,-109.4108939
68924,9,38,14,13,16,0,90,38.214736428322304,-109.4106244
68925,10,37,13,12,15,1,88,38.214736428322304,-109.4103549
68926,10,35,13,10,14,2,84,38.214736428322304,-109.4100855
68927,10,35,13,8,13,4,83,38.214736428322304,-109.409816
68928,10,36,13,9,13,4,85,38.214736428322304,-109.4095465
68929,11,37,13,8,13,4,86,38.214736428322304,-109.409277
68930,13,37,13,8,13,3,87,38.214736428322304,-109.4090075
68931,14,38,13,7,14,2,88,38.214736428322304,-109.408738
68932,13,39,14,8,14,2,90,38.214736428322304,-109.4084685
68933,15,37,13,10,14,0,89,38.214736428322304,-109.408199
68934,16,36,13,10,14,0,89,38.214736428322304,-109.4079295
68935,17,35,13,10,14,0,89,38.214736428322304,-109.40766
68936,16,35,13,10,14,0,88,38.214736428322304,-109.4073905
68937,16,36,13,9,13,1,88,38.214736428322304,-109.407121
68938,13,37,13,9,13,1,86,38.214736428322304,-109.4068515
68939,11,34,13,11,13,2,84,38.214736428322304,-109.406582
68940,10,31,12,13,12,2,80,38.214736428322304,-109.4063125
68941,8,25,11,13,11,2,70,38.214736428322304,-109.406043
68942,4,17,9,9,8,5,52,38.214736428322304,-109.4057735
68943,4,22,11,11,9,4,61,38.214736428322304,-109.405504
68944,2,26,11,13,9,4,65,38.214736428322304,-109.4052345
68945,1,25,11,9,7,9,62,38.214736428322304,-109.4049651
68946,2,26,11,9,9,9,66,38.214736428322304,-109.4046956
68947,2,23,12,14,12,7,70,38.214736428322304,-109.4044261
68948,7,23,11,21,14,4,80,38.214736428322304,-109.4041566
68949,7,20,10,29,20,2,88,38.214736428322304,-109.4038871
68950,3,17,11,28,24,6,89,38.214736428322304,-109.4036176
68951,4,18,10,30,22,5,89,38.214736428322304,-109.4033481
68952,3,19,11,29,22,4,88,38.214736428322304,-109.4030786
68953,3,20,10,28,23,5,89,38.214736428322304,-109.4028091
68954,4,18,8,27,24,6,87,38.214736428322304,-109.4025396
68955,3,13,7,26,24,7,80,38.214736428322304,-109.4022701
68956,4,19,11,26,24,4,88,38.214736428322304,-109.4020006
68957,11,23,12,20,16,3,85,38.214736428322304,-109.4017311
68958,42,25,7,13,7,1,95,38.214736428322304,-109.3909513
68959,29,26,8,13,13,2,91,38.214736428322304,-109.3906818
68960,24,20,10,15,17,2,88,38.214736428322304,-109.3904123
68961,21,18,10,16,16,3,84,38.214736428322304,-109.3901429
68962,21,23,11,13,13,4,85,38.214736428322304,-109.3898734
68963,14,33,12,10,15,4,88,38.214736428322304,-109.3896039
68964,4,33,12,7,13,8,77,38.214736428322304,-109.3893344
68965,2,32,11,3,10,13,71,38.214736428322304,-109.3890649
68966,2,30,11,3,9,14,69,38.214736428322304,-109.3887954
68967,2,36,10,1,12,10,71,38.214736428322304,-109.3885259
68968,2,43,10,2,14,6,77,38.214736428322304,-109.3882564
68969,2,44,10,3,14,5,78,38.214736428322304,-109.3879869
68970,4,46,10,5,15,3,83,38.214736428322304,-109.3877174
68971,5,48,11,8,15,1,88,38.214736428322304,-109.3874479
68972,7,47,11,8,15,0,88,38.214736428322304,-109.3871784
68973,8,48,12,8,16,0,92,38.214736428322304,-109.3869089
68974,8,46,12,9,15,0,90,38.214736428322304,-109.3866394
68975,9,43,13,10,15,0,90,38.214736428322304,-109.3863699
68976,12,42,13,10,14,0,91,38.214736428322304,-109.3861004
68977,7,36,13,9,14,3,82,38.21446693373707,-109.4114329
68978,7,36,13,11,14,2,83,38.21446693373707,-109.4111634
68979,9,37,15,14,14,1,90,38.21446693373707,-109.4108939
68980,10,38,15,13,15,1,92,38.21446693373707,-109.4106244
68981,11,36,14,12,15,1,89,38.21446693373707,-109.4103549
68982,11,33,13,11,13,3,84,38.21446693373707,-109.4100855
68983,10,33,13,10,13,4,83,38.21446693373707,-109.409816
68984,9,36,13,8,12,5,83,38.21446693373707,-109.4095465
68985,9,36,13,8,13,5,84,38.21446693373707,-109.409277
68986,10,37,13,8,13,4,85,38.21446693373707,-109.4090075
68987,13,37,13,8,13,2,86,38.21446693373707,-109.408738
68988,13,37,13,8,13,3,87,38.21446693373707,-109.4084685
68989,12,35,13,10,13,3,86,38.21446693373707,-109.408199
68990,11,36,13,9,13,3,85,38.21446693373707,-109.4079295
68991,12,37,13,8,13,3,86,38.21446693373707,-109.40766
68992,12,36,13,9,13,2,85,38.21446693373707,-109.4073905
68993,10,37,13,8,13,4,85,38.21446693373707,-109.407121
68994,11,36,13,10,14,2,86,38.21446693373707,-109.4068515
68995,13,35,13,12,13,1,87,38.21446693373707,-109.406582
68996,14,33,13,11,12,1,84,38.21446693373707,-109.4063125
68997,9,26,11,12,11,2,71,38.21446693373707,-109.406043
68998,6,22,10,10,9,4,61,38.21446693373707,-109.4057735
68999,3,25,11,10,9,5,63,38.21446693373707,-109.405504
69000,2,25,11,13,11,4,66,38.21446693373707,-109.4052345
69001,4,29,11,14,14,3,75,38.21446693373707,-109.4049651
69002,1,27,11,9,11,7,66,38.21446693373707,-109.4046956
69003,1,27,11,8,9,8,64,38.21446693373707,-109.4044261
69004,3,25,11,13,12,7,71,38.21446693373707,-109.4041566
69005,8,24,11,17,19,3,82,38.21446693373707,-109.4038871
69006,9,17,10,29,22,4,91,38.21446693373707,-109.4036176
69007,4,17,10,31,23,6,91,38.21446693373707,-109.4033481
69008,4,18,10,29,23,5,89,38.21446693373707,-109.4030786
69009,4,18,10,29,23,4,88,38.21446693373707,-109.4028091
69010,5,18,10,29,23,5,90,38.21446693373707,-109.4025396
69011,5,16,9,29,24,6,89,38.21446693373707,-109.4022701
69012,9,21,11,25,21,3,90,38.21446693373707,-109.4020006
69013,10,26,12,20,15,1,84,38.21446693373707,-109.4017311
69014,40,24,8,13,8,1,94,38.21446693373707,-109.3909513
69015,31,22,8,17,12,1,91,38.21446693373707,-109.3906818
69016,27,19,9,18,15,2,90,38.21446693373707,-109.3904123
69017,28,16,10,18,14,2,88,38.21446693373707,-109.3901429
69018,30,17,10,16,13,2,88,38.21446693373707,-109.3898734
69019,32,26,11,9,12,2,92,38.21446693373707,-109.3896039
69020,10,39,12,7,14,5,87,38.21446693373707,-109.3893344
69021,4,41,10,2,13,7,77,38.21446693373707,-109.3890649
69022,2,34,10,2,13,9,70,38.21446693373707,-109.3887954
69023,3,32,10,3,13,7,68,38.21446693373707,-109.3885259
69024,6,44,10,7,14,2,83,38.21446693373707,-109.3882564
69025,4,50,10,5,14,2,85,38.21446693373707,-109.3879869
69026,4,52,10,5,13,1,85,38.21446693373707,-109.3877174
69027,4,52,10,7,13,1,87,38.21446693373707,-109.3874479
69028,6,51,10,7,14,0,88,38.21446693373707,-109.3871784
69029,6,47,11,9,13,1,87,38.21446693373707,-109.3869089
69030,7,45,13,10,13,1,89,38.21446693373707,-109.3866394
69031,7,43,13,12,13,1,89,38.21446693373707,-109.3863699
69032,7,43,13,12,13,1,89,38.21446693373707,-109.3861004
69033,7,37,13,10,15,2,84,38.21419743915183,-109.4114329
69034,8,37,14,12,14,1,86,38.21419743915183,-109.4111634
69035,7,36,15,14,14,1,87,38.21419743915183,-109.4108939
69036,10,37,15,14,15,0,91,38.21419743915183,-109.4106244
69037,11,36,14,13,15,1,90,38.21419743915183,-109.4103549
69038,10,32,13,12,14,2,83,38.21419743915183,-109.4100855
69039,8,32,13,9,12,6,80,38.21419743915183,-109.409816
69040,8,35,13,8,12,7,83,38.21419743915183,-109.4095465
69041,7,35,13,7,12,6,80,38.21419743915183,-109.409277
69042,7,35,13,7,12,6,80,38.21419743915183,-109.4090075
69043,7,34,13,8,12,6,80,38.21419743915183,-109.408738
69044,7,32,13,8,11,8,79,38.21419743915183,-109.4084685
69045,11,34,13,9,13,4,84,38.21419743915183,-109.408199
69046,12,36,13,9,13,3,86,38.21419743915183,-109.4079295
69047,11,36,14,9,13,4,87,38.21419743915183,-109.40766
69048,10,36,13,8,13,4,84,38.21419743915183,-109.4073905
69049,10,36,13,9,13,4,85,38.21419743915183,-109.407121
69050,12,36,14,11,14,1,88,38.21419743915183,-109.4068515
69051,11,35,14,13,13,1,87,38.21419743915183,-109.406582
69052,10,32,13,15,12,1,83,38.21419743915183,-109.4063125
69053,8,26,12,16,10,2,74,38.21419743915183,-109.406043
69054,5,28,12,14,12,4,75,38.21419743915183,-109.4057735
69055,4,29,12,11,12,5,73,38.21419743915183,-109.405504
69056,3,30,11,10,12,6,72,38.21419743915183,-109.4052345
69057,4,31,11,10,13,5,74,38.21419743915183,-109.4049651
69058,4,32,11,8,12,5,72,38.21419743915183,-109.4046956
69059,2,28,11,8,11,7,67,38.21419743915183,-109.4044261
69060,2,27,11,8,9,9,66,38.21419743915183,-109.4041566
69061,4,24,12,15,13,6,74,38.21419743915183,-109.4038871
69062,9,23,11,19,23,2,87,38.21419743915183,-109.4036176
69063,10,16,10,26,21,5,88,38.21419743915183,-109.4033481
69064,6,17,10,29,22,5,89,38.21419743915183,-109.4030786
69065,4,17,10,32,23,3,89,38.21419743915183,-109.4028091
69066,4,17,10,31,23,3,88,38.21419743915183,-109.4025396
69067,3,16,11,28,25,6,89,38.21419743915183,-109.4022701
69068,7,23,11,24,20,3,88,38.21419743915183,-109.4020006
69069,8,32,12,22,15,0,89,38.21419743915183,-109.4017311
69070,38,24,8,15,9,1,95,38.21419743915183,-109.3909513
69071,26,23,9,16,15,1,90,38.21419743915183,-109.3906818
69072,23,25,10,16,14,2,90,38.21419743915183,-109.3904123
69073,36,24,9,14,11,0,94,38.21419743915183,-109.3901429
69074,44,19,9,15,10,0,97,38.21419743915183,-109.3898734
69075,44,18,9,12,12,1,96,38.21419743915183,-109.3896039
69076,21,27,11,12,14,1,86,38.21419743915183,-109.3893344
69077,7,35,10,7,14,4,77,38.21419743915183,-109.3890649
69078,2,40,9,3,12,6,72,38.21419743915183,-109.3887954
69079,3,41,8,3,11,6,72,38.21419743915183,-109.3885259
69080,4,46,9,6,12,2,79,38.21419743915183,-109.3882564
69081,5,47,9,9,11,1,82,38.21419743915183,-109.3879869
69082,5,47,10,9,12,1,84,38.21419743915183,-109.3877174
69083,6,47,10,10,12,1,86,38.21419743915183,-109.3874479
69084,7,47,10,11,12,1,88,38.21419743915183,-109.3871784
69085,6,48,11,9,12,1,87,38.21419743915183,-109.3869089
69086,6,46,12,10,12,1,87,38.21419743915183,-109.3866394
69087,6,44,13,11,12,2,88,38.21419743915183,-109.3863699
69088,7,45,13,11,12,2,90,38.21419743915183,-109.3861004
69089,7,39,13,10,15,1,85,38.21392794,-109.4114329
69090,8,38,14,12,14,1,87,38.21392794,-109.4111634
69091,6,38,15,14,14,1,88,38.21392794,-109.4108939
69092,8,38,15,15,14,1,91,38.21392794,-109.4106244
69093,8,37,14,13,15,1,88,38.21392794,-109.4103549
69094,7,34,13,11,15,3,83,38.21392794,-109.4100855
69095,7,32,13,9,13,6,80,38.21392794,-109.409816
69096,6,35,14,8,13,5,81,38.21392794,-109.4095465
69097,6,35,14,9,14,4,82,38.21392794,-109.409277
69098,6,34,13,8,13,5,79,38.21392794,-109.4090075
69099,6,34,13,7,12,6,78,38.21392794,-109.408738
69100,8,36,13,7,12,6,82,38.21392794,-109.4084685
69101,8,35,14,8,11,7,83,38.21392794,-109.408199
69102,9,36,14,7,11,6,83,38.21392794,-109.4079295
69103,10,37,14,6,11,7,85,38.21392794,-109.40766
69104,8,36,14,6,11,8,83,38.21392794,-109.4073905
69105,9,36,13,8,13,4,83,38.21392794,-109.407121
69106,9,35,14,11,15,2,86,38.21392794,-109.4068515
69107,7,35,15,14,14,1,86,38.21392794,-109.406582
69108,6,34,14,14,14,2,84,38.21392794,-109.4063125
69109,4,27,12,13,11,5,72,38.21392794,-109.406043
69110,6,33,12,19,14,1,85,38.21392794,-109.4057735
69111,8,34,12,16,14,1,85,38.21392794,-109.405504
69112,9,35,12,14,14,2,86,38.21392794,-109.4052345
69113,8,33,12,13,14,2,82,38.21392794,-109.4049651
69114,8,32,11,12,14,2,79,38.21392794,-109.4046956
69115,3,25,11,12,11,5,67,38.21392794,-109.4044261
69116,2,27,11,8,10,7,65,38.21392794,-109.4041566
69117,3,28,12,12,10,5,70,38.21392794,-109.4038871
69118,6,30,13,18,13,2,82,38.21392794,-109.4036176
69119,15,16,8,31,15,2,87,38.21392794,-109.4033481
69120,9,17,9,27,21,4,87,38.21392794,-109.4030786
69121,5,18,10,29,23,3,88,38.21392794,-109.4028091
69122,4,17,11,30,23,4,89,38.21392794,-109.4025396
69123,4,17,11,28,23,4,87,38.21392794,-109.4022701
69124,7,24,11,24,19,2,87,38.21392794,-109.4020006
69125,8,32,12,21,16,1,90,38.21392794,-109.4017311
69126,6,41,13,9,15,2,86,38.21365844998137,-109.4114329
69127,7,41,14,11,14,2,89,38.21365844998137,-109.4111634
69128,5,41,15,14,14,1,90,38.21365844998137,-109.4108939
69129,5,40,14,12,15,1,87,38.21365844998137,-109.4106244
69130,6,39,14,11,15,1,86,38.21365844998137,-109.4103549
69131,7,37,14,11,16,1,86,38.21365844998137,-109.4100855
69132,7,35,15,10,15,2,84,38.21365844998137,-109.409816
69133,8,34,14,9,15,3,83,38.21365844998137,-109.4095465
69134,7,34,13,9,14,3,80,38.21365844998137,-109.409277
69135,8,34,13,9,14,3,81,38.21365844998137,-109.4090075
69136,8,35,13,8,15,4,83,38.21365844998137,-109.408738
69137,7,35,14,8,15,4,83,38.21365844998137,-109.4084685
69138,8,38,14,7,14,4,85,38.21365844998137,-109.408199
69139,6,37,14,7,14,5,83,38.21365844998137,-109.4079295
69140,7,37,14,8,14,4,84,38.21365844998137,-109.40766
69141,10,37,14,8,13,4,86,38.21365844998137,-109.4073905
69142,9,36,15,13,15,1,89,38.21365844998137,-109.407121
69143,8,35,15,13,15,1,87,38.21365844998137,-109.4068515
69144,9,35,15,13,14,1,87,38.21365844998137,-109.406582
69145,8,34,14,14,15,1,86,38.21365844998137,-109.4063125
69146,5,31,12,16,15,2,81,38.21365844998137,-109.406043
69147,9,33,12,20,15,0,89,38.21365844998137,-109.4057735
69148,10,33,13,16,15,1,88,38.21365844998137,-109.405504
69149,11,33,13,14,15,1,87,38.21365844998137,-109.4052345
69150,10,33,13,15,15,1,87,38.21365844998137,-109.4049651
69151,8,31,12,15,13,2,81,38.21365844998137,-109.4046956
69152,8,29,12,15,12,1,77,38.21365844998137,-109.4044261
69153,5,25,10,11,11,4,66,38.21365844998137,-109.4041566
69154,4,24,10,9,10,5,62,38.21365844998137,-109.4038871
69155,7,26,12,14,12,2,73,38.21365844998137,-109.4036176
69156,10,20,9,36,14,1,90,38.21365844998137,-109.4033481
69157,8,19,9,29,21,2,88,38.21365844998137,-109.4030786
69158,6,20,11,25,25,3,90,38.21365844998137,-109.4028091
69159,5,20,12,25,24,3,89,38.21365844998137,-109.4025396
69160,4,20,12,27,24,4,91,38.21365844998137,-109.4022701
69161,5,23,11,27,20,4,90,38.21365844998137,-109.4020006
69162,6,25,11,25,20,3,90,38.21365844998137,-109.4017311
69163,6,42,13,9,15,2,87,38.21338895539613,-109.4114329
69164,6,42,14,10,14,2,88,38.21338895539613,-109.4111634
69165,5,42,14,12,15,1,89,38.21338895539613,-109.4108939
69166,4,41,14,12,15,2,88,38.21338895539613,-109.4106244
69167,4,40,14,12,15,1,86,38.21338895539613,-109.4103549
69168,5,39,15,11,15,2,87,38.21338895539613,-109.4100855
69169,5,38,14,8,14,3,82,38.21338895539613,-109.409816
69170,5,37,13,8,15,3,81,38.21338895539613,-109.4095465
69171,6,36,14,9,16,3,84,38.21338895539613,-109.409277
69172,7,36,14,9,16,2,84,38.21338895539613,-109.4090075
69173,9,36,14,8,16,2,85,38.21338895539613,-109.408738
69174,12,38,14,8,15,2,89,38.21338895539613,-109.4084685
69175,11,40,14,7,14,3,89,38.21338895539613,-109.408199
69176,9,39,15,7,12,5,87,38.21338895539613,-109.4079295
69177,9,38,15,7,13,5,87,38.21338895539613,-109.40766
69178,9,39,15,9,15,3,90,38.21338895539613,-109.4073905
69179,8,37,15,12,16,1,89,38.21338895539613,-109.407121
69180,9,37,15,12,16,1,90,38.21338895539613,-109.4068515
69181,10,35,15,13,16,1,90,38.21338895539613,-109.406582
69182,9,34,14,13,16,1,87,38.21338895539613,-109.4063125
69183,7,32,13,14,15,2,83,38.21338895539613,-109.406043
69184,6,32,13,14,15,3,83,38.21338895539613,-109.4057735
69185,7,33,13,13,16,2,84,38.21338895539613,-109.405504
69186,11,33,14,12,15,2,87,38.21338895539613,-109.4052345
69187,11,34,13,13,14,1,86,38.21338895539613,-109.4049651
69188,5,29,12,15,12,3,76,38.21338895539613,-109.4046956
69189,9,27,11,15,12,1,75,38.21338895539613,-109.4044261
69190,5,21,10,10,11,5,62,38.21338895539613,-109.4041566
69191,4,24,11,13,12,3,67,38.21338895539613,-109.4038871
69192,8,24,12,23,12,1,80,38.21338895539613,-109.4036176
69193,6,20,10,31,17,2,86,38.21338895539613,-109.4033481
69194,7,18,11,29,23,3,91,38.21338895539613,-109.4030786
69195,5,20,11,26,25,4,91,38.21338895539613,-109.4028091
69196,3,22,11,27,23,4,90,38.21338895539613,-109.4025396
69197,4,23,12,26,21,4,90,38.21338895539613,-109.4022701
69198,3,23,12,26,21,5,90,38.21338895539613,-109.4020006
69199,3,22,12,25,23,4,89,38.21338895539613,-109.4017311
69200,5,46,13,7,14,2,87,38.21311946081089,-109.4114329
69201,6,45,14,8,15,1,89,38.21311946081089,-109.4111634
69202,5,44,14,10,16,1,90,38.21311946081089,-109.4108939
69203,4,42,14,10,15,1,86,38.21311946081089,-109.4106244
69204,4,41,15,10,15,1,86,38.21311946081089,-109.4103549
69205,5,40,15,10,15,2,87,38.21311946081089,-109.4100855
69206,5,40,14,9,15,2,85,38.21311946081089,-109.409816
69207,4,40,13,10,15,2,84,38.21311946081089,-109.4095465
69208,8,38,14,13,16,1,90,38.21311946081089,-109.409277
69209,9,38,14,11,17,0,89,38.21311946081089,-109.4090075
69210,6,37,14,9,17,3,86,38.21311946081089,-109.408738
69211,7,39,14,7,15,3,85,38.21311946081089,-109.4084685
69212,9,39,14,8,15,3,88,38.21311946081089,-109.408199
69213,8,38,14,8,15,4,87,38.21311946081089,-109.4079295
69214,9,38,15,8,15,4,89,38.21311946081089,-109.40766
69215,9,38,15,9,16,2,89,38.21311946081089,-109.4073905
69216,7,37,15,10,17,2,88,38.21311946081089,-109.407121
69217,7,36,14,12,17,1,87,38.21311946081089,-109.4068515
69218,9,34,15,12,16,1,87,38.21311946081089,-109.406582
69219,11,31,15,13,15,1,86,38.21311946081089,-109.4063125
69220,14,29,13,15,14,1,86,38.21311946081089,-109.406043
69221,11,33,13,14,16,1,88,38.21311946081089,-109.4057735
69222,8,34,14,12,17,2,87,38.21311946081089,-109.405504
69223,8,33,14,11,16,2,84,38.21311946081089,-109.4052345
69224,7,32,14,12,15,2,82,38.21311946081089,-109.4049651
69225,6,30,13,15,13,2,79,38.21311946081089,-109.4046956
69226,8,27,12,18,12,1,78,38.21311946081089,-109.4044261
69227,5,24,11,13,11,4,68,38.21311946081089,-109.4041566
69228,6,26,11,15,13,2,73,38.21311946081089,-109.4038871
69229,8,24,11,20,13,1,77,38.21311946081089,-109.4036176
69230,10,19,11,27,14,3,84,38.21311946081089,-109.4033481
69231,10,15,9,35,19,2,90,38.21311946081089,-109.4030786
69232,7,17,10,32,23,3,92,38.21311946081089,-109.4028091
69233,4,22,11,28,22,4,91,38.21311946081089,-109.4025396
69234,3,23,12,26,21,4,89,38.21311946081089,-109.4022701
69235,3,23,12,26,21,4,89,38.21311946081089,-109.4020006
69236,3,23,12,24,23,4,89,38.21311946081089,-109.4017311
69237,5,44,14,8,17,1,89,38.212849966225654,-109.4232907
69238,5,46,14,8,16,1,90,38.212849966225654,-109.4230212
69239,5,47,14,8,16,1,91,38.212849966225654,-109.4227517
69240,5,47,14,9,16,1,92,38.212849966225654,-109.4224822
69241,6,48,14,8,17,0,93,38.212849966225654,-109.4222127
69242,6,47,14,8,17,0,92,38.212849966225654,-109.4219432
69243,6,46,14,7,18,1,92,38.212849966225654,-109.4216737
69244,5,46,14,6,17,2,90,38.212849966225654,-109.4214042
69245,5,44,14,5,17,3,88,38.212849966225654,-109.4211347
69246,4,44,13,5,18,3,87,38.212849966225654,-109.4208652
69247,4,43,13,5,18,3,86,38.212849966225654,-109.4205957
69248,4,43,14,6,18,2,87,38.212849966225654,-109.4203262
69249,5,43,14,8,18,1,89,38.212849966225654,-109.4200568
69250,6,42,13,11,17,1,90,38.212849966225654,-109.4197873
69251,7,40,13,10,17,1,88,38.212849966225654,-109.4195178
69252,7,40,13,10,18,1,89,38.212849966225654,-109.4192483
69253,7,40,13,10,18,1,89,38.212849966225654,-109.4189788
69254,8,39,14,10,18,0,89,38.212849966225654,-109.4187093
69255,7,40,14,10,18,1,90,38.212849966225654,-109.4184398
69256,6,41,14,10,17,1,89,38.212849966225654,-109.4181703
69257,6,41,14,11,16,1,89,38.212849966225654,-109.4179008
69258,6,42,14,11,16,1,90,38.212849966225654,-109.4176313
69259,6,43,14,10,16,1,90,38.212849966225654,-109.4173618
69260,6,42,14,10,16,1,89,38.212849966225654,-109.4170923
69261,7,41,14,11,16,1,90,38.212849966225654,-109.4168228
69262,8,40,14,11,16,1,90,38.212849966225654,-109.4165533
69263,9,40,14,11,16,1,91,38.212849966225654,-109.4162838
69264,10,41,14,11,16,0,92,38.212849966225654,-109.4160143
69265,8,42,14,12,16,0,92,38.212849966225654,-109.4157448
69266,7,42,14,10,16,1,90,38.212849966225654,-109.4154753
69267,6,42,14,9,17,2,90,38.212849966225654,-109.4152058
69268,7,43,14,9,17,2,92,38.212849966225654,-109.4149364
69269,6,45,14,8,17,1,91,38.212849966225654,-109.4146669
69270,6,43,14,9,16,2,90,38.212849966225654,-109.4143974
69271,7,41,15,11,16,2,92,38.212849966225654,-109.4141279
69272,8,41,15,12,16,1,93,38.212849966225654,-109.4138584
69273,8,40,15,11,16,1,91,38.212849966225654,-109.4135889
69274,9,40,15,12,16,1,93,38.212849966225654,-109.4133194
69275,7,41,14,10,15,1,88,38.212849966225654,-109.4130499
69276,5,42,14,10,15,2,88,38.212849966225654,-109.4127804
69277,5,42,14,9,16,2,88,38.212849966225654,-109.4125109
69278,4,42,14,9,15,3,87,38.212849966225654,-109.4122414
69279,4,43,14,9,15,2,87,38.212849966225654,-109.4119719
69280,4,44,14,8,15,2,87,38.212849966225654,-109.4117024
69281,5,45,14,8,15,2,89,38.212849966225654,-109.4114329
69282,5,43,14,9,15,2,88,38.212849966225654,-109.4111634
69283,5,42,14,10,15,2,88,38.212849966225654,-109.4108939
69284,4,41,14,9,15,2,85,38.212849966225654,-109.4106244
69285,4,41,15,9,16,2,87,38.212849966225654,-109.4103549
69286,5,42,15,8,16,2,88,38.212849966225654,-109.4100855
69287,5,43,15,7,15,2,87,38.212849966225654,-109.409816
69288,4,41,14,6,15,4,84,38.212849966225654,-109.4095465
69289,6,42,13,8,16,2,87,38.212849966225654,-109.409277
69290,9,40,14,10,16,1,90,38.212849966225654,-109.4090075
69291,7,40,13,8,17,2,87,38.212849966225654,-109.408738
69292,6,42,13,6,16,3,86,38.212849966225654,-109.4084685
69293,7,42,14,7,16,2,88,38.212849966225654,-109.408199
69294,9,39,14,8,15,3,88,38.212849966225654,-109.4079295
69295,9,38,15,8,15,3,88,38.212849966225654,-109.40766
69296,8,38,15,8,16,2,87,38.212849966225654,-109.4073905
69297,5,34,14,10,16,3,82,38.212849966225654,-109.407121
69298,6,35,14,12,17,1,85,38.212849966225654,-109.4068515
69299,6,33,15,13,17,2,86,38.212849966225654,-109.406582
69300,7,34,15,13,17,2,88,38.212849966225654,-109.4063125
69301,10,33,14,13,16,1,87,38.212849966225654,-109.406043
69302,8,35,14,14,18,1,90,38.212849966225654,-109.4057735
69303,9,36,15,12,18,1,91,38.212849966225654,-109.405504
69304,7,35,15,12,17,1,87,38.212849966225654,-109.4052345
69305,6,33,14,12,16,2,83,38.212849966225654,-109.4049651
69306,6,31,14,14,15,2,82,38.212849966225654,-109.4046956
69307,6,30,13,17,14,2,82,38.212849966225654,-109.4044261
69308,4,27,12,14,12,3,72,38.212849966225654,-109.4041566
69309,4,25,11,14,13,3,70,38.212849966225654,-109.4038871
69310,8,23,12,18,14,1,76,38.212849966225654,-109.4036176
69311,7,21,12,25,14,2,81,38.212849966225654,-109.4033481
69312,7,16,10,33,20,2,88,38.212849966225654,-109.4030786
69313,7,15,10,31,24,3,90,38.212849966225654,-109.4028091
69314,6,17,10,29,24,3,89,38.212849966225654,-109.4025396
69315,6,20,11,25,24,4,90,38.212849966225654,-109.4022701
69316,4,19,12,26,25,4,90,38.212849966225654,-109.4020006
69317,4,20,11,26,26,3,90,38.212849966225654,-109.4017311
69318,6,48,14,9,15,0,92,38.21258047164042,-109.4227517
69319,5,48,14,11,15,0,93,38.21258047164042,-109.4224822
69320,6,47,14,12,15,0,94,38.21258047164042,-109.4222127
69321,7,46,14,8,17,0,92,38.21258047164042,-109.4219432
69322,6,46,14,8,18,0,92,38.21258047164042,-109.4216737
69323,5,45,14,7,18,1,90,38.21258047164042,-109.4214042
69324,5,44,14,6,18,2,89,38.21258047164042,-109.4211347
69325,5,43,14,6,18,3,89,38.21258047164042,-109.4208652
69326,4,43,14,6,18,3,88,38.21258047164042,-109.4205957
69327,4,42,14,7,18,3,88,38.21258047164042,-109.4203262
69328,4,42,13,8,18,2,87,38.21258047164042,-109.4200568
69329,5,41,13,10,18,1,88,38.21258047164042,-109.4197873
69330,6,40,13,12,17,1,89,38.21258047164042,-109.4195178
69331,7,40,13,12,17,0,89,38.21258047164042,-109.4192483
69332,7,39,14,11,18,0,89,38.21258047164042,-109.4189788
69333,7,39,14,10,18,1,89,38.21258047164042,-109.4187093
69334,6,41,14,10,17,1,89,38.21258047164042,-109.4184398
69335,6,41,15,10,16,1,89,38.21258047164042,-109.4181703
69336,6,41,15,11,16,1,90,38.21258047164042,-109.4179008
69337,7,42,15,12,16,1,93,38.21258047164042,-109.4176313
69338,7,41,14,12,16,1,91,38.21258047164042,-109.4173618
69339,9,40,14,11,16,1,91,38.21258047164042,-109.4170923
69340,8,40,14,11,16,1,90,38.21258047164042,-109.4168228
69341,8,40,14,11,16,1,90,38.21258047164042,-109.4165533
69342,8,40,14,11,16,1,90,38.21258047164042,-109.4162838
69343,7,42,14,11,16,1,91,38.21258047164042,-109.4160143
69344,7,43,14,12,16,0,92,38.21258047164042,-109.4157448
69345,7,41,14,11,16,1,90,38.21258047164042,-109.4154753
69346,7,41,14,10,17,1,90,38.21258047164042,-109.4152058
69347,7,42,14,10,17,2,92,38.21258047164042,-109.4149364
69348,6,42,14,10,16,2,90,38.21258047164042,-109.4146669
69349,6,40,14,10,15,3,88,38.21258047164042,-109.4143974
69350,6,40,14,11,15,3,89,38.21258047164042,-109.4141279
69351,6,41,14,11,15,2,89,38.21258047164042,-109.4138584
69352,6,42,15,11,15,1,90,38.21258047164042,-109.4135889
69353,6,41,14,10,15,2,88,38.21258047164042,-109.4133194
69354,6,43,14,10,15,2,90,38.21258047164042,-109.4130499
69355,5,43,14,10,15,2,89,38.21258047164042,-109.4127804
69356,5,42,14,10,15,2,88,38.21258047164042,-109.4125109
69357,4,42,14,10,15,3,88,38.21258047164042,-109.4122414
69358,4,43,15,8,16,2,88,38.21258047164042,-109.4119719
69359,4,43,14,7,16,3,87,38.21258047164042,-109.4117024
69360,4,43,14,7,15,3,86,38.21258047164042,-109.4114329
69361,4,41,14,8,14,3,84,38.21258047164042,-109.4111634
69362,4,39,14,9,15,3,84,38.21258047164042,-109.4108939
69363,5,42,14,7,15,3,86,38.21258047164042,-109.4106244
69364,5,41,14,6,15,3,84,38.21258047164042,-109.4103549
69365,5,40,14,6,15,4,84,38.21258047164042,-109.4100855
69366,5,42,14,6,16,3,86,38.21258047164042,-109.409816
69367,4,43,14,6,16,4,87,38.21258047164042,-109.4095465
69368,5,43,14,5,16,4,87,38.21258047164042,-109.409277
69369,5,42,14,6,16,4,87,38.21258047164042,-109.4090075
69370,5,42,14,6,16,3,86,38.21258047164042,-109.408738
69371,6,41,14,7,15,3,86,38.21258047164042,-109.4084685
69372,7,40,15,10,16,2,90,38.21258047164042,-109.408199
69373,7,39,15,9,16,3,89,38.21258047164042,-109.4079295
69374,8,38,14,8,15,3,86,38.21258047164042,-109.40766
69375,8,37,14,9,16,3,87,38.21258047164042,-109.4073905
69376,9,34,14,11,15,2,85,38.21258047164042,-109.407121
69377,11,35,14,11,16,1,88,38.21258047164042,-109.4068515
69378,10,36,15,11,16,1,89,38.21258047164042,-109.406582
69379,10,36,15,12,16,1,90,38.21258047164042,-109.4063125
69380,10,35,14,12,17,0,88,38.21258047164042,-109.406043
69381,9,34,14,13,17,1,88,38.21258047164042,-109.4057735
69382,8,36,14,9,17,2,86,38.21258047164042,-109.405504
69383,8,36,14,8,17,2,85,38.21258047164042,-109.4052345
69384,8,36,14,10,16,2,86,38.21258047164042,-109.4049651
69385,9,34,14,11,16,1,85,38.21258047164042,-109.4046956
69386,9,35,14,14,16,1,89,38.21258047164042,-109.4044261
69387,4,28,12,13,13,3,73,38.21258047164042,-109.4041566
69388,5,26,11,14,13,3,72,38.21258047164042,-109.4038871
69389,11,27,13,15,13,1,80,38.21258047164042,-109.4036176
69390,3,26,11,21,14,1,76,38.21258047164042,-109.4033481
69391,5,18,10,34,18,2,87,38.21258047164042,-109.4030786
69392,5,15,11,26,28,3,88,38.21258047164042,-109.4028091
69393,9,15,11,23,26,7,91,38.21258047164042,-109.4025396
69394,16,15,10,25,20,4,90,38.21258047164042,-109.4022701
69395,10,15,10,24,24,7,90,38.21258047164042,-109.4020006
69396,6,15,10,29,24,7,91,38.21258047164042,-109.4017311
69397,5,48,14,11,15,0,93,38.21231097705518,-109.4224822
69398,5,48,14,11,15,0,93,38.21231097705518,-109.4222127
69399,6,47,13,8,17,0,91,38.21231097705518,-109.4219432
69400,6,46,14,7,17,1,91,38.21231097705518,-109.4216737
69401,5,44,14,6,18,2,89,38.21231097705518,-109.4214042
69402,5,43,14,7,18,2,89,38.21231097705518,-109.4211347
69403,6,42,14,8,18,1,89,38.21231097705518,-109.4208652
69404,6,42,14,8,18,1,89,38.21231097705518,-109.4205957
69405,5,42,14,8,18,2,89,38.21231097705518,-109.4203262
69406,5,41,13,9,17,2,87,38.21231097705518,-109.4200568
69407,6,40,13,11,17,1,88,38.21231097705518,-109.4197873
69408,6,40,13,11,17,1,88,38.21231097705518,-109.4195178
69409,8,41,14,13,17,0,93,38.21231097705518,-109.4192483
69410,8,41,14,13,16,0,92,38.21231097705518,-109.4189788
69411,7,40,15,12,16,0,90,38.21231097705518,-109.4187093
69412,6,40,15,11,16,1,89,38.21231097705518,-109.4184398
69413,5,41,14,10,16,1,87,38.21231097705518,-109.4181703
69414,6,42,14,11,16,1,90,38.21231097705518,-109.4179008
69415,8,42,14,11,16,0,91,38.21231097705518,-109.4176313
69416,9,41,14,11,16,0,91,38.21231097705518,-109.4173618
69417,10,39,14,12,15,1,91,38.21231097705518,-109.4170923
69418,9,39,14,12,15,1,90,38.21231097705518,-109.4168228
69419,8,39,14,12,15,1,89,38.21231097705518,-109.4165533
69420,8,39,15,12,16,1,91,38.21231097705518,-109.4162838
69421,7,40,15,11,16,1,90,38.21231097705518,-109.4160143
69422,6,41,14,11,16,1,89,38.21231097705518,-109.4157448
69423,6,41,15,11,16,1,90,38.21231097705518,-109.4154753
69424,6,40,15,11,16,1,89,38.21231097705518,-109.4152058
69425,6,40,15,11,16,2,90,38.21231097705518,-109.4149364
69426,5,39,15,11,14,3,87,38.21231097705518,-109.4146669
69427,5,39,14,10,14,3,85,38.21231097705518,-109.4143974
69428,5,40,14,10,14,3,86,38.21231097705518,-109.4141279
69429,5,41,14,9,14,3,86,38.21231097705518,-109.4138584
69430,5,41,14,10,14,2,86,38.21231097705518,-109.4135889
69431,5,39,14,9,14,3,84,38.21231097705518,-109.4133194
69432,6,42,14,10,15,2,89,38.21231097705518,-109.4130499
69433,5,42,14,11,15,2,89,38.21231097705518,-109.4127804
69434,5,42,14,11,14,2,88,38.21231097705518,-109.4125109
69435,5,43,15,10,15,2,90,38.21231097705518,-109.4122414
69436,5,42,14,9,15,2,87,38.21231097705518,-109.4119719
69437,4,41,14,9,15,3,86,38.21231097705518,-109.4117024
69438,4,41,14,8,15,4,86,38.21231097705518,-109.4114329
69439,4,41,14,7,15,4,85,38.21231097705518,-109.4111634
69440,4,39,14,7,14,4,82,38.21231097705518,-109.4108939
69441,5,41,14,7,15,3,85,38.21231097705518,-109.4106244
69442,5,42,14,5,16,3,85,38.21231097705518,-109.4103549
69443,5,43,14,5,16,4,87,38.21231097705518,-109.4100855
69444,5,43,14,4,16,4,86,38.21231097705518,-109.409816
69445,5,46,14,4,16,3,88,38.21231097705518,-109.4095465
69446,4,44,14,4,15,4,85,38.21231097705518,-109.409277
69447,4,42,14,6,16,3,85,38.21231097705518,-109.4090075
69448,4,40,15,7,16,3,85,38.21231097705518,-109.408738
69449,5,37,14,9,14,3,82,38.21231097705518,-109.4084685
69450,7,39,15,12,17,1,91,38.21231097705518,-109.408199
69451,8,39,15,10,16,1,89,38.21231097705518,-109.4079295
69452,9,39,14,9,16,1,88,38.21231097705518,-109.40766
69453,10,37,14,9,16,1,87,38.21231097705518,-109.4073905
69454,9,36,14,9,15,3,86,38.21231097705518,-109.407121
69455,10,35,14,10,15,2,86,38.21231097705518,-109.4068515
69456,9,35,15,12,16,1,88,38.21231097705518,-109.406582
69457,9,35,15,13,17,0,89,38.21231097705518,-109.4063125
69458,10,36,14,12,17,0,89,38.21231097705518,-109.406043
69459,11,36,14,10,16,1,88,38.21231097705518,-109.4057735
69460,11,36,14,9,16,1,87,38.21231097705518,-109.405504
69461,10,37,14,9,17,1,88,38.21231097705518,-109.4052345
69462,10,37,14,10,17,1,89,38.21231097705518,-109.4049651
69463,10,36,14,11,16,1,88,38.21231097705518,-109.4046956
69464,8,35,14,13,15,2,87,38.21231097705518,-109.4044261
69465,5,30,11,11,13,3,73,38.21231097705518,-109.4041566
69466,5,28,11,12,13,3,72,38.21231097705518,-109.4038871
69467,8,30,11,13,14,1,77,38.21231097705518,-109.4036176
69468,6,27,11,13,15,2,74,38.21231097705518,-109.4033481
69469,3,22,11,26,17,1,80,38.21231097705518,-109.4030786
69470,5,18,10,34,18,1,86,38.21231097705518,-109.4028091
69471,7,17,10,21,28,5,88,38.21231097705518,-109.4025396
69472,9,18,10,18,25,8,88,38.21231097705518,-109.4022701
69473,15,15,9,18,23,8,88,38.21231097705518,-109.4020006
69474,6,12,8,20,23,13,82,38.21231097705518,-109.4017311
69475,5,45,13,7,17,2,89,38.21204148246995,-109.4219432
69476,5,46,13,6,17,2,89,38.21204148246995,-109.4216737
69477,5,45,14,6,17,2,89,38.21204148246995,-109.4214042
69478,6,44,14,7,17,2,90,38.21204148246995,-109.4211347
69479,7,43,14,9,17,1,91,38.21204148246995,-109.4208652
69480,7,42,14,9,18,1,91,38.21204148246995,-109.4205957
69481,6,41,13,9,18,1,88,38.21204148246995,-109.4203262
69482,6,40,13,10,17,1,87,38.21204148246995,-109.4200568
69483,6,40,13,11,17,1,88,38.21204148246995,-109.4197873
69484,6,41,13,9,17,1,87,38.21204148246995,-109.4195178
69485,7,42,14,11,17,0,91,38.21204148246995,-109.4192483
69486,7,42,15,14,15,0,93,38.21204148246995,-109.4189788
69487,7,41,15,14,15,0,92,38.21204148246995,-109.4187093
69488,6,40,15,13,15,1,90,38.21204148246995,-109.4184398
69489,8,41,15,11,16,0,91,38.21204148246995,-109.4181703
69490,10,41,14,12,15,0,92,38.21204148246995,-109.4179008
69491,11,41,14,11,15,0,92,38.21204148246995,-109.4176313
69492,11,41,14,11,15,0,92,38.21204148246995,-109.4173618
69493,10,40,14,13,15,0,92,38.21204148246995,-109.4170923
69494,9,39,14,13,15,1,91,38.21204148246995,-109.4168228
69495,9,39,15,13,15,1,92,38.21204148246995,-109.4165533
69496,8,39,15,13,15,1,91,38.21204148246995,-109.4162838
69497,8,39,15,13,16,1,92,38.21204148246995,-109.4160143
69498,6,38,15,12,15,2,88,38.21204148246995,-109.4157448
69499,5,37,15,11,15,2,85,38.21204148246995,-109.4154753
69500,5,36,15,11,14,3,84,38.21204148246995,-109.4152058
69501,5,36,15,11,14,3,84,38.21204148246995,-109.4149364
69502,5,37,15,10,14,3,84,38.21204148246995,-109.4146669
69503,5,39,14,10,14,3,85,38.21204148246995,-109.4143974
69504,5,40,14,9,14,3,85,38.21204148246995,-109.4141279
69505,5,41,14,10,14,3,87,38.21204148246995,-109.4138584
69506,5,42,14,10,14,2,87,38.21204148246995,-109.4135889
69507,5,40,14,9,14,3,85,38.21204148246995,-109.4133194
69508,5,41,14,9,14,3,86,38.21204148246995,-109.4130499
69509,5,40,15,10,14,3,87,38.21204148246995,-109.4127804
69510,5,39,15,11,13,2,85,38.21204148246995,-109.4125109
69511,5,40,15,12,13,2,87,38.21204148246995,-109.4122414
69512,4,40,14,9,14,3,84,38.21204148246995,-109.4119719
69513,4,40,15,9,14,3,85,38.21204148246995,-109.4117024
69514,4,40,15,8,14,3,84,38.21204148246995,-109.4114329
69515,4,41,15,7,15,4,86,38.21204148246995,-109.4111634
69516,4,40,14,7,14,4,83,38.21204148246995,-109.4108939
69517,5,42,15,7,15,3,87,38.21204148246995,-109.4106244
69518,5,43,14,6,16,3,87,38.21204148246995,-109.4103549
69519,5,43,14,5,16,3,86,38.21204148246995,-109.4100855
69520,6,44,14,5,16,3,88,38.21204148246995,-109.409816
69521,7,43,13,6,15,3,87,38.21204148246995,-109.4095465
69522,5,43,14,5,16,4,87,38.21204148246995,-109.409277
69523,5,41,14,5,15,4,84,38.21204148246995,-109.4090075
69524,5,40,14,6,15,4,84,38.21204148246995,-109.408738
69525,4,38,14,8,14,4,82,38.21204148246995,-109.4084685
69526,7,38,15,11,16,2,89,38.21204148246995,-109.408199
69527,9,37,15,12,16,1,90,38.21204148246995,-109.4079295
69528,7,37,15,12,17,1,89,38.21204148246995,-109.40766
69529,6,37,14,10,17,2,86,38.21204148246995,-109.4073905
69530,9,37,15,9,17,2,89,38.21204148246995,-109.407121
69531,7,36,15,10,16,2,86,38.21204148246995,-109.4068515
69532,7,36,15,11,17,2,88,38.21204148246995,-109.406582
69533,7,37,15,11,17,1,88,38.21204148246995,-109.4063125
69534,8,38,14,10,17,1,88,38.21204148246995,-109.406043
69535,11,37,13,10,17,1,89,38.21204148246995,-109.4057735
69536,10,37,14,9,16,2,88,38.21204148246995,-109.405504
69537,9,38,14,9,16,2,88,38.21204148246995,-109.4052345
69538,9,37,14,10,16,1,87,38.21204148246995,-109.4049651
69539,10,36,15,11,17,1,90,38.21204148246995,-109.4046956
69540,9,36,14,13,16,1,89,38.21204148246995,-109.4044261
69541,6,33,12,12,14,2,79,38.21204148246995,-109.4041566
69542,6,32,11,12,14,2,77,38.21204148246995,-109.4038871
69543,9,32,11,11,15,1,79,38.21204148246995,-109.4036176
69544,12,31,10,9,14,1,77,38.21204148246995,-109.4033481
69545,7,26,10,13,15,2,73,38.21204148246995,-109.4030786
69546,6,23,11,29,15,1,85,38.21204148246995,-109.4028091
69547,4,16,9,35,19,1,84,38.21204148246995,-109.4025396
69548,4,15,11,27,26,5,88,38.21204148246995,-109.4022701
69549,4,12,10,24,22,12,84,38.21204148246995,-109.4020006
69550,8,11,9,24,22,13,87,38.21204148246995,-109.4017311
69551,6,46,14,7,17,1,91,38.21177198788471,-109.4214042
69552,7,43,13,7,18,2,90,38.21177198788471,-109.4211347
69553,7,42,13,8,17,1,88,38.21177198788471,-109.4208652
69554,8,41,13,9,18,1,90,38.21177198788471,-109.4205957
69555,7,41,13,10,18,1,90,38.21177198788471,-109.4203262
69556,6,41,13,10,17,1,88,38.21177198788471,-109.4200568
69557,6,41,14,9,17,1,88,38.21177198788471,-109.4197873
69558,6,44,14,9,17,1,91,38.21177198788471,-109.4195178
69559,6,43,14,10,17,1,91,38.21177198788471,-109.4192483
69560,5,43,15,13,15,0,91,38.21177198788471,-109.4189788
69561,6,43,15,15,15,0,94,38.21177198788471,-109.4187093
69562,7,41,15,14,15,0,92,38.21177198788471,-109.4184398
69563,12,39,15,13,15,0,94,38.21177198788471,-109.4181703
69564,15,38,14,12,14,0,93,38.21177198788471,-109.4179008
69565,15,38,14,12,14,0,93,38.21177198788471,-109.4176313
69566,12,40,15,12,14,0,93,38.21177198788471,-109.4173618
69567,9,41,15,13,15,0,93,38.21177198788471,-109.4170923
69568,8,41,15,13,16,1,94,38.21177198788471,-109.4168228
69569,7,40,15,12,16,1,91,38.21177198788471,-109.4165533
69570,8,39,15,12,16,1,91,38.21177198788471,-109.4162838
69571,8,40,15,11,16,1,91,38.21177198788471,-109.4160143
69572,6,39,15,12,16,2,90,38.21177198788471,-109.4157448
69573,5,36,15,11,14,2,83,38.21177198788471,-109.4154753
69574,5,35,15,11,14,3,83,38.21177198788471,-109.4152058
69575,5,35,16,11,13,3,83,38.21177198788471,-109.4149364
69576,4,37,16,10,13,3,83,38.21177198788471,-109.4146669
69577,4,38,15,9,14,3,83,38.21177198788471,-109.4143974
69578,5,40,14,9,15,3,86,38.21177198788471,-109.4141279
69579,5,41,14,10,14,2,86,38.21177198788471,-109.4138584
69580,5,41,14,10,14,2,86,38.21177198788471,-109.4135889
69581,5,40,14,9,15,3,86,38.21177198788471,-109.4133194
69582,4,40,15,9,14,3,85,38.21177198788471,-109.4130499
69583,4,39,15,9,13,3,83,38.21177198788471,-109.4127804
69584,4,39,15,10,13,3,84,38.21177198788471,-109.4125109
69585,5,40,15,11,14,2,87,38.21177198788471,-109.4122414
69586,5,40,15,10,14,3,87,38.21177198788471,-109.4119719
69587,4,39,15,9,14,3,84,38.21177198788471,-109.4117024
69588,4,41,15,8,15,3,86,38.21177198788471,-109.4114329
69589,4,42,14,7,16,3,86,38.21177198788471,-109.4111634
69590,4,40,14,7,15,4,84,38.21177198788471,-109.4108939
69591,4,40,14,7,16,4,85,38.21177198788471,-109.4106244
69592,4,41,14,6,16,4,85,38.21177198788471,-109.4103549
69593,5,41,13,5,15,4,83,38.21177198788471,-109.4100855
69594,5,43,14,5,15,4,86,38.21177198788471,-109.409816
69595,7,44,14,6,16,2,89,38.21177198788471,-109.4095465
69596,5,42,14,5,16,4,86,38.21177198788471,-109.409277
69597,5,41,14,5,15,4,84,38.21177198788471,-109.4090075
69598,5,41,15,6,15,4,86,38.21177198788471,-109.408738
69599,4,39,15,8,15,4,85,38.21177198788471,-109.4084685
69600,5,35,15,11,15,3,84,38.21177198788471,-109.408199
69601,8,34,16,14,14,2,88,38.21177198788471,-109.4079295
69602,8,34,16,15,15,1,89,38.21177198788471,-109.40766
69603,7,36,16,14,15,2,90,38.21177198788471,-109.4073905
69604,9,37,16,11,16,1,90,38.21177198788471,-109.407121
69605,8,38,15,11,16,2,90,38.21177198788471,-109.4068515
69606,6,38,15,11,17,2,89,38.21177198788471,-109.406582
69607,6,38,14,11,18,1,88,38.21177198788471,-109.4063125
69608,7,39,14,11,18,1,90,38.21177198788471,-109.406043
69609,6,38,14,10,17,2,87,38.21177198788471,-109.4057735
69610,9,37,14,10,17,1,88,38.21177198788471,-109.405504
69611,9,37,14,10,17,1,88,38.21177198788471,-109.4052345
69612,8,36,14,10,16,2,86,38.21177198788471,-109.4049651
69613,7,36,14,10,16,2,85,38.21177198788471,-109.4046956
69614,7,37,14,10,17,1,86,38.21177198788471,-109.4044261
69615,6,36,14,12,17,1,86,38.21177198788471,-109.4041566
69616,8,36,13,13,16,1,87,38.21177198788471,-109.4038871
69617,12,36,12,13,15,0,88,38.21177198788471,-109.4036176
69618,14,33,11,10,14,0,82,38.21177198788471,-109.4033481
69619,7,27,10,11,15,2,72,38.21177198788471,-109.4030786
69620,7,25,11,17,16,1,77,38.21177198788471,-109.4028091
69621,8,21,10,30,17,0,86,38.21177198788471,-109.4025396
69622,4,15,10,29,22,0,80,38.21177198788471,-109.4022701
69623,2,9,10,30,30,5,86,38.21177198788471,-109.4020006
69624,1,9,10,32,29,8,89,38.21177198788471,-109.4017311
69625,8,41,13,8,17,1,88,38.21150249329948,-109.4211347
69626,7,40,13,8,18,1,87,38.21150249329948,-109.4208652
69627,8,41,13,9,17,1,89,38.21150249329948,-109.4205957
69628,7,41,13,10,17,1,89,38.21150249329948,-109.4203262
69629,7,41,13,10,17,0,88,38.21150249329948,-109.4200568
69630,7,43,13,9,17,0,89,38.21150249329948,-109.4197873
69631,6,45,14,9,17,1,92,38.21150249329948,-109.4195178
69632,6,44,14,10,16,1,91,38.21150249329948,-109.4192483
69633,6,43,15,12,16,1,93,38.21150249329948,-109.4189788
69634,6,42,15,13,16,1,93,38.21150249329948,-109.4187093
69635,8,41,14,13,16,0,92,38.21150249329948,-109.4184398
69636,13,39,14,12,15,0,93,38.21150249329948,-109.4181703
69637,15,38,14,12,15,0,94,38.21150249329948,-109.4179008
69638,14,38,14,12,14,0,92,38.21150249329948,-109.4176313
69639,11,39,15,13,15,0,93,38.21150249329948,-109.4173618
69640,7,43,15,12,16,0,93,38.21150249329948,-109.4170923
69641,6,41,15,11,17,1,91,38.21150249329948,-109.4168228
69642,6,40,15,10,17,1,89,38.21150249329948,-109.4165533
69643,6,40,14,10,16,2,88,38.21150249329948,-109.4162838
69644,6,40,15,10,17,2,90,38.21150249329948,-109.4160143
69645,7,39,15,12,16,1,90,38.21150249329948,-109.4157448
69646,6,38,15,12,15,2,88,38.21150249329948,-109.4154753
69647,6,36,15,11,14,2,84,38.21150249329948,-109.4152058
69648,5,36,16,10,14,3,84,38.21150249329948,-109.4149364
69649,5,38,16,9,14,3,85,38.21150249329948,-109.4146669
69650,5,39,15,9,15,3,86,38.21150249329948,-109.4143974
69651,5,40,15,9,15,3,87,38.21150249329948,-109.4141279
69652,5,41,14,10,15,2,87,38.21150249329948,-109.4138584
69653,6,41,15,10,15,2,89,38.21150249329948,-109.4135889
69654,5,40,15,11,15,2,88,38.21150249329948,-109.4133194
69655,5,39,15,11,14,2,86,38.21150249329948,-109.4130499
69656,5,40,14,10,13,3,85,38.21150249329948,-109.4127804
69657,4,40,14,9,14,3,84,38.21150249329948,-109.4125109
69658,4,41,15,10,15,2,87,38.21150249329948,-109.4122414
69659,5,41,15,10,14,2,87,38.21150249329948,-109.4119719
69660,4,40,15,10,14,3,86,38.21150249329948,-109.4117024
69661,4,40,15,9,15,3,86,38.21150249329948,-109.4114329
69662,4,41,14,8,15,3,85,38.21150249329948,-109.4111634
69663,4,39,13,7,14,4,81,38.21150249329948,-109.4108939
69664,4,41,14,7,15,4,85,38.21150249329948,-109.4106244
69665,5,41,14,6,15,3,84,38.21150249329948,-109.4103549
69666,6,42,14,6,16,3,87,38.21150249329948,-109.4100855
69667,6,43,14,6,17,3,89,38.21150249329948,-109.409816
69668,6,43,14,6,17,2,88,38.21150249329948,-109.4095465
69669,5,41,14,6,16,3,85,38.21150249329948,-109.409277
69670,4,41,14,6,15,4,84,38.21150249329948,-109.4090075
69671,4,39,14,6,14,4,81,38.21150249329948,-109.408738
69672,4,36,15,7,14,4,80,38.21150249329948,-109.4084685
69673,5,35,16,12,15,2,85,38.21150249329948,-109.408199
69674,9,30,17,13,14,2,85,38.21150249329948,-109.4079295
69675,9,30,17,14,14,2,86,38.21150249329948,-109.40766
69676,7,33,16,14,14,2,86,38.21150249329948,-109.4073905
69677,6,35,16,13,15,2,87,38.21150249329948,-109.407121
69678,7,37,16,12,15,2,89,38.21150249329948,-109.4068515
69679,6,38,15,12,16,1,88,38.21150249329948,-109.406582
69680,7,38,15,12,17,1,90,38.21150249329948,-109.4063125
69681,7,39,14,11,17,0,88,38.21150249329948,-109.406043
69682,7,39,14,11,17,0,88,38.21150249329948,-109.4057735
69683,8,36,14,12,17,1,88,38.21150249329948,-109.405504
69684,8,35,14,12,17,1,87,38.21150249329948,-109.4052345
69685,9,35,15,11,17,1,88,38.21150249329948,-109.4049651
69686,10,37,14,10,16,1,88,38.21150249329948,-109.4046956
69687,10,37,14,9,16,1,87,38.21150249329948,-109.4044261
69688,8,35,14,13,17,1,88,38.21150249329948,-109.4041566
69689,7,36,14,13,17,1,88,38.21150249329948,-109.4038871
69690,8,36,13,12,16,1,86,38.21150249329948,-109.4036176
69691,11,36,13,13,15,0,88,38.21150249329948,-109.4033481
69692,6,31,11,14,13,2,77,38.21150249329948,-109.4030786
69693,7,31,11,14,15,1,79,38.21150249329948,-109.4028091
69694,7,29,11,18,17,1,83,38.21150249329948,-109.4025396
69695,10,24,12,26,16,0,88,38.21150249329948,-109.4022701
69696,5,19,10,35,17,0,86,38.21150249329948,-109.4020006
69697,3,19,10,31,22,0,85,38.21150249329948,-109.4017311
69698,6,14,9,25,28,1,83,38.21150249329948,-109.4014616
69699,4,11,7,19,29,2,72,38.21150249329948,-109.4011921
69700,2,10,5,12,28,1,58,38.21150249329948,-109.4009226
69701,0,9,6,16,26,5,62,38.21150249329948,-109.4006531
69702,1,10,12,29,29,5,86,38.21150249329948,-109.4003836
69703,1,16,12,27,23,6,85,38.21150249329948,-109.4001142
69704,3,22,11,23,17,6,82,38.21150249329948,-109.3998447
69705,4,22,11,27,19,1,84,38.21150249329948,-109.3995752
69706,5,29,13,22,18,0,87,38.21150249329948,-109.3993057
69707,4,32,11,16,16,1,80,38.21150249329948,-109.3990362
69708,4,33,10,14,14,2,77,38.21150249329948,-109.3987667
69709,3,33,10,12,14,2,74,38.21150249329948,-109.3984972
69710,3,34,10,10,16,2,75,38.21150249329948,-109.3982277
69711,2,34,9,4,17,3,69,38.21150249329948,-109.3979582
69712,2,35,10,6,18,3,74,38.21150249329948,-109.3976887
69713,4,39,12,8,18,1,82,38.21150249329948,-109.3974192
69714,5,44,13,8,17,1,88,38.21150249329948,-109.3971497
69715,4,45,13,7,16,1,86,38.21150249329948,-109.3968802
69716,4,44,13,7,17,2,87,38.21150249329948,-109.3966107
69717,3,49,11,5,15,2,85,38.21150249329948,-109.3963412
69718,3,50,10,5,13,3,84,38.21150249329948,-109.3960717
69719,3,46,10,5,12,3,79,38.21150249329948,-109.3958022
69720,3,36,9,6,11,3,68,38.21150249329948,-109.3955327
69721,2,30,9,6,8,6,61,38.21150249329948,-109.3952632
69722,3,17,12,10,9,11,62,38.21150249329948,-109.3949938
69723,5,21,11,18,18,8,81,38.21150249329948,-109.3947243
69724,4,21,10,21,27,5,88,38.21150249329948,-109.3944548
69725,6,22,9,24,22,3,86,38.21150249329948,-109.3941853
69726,9,21,8,26,21,2,87,38.21150249329948,-109.3939158
69727,10,20,8,28,21,2,89,38.21150249329948,-109.3936463
69728,9,21,9,27,23,2,91,38.21150249329948,-109.3933768
69729,6,19,10,26,25,3,89,38.21150249329948,-109.3931073
69730,3,19,12,25,27,4,90,38.21150249329948,-109.3928378
69731,7,16,11,27,26,3,90,38.21150249329948,-109.3925683
69732,19,17,10,22,22,3,93,38.21150249329948,-109.3922988
69733,11,23,12,23,18,1,88,38.21150249329948,-109.3920293
69734,6,40,12,15,14,0,87,38.21150249329948,-109.3917598
69735,7,48,12,16,10,0,93,38.21150249329948,-109.3914903
69736,13,45,11,15,9,0,93,38.21150249329948,-109.3912208
69737,21,40,11,13,8,0,93,38.21150249329948,-109.3909513
69738,17,38,12,17,11,0,95,38.21150249329948,-109.3906818
69739,14,38,12,14,14,0,92,38.21150249329948,-109.3904123
69740,17,39,12,13,14,0,95,38.21150249329948,-109.3901429
69741,20,37,12,13,14,1,97,38.21150249329948,-109.3898734
69742,21,33,12,13,12,1,92,38.21150249329948,-109.3896039
69743,15,34,10,6,9,2,76,38.21150249329948,-109.3893344
69744,11,45,12,10,12,2,92,38.21150249329948,-109.3890649
69745,4,46,10,8,12,2,82,38.21150249329948,-109.3887954
69746,3,44,8,6,10,3,74,38.21150249329948,-109.3885259
69747,4,45,7,7,9,2,74,38.21150249329948,-109.3882564
69748,3,48,8,9,9,1,78,38.21150249329948,-109.3879869
69749,4,49,8,9,9,1,80,38.21150249329948,-109.3877174
69750,4,53,9,9,10,1,86,38.21150249329948,-109.3874479
69751,4,58,10,9,12,0,93,38.21150249329948,-109.3871784
69752,10,48,9,10,10,1,88,38.21150249329948,-109.3869089
69753,16,40,6,6,8,0,76,38.21150249329948,-109.3866394
69754,20,40,7,7,8,0,82,38.21150249329948,-109.3863699
69755,23,40,8,7,8,0,86,38.21150249329948,-109.3861004
69756,24,39,7,8,7,0,85,38.21150249329948,-109.3858309
69757,8,40,13,9,18,0,88,38.21123299871424,-109.4205957
69758,8,40,12,10,17,0,87,38.21123299871424,-109.4203262
69759,8,41,12,10,17,0,88,38.21123299871424,-109.4200568
69760,10,42,13,9,17,0,91,38.21123299871424,-109.4197873
69761,8,44,13,9,17,0,91,38.21123299871424,-109.4195178
69762,7,43,14,10,17,0,91,38.21123299871424,-109.4192483
69763,7,43,15,10,17,0,92,38.21123299871424,-109.4189788
69764,7,42,15,12,17,0,93,38.21123299871424,-109.4187093
69765,9,41,15,12,16,0,93,38.21123299871424,-109.4184398
69766,12,40,14,11,15,0,92,38.21123299871424,-109.4181703
69767,13,39,14,11,14,0,91,38.21123299871424,-109.4179008
69768,12,39,14,13,15,0,93,38.21123299871424,-109.4176313
69769,10,40,15,13,16,0,94,38.21123299871424,-109.4173618
69770,8,42,15,12,16,0,93,38.21123299871424,-109.4170923
69771,6,40,15,10,17,1,89,38.21123299871424,-109.4168228
69772,5,40,14,10,16,2,87,38.21123299871424,-109.4165533
69773,6,40,14,10,16,2,88,38.21123299871424,-109.4162838
69774,6,41,15,11,17,1,91,38.21123299871424,-109.4160143
69775,5,40,15,11,16,1,88,38.21123299871424,-109.4157448
69776,5,39,15,11,16,2,88,38.21123299871424,-109.4154753
69777,6,38,16,11,15,2,88,38.21123299871424,-109.4152058
69778,6,38,15,11,15,2,87,38.21123299871424,-109.4149364
69779,5,40,15,10,15,2,87,38.21123299871424,-109.4146669
69780,5,39,15,9,14,3,85,38.21123299871424,-109.4143974
69781,6,40,15,9,14,2,86,38.21123299871424,-109.4141279
69782,6,40,15,10,14,2,87,38.21123299871424,-109.4138584
69783,5,40,14,9,15,2,85,38.21123299871424,-109.4135889
69784,5,40,15,10,15,2,87,38.21123299871424,-109.4133194
69785,5,40,14,11,14,2,86,38.21123299871424,-109.4130499
69786,5,41,14,10,14,2,86,38.21123299871424,-109.4127804
69787,5,43,14,9,15,2,88,38.21123299871424,-109.4125109
69788,4,44,15,9,15,2,89,38.21123299871424,-109.4122414
69789,4,44,14,9,14,2,87,38.21123299871424,-109.4119719
69790,4,42,15,9,13,2,85,38.21123299871424,-109.4117024
69791,4,41,15,9,14,3,86,38.21123299871424,-109.4114329
69792,4,40,14,8,14,3,83,38.21123299871424,-109.4111634
69793,5,40,14,8,15,3,85,38.21123299871424,-109.4108939
69794,6,43,14,9,16,2,90,38.21123299871424,-109.4106244
69795,6,42,14,8,16,2,88,38.21123299871424,-109.4103549
69796,5,42,14,7,16,2,86,38.21123299871424,-109.4100855
69797,5,42,14,7,16,3,87,38.21123299871424,-109.409816
69798,5,40,14,7,16,3,85,38.21123299871424,-109.4095465
69799,5,40,14,6,16,4,85,38.21123299871424,-109.409277
69800,5,40,15,7,15,3,85,38.21123299871424,-109.4090075
69801,5,39,15,8,14,3,84,38.21123299871424,-109.408738
69802,5,37,15,9,14,3,83,38.21123299871424,-109.4084685
69803,5,37,15,9,15,3,84,38.21123299871424,-109.408199
69804,5,34,16,10,15,3,83,38.21123299871424,-109.4079295
69805,5,35,16,11,15,2,84,38.21123299871424,-109.40766
69806,6,36,16,12,15,2,87,38.21123299871424,-109.4073905
69807,5,36,15,12,15,2,85,38.21123299871424,-109.407121
69808,5,36,16,11,15,2,85,38.21123299871424,-109.4068515
69809,6,37,15,11,16,2,87,38.21123299871424,-109.406582
69810,7,39,15,12,17,1,91,38.21123299871424,-109.4063125
69811,7,39,15,12,17,0,90,38.21123299871424,-109.406043
69812,6,39,15,13,18,0,91,38.21123299871424,-109.4057735
69813,8,37,15,13,17,0,90,38.21123299871424,-109.405504
69814,8,36,15,13,17,1,90,38.21123299871424,-109.4052345
69815,7,35,15,12,17,1,87,38.21123299871424,-109.4049651
69816,8,36,15,12,17,1,89,38.21123299871424,-109.4046956
69817,11,35,14,11,17,0,88,38.21123299871424,-109.4044261
69818,8,34,14,13,17,1,87,38.21123299871424,-109.4041566
69819,8,35,14,13,17,1,88,38.21123299871424,-109.4038871
69820,8,36,14,13,17,0,88,38.21123299871424,-109.4036176
69821,8,38,14,12,16,0,88,38.21123299871424,-109.4033481
69822,9,37,13,13,16,1,89,38.21123299871424,-109.4030786
69823,9,36,13,14,16,1,89,38.21123299871424,-109.4028091
69824,10,34,12,14,15,1,86,38.21123299871424,-109.4025396
69825,9,32,12,17,14,1,85,38.21123299871424,-109.4022701
69826,6,30,12,19,16,1,84,38.21123299871424,-109.4020006
69827,5,28,12,22,17,1,85,38.21123299871424,-109.4017311
69828,3,28,12,30,15,0,88,38.21123299871424,-109.4014616
69829,3,26,11,36,13,0,89,38.21123299871424,-109.4011921
69830,3,23,10,34,15,0,85,38.21123299871424,-109.4009226
69831,3,23,10,30,18,1,85,38.21123299871424,-109.4006531
69832,3,23,11,25,22,0,84,38.21123299871424,-109.4003836
69833,5,27,11,23,21,0,87,38.21123299871424,-109.4001142
69834,7,30,11,19,19,0,86,38.21123299871424,-109.3998447
69835,8,32,12,16,18,0,86,38.21123299871424,-109.3995752
69836,7,37,12,15,15,1,87,38.21123299871424,-109.3993057
69837,8,36,12,11,16,1,84,38.21123299871424,-109.3990362
69838,7,35,11,11,16,1,81,38.21123299871424,-109.3987667
69839,6,35,11,12,16,1,81,38.21123299871424,-109.3984972
69840,6,35,11,10,17,1,80,38.21123299871424,-109.3982277
69841,4,36,10,7,17,2,76,38.21123299871424,-109.3979582
69842,5,38,12,8,18,1,82,38.21123299871424,-109.3976887
69843,5,42,13,8,18,1,87,38.21123299871424,-109.3974192
69844,5,46,13,7,16,1,88,38.21123299871424,-109.3971497
69845,4,43,13,8,15,2,85,38.21123299871424,-109.3968802
69846,4,43,13,8,16,2,86,38.21123299871424,-109.3966107
69847,3,46,12,6,16,2,85,38.21123299871424,-109.3963412
69848,3,48,11,5,15,2,84,38.21123299871424,-109.3960717
69849,2,45,10,4,14,3,78,38.21123299871424,-109.3958022
69850,1,37,9,5,12,4,68,38.21123299871424,-109.3955327
69851,3,30,9,6,9,5,62,38.21123299871424,-109.3952632
69852,5,22,11,7,12,7,64,38.21123299871424,-109.3949938
69853,6,17,10,19,18,6,76,38.21123299871424,-109.3947243
69854,4,18,10,20,29,9,90,38.21123299871424,-109.3944548
69855,6,21,9,21,25,5,87,38.21123299871424,-109.3941853
69856,6,22,9,22,23,4,86,38.21123299871424,-109.3939158
69857,9,23,8,23,22,3,88,38.21123299871424,-109.3936463
69858,11,23,8,23,23,2,90,38.21123299871424,-109.3933768
69859,12,22,8,25,22,1,90,38.21123299871424,-109.3931073
69860,6,20,10,25,26,3,90,38.21123299871424,-109.3928378
69861,5,18,11,24,29,4,91,38.21123299871424,-109.3925683
69862,11,17,11,23,24,2,88,38.21123299871424,-109.3922988
69863,7,25,12,20,17,1,82,38.21123299871424,-109.3920293
69864,4,47,9,12,12,1,85,38.21123299871424,-109.3917598
69865,5,52,11,15,10,0,93,38.21123299871424,-109.3914903
69866,9,46,12,16,10,0,93,38.21123299871424,-109.3912208
69867,14,42,12,15,10,0,93,38.21123299871424,-109.3909513
69868,13,38,13,20,12,0,96,38.21123299871424,-109.3906818
69869,12,37,13,15,14,0,91,38.21123299871424,-109.3904123
69870,10,40,13,13,15,1,92,38.21123299871424,-109.3901429
69871,12,41,13,12,15,1,94,38.21123299871424,-109.3898734
69872,13,43,13,12,14,1,96,38.21123299871424,-109.3896039
69873,7,50,13,11,12,1,94,38.21123299871424,-109.3893344
69874,5,53,11,8,12,1,90,38.21123299871424,-109.3890649
69875,3,48,9,7,11,1,79,38.21123299871424,-109.3887954
69876,2,41,7,5,10,3,68,38.21123299871424,-109.3885259
69877,2,39,7,5,9,3,65,38.21123299871424,-109.3882564
69878,3,41,7,7,9,2,69,38.21123299871424,-109.3879869
69879,3,42,7,7,8,2,69,38.21123299871424,-109.3877174
69880,3,43,8,7,10,2,73,38.21123299871424,-109.3874479
69881,5,51,10,10,11,1,88,38.21123299871424,-109.3871784
69882,10,49,9,10,10,1,89,38.21123299871424,-109.3869089
69883,16,38,6,5,7,0,72,38.21123299871424,-109.3866394
69884,20,39,8,8,8,0,83,38.21123299871424,-109.3863699
69885,20,40,10,11,9,0,90,38.21123299871424,-109.3861004
69886,18,42,10,11,10,0,91,38.21123299871424,-109.3858309
69887,11,40,13,9,16,0,89,38.210963504129005,-109.4200568
69888,14,40,13,8,16,0,91,38.210963504129005,-109.4197873
69889,11,42,13,9,17,0,92,38.210963504129005,-109.4195178
69890,10,41,13,9,17,0,90,38.210963504129005,-109.4192483
69891,8,42,14,9,17,1,91,38.210963504129005,-109.4189788
69892,7,43,14,9,17,1,91,38.210963504129005,-109.4187093
69893,7,43,14,9,17,1,91,38.210963504129005,-109.4184398
69894,11,42,13,9,16,0,91,38.210963504129005,-109.4181703
69895,13,41,13,10,15,0,92,38.210963504129005,-109.4179008
69896,12,40,14,11,15,0,92,38.210963504129005,-109.4176313
69897,9,40,14,12,16,0,91,38.210963504129005,-109.4173618
69898,8,40,14,11,16,1,90,38.210963504129005,-109.4170923
69899,6,40,14,10,16,2,88,38.210963504129005,-109.4168228
69900,6,40,14,10,16,2,88,38.210963504129005,-109.4165533
69901,6,41,14,10,16,2,89,38.210963504129005,-109.4162838
69902,6,41,15,11,16,2,91,38.210963504129005,-109.4160143
69903,5,41,15,11,16,2,90,38.210963504129005,-109.4157448
69904,5,40,15,11,15,2,88,38.210963504129005,-109.4154753
69905,5,40,15,10,15,2,87,38.210963504129005,-109.4152058
69906,5,40,15,10,15,2,87,38.210963504129005,-109.4149364
69907,5,40,14,8,15,3,85,38.210963504129005,-109.4146669
69908,5,38,15,9,14,3,84,38.210963504129005,-109.4143974
69909,6,39,15,9,13,3,85,38.210963504129005,-109.4141279
69910,6,39,15,10,14,2,86,38.210963504129005,-109.4138584
69911,6,39,14,9,14,2,84,38.210963504129005,-109.4135889
69912,6,40,14,9,14,2,85,38.210963504129005,-109.4133194
69913,5,40,14,9,15,2,85,38.210963504129005,-109.4130499
69914,6,41,14,9,15,2,87,38.210963504129005,-109.4127804
69915,5,43,14,9,16,2,89,38.210963504129005,-109.4125109
69916,4,44,14,9,15,2,88,38.210963504129005,-109.4122414
69917,4,46,14,8,13,2,87,38.210963504129005,-109.4119719
69918,4,45,14,8,13,2,86,38.210963504129005,-109.4117024
69919,4,43,14,8,14,3,86,38.210963504129005,-109.4114329
69920,4,42,15,8,15,3,87,38.210963504129005,-109.4111634
69921,5,42,14,7,16,3,87,38.210963504129005,-109.4108939
69922,5,43,14,7,17,2,88,38.210963504129005,-109.4106244
69923,5,43,14,7,16,2,87,38.210963504129005,-109.4103549
69924,5,42,14,7,16,2,86,38.210963504129005,-109.4100855
69925,5,42,14,7,16,2,86,38.210963504129005,-109.409816
69926,5,41,14,7,16,3,86,38.210963504129005,-109.4095465
69927,5,39,14,7,15,4,84,38.210963504129005,-109.409277
69928,5,39,15,8,15,3,85,38.210963504129005,-109.4090075
69929,5,39,15,9,15,2,85,38.210963504129005,-109.408738
69930,5,38,15,10,15,2,85,38.210963504129005,-109.4084685
69931,6,40,15,9,15,2,87,38.210963504129005,-109.408199
69932,4,39,15,7,15,3,83,38.210963504129005,-109.4079295
69933,4,38,15,9,14,3,83,38.210963504129005,-109.40766
69934,5,38,15,10,15,2,85,38.210963504129005,-109.4073905
69935,5,39,15,9,16,2,86,38.210963504129005,-109.407121
69936,4,36,14,8,14,4,80,38.210963504129005,-109.4068515
69937,5,38,15,10,15,2,85,38.210963504129005,-109.406582
69938,6,40,15,12,16,1,90,38.210963504129005,-109.4063125
69939,7,40,15,12,17,0,91,38.210963504129005,-109.406043
69940,5,40,15,13,17,0,90,38.210963504129005,-109.4057735
69941,7,37,15,13,18,0,90,38.210963504129005,-109.405504
69942,9,36,15,13,17,0,90,38.210963504129005,-109.4052345
69943,9,35,15,13,16,1,89,38.210963504129005,-109.4049651
69944,8,36,15,13,17,1,90,38.210963504129005,-109.4046956
69945,9,35,14,13,17,1,89,38.210963504129005,-109.4044261
69946,8,35,15,13,17,1,89,38.210963504129005,-109.4041566
69947,7,35,14,13,17,1,87,38.210963504129005,-109.4038871
69948,6,36,14,12,17,1,86,38.210963504129005,-109.4036176
69949,7,37,14,12,17,1,88,38.210963504129005,-109.4033481
69950,9,37,14,13,17,0,90,38.210963504129005,-109.4030786
69951,9,36,14,13,17,0,89,38.210963504129005,-109.4028091
69952,8,36,14,14,16,1,89,38.210963504129005,-109.4025396
69953,6,33,13,15,14,1,82,38.210963504129005,-109.4022701
69954,5,30,12,15,13,2,77,38.210963504129005,-109.4020006
69955,4,30,11,12,12,3,72,38.210963504129005,-109.4017311
69956,3,31,10,11,14,3,72,38.210963504129005,-109.4014616
69957,5,32,11,12,15,2,77,38.210963504129005,-109.4011921
69958,8,32,11,14,15,1,81,38.210963504129005,-109.4009226
69959,5,34,11,14,16,2,82,38.210963504129005,-109.4006531
69960,5,34,11,13,17,2,82,38.210963504129005,-109.4003836
69961,8,35,11,11,16,1,82,38.210963504129005,-109.4001142
69962,11,36,12,11,16,1,87,38.210963504129005,-109.3998447
69963,11,37,13,12,15,1,89,38.210963504129005,-109.3995752
69964,7,40,13,11,14,1,86,38.210963504129005,-109.3993057
69965,6,40,12,9,15,1,83,38.210963504129005,-109.3990362
69966,5,38,12,9,17,1,82,38.210963504129005,-109.3987667
69967,4,36,12,11,17,1,81,38.210963504129005,-109.3984972
69968,5,37,11,10,17,1,81,38.210963504129005,-109.3982277
69969,7,37,12,9,16,0,81,38.210963504129005,-109.3979582
69970,6,39,13,10,17,1,86,38.210963504129005,-109.3976887
69971,5,42,13,9,16,1,86,38.210963504129005,-109.3974192
69972,5,43,13,8,16,1,86,38.210963504129005,-109.3971497
69973,5,41,13,11,15,1,86,38.210963504129005,-109.3968802
69974,4,42,13,9,15,1,84,38.210963504129005,-109.3966107
69975,4,44,13,8,15,1,85,38.210963504129005,-109.3963412
69976,4,44,11,7,15,2,83,38.210963504129005,-109.3960717
69977,4,42,10,6,14,2,78,38.210963504129005,-109.3958022
69978,2,42,9,5,12,3,73,38.210963504129005,-109.3955327
69979,3,33,9,6,10,4,65,38.210963504129005,-109.3952632
69980,5,25,10,7,12,5,64,38.210963504129005,-109.3949938
69981,8,23,11,17,17,3,79,38.210963504129005,-109.3947243
69982,2,13,7,15,28,9,74,38.210963504129005,-109.3944548
69983,7,20,9,16,29,8,89,38.210963504129005,-109.3941853
69984,6,22,9,20,26,4,87,38.210963504129005,-109.3939158
69985,6,23,9,20,24,3,85,38.210963504129005,-109.3936463
69986,8,23,9,18,24,3,85,38.210963504129005,-109.3933768
69987,10,23,8,20,23,3,87,38.210963504129005,-109.3931073
69988,8,23,9,23,24,2,89,38.210963504129005,-109.3928378
69989,6,22,10,25,24,3,90,38.210963504129005,-109.3925683
69990,12,24,10,22,20,2,90,38.210963504129005,-109.3922988
69991,11,32,11,23,15,0,92,38.210963504129005,-109.3920293
69992,4,44,10,15,12,1,86,38.210963504129005,-109.3917598
69993,4,51,9,14,10,0,88,38.210963504129005,-109.3914903
69994,5,52,10,15,10,0,92,38.210963504129005,-109.3912208
69995,10,46,12,15,10,0,93,38.210963504129005,-109.3909513
69996,14,39,13,14,13,0,93,38.210963504129005,-109.3906818
69997,10,38,13,14,14,0,89,38.210963504129005,-109.3904123
69998,10,40,13,12,15,0,90,38.210963504129005,-109.3901429
69999,12,42,13,12,14,0,93,38.210963504129005,-109.3898734
70000,14,43,13,12,13,1,96,38.210963504129005,-109.3896039
70001,13,41,11,8,10,1,84,38.210963504129005,-109.3893344
70002,10,50,11,9,12,1,93,38.210963504129005,-109.3890649
70003,7,48,11,11,11,1,89,38.210963504129005,-109.3887954
70004,6,40,10,8,11,2,77,38.210963504129005,-109.3885259
70005,2,36,7,5,10,4,64,38.210963504129005,-109.3882564
70006,3,43,6,6,7,2,67,38.210963504129005,-109.3879869
70007,2,40,6,6,7,2,63,38.210963504129005,-109.3877174
70008,3,40,7,6,9,2,67,38.210963504129005,-109.3874479
70009,5,46,9,9,11,1,81,38.210963504129005,-109.3871784
70010,9,51,11,11,11,0,93,38.210963504129005,-109.3869089
70011,16,45,12,12,10,0,95,38.210963504129005,-109.3866394
70012,13,44,12,14,11,0,94,38.210963504129005,-109.3863699
70013,10,45,12,15,12,0,94,38.210963504129005,-109.3861004
70014,9,46,12,14,12,0,93,38.210963504129005,-109.3858309
70015,11,41,13,9,16,0,90,38.21069400954377,-109.4195178
70016,10,42,13,9,17,0,91,38.21069400954377,-109.4192483
70017,8,43,14,8,17,1,91,38.21069400954377,-109.4189788
70018,7,44,14,8,17,1,91,38.21069400954377,-109.4187093
70019,8,44,13,8,16,1,90,38.21069400954377,-109.4184398
70020,10,43,13,8,16,0,90,38.21069400954377,-109.4181703
70021,11,42,13,9,15,0,90,38.21069400954377,-109.4179008
70022,10,42,13,9,16,0,90,38.21069400954377,-109.4176313
70023,9,43,14,9,16,1,92,38.21069400954377,-109.4173618
70024,8,43,14,9,16,1,91,38.21069400954377,-109.4170923
70025,7,43,14,9,16,1,90,38.21069400954377,-109.4168228
70026,6,41,14,9,16,1,87,38.21069400954377,-109.4165533
70027,6,40,14,10,15,2,87,38.21069400954377,-109.4162838
70028,6,40,15,11,15,2,89,38.21069400954377,-109.4160143
70029,5,41,16,11,15,1,89,38.21069400954377,-109.4157448
70030,5,40,15,10,15,2,87,38.21069400954377,-109.4154753
70031,6,41,14,10,15,2,88,38.21069400954377,-109.4152058
70032,5,42,14,9,15,2,87,38.21069400954377,-109.4149364
70033,5,41,13,8,14,3,84,38.21069400954377,-109.4146669
70034,6,40,14,8,13,3,84,38.21069400954377,-109.4143974
70035,6,38,14,9,13,3,83,38.21069400954377,-109.4141279
70036,6,40,14,9,13,3,85,38.21069400954377,-109.4138584
70037,6,43,14,9,13,2,87,38.21069400954377,-109.4135889
70038,6,44,14,8,14,2,88,38.21069400954377,-109.4133194
70039,7,44,14,9,13,2,89,38.21069400954377,-109.4130499
70040,7,44,14,8,14,2,89,38.21069400954377,-109.4127804
70041,5,44,14,8,15,2,88,38.21069400954377,-109.4125109
70042,4,44,14,8,15,2,87,38.21069400954377,-109.4122414
70043,4,45,14,9,14,2,88,38.21069400954377,-109.4119719
70044,4,45,14,9,13,2,87,38.21069400954377,-109.4117024
70045,4,43,14,8,14,3,86,38.21069400954377,-109.4114329
70046,4,42,14,8,15,3,86,38.21069400954377,-109.4111634
70047,4,42,14,8,16,2,86,38.21069400954377,-109.4108939
70048,4,41,14,7,15,3,84,38.21069400954377,-109.4106244
70049,4,41,14,7,15,3,84,38.21069400954377,-109.4103549
70050,5,42,15,8,16,2,88,38.21069400954377,-109.4100855
70051,6,43,15,9,16,1,90,38.21069400954377,-109.409816
70052,7,42,15,8,15,2,89,38.21069400954377,-109.4095465
70053,7,40,15,8,16,2,88,38.21069400954377,-109.409277
70054,5,38,15,8,15,3,84,38.21069400954377,-109.4090075
70055,5,38,16,9,15,2,85,38.21069400954377,-109.408738
70056,4,40,16,9,16,2,87,38.21069400954377,-109.4084685
70057,4,38,15,9,15,3,84,38.21069400954377,-109.408199
70058,4,38,14,8,15,3,82,38.21069400954377,-109.4079295
70059,4,37,14,8,14,3,80,38.21069400954377,-109.40766
70060,4,37,14,9,14,3,81,38.21069400954377,-109.4073905
70061,5,39,15,8,14,3,84,38.21069400954377,-109.407121
70062,4,37,14,8,14,4,81,38.21069400954377,-109.4068515
70063,4,38,14,9,14,3,82,38.21069400954377,-109.406582
70064,5,40,14,11,15,1,86,38.21069400954377,-109.4063125
70065,7,41,15,12,16,0,91,38.21069400954377,-109.406043
70066,7,39,15,14,17,0,92,38.21069400954377,-109.4057735
70067,8,37,15,16,16,0,92,38.21069400954377,-109.405504
70068,9,35,15,14,17,0,90,38.21069400954377,-109.4052345
70069,10,34,14,13,16,1,88,38.21069400954377,-109.4049651
70070,8,34,14,13,17,1,87,38.21069400954377,-109.4046956
70071,8,34,14,13,16,1,86,38.21069400954377,-109.4044261
70072,11,34,14,14,16,1,90,38.21069400954377,-109.4041566
70073,10,35,14,14,16,1,90,38.21069400954377,-109.4038871
70074,8,36,14,14,17,1,90,38.21069400954377,-109.4036176
70075,8,37,14,13,17,0,89,38.21069400954377,-109.4033481
70076,9,36,14,14,16,0,89,38.21069400954377,-109.4030786
70077,8,37,15,13,17,0,90,38.21069400954377,-109.4028091
70078,8,37,15,13,16,1,90,38.21069400954377,-109.4025396
70079,8,36,14,13,15,1,87,38.21069400954377,-109.4022701
70080,7,33,13,14,14,2,83,38.21069400954377,-109.4020006
70081,6,32,11,12,12,2,75,38.21069400954377,-109.4017311
70082,5,32,11,11,14,2,75,38.21069400954377,-109.4014616
70083,5,33,12,12,16,1,79,38.21069400954377,-109.4011921
70084,7,36,12,12,17,1,85,38.21069400954377,-109.4009226
70085,6,36,12,13,17,1,85,38.21069400954377,-109.4006531
70086,6,38,13,10,18,2,87,38.21069400954377,-109.4003836
70087,6,38,13,10,17,2,86,38.21069400954377,-109.4001142
70088,8,38,13,11,16,1,87,38.21069400954377,-109.3998447
70089,8,39,13,11,15,1,87,38.21069400954377,-109.3995752
70090,6,46,12,9,13,1,87,38.21069400954377,-109.3993057
70091,4,44,11,7,16,1,83,38.21069400954377,-109.3990362
70092,4,36,11,9,17,1,78,38.21069400954377,-109.3987667
70093,4,34,11,11,17,1,78,38.21069400954377,-109.3984972
70094,6,39,11,11,16,1,84,38.21069400954377,-109.3982277
70095,9,37,12,12,16,0,86,38.21069400954377,-109.3979582
70096,7,38,13,12,16,0,86,38.21069400954377,-109.3976887
70097,6,40,13,11,16,1,87,38.21069400954377,-109.3974192
70098,6,39,14,11,15,1,86,38.21069400954377,-109.3971497
70099,7,39,14,13,15,1,89,38.21069400954377,-109.3968802
70100,6,40,13,10,15,1,85,38.21069400954377,-109.3966107
70101,4,42,13,10,15,1,85,38.21069400954377,-109.3963412
70102,4,40,12,9,14,2,81,38.21069400954377,-109.3960717
70103,4,39,10,7,13,2,75,38.21069400954377,-109.3958022
70104,2,39,9,4,11,3,68,38.21069400954377,-109.3955327
70105,3,33,8,5,10,3,62,38.21069400954377,-109.3952632
70106,5,25,9,6,13,3,61,38.21069400954377,-109.3949938
70107,8,27,10,15,15,3,78,38.21069400954377,-109.3947243
70108,1,11,5,10,27,10,64,38.21069400954377,-109.3944548
70109,2,13,6,13,27,11,72,38.21069400954377,-109.3941853
70110,5,21,9,15,28,9,87,38.21069400954377,-109.3939158
70111,5,23,9,16,26,6,85,38.21069400954377,-109.3936463
70112,7,21,9,17,24,7,85,38.21069400954377,-109.3933768
70113,12,22,8,16,22,7,87,38.21069400954377,-109.3931073
70114,12,23,8,17,22,5,87,38.21069400954377,-109.3928378
70115,9,23,9,22,22,3,88,38.21069400954377,-109.3925683
70116,16,27,10,17,19,2,91,38.21069400954377,-109.3922988
70117,15,37,12,17,13,0,94,38.21069400954377,-109.3920293
70118,12,43,12,10,12,0,89,38.21069400954377,-109.3917598
70119,4,52,9,14,10,0,89,38.21069400954377,-109.3914903
70120,4,53,10,16,10,0,93,38.21069400954377,-109.3912208
70121,8,46,12,16,11,0,93,38.21069400954377,-109.3909513
70122,15,40,13,15,11,0,94,38.21069400954377,-109.3906818
70123,16,37,14,15,13,0,95,38.21069400954377,-109.3904123
70124,13,38,13,14,14,0,92,38.21069400954377,-109.3901429
70125,13,40,12,14,13,0,92,38.21069400954377,-109.3898734
70126,17,41,12,12,10,0,92,38.21069400954377,-109.3896039
70127,14,31,7,2,6,0,60,38.21069400954377,-109.3893344
70128,10,25,5,0,5,0,45,38.21069400954377,-109.3890649
70129,10,28,6,1,6,0,51,38.21069400954377,-109.3887954
70130,15,37,13,10,10,0,85,38.21069400954377,-109.3885259
70131,9,32,10,12,13,2,78,38.21069400954377,-109.3882564
70132,8,27,9,9,14,3,70,38.21069400954377,-109.3879869
70133,3,23,9,7,10,5,57,38.21069400954377,-109.3877174
70134,4,25,9,6,8,6,58,38.21069400954377,-109.3874479
70135,3,30,9,6,9,6,63,38.21069400954377,-109.3871784
70136,4,37,9,6,13,3,72,38.21069400954377,-109.3869089
70137,6,45,11,11,14,1,88,38.21069400954377,-109.3866394
70138,6,46,11,13,13,0,89,38.21069400954377,-109.3863699
70139,6,47,11,14,12,0,90,38.21069400954377,-109.3861004
70140,5,47,11,14,13,0,90,38.21069400954377,-109.3858309
70141,7,44,13,8,17,1,90,38.21042451495853,-109.4189788
70142,8,44,13,8,17,1,91,38.21042451495853,-109.4187093
70143,11,43,13,8,16,0,91,38.21042451495853,-109.4184398
70144,12,42,13,8,15,0,90,38.21042451495853,-109.4181703
70145,10,43,13,7,16,1,90,38.21042451495853,-109.4179008
70146,9,44,13,7,16,1,90,38.21042451495853,-109.4176313
70147,8,43,14,8,16,1,90,38.21042451495853,-109.4173618
70148,8,43,14,9,16,1,91,38.21042451495853,-109.4170923
70149,7,42,14,10,16,1,90,38.21042451495853,-109.4168228
70150,7,40,14,10,15,2,88,38.21042451495853,-109.4165533
70151,7,40,14,10,15,2,88,38.21042451495853,-109.4162838
70152,7,40,14,10,15,2,88,38.21042451495853,-109.4160143
70153,6,42,14,9,15,2,88,38.21042451495853,-109.4157448
70154,6,43,14,9,16,2,90,38.21042451495853,-109.4154753
70155,6,45,14,9,15,2,91,38.21042451495853,-109.4152058
70156,6,45,13,9,14,2,89,38.21042451495853,-109.4149364
70157,6,42,14,8,13,2,85,38.21042451495853,-109.4146669
70158,6,41,14,8,13,3,85,38.21042451495853,-109.4143974
70159,6,40,14,8,13,3,84,38.21042451495853,-109.4141279
70160,6,43,14,8,13,3,87,38.21042451495853,-109.4138584
70161,7,46,13,8,12,2,88,38.21042451495853,-109.4135889
70162,7,46,14,8,13,2,90,38.21042451495853,-109.4133194
70163,7,43,14,9,13,2,88,38.21042451495853,-109.4130499
70164,6,42,14,8,14,2,86,38.21042451495853,-109.4127804
70165,5,44,14,8,14,2,87,38.21042451495853,-109.4125109
70166,5,45,14,8,14,2,88,38.21042451495853,-109.4122414
70167,4,45,14,9,13,2,87,38.21042451495853,-109.4119719
70168,4,44,14,9,12,2,85,38.21042451495853,-109.4117024
70169,4,43,14,8,13,3,85,38.21042451495853,-109.4114329
70170,4,43,14,8,14,3,86,38.21042451495853,-109.4111634
70171,5,42,14,8,14,2,85,38.21042451495853,-109.4108939
70172,5,41,14,8,15,3,86,38.21042451495853,-109.4106244
70173,5,44,15,8,15,2,89,38.21042451495853,-109.4103549
70174,6,44,15,9,15,1,90,38.21042451495853,-109.4100855
70175,6,42,15,10,15,1,89,38.21042451495853,-109.409816
70176,8,42,15,9,14,1,89,38.21042451495853,-109.4095465
70177,6,39,16,10,16,2,89,38.21042451495853,-109.409277
70178,5,38,16,9,15,2,85,38.21042451495853,-109.4090075
70179,4,38,16,8,14,3,83,38.21042451495853,-109.408738
70180,4,39,16,8,14,3,84,38.21042451495853,-109.4084685
70181,4,39,16,7,14,3,83,38.21042451495853,-109.408199
70182,4,38,15,8,14,3,82,38.21042451495853,-109.4079295
70183,4,39,15,7,14,3,82,38.21042451495853,-109.40766
70184,4,40,15,7,14,3,83,38.21042451495853,-109.4073905
70185,5,40,15,8,15,3,86,38.21042451495853,-109.407121
70186,5,36,14,8,13,4,80,38.21042451495853,-109.4068515
70187,5,39,14,9,14,3,84,38.21042451495853,-109.406582
70188,5,41,14,10,16,1,87,38.21042451495853,-109.4063125
70189,6,41,15,12,16,0,90,38.21042451495853,-109.406043
70190,5,39,16,14,17,0,91,38.21042451495853,-109.4057735
70191,6,38,16,15,16,0,91,38.21042451495853,-109.405504
70192,8,38,15,14,16,0,91,38.21042451495853,-109.4052345
70193,8,37,15,13,16,0,89,38.21042451495853,-109.4049651
70194,8,35,14,13,17,1,88,38.21042451495853,-109.4046956
70195,7,34,14,14,17,1,87,38.21042451495853,-109.4044261
70196,8,34,15,15,17,1,90,38.21042451495853,-109.4041566
70197,9,35,15,15,16,1,91,38.21042451495853,-109.4038871
70198,9,35,14,14,16,1,89,38.21042451495853,-109.4036176
70199,9,36,15,13,16,1,90,38.21042451495853,-109.4033481
70200,8,36,14,14,16,1,89,38.21042451495853,-109.4030786
70201,8,36,14,14,16,1,89,38.21042451495853,-109.4028091
70202,8,36,15,14,16,1,90,38.21042451495853,-109.4025396
70203,8,36,14,13,16,1,88,38.21042451495853,-109.4022701
70204,9,34,14,12,15,1,85,38.21042451495853,-109.4020006
70205,7,30,12,13,13,2,77,38.21042451495853,-109.4017311
70206,7,31,11,14,15,1,79,38.21042451495853,-109.4014616
70207,7,31,11,15,16,1,81,38.21042451495853,-109.4011921
70208,8,33,11,16,15,1,84,38.21042451495853,-109.4009226
70209,10,35,12,13,16,1,87,38.21042451495853,-109.4006531
70210,6,39,14,10,18,1,88,38.21042451495853,-109.4003836
70211,6,39,14,10,17,1,87,38.21042451495853,-109.4001142
70212,6,39,14,10,16,1,86,38.21042451495853,-109.3998447
70213,6,40,13,9,16,1,85,38.21042451495853,-109.3995752
70214,4,45,12,8,15,1,85,38.21042451495853,-109.3993057
70215,3,40,10,8,16,1,78,38.21042451495853,-109.3990362
70216,4,32,10,12,15,1,74,38.21042451495853,-109.3987667
70217,6,33,11,13,16,1,80,38.21042451495853,-109.3984972
70218,7,39,13,12,15,1,87,38.21042451495853,-109.3982277
70219,10,38,13,13,16,0,90,38.21042451495853,-109.3979582
70220,10,38,14,13,16,0,91,38.21042451495853,-109.3976887
70221,10,38,14,13,16,0,91,38.21042451495853,-109.3974192
70222,9,38,14,14,16,0,91,38.21042451495853,-109.3971497
70223,9,38,14,13,15,0,89,38.21042451495853,-109.3968802
70224,8,39,14,12,15,0,88,38.21042451495853,-109.3966107
70225,5,39,13,10,14,1,82,38.21042451495853,-109.3963412
70226,4,38,11,9,14,2,78,38.21042451495853,-109.3960717
70227,3,38,9,7,13,2,72,38.21042451495853,-109.3958022
70228,1,42,8,3,10,4,68,38.21042451495853,-109.3955327
70229,2,34,8,3,9,4,60,38.21042451495853,-109.3952632
70230,4,26,9,6,14,4,63,38.21042451495853,-109.3949938
70231,7,28,11,17,15,3,81,38.21042451495853,-109.3947243
70232,2,11,6,12,27,11,69,38.21042451495853,-109.3944548
70233,0,9,5,11,23,9,57,38.21042451495853,-109.3941853
70234,3,14,6,13,25,10,71,38.21042451495853,-109.3939158
70235,7,20,9,15,27,9,87,38.21042451495853,-109.3936463
70236,9,20,9,14,26,8,86,38.21042451495853,-109.3933768
70237,11,21,9,13,24,8,86,38.21042451495853,-109.3931073
70238,11,22,9,13,23,7,85,38.21042451495853,-109.3928378
70239,12,24,9,14,24,5,88,38.21042451495853,-109.3925683
70240,17,27,9,15,19,2,89,38.21042451495853,-109.3922988
70241,15,35,11,16,14,1,92,38.21042451495853,-109.3920293
70242,10,43,12,15,13,0,93,38.21042451495853,-109.3917598
70243,5,48,10,14,12,0,89,38.21042451495853,-109.3914903
70244,5,52,11,13,11,0,92,38.21042451495853,-109.3912208
70245,8,49,12,13,11,0,93,38.21042451495853,-109.3909513
70246,15,44,12,13,9,0,93,38.21042451495853,-109.3906818
70247,19,37,13,12,11,0,92,38.21042451495853,-109.3904123
70248,16,38,13,13,13,0,93,38.21042451495853,-109.3901429
70249,14,39,13,14,13,0,93,38.21042451495853,-109.3898734
70250,15,42,12,15,10,0,94,38.21042451495853,-109.3896039
70251,16,39,9,7,8,0,79,38.21042451495853,-109.3893344
70252,13,28,7,5,7,0,60,38.21042451495853,-109.3890649
70253,9,26,6,3,6,0,50,38.21042451495853,-109.3887954
70254,11,27,8,3,7,0,56,38.21042451495853,-109.3885259
70255,19,29,15,13,13,1,90,38.21042451495853,-109.3882564
70256,15,24,15,18,18,1,91,38.21042451495853,-109.3879869
70257,10,22,17,17,11,5,82,38.21042451495853,-109.3877174
70258,5,19,16,9,7,12,68,38.21042451495853,-109.3874479
70259,3,20,14,6,7,14,64,38.21042451495853,-109.3871784
70260,3,33,10,10,13,4,73,38.21042451495853,-109.3869089
70261,5,42,11,15,14,1,88,38.21042451495853,-109.3866394
70262,4,46,11,14,13,1,89,38.21042451495853,-109.3863699
70263,4,47,11,14,13,1,90,38.21042451495853,-109.3861004
70264,4,45,11,13,14,1,88,38.21042451495853,-109.3858309
70265,11,43,13,8,16,0,91,38.21015502037329,-109.4184398
70266,9,43,13,8,17,1,91,38.21015502037329,-109.4181703
70267,9,44,13,7,17,1,91,38.21015502037329,-109.4179008
70268,9,44,14,7,17,1,92,38.21015502037329,-109.4176313
70269,9,43,14,8,17,1,92,38.21015502037329,-109.4173618
70270,8,43,14,9,17,1,92,38.21015502037329,-109.4170923
70271,6,41,15,9,16,1,88,38.21015502037329,-109.4168228
70272,7,40,15,9,15,2,88,38.21015502037329,-109.4165533
70273,7,40,15,9,15,2,88,38.21015502037329,-109.4162838
70274,6,41,14,9,15,2,87,38.21015502037329,-109.4160143
70275,6,41,14,8,15,2,86,38.21015502037329,-109.4157448
70276,6,44,14,9,15,2,90,38.21015502037329,-109.4154753
70277,6,44,14,9,15,2,90,38.21015502037329,-109.4152058
70278,7,43,14,9,14,2,89,38.21015502037329,-109.4149364
70279,7,41,14,9,13,2,86,38.21015502037329,-109.4146669
70280,6,39,14,9,13,3,84,38.21015502037329,-109.4143974
70281,7,43,14,8,13,2,87,38.21015502037329,-109.4141279
70282,7,46,14,7,12,2,88,38.21015502037329,-109.4138584
70283,7,47,13,7,13,2,89,38.21015502037329,-109.4135889
70284,5,45,13,7,13,2,85,38.21015502037329,-109.4133194
70285,6,44,13,8,13,2,86,38.21015502037329,-109.4130499
70286,6,44,14,8,13,2,87,38.21015502037329,-109.4127804
70287,5,43,13,8,13,3,85,38.21015502037329,-109.4125109
70288,5,44,13,7,13,3,85,38.21015502037329,-109.4122414
70289,5,45,14,8,13,2,87,38.21015502037329,-109.4119719
70290,5,43,14,8,13,3,86,38.21015502037329,-109.4117024
70291,5,43,14,8,14,2,86,38.21015502037329,-109.4114329
70292,5,44,14,8,14,2,87,38.21015502037329,-109.4111634
70293,5,44,14,9,14,2,88,38.21015502037329,-109.4108939
70294,5,43,14,9,15,2,88,38.21015502037329,-109.4106244
70295,6,42,15,9,15,1,88,38.21015502037329,-109.4103549
70296,7,41,15,9,15,1,88,38.21015502037329,-109.4100855
70297,8,41,15,10,15,1,90,38.21015502037329,-109.409816
70298,8,41,16,9,14,1,89,38.21015502037329,-109.4095465
70299,7,41,16,9,15,1,89,38.21015502037329,-109.409277
70300,5,41,16,8,15,2,87,38.21015502037329,-109.4090075
70301,4,41,16,8,15,2,86,38.21015502037329,-109.408738
70302,4,39,15,7,14,3,82,38.21015502037329,-109.4084685
70303,4,39,15,8,12,3,81,38.21015502037329,-109.408199
70304,5,37,15,10,13,3,83,38.21015502037329,-109.4079295
70305,5,39,15,9,14,3,85,38.21015502037329,-109.40766
70306,5,40,15,8,15,3,86,38.21015502037329,-109.4073905
70307,5,39,15,9,16,2,86,38.21015502037329,-109.407121
70308,6,38,15,8,14,2,83,38.21015502037329,-109.4068515
70309,6,41,15,10,15,1,88,38.21015502037329,-109.406582
70310,7,42,15,11,16,0,91,38.21015502037329,-109.4063125
70311,7,42,15,12,16,0,92,38.21015502037329,-109.406043
70312,6,40,16,13,16,1,92,38.21015502037329,-109.4057735
70313,5,40,15,12,16,1,89,38.21015502037329,-109.405504
70314,6,41,15,12,16,0,90,38.21015502037329,-109.4052345
70315,8,39,15,13,16,0,91,38.21015502037329,-109.4049651
70316,8,37,15,14,16,0,90,38.21015502037329,-109.4046956
70317,7,34,14,13,16,1,85,38.21015502037329,-109.4044261
70318,8,35,14,13,16,0,86,38.21015502037329,-109.4041566
70319,8,35,14,13,17,1,88,38.21015502037329,-109.4038871
70320,8,36,14,13,16,1,88,38.21015502037329,-109.4036176
70321,8,36,15,13,16,1,89,38.21015502037329,-109.4033481
70322,8,37,15,13,16,1,90,38.21015502037329,-109.4030786
70323,8,36,15,14,16,1,90,38.21015502037329,-109.4028091
70324,7,36,15,13,16,1,88,38.21015502037329,-109.4025396
70325,6,35,15,12,15,2,85,38.21015502037329,-109.4022701
70326,5,33,14,12,14,2,80,38.21015502037329,-109.4020006
70327,4,31,12,17,13,2,79,38.21015502037329,-109.4017311
70328,5,31,11,17,15,1,80,38.21015502037329,-109.4014616
70329,8,32,11,17,15,1,84,38.21015502037329,-109.4011921
70330,8,33,12,16,15,1,85,38.21015502037329,-109.4009226
70331,10,36,14,13,15,1,89,38.21015502037329,-109.4006531
70332,6,39,15,12,16,1,89,38.21015502037329,-109.4003836
70333,5,39,15,11,16,1,87,38.21015502037329,-109.4001142
70334,5,38,14,10,16,2,85,38.21015502037329,-109.3998447
70335,5,38,14,9,16,2,84,38.21015502037329,-109.3995752
70336,5,40,12,8,16,1,82,38.21015502037329,-109.3993057
70337,3,33,10,9,16,2,73,38.21015502037329,-109.3990362
70338,6,30,11,12,15,1,75,38.21015502037329,-109.3987667
70339,8,34,12,14,15,0,83,38.21015502037329,-109.3984972
70340,6,37,14,14,17,0,88,38.21015502037329,-109.3982277
70341,10,36,14,13,17,0,90,38.21015502037329,-109.3979582
70342,10,36,14,13,16,0,89,38.21015502037329,-109.3976887
70343,10,36,14,13,16,0,89,38.21015502037329,-109.3974192
70344,10,36,14,13,16,0,89,38.21015502037329,-109.3971497
70345,10,37,14,13,16,0,90,38.21015502037329,-109.3968802
70346,8,38,15,14,16,0,91,38.21015502037329,-109.3966107
70347,10,36,12,10,14,1,83,38.21015502037329,-109.3963412
70348,5,37,10,9,13,2,76,38.21015502037329,-109.3960717
70349,2,42,9,6,12,2,73,38.21015502037329,-109.3958022
70350,0,48,8,2,10,3,71,38.21015502037329,-109.3955327
70351,2,37,7,4,10,3,63,38.21015502037329,-109.3952632
70352,4,25,10,9,15,3,66,38.21015502037329,-109.3949938
70353,7,23,11,22,16,2,81,38.21015502037329,-109.3947243
70354,4,18,9,15,33,9,88,38.21015502037329,-109.3944548
70355,0,11,5,13,22,6,57,38.21015502037329,-109.3941853
70356,0,11,5,15,22,7,60,38.21015502037329,-109.3939158
70357,2,15,6,16,24,8,71,38.21015502037329,-109.3936463
70358,5,19,8,17,25,7,81,38.21015502037329,-109.3933768
70359,7,18,7,17,24,7,80,38.21015502037329,-109.3931073
70360,6,22,8,19,23,6,84,38.21015502037329,-109.3928378
70361,5,23,8,18,24,7,85,38.21015502037329,-109.3925683
70362,8,24,9,13,25,8,87,38.21015502037329,-109.3922988
70363,15,22,9,12,23,7,88,38.21015502037329,-109.3920293
70364,14,23,10,17,16,2,82,38.21015502037329,-109.3917598
70365,9,33,12,18,17,0,89,38.21015502037329,-109.3914903
70366,6,41,13,17,15,0,92,38.21015502037329,-109.3912208
70367,6,45,13,16,12,0,92,38.21015502037329,-109.3909513
70368,7,45,12,17,11,0,92,38.21015502037329,-109.3906818
70369,10,41,12,14,12,0,89,38.21015502037329,-109.3904123
70370,8,40,13,15,14,0,90,38.21015502037329,-109.3901429
70371,7,40,13,14,14,0,88,38.21015502037329,-109.3898734
70372,8,41,12,15,14,0,90,38.21015502037329,-109.3896039
70373,9,37,12,17,15,1,91,38.21015502037329,-109.3893344
70374,13,31,12,16,16,1,89,38.21015502037329,-109.3890649
70375,14,29,13,17,15,1,89,38.21015502037329,-109.3887954
70376,13,29,14,18,14,1,89,38.21015502037329,-109.3885259
70377,11,30,14,20,14,1,90,38.21015502037329,-109.3882564
70378,8,31,13,23,15,1,91,38.21015502037329,-109.3879869
70379,5,30,13,18,15,3,84,38.21015502037329,-109.3877174
70380,2,24,12,9,11,10,68,38.21015502037329,-109.3874479
70381,0,25,11,4,12,12,64,38.21015502037329,-109.3871784
70382,1,31,10,10,15,5,72,38.21015502037329,-109.3869089
70383,3,39,11,14,15,1,83,38.21015502037329,-109.3866394
70384,3,43,11,12,13,1,83,38.21015502037329,-109.3863699
70385,3,43,10,11,13,1,81,38.21015502037329,-109.3861004
70386,3,37,10,12,15,1,78,38.21015502037329,-109.3858309
70387,7,46,13,7,17,2,92,38.20988552578806,-109.4179008
70388,8,45,14,7,17,2,93,38.20988552578806,-109.4176313
70389,8,45,14,8,17,1,93,38.20988552578806,-109.4173618
70390,6,45,14,8,17,1,91,38.20988552578806,-109.4170923
70391,5,42,15,8,17,2,89,38.20988552578806,-109.4168228
70392,6,41,15,8,16,2,88,38.20988552578806,-109.4165533
70393,6,40,15,8,15,2,86,38.20988552578806,-109.4162838
70394,6,40,15,8,15,2,86,38.20988552578806,-109.4160143
70395,6,40,14,8,15,2,85,38.20988552578806,-109.4157448
70396,7,40,15,9,15,2,88,38.20988552578806,-109.4154753
70397,7,40,15,9,14,2,87,38.20988552578806,-109.4152058
70398,8,39,15,10,14,2,88,38.20988552578806,-109.4149364
70399,7,39,15,10,14,2,87,38.20988552578806,-109.4146669
70400,7,39,15,10,13,2,86,38.20988552578806,-109.4143974
70401,7,43,15,9,13,2,89,38.20988552578806,-109.4141279
70402,7,44,14,9,13,2,89,38.20988552578806,-109.4138584
70403,6,44,14,8,13,2,87,38.20988552578806,-109.4135889
70404,5,44,14,7,13,2,85,38.20988552578806,-109.4133194
70405,5,45,14,8,13,2,87,38.20988552578806,-109.4130499
70406,5,45,14,7,13,3,87,38.20988552578806,-109.4127804
70407,5,44,14,7,14,3,87,38.20988552578806,-109.4125109
70408,5,44,14,8,14,2,87,38.20988552578806,-109.4122414
70409,5,43,14,8,14,2,86,38.20988552578806,-109.4119719
70410,5,44,14,7,14,2,86,38.20988552578806,-109.4117024
70411,5,44,13,7,14,2,85,38.20988552578806,-109.4114329
70412,5,45,14,8,14,1,87,38.20988552578806,-109.4111634
70413,6,46,14,9,15,0,90,38.20988552578806,-109.4108939
70414,6,45,14,8,15,1,89,38.20988552578806,-109.4106244
70415,9,45,15,9,14,0,92,38.20988552578806,-109.4103549
70416,10,44,15,8,15,0,92,38.20988552578806,-109.4100855
70417,8,43,15,8,15,1,90,38.20988552578806,-109.409816
70418,6,44,15,8,15,2,90,38.20988552578806,-109.4095465
70419,5,42,15,7,15,3,87,38.20988552578806,-109.409277
70420,5,41,15,7,15,3,86,38.20988552578806,-109.4090075
70421,4,40,15,7,14,4,84,38.20988552578806,-109.408738
70422,4,37,15,8,13,4,81,38.20988552578806,-109.4084685
70423,5,36,16,9,13,3,82,38.20988552578806,-109.408199
70424,6,37,16,10,14,2,85,38.20988552578806,-109.4079295
70425,6,38,15,9,14,2,84,38.20988552578806,-109.40766
70426,5,39,15,9,15,2,85,38.20988552578806,-109.4073905
70427,5,39,15,9,15,2,85,38.20988552578806,-109.407121
70428,7,39,15,10,14,1,86,38.20988552578806,-109.4068515
70429,8,41,15,10,15,1,90,38.20988552578806,-109.406582
70430,8,42,15,10,16,0,91,38.20988552578806,-109.4063125
70431,7,42,15,11,16,1,92,38.20988552578806,-109.406043
70432,7,41,15,11,15,1,90,38.20988552578806,-109.4057735
70433,7,45,15,10,16,0,93,38.20988552578806,-109.405504
70434,8,43,15,10,17,0,93,38.20988552578806,-109.4052345
70435,8,42,15,11,17,0,93,38.20988552578806,-109.4049651
70436,7,39,14,12,16,0,88,38.20988552578806,-109.4046956
70437,6,37,14,12,16,1,86,38.20988552578806,-109.4044261
70438,6,37,14,12,16,1,86,38.20988552578806,-109.4041566
70439,6,37,14,12,16,1,86,38.20988552578806,-109.4038871
70440,6,36,14,13,16,1,86,38.20988552578806,-109.4036176
70441,7,37,14,12,16,1,87,38.20988552578806,-109.4033481
70442,7,38,14,11,17,1,88,38.20988552578806,-109.4030786
70443,8,37,15,13,16,1,90,38.20988552578806,-109.4028091
70444,6,37,15,13,16,1,88,38.20988552578806,-109.4025396
70445,5,36,15,12,16,2,86,38.20988552578806,-109.4022701
70446,5,37,15,12,16,2,87,38.20988552578806,-109.4020006
70447,5,35,14,16,16,1,87,38.20988552578806,-109.4017311
70448,6,34,13,15,16,1,85,38.20988552578806,-109.4014616
70449,7,35,13,14,16,1,86,38.20988552578806,-109.4011921
70450,9,36,14,14,16,1,90,38.20988552578806,-109.4009226
70451,8,37,14,14,16,1,90,38.20988552578806,-109.4006531
70452,7,37,15,13,15,1,88,38.20988552578806,-109.4003836
70453,6,37,15,11,16,1,86,38.20988552578806,-109.4001142
70454,6,37,15,11,16,1,86,38.20988552578806,-109.3998447
70455,6,37,14,11,16,1,85,38.20988552578806,-109.3995752
70456,6,37,14,11,16,1,85,38.20988552578806,-109.3993057
70457,6,34,12,13,15,1,81,38.20988552578806,-109.3990362
70458,9,33,12,13,15,1,83,38.20988552578806,-109.3987667
70459,10,34,12,13,15,1,85,38.20988552578806,-109.3984972
70460,7,36,14,14,17,0,88,38.20988552578806,-109.3982277
70461,8,36,14,13,17,0,88,38.20988552578806,-109.3979582
70462,9,36,14,13,17,0,89,38.20988552578806,-109.3976887
70463,8,37,14,13,17,0,89,38.20988552578806,-109.3974192
70464,8,37,14,12,17,0,88,38.20988552578806,-109.3971497
70465,9,38,14,13,17,0,91,38.20988552578806,-109.3968802
70466,7,38,14,14,15,0,88,38.20988552578806,-109.3966107
70467,8,34,11,10,13,1,77,38.20988552578806,-109.3963412
70468,3,37,10,8,13,2,73,38.20988552578806,-109.3960717
70469,1,46,8,5,11,2,73,38.20988552578806,-109.3958022
70470,1,46,8,3,10,2,70,38.20988552578806,-109.3955327
70471,3,35,9,5,10,3,65,38.20988552578806,-109.3952632
70472,3,23,11,15,15,3,70,38.20988552578806,-109.3949938
70473,5,28,13,26,16,2,90,38.20988552578806,-109.3947243
70474,3,25,11,15,33,3,90,38.20988552578806,-109.3944548
70475,2,13,6,16,25,5,67,38.20988552578806,-109.3941853
70476,0,11,5,17,24,5,62,38.20988552578806,-109.3939158
70477,2,13,6,19,23,6,69,38.20988552578806,-109.3936463
70478,5,17,6,20,23,6,77,38.20988552578806,-109.3933768
70479,6,17,6,19,23,6,77,38.20988552578806,-109.3931073
70480,2,15,6,18,23,7,71,38.20988552578806,-109.3928378
70481,0,14,6,16,25,6,67,38.20988552578806,-109.3925683
70482,0,11,5,13,25,10,64,38.20988552578806,-109.3922988
70483,0,8,5,14,22,16,65,38.20988552578806,-109.3920293
70484,2,6,7,25,13,23,76,38.20988552578806,-109.3917598
70485,14,20,10,21,21,3,89,38.20988552578806,-109.3914903
70486,6,31,11,23,17,1,89,38.20988552578806,-109.3912208
70487,5,41,13,18,14,0,91,38.20988552578806,-109.3909513
70488,5,46,12,13,13,0,89,38.20988552578806,-109.3906818
70489,5,46,13,13,13,0,90,38.20988552578806,-109.3904123
70490,6,41,13,15,13,1,89,38.20988552578806,-109.3901429
70491,5,40,12,14,13,1,85,38.20988552578806,-109.3898734
70492,5,41,12,14,13,1,86,38.20988552578806,-109.3896039
70493,7,38,12,14,13,1,85,38.20988552578806,-109.3893344
70494,9,32,13,15,15,1,85,38.20988552578806,-109.3890649
70495,9,34,14,16,15,1,89,38.20988552578806,-109.3887954
70496,7,37,14,18,14,1,91,38.20988552578806,-109.3885259
70497,5,37,14,19,14,0,89,38.20988552578806,-109.3882564
70498,3,33,13,22,14,1,86,38.20988552578806,-109.3879869
70499,3,33,12,14,15,3,80,38.20988552578806,-109.3877174
70500,1,29,10,10,15,7,72,38.20988552578806,-109.3874479
70501,0,26,10,11,14,6,67,38.20988552578806,-109.3871784
70502,5,35,12,14,14,1,81,38.20988552578806,-109.3869089
70503,4,41,11,9,13,2,80,38.20988552578806,-109.3866394
70504,3,41,10,7,12,2,75,38.20988552578806,-109.3863699
70505,2,42,9,7,12,2,74,38.20988552578806,-109.3861004
70506,2,41,10,9,13,2,77,38.20988552578806,-109.3858309
70507,6,46,14,7,17,1,91,38.20961603120283,-109.4173618
70508,6,45,14,7,17,2,91,38.20961603120283,-109.4170923
70509,5,44,15,8,16,1,89,38.20961603120283,-109.4168228
70510,6,44,15,8,16,1,90,38.20961603120283,-109.4165533
70511,6,42,15,8,16,2,89,38.20961603120283,-109.4162838
70512,6,41,15,8,16,2,88,38.20961603120283,-109.4160143
70513,6,40,15,8,16,2,87,38.20961603120283,-109.4157448
70514,6,38,15,9,15,3,86,38.20961603120283,-109.4154753
70515,6,38,16,9,15,2,86,38.20961603120283,-109.4152058
70516,7,38,16,10,15,2,88,38.20961603120283,-109.4149364
70517,7,39,15,10,14,2,87,38.20961603120283,-109.4146669
70518,8,41,15,10,14,2,90,38.20961603120283,-109.4143974
70519,6,42,14,9,14,2,87,38.20961603120283,-109.4141279
70520,6,43,14,9,13,2,87,38.20961603120283,-109.4138584
70521,6,42,15,9,13,2,87,38.20961603120283,-109.4135889
70522,5,42,15,8,14,2,86,38.20961603120283,-109.4133194
70523,4,42,15,8,14,3,86,38.20961603120283,-109.4130499
70524,4,43,14,7,13,3,84,38.20961603120283,-109.4127804
70525,4,43,14,7,13,3,84,38.20961603120283,-109.4125109
70526,5,43,14,8,13,2,85,38.20961603120283,-109.4122414
70527,5,44,14,8,14,2,87,38.20961603120283,-109.4119719
70528,5,45,14,8,14,2,88,38.20961603120283,-109.4117024
70529,6,45,14,9,15,1,90,38.20961603120283,-109.4114329
70530,7,46,14,9,15,0,91,38.20961603120283,-109.4111634
70531,7,45,14,9,15,0,90,38.20961603120283,-109.4108939
70532,7,44,14,8,16,1,90,38.20961603120283,-109.4106244
70533,10,43,14,8,15,0,90,38.20961603120283,-109.4103549
70534,10,44,15,8,15,0,92,38.20961603120283,-109.4100855
70535,8,45,15,7,16,1,92,38.20961603120283,-109.409816
70536,5,43,14,6,16,3,87,38.20961603120283,-109.4095465
70537,5,43,14,6,15,3,86,38.20961603120283,-109.409277
70538,5,42,15,6,14,3,85,38.20961603120283,-109.4090075
70539,5,41,15,6,14,3,84,38.20961603120283,-109.408738
70540,5,40,16,7,14,3,85,38.20961603120283,-109.4084685
70541,8,39,16,9,13,2,87,38.20961603120283,-109.408199
70542,8,39,16,9,14,2,88,38.20961603120283,-109.4079295
70543,6,38,16,9,14,2,85,38.20961603120283,-109.40766
70544,5,38,16,9,14,2,84,38.20961603120283,-109.4073905
70545,7,40,15,10,15,1,88,38.20961603120283,-109.407121
70546,8,42,15,10,15,1,91,38.20961603120283,-109.4068515
70547,7,40,14,10,15,1,87,38.20961603120283,-109.406582
70548,7,40,14,11,15,1,88,38.20961603120283,-109.4063125
70549,8,41,15,11,15,1,91,38.20961603120283,-109.406043
70550,9,42,15,11,15,0,92,38.20961603120283,-109.4057735
70551,8,43,15,11,15,0,92,38.20961603120283,-109.405504
70552,10,42,15,11,15,0,93,38.20961603120283,-109.4052345
70553,9,40,15,12,16,0,92,38.20961603120283,-109.4049651
70554,8,38,15,12,17,0,90,38.20961603120283,-109.4046956
70555,8,40,15,12,16,0,91,38.20961603120283,-109.4044261
70556,7,41,14,11,16,0,89,38.20961603120283,-109.4041566
70557,7,40,14,12,16,0,89,38.20961603120283,-109.4038871
70558,7,38,14,12,16,1,88,38.20961603120283,-109.4036176
70559,7,36,14,12,16,1,86,38.20961603120283,-109.4033481
70560,9,38,14,11,16,1,89,38.20961603120283,-109.4030786
70561,9,38,15,11,16,1,90,38.20961603120283,-109.4028091
70562,7,38,15,11,17,1,89,38.20961603120283,-109.4025396
70563,6,37,15,11,17,1,87,38.20961603120283,-109.4022701
70564,6,37,14,12,17,1,87,38.20961603120283,-109.4020006
70565,7,37,14,14,17,1,90,38.20961603120283,-109.4017311
70566,8,34,14,13,17,1,87,38.20961603120283,-109.4014616
70567,8,35,14,13,17,1,88,38.20961603120283,-109.4011921
70568,9,35,14,14,16,1,89,38.20961603120283,-109.4009226
70569,9,35,14,13,16,1,88,38.20961603120283,-109.4006531
70570,8,35,15,13,16,1,88,38.20961603120283,-109.4003836
70571,8,35,15,13,15,1,87,38.20961603120283,-109.4001142
70572,8,36,15,13,16,1,89,38.20961603120283,-109.3998447
70573,7,36,15,13,16,1,88,38.20961603120283,-109.3995752
70574,7,36,14,12,16,1,86,38.20961603120283,-109.3993057
70575,8,36,14,15,16,0,89,38.20961603120283,-109.3990362
70576,8,35,13,14,16,1,87,38.20961603120283,-109.3987667
70577,9,35,13,13,16,1,87,38.20961603120283,-109.3984972
70578,8,36,14,14,17,0,89,38.20961603120283,-109.3982277
70579,8,37,14,13,17,1,90,38.20961603120283,-109.3979582
70580,9,36,14,13,16,1,89,38.20961603120283,-109.3976887
70581,9,37,14,12,16,0,88,38.20961603120283,-109.3974192
70582,8,38,14,12,17,0,89,38.20961603120283,-109.3971497
70583,8,38,14,12,17,0,89,38.20961603120283,-109.3968802
70584,8,36,13,12,15,1,85,38.20961603120283,-109.3966107
70585,6,34,11,9,13,2,75,38.20961603120283,-109.3963412
70586,2,37,10,7,13,3,72,38.20961603120283,-109.3960717
70587,1,43,9,4,11,3,71,38.20961603120283,-109.3958022
70588,2,42,9,5,9,2,69,38.20961603120283,-109.3955327
70589,4,32,9,7,11,3,66,38.20961603120283,-109.3952632
70590,3,23,12,18,15,3,74,38.20961603120283,-109.3949938
70591,5,29,13,25,17,2,91,38.20961603120283,-109.3947243
70592,5,28,12,17,26,3,91,38.20961603120283,-109.3944548
70593,5,17,8,21,25,6,82,38.20961603120283,-109.3941853
70594,2,12,6,16,25,5,66,38.20961603120283,-109.3939158
70595,1,12,6,17,24,5,65,38.20961603120283,-109.3936463
70596,3,13,6,20,24,5,71,38.20961603120283,-109.3933768
70597,4,15,7,21,24,6,77,38.20961603120283,-109.3931073
70598,3,15,5,23,20,5,71,38.20961603120283,-109.3928378
70599,2,12,5,20,21,5,65,38.20961603120283,-109.3925683
70600,2,12,6,21,22,5,68,38.20961603120283,-109.3922988
70601,2,13,7,24,23,7,76,38.20961603120283,-109.3920293
70602,1,10,7,27,22,9,76,38.20961603120283,-109.3917598
70603,4,14,9,33,21,6,87,38.20961603120283,-109.3914903
70604,5,18,10,28,21,2,84,38.20961603120283,-109.3912208
70605,5,24,10,26,18,1,84,38.20961603120283,-109.3909513
70606,4,34,12,22,14,0,86,38.20961603120283,-109.3906818
70607,3,45,12,18,11,0,89,38.20961603120283,-109.3904123
70608,3,43,11,14,12,1,84,38.20961603120283,-109.3901429
70609,3,40,12,15,13,1,84,38.20961603120283,-109.3898734
70610,3,38,12,16,14,1,84,38.20961603120283,-109.3896039
70611,6,34,13,17,15,1,86,38.20961603120283,-109.3893344
70612,8,29,12,14,17,2,82,38.20961603120283,-109.3890649
70613,7,30,13,17,16,2,85,38.20961603120283,-109.3887954
70614,5,35,13,17,16,1,87,38.20961603120283,-109.3885259
70615,4,39,13,17,14,1,88,38.20961603120283,-109.3882564
70616,3,35,12,16,15,2,83,38.20961603120283,-109.3879869
70617,2,32,11,12,15,4,76,38.20961603120283,-109.3877174
70618,1,28,10,8,13,6,66,38.20961603120283,-109.3874479
70619,1,31,9,8,11,5,65,38.20961603120283,-109.3871784
70620,6,37,10,8,13,2,76,38.20961603120283,-109.3869089
70621,3,36,9,6,11,2,67,38.20961603120283,-109.3866394
70622,2,39,7,5,9,3,65,38.20961603120283,-109.3863699
70623,2,42,8,6,10,2,70,38.20961603120283,-109.3861004
70624,2,47,9,6,12,2,78,38.20961603120283,-109.3858309
70625,5,42,15,8,16,2,88,38.20934653661759,-109.4168228
70626,7,43,15,9,16,1,91,38.20934653661759,-109.4165533
70627,7,43,15,10,16,1,92,38.20934653661759,-109.4162838
70628,7,42,15,9,16,1,90,38.20934653661759,-109.4160143
70629,7,42,15,9,15,1,89,38.20934653661759,-109.4157448
70630,6,40,15,8,14,2,85,38.20934653661759,-109.4154753
70631,7,39,16,9,14,2,87,38.20934653661759,-109.4152058
70632,7,39,15,10,14,2,87,38.20934653661759,-109.4149364
70633,8,41,15,10,13,2,89,38.20934653661759,-109.4146669
70634,8,42,15,10,14,2,91,38.20934653661759,-109.4143974
70635,6,43,15,9,14,2,89,38.20934653661759,-109.4141279
70636,5,41,15,9,14,2,86,38.20934653661759,-109.4138584
70637,5,41,15,8,14,2,85,38.20934653661759,-109.4135889
70638,5,42,15,8,14,3,87,38.20934653661759,-109.4133194
70639,4,41,15,7,13,3,83,38.20934653661759,-109.4130499
70640,4,43,15,8,13,3,86,38.20934653661759,-109.4127804
70641,4,44,15,8,13,2,86,38.20934653661759,-109.4125109
70642,5,44,15,9,14,2,89,38.20934653661759,-109.4122414
70643,5,44,14,9,14,1,87,38.20934653661759,-109.4119719
70644,5,44,14,9,14,2,88,38.20934653661759,-109.4117024
70645,6,45,14,9,15,1,90,38.20934653661759,-109.4114329
70646,8,45,14,9,15,0,91,38.20934653661759,-109.4111634
70647,10,44,14,8,15,0,91,38.20934653661759,-109.4108939
70648,10,43,14,8,16,0,91,38.20934653661759,-109.4106244
70649,11,42,14,9,15,0,91,38.20934653661759,-109.4103549
70650,12,41,15,8,16,0,92,38.20934653661759,-109.4100855
70651,9,43,16,8,16,1,93,38.20934653661759,-109.409816
70652,6,42,15,7,16,3,89,38.20934653661759,-109.4095465
70653,5,41,15,7,14,3,85,38.20934653661759,-109.409277
70654,5,40,16,7,14,3,85,38.20934653661759,-109.4090075
70655,5,41,16,7,15,2,86,38.20934653661759,-109.408738
70656,6,42,16,8,15,2,89,38.20934653661759,-109.4084685
70657,7,43,16,9,15,1,91,38.20934653661759,-109.408199
70658,8,41,16,8,14,2,89,38.20934653661759,-109.4079295
70659,7,41,16,8,14,2,88,38.20934653661759,-109.40766
70660,7,41,15,8,14,1,86,38.20934653661759,-109.4073905
70661,7,42,15,9,14,1,88,38.20934653661759,-109.407121
70662,8,41,14,11,15,0,89,38.20934653661759,-109.4068515
70663,6,40,14,9,15,2,86,38.20934653661759,-109.406582
70664,7,41,14,9,16,1,88,38.20934653661759,-109.4063125
70665,8,41,14,10,16,1,90,38.20934653661759,-109.406043
70666,8,41,14,11,15,0,89,38.20934653661759,-109.4057735
70667,8,42,14,11,15,0,90,38.20934653661759,-109.405504
70668,10,39,14,12,16,0,91,38.20934653661759,-109.4052345
70669,11,37,15,13,16,0,92,38.20934653661759,-109.4049651
70670,10,37,15,13,16,0,91,38.20934653661759,-109.4046956
70671,7,39,14,10,16,1,87,38.20934653661759,-109.4044261
70672,6,41,13,9,15,1,85,38.20934653661759,-109.4041566
70673,7,40,14,10,16,1,88,38.20934653661759,-109.4038871
70674,8,39,14,11,16,0,88,38.20934653661759,-109.4036176
70675,9,38,14,12,16,0,89,38.20934653661759,-109.4033481
70676,8,37,14,12,16,1,88,38.20934653661759,-109.4030786
70677,10,36,14,11,15,1,87,38.20934653661759,-109.4028091
70678,10,37,14,10,16,1,88,38.20934653661759,-109.4025396
70679,9,37,14,10,17,1,88,38.20934653661759,-109.4022701
70680,9,38,14,11,17,1,90,38.20934653661759,-109.4020006
70681,7,36,14,13,17,1,88,38.20934653661759,-109.4017311
70682,8,36,14,13,17,1,89,38.20934653661759,-109.4014616
70683,8,35,14,13,16,1,87,38.20934653661759,-109.4011921
70684,8,35,14,13,16,1,87,38.20934653661759,-109.4009226
70685,8,35,14,13,16,1,87,38.20934653661759,-109.4006531
70686,8,35,14,13,16,1,87,38.20934653661759,-109.4003836
70687,8,36,14,13,16,1,88,38.20934653661759,-109.4001142
70688,8,36,15,13,16,1,89,38.20934653661759,-109.3998447
70689,7,35,14,12,17,1,86,38.20934653661759,-109.3995752
70690,9,36,14,12,16,1,88,38.20934653661759,-109.3993057
70691,9,35,14,13,16,1,88,38.20934653661759,-109.3990362
70692,9,35,14,13,17,1,89,38.20934653661759,-109.3987667
70693,9,35,14,13,17,1,89,38.20934653661759,-109.3984972
70694,8,36,14,14,17,1,90,38.20934653661759,-109.3982277
70695,8,36,14,13,17,1,89,38.20934653661759,-109.3979582
70696,9,37,14,13,16,1,90,38.20934653661759,-109.3976887
70697,8,37,14,12,16,1,88,38.20934653661759,-109.3974192
70698,7,38,14,12,17,1,89,38.20934653661759,-109.3971497
70699,7,38,14,12,17,1,89,38.20934653661759,-109.3968802
70700,8,35,13,11,14,1,82,38.20934653661759,-109.3966107
70701,5,33,11,9,13,2,73,38.20934653661759,-109.3963412
70702,1,37,10,7,13,3,71,38.20934653661759,-109.3960717
70703,1,40,9,5,12,3,70,38.20934653661759,-109.3958022
70704,3,36,9,6,10,3,67,38.20934653661759,-109.3955327
70705,4,33,10,7,10,3,67,38.20934653661759,-109.3952632
70706,3,24,12,17,14,3,73,38.20934653661759,-109.3949938
70707,6,31,14,19,18,3,91,38.20934653661759,-109.3947243
70708,4,30,13,17,22,4,90,38.20934653661759,-109.3944548
70709,3,20,10,21,30,5,89,38.20934653661759,-109.3941853
70710,2,15,7,19,26,6,75,38.20934653661759,-109.3939158
70711,2,15,7,16,25,7,72,38.20934653661759,-109.3936463
70712,3,16,7,18,25,7,76,38.20934653661759,-109.3933768
70713,4,16,7,23,24,7,81,38.20934653661759,-109.3931073
70714,6,16,7,22,23,6,80,38.20934653661759,-109.3928378
70715,3,15,5,21,20,5,69,38.20934653661759,-109.3925683
70716,2,14,6,21,21,6,70,38.20934653661759,-109.3922988
70717,2,15,7,22,24,6,76,38.20934653661759,-109.3920293
70718,2,20,9,24,27,5,87,38.20934653661759,-109.3917598
70719,4,22,9,26,26,3,90,38.20934653661759,-109.3914903
70720,4,21,10,26,25,3,89,38.20934653661759,-109.3912208
70721,2,20,10,26,24,4,86,38.20934653661759,-109.3909513
70722,1,21,10,26,24,3,85,38.20934653661759,-109.3906818
70723,1,23,10,27,22,1,84,38.20934653661759,-109.3904123
70724,3,26,10,29,17,1,86,38.20934653661759,-109.3901429
70725,4,29,10,28,16,1,88,38.20934653661759,-109.3898734
70726,5,28,11,27,18,1,90,38.20934653661759,-109.3896039
70727,8,29,11,19,20,2,89,38.20934653661759,-109.3893344
70728,7,26,12,21,19,3,88,38.20934653661759,-109.3890649
70729,6,30,12,17,19,2,86,38.20934653661759,-109.3887954
70730,6,33,12,16,18,2,87,38.20934653661759,-109.3885259
70731,5,34,12,14,16,2,83,38.20934653661759,-109.3882564
70732,3,32,12,11,16,4,78,38.20934653661759,-109.3879869
70733,2,28,11,8,15,6,70,38.20934653661759,-109.3877174
70734,2,36,8,7,7,6,66,38.20934653661759,-109.3874479
70735,2,40,6,5,6,5,64,38.20934653661759,-109.3871784
70736,3,39,8,4,9,3,66,38.20934653661759,-109.3869089
70737,3,36,8,6,11,3,67,38.20934653661759,-109.3866394
70738,2,38,6,6,7,4,63,38.20934653661759,-109.3863699
70739,2,43,6,6,7,2,66,38.20934653661759,-109.3861004
70740,2,48,8,6,10,1,75,38.20934653661759,-109.3858309
70741,8,43,15,11,16,1,94,38.209077042032355,-109.4162838
70742,7,44,14,11,16,1,93,38.209077042032355,-109.4160143
70743,7,44,14,9,15,1,90,38.209077042032355,-109.4157448
70744,7,41,15,8,14,2,87,38.209077042032355,-109.4154753
70745,7,40,15,8,14,3,87,38.209077042032355,-109.4152058
70746,7,40,15,8,14,2,86,38.209077042032355,-109.4149364
70747,8,41,15,9,13,2,88,38.209077042032355,-109.4146669
70748,9,42,15,10,13,2,91,38.209077042032355,-109.4143974
70749,8,42,15,10,14,2,91,38.209077042032355,-109.4141279
70750,6,41,15,8,14,2,86,38.209077042032355,-109.4138584
70751,5,41,15,7,14,3,85,38.209077042032355,-109.4135889
70752,4,43,15,7,14,3,86,38.209077042032355,-109.4133194
70753,4,40,15,7,13,3,82,38.209077042032355,-109.4130499
70754,4,42,15,8,12,3,84,38.209077042032355,-109.4127804
70755,5,44,15,9,12,2,87,38.209077042032355,-109.4125109
70756,5,45,15,9,13,2,89,38.209077042032355,-109.4122414
70757,5,44,15,8,15,2,89,38.209077042032355,-109.4119719
70758,5,42,14,9,14,2,86,38.209077042032355,-109.4117024
70759,6,44,14,10,14,1,89,38.209077042032355,-109.4114329
70760,8,45,14,10,15,0,92,38.209077042032355,-109.4111634
70761,10,44,14,8,16,0,92,38.209077042032355,-109.4108939
70762,9,44,14,8,17,0,92,38.209077042032355,-109.4106244
70763,8,43,15,8,16,0,90,38.209077042032355,-109.4103549
70764,8,42,15,9,16,1,91,38.209077042032355,-109.4100855
70765,6,40,16,9,16,2,89,38.209077042032355,-109.409816
70766,5,40,16,8,16,2,87,38.209077042032355,-109.4095465
70767,5,42,16,7,16,2,88,38.209077042032355,-109.409277
70768,6,41,16,8,16,2,89,38.209077042032355,-109.4090075
70769,6,42,16,8,16,1,89,38.209077042032355,-109.408738
70770,6,43,16,8,16,1,90,38.209077042032355,-109.4084685
70771,7,43,16,8,16,1,91,38.209077042032355,-109.408199
70772,8,41,16,9,15,2,91,38.209077042032355,-109.4079295
70773,8,39,16,9,15,1,88,38.209077042032355,-109.40766
70774,9,41,16,9,15,1,91,38.209077042032355,-109.4073905
70775,9,42,16,10,15,1,93,38.209077042032355,-109.407121
70776,8,42,15,9,16,1,91,38.209077042032355,-109.4068515
70777,7,42,15,8,16,1,89,38.209077042032355,-109.406582
70778,8,42,15,9,16,1,91,38.209077042032355,-109.4063125
70779,9,42,15,10,16,0,92,38.209077042032355,-109.406043
70780,7,41,14,10,16,1,89,38.209077042032355,-109.4057735
70781,8,43,14,9,16,0,90,38.209077042032355,-109.405504
70782,10,40,14,10,15,0,89,38.209077042032355,-109.4052345
70783,11,38,14,11,15,0,89,38.209077042032355,-109.4049651
70784,10,38,14,10,16,0,88,38.209077042032355,-109.4046956
70785,9,41,14,9,16,0,89,38.209077042032355,-109.4044261
70786,8,43,14,8,16,0,89,38.209077042032355,-109.4041566
70787,7,42,13,8,16,1,87,38.209077042032355,-109.4038871
70788,7,40,13,10,16,1,87,38.209077042032355,-109.4036176
70789,8,38,14,12,16,1,89,38.209077042032355,-109.4033481
70790,8,38,14,11,17,1,89,38.209077042032355,-109.4030786
70791,11,37,14,10,15,1,88,38.209077042032355,-109.4028091
70792,9,36,14,10,15,2,86,38.209077042032355,-109.4025396
70793,8,37,14,9,16,2,86,38.209077042032355,-109.4022701
70794,7,39,14,10,17,1,88,38.209077042032355,-109.4020006
70795,6,36,14,11,16,2,85,38.209077042032355,-109.4017311
70796,7,36,14,13,16,1,87,38.209077042032355,-109.4014616
70797,7,37,14,13,16,1,88,38.209077042032355,-109.4011921
70798,7,37,14,13,16,1,88,38.209077042032355,-109.4009226
70799,8,36,14,13,16,1,88,38.209077042032355,-109.4006531
70800,9,36,14,13,16,1,89,38.209077042032355,-109.4003836
70801,9,36,14,12,16,1,88,38.209077042032355,-109.4001142
70802,9,36,14,12,17,1,89,38.209077042032355,-109.3998447
70803,7,35,14,12,17,1,86,38.209077042032355,-109.3995752
70804,8,36,14,11,17,1,87,38.209077042032355,-109.3993057
70805,9,36,14,12,17,1,89,38.209077042032355,-109.3990362
70806,10,35,14,13,17,1,90,38.209077042032355,-109.3987667
70807,10,35,14,13,16,1,89,38.209077042032355,-109.3984972
70808,9,35,14,14,16,1,89,38.209077042032355,-109.3982277
70809,8,36,14,14,16,1,89,38.209077042032355,-109.3979582
70810,10,37,14,13,16,1,91,38.209077042032355,-109.3976887
70811,9,37,14,13,16,1,90,38.209077042032355,-109.3974192
70812,7,38,14,12,17,1,89,38.209077042032355,-109.3971497
70813,7,38,14,11,17,0,87,38.209077042032355,-109.3968802
70814,6,35,13,13,15,1,83,38.209077042032355,-109.3966107
70815,5,33,11,10,13,2,74,38.209077042032355,-109.3963412
70816,2,36,10,6,13,3,70,38.209077042032355,-109.3960717
70817,1,38,9,4,12,4,68,38.209077042032355,-109.3958022
70818,3,36,9,7,10,3,68,38.209077042032355,-109.3955327
70819,2,31,9,7,11,3,63,38.209077042032355,-109.3952632
70820,4,23,12,17,15,3,74,38.209077042032355,-109.3949938
70821,8,29,14,18,18,3,90,38.209077042032355,-109.3947243
70822,4,30,14,18,21,5,92,38.209077042032355,-109.3944548
70823,2,24,12,17,31,3,89,38.209077042032355,-109.3941853
70824,2,18,8,22,26,6,82,38.209077042032355,-109.3939158
70825,2,16,7,20,23,7,75,38.209077042032355,-109.3936463
70826,3,17,7,21,24,7,79,38.209077042032355,-109.3933768
70827,5,20,9,26,25,5,90,38.209077042032355,-109.3931073
70828,5,18,8,25,24,6,86,38.209077042032355,-109.3928378
70829,4,14,5,21,22,6,72,38.209077042032355,-109.3925683
70830,3,13,6,20,22,5,69,38.209077042032355,-109.3922988
70831,3,14,7,21,23,6,74,38.209077042032355,-109.3920293
70832,2,18,9,27,26,6,88,38.209077042032355,-109.3917598
70833,2,21,9,28,25,3,88,38.209077042032355,-109.3914903
70834,4,22,9,28,25,2,90,38.209077042032355,-109.3912208
70835,4,21,9,27,26,2,89,38.209077042032355,-109.3909513
70836,4,18,9,27,27,5,90,38.209077042032355,-109.3906818
70837,3,18,10,22,31,6,90,38.209077042032355,-109.3904123
70838,4,14,9,30,26,7,90,38.209077042032355,-109.3901429
70839,5,14,10,30,27,5,91,38.209077042032355,-109.3898734
70840,4,17,11,27,25,4,88,38.209077042032355,-109.3896039
70841,2,19,12,26,23,4,86,38.209077042032355,-109.3893344
70842,3,23,12,18,27,5,88,38.209077042032355,-109.3890649
70843,6,28,12,23,21,2,92,38.209077042032355,-109.3887954
70844,6,33,11,19,18,0,87,38.209077042032355,-109.3885259
70845,4,33,10,15,15,2,79,38.209077042032355,-109.3882564
70846,1,32,9,11,12,5,70,38.209077042032355,-109.3879869
70847,4,36,10,15,13,1,79,38.209077042032355,-109.3877174
70848,3,43,6,7,6,3,68,38.209077042032355,-109.3874479
70849,1,35,7,4,8,5,60,38.209077042032355,-109.3871784
70850,4,31,10,8,15,3,71,38.209077042032355,-109.3869089
70851,6,27,11,11,15,3,73,38.209077042032355,-109.3866394
70852,3,31,8,5,8,5,60,38.209077042032355,-109.3863699
70853,2,39,6,6,6,3,62,38.209077042032355,-109.3861004
70854,2,41,6,5,7,3,64,38.209077042032355,-109.3858309
70855,7,39,15,9,14,2,86,38.208807547447115,-109.4154753
70856,8,39,15,9,14,2,87,38.208807547447115,-109.4152058
70857,9,40,15,9,13,2,88,38.208807547447115,-109.4149364
70858,10,41,15,10,13,2,91,38.208807547447115,-109.4146669
70859,12,42,16,11,13,1,95,38.208807547447115,-109.4143974
70860,9,41,16,11,13,1,91,38.208807547447115,-109.4141279
70861,8,43,16,10,14,2,93,38.208807547447115,-109.4138584
70862,6,44,15,8,14,2,89,38.208807547447115,-109.4135889
70863,6,43,15,7,13,2,86,38.208807547447115,-109.4133194
70864,5,42,15,7,13,3,85,38.208807547447115,-109.4130499
70865,5,43,15,8,12,2,85,38.208807547447115,-109.4127804
70866,5,45,15,9,12,2,88,38.208807547447115,-109.4125109
70867,5,47,15,9,13,2,91,38.208807547447115,-109.4122414
70868,5,46,15,8,14,2,90,38.208807547447115,-109.4119719
70869,5,45,14,8,13,2,87,38.208807547447115,-109.4117024
70870,6,46,14,8,14,1,89,38.208807547447115,-109.4114329
70871,8,46,14,8,14,1,91,38.208807547447115,-109.4111634
70872,9,45,14,8,15,0,91,38.208807547447115,-109.4108939
70873,9,45,14,9,15,0,92,38.208807547447115,-109.4106244
70874,7,45,15,8,16,1,92,38.208807547447115,-109.4103549
70875,6,43,15,8,16,1,89,38.208807547447115,-109.4100855
70876,5,40,16,8,16,2,87,38.208807547447115,-109.409816
70877,5,39,16,8,15,2,85,38.208807547447115,-109.4095465
70878,5,39,16,9,15,3,87,38.208807547447115,-109.409277
70879,5,41,16,9,15,2,88,38.208807547447115,-109.4090075
70880,5,42,16,9,17,1,90,38.208807547447115,-109.408738
70881,5,42,15,9,17,1,89,38.208807547447115,-109.4084685
70882,6,42,16,9,16,2,91,38.208807547447115,-109.408199
70883,7,41,16,10,15,1,90,38.208807547447115,-109.4079295
70884,9,40,16,11,15,1,92,38.208807547447115,-109.40766
70885,10,40,16,11,15,0,92,38.208807547447115,-109.4073905
70886,9,41,16,10,15,0,91,38.208807547447115,-109.407121
70887,8,40,16,9,15,1,89,38.208807547447115,-109.4068515
70888,9,41,16,9,15,1,91,38.208807547447115,-109.406582
70889,10,41,15,9,15,1,91,38.208807547447115,-109.4063125
70890,9,42,15,9,16,0,91,38.208807547447115,-109.406043
70891,8,42,14,10,16,0,90,38.208807547447115,-109.4057735
70892,9,42,14,10,16,0,91,38.208807547447115,-109.405504
70893,10,40,14,11,16,0,91,38.208807547447115,-109.4052345
70894,11,39,14,11,16,0,91,38.208807547447115,-109.4049651
70895,10,39,14,11,16,0,90,38.208807547447115,-109.4046956
70896,9,40,14,9,17,0,89,38.208807547447115,-109.4044261
70897,8,41,14,9,16,0,88,38.208807547447115,-109.4041566
70898,7,41,14,8,17,1,88,38.208807547447115,-109.4038871
70899,7,39,14,8,17,1,86,38.208807547447115,-109.4036176
70900,7,38,13,9,16,1,84,38.208807547447115,-109.4033481
70901,8,39,13,9,16,1,86,38.208807547447115,-109.4030786
70902,11,39,13,9,15,1,88,38.208807547447115,-109.4028091
70903,9,37,13,8,15,2,84,38.208807547447115,-109.4025396
70904,8,37,13,8,15,3,84,38.208807547447115,-109.4022701
70905,8,38,13,9,16,2,86,38.208807547447115,-109.4020006
70906,7,36,13,10,16,2,84,38.208807547447115,-109.4017311
70907,7,37,14,11,16,2,87,38.208807547447115,-109.4014616
70908,7,37,14,11,16,1,86,38.208807547447115,-109.4011921
70909,8,38,14,11,16,1,88,38.208807547447115,-109.4009226
70910,9,38,14,12,16,1,90,38.208807547447115,-109.4006531
70911,9,37,14,12,16,1,89,38.208807547447115,-109.4003836
70912,10,36,14,12,16,1,89,38.208807547447115,-109.4001142
70913,10,37,14,12,16,1,90,38.208807547447115,-109.3998447
70914,9,37,15,12,17,1,91,38.208807547447115,-109.3995752
70915,8,36,14,12,17,1,88,38.208807547447115,-109.3993057
70916,7,35,14,13,16,1,86,38.208807547447115,-109.3990362
70917,8,36,14,12,16,1,87,38.208807547447115,-109.3987667
70918,9,36,14,12,16,1,88,38.208807547447115,-109.3984972
70919,8,36,14,13,16,1,88,38.208807547447115,-109.3982277
70920,7,35,14,14,16,1,87,38.208807547447115,-109.3979582
70921,9,35,14,13,16,1,88,38.208807547447115,-109.3976887
70922,10,36,14,13,16,1,90,38.208807547447115,-109.3974192
70923,9,37,14,12,16,0,88,38.208807547447115,-109.3971497
70924,7,37,14,12,16,1,87,38.208807547447115,-109.3968802
70925,7,36,14,12,15,1,85,38.208807547447115,-109.3966107
70926,5,33,12,12,14,2,78,38.208807547447115,-109.3963412
70927,2,35,11,8,14,3,73,38.208807547447115,-109.3960717
70928,1,37,10,4,14,4,70,38.208807547447115,-109.3958022
70929,2,34,8,5,10,5,64,38.208807547447115,-109.3955327
70930,1,25,9,7,11,5,58,38.208807547447115,-109.3952632
70931,4,21,12,17,15,4,73,38.208807547447115,-109.3949938
70932,6,26,14,21,19,3,89,38.208807547447115,-109.3947243
70933,4,29,12,25,19,3,92,38.208807547447115,-109.3944548
70934,2,27,13,18,26,2,88,38.208807547447115,-109.3941853
70935,2,22,9,24,27,5,89,38.208807547447115,-109.3939158
70936,2,17,8,23,22,7,79,38.208807547447115,-109.3936463
70937,3,18,8,25,22,7,83,38.208807547447115,-109.3933768
70938,2,20,10,27,24,5,88,38.208807547447115,-109.3931073
70939,3,17,9,28,25,6,88,38.208807547447115,-109.3928378
70940,5,15,8,29,25,6,88,38.208807547447115,-109.3925683
70941,4,15,8,26,25,5,83,38.208807547447115,-109.3922988
70942,3,15,8,21,25,6,78,38.208807547447115,-109.3920293
70943,3,16,8,22,25,6,80,38.208807547447115,-109.3917598
70944,2,20,10,23,28,6,89,38.208807547447115,-109.3914903
70945,2,21,9,26,27,3,88,38.208807547447115,-109.3912208
70946,2,21,9,27,27,2,88,38.208807547447115,-109.3909513
70947,4,21,9,26,28,2,90,38.208807547447115,-109.3906818
70948,4,19,9,27,28,3,90,38.208807547447115,-109.3904123
70949,3,21,11,20,30,3,88,38.208807547447115,-109.3901429
70950,3,22,12,21,26,4,88,38.208807547447115,-109.3898734
70951,3,22,13,22,23,4,87,38.208807547447115,-109.3896039
70952,4,21,12,21,24,5,87,38.208807547447115,-109.3893344
70953,6,23,12,17,23,5,86,38.208807547447115,-109.3890649
70954,6,30,12,19,21,2,90,38.208807547447115,-109.3887954
70955,5,34,12,17,17,1,86,38.208807547447115,-109.3885259
70956,3,35,11,14,15,1,79,38.208807547447115,-109.3882564
70957,1,37,9,8,12,4,71,38.208807547447115,-109.3879869
70958,9,39,10,11,12,1,82,38.208807547447115,-109.3877174
70959,2,36,7,5,10,3,63,38.208807547447115,-109.3874479
70960,2,31,9,6,13,4,65,38.208807547447115,-109.3871784
70961,5,31,13,17,16,1,83,38.208807547447115,-109.3869089
70962,7,29,13,13,15,4,81,38.208807547447115,-109.3866394
70963,3,24,10,11,13,5,66,38.208807547447115,-109.3863699
70964,3,27,9,6,12,5,62,38.208807547447115,-109.3861004
70965,3,31,8,5,11,4,62,38.208807547447115,-109.3858309
70966,2,30,8,5,10,4,59,38.208807547447115,-109.3855614
70967,3,33,7,5,8,4,60,38.208807547447115,-109.3852919
70968,2,28,8,4,10,5,57,38.208807547447115,-109.3850225
70969,2,29,8,4,10,5,58,38.208807547447115,-109.384753
70970,2,32,8,5,9,4,60,38.208807547447115,-109.3844835
70971,3,36,8,5,10,3,65,38.208807547447115,-109.384214
70972,2,35,8,5,10,4,64,38.208807547447115,-109.3839445
70973,2,33,8,6,11,5,65,38.208807547447115,-109.383675
70974,2,37,9,6,12,4,70,38.208807547447115,-109.3834055
70975,3,43,10,8,14,1,79,38.208807547447115,-109.383136
70976,3,46,11,10,14,1,85,38.208807547447115,-109.3828665
70977,5,48,13,12,14,0,92,38.208807547447115,-109.382597
70978,7,47,13,12,14,0,93,38.208807547447115,-109.3823275
70979,7,48,13,11,15,0,94,38.208807547447115,-109.382058
70980,7,48,13,10,15,0,93,38.208807547447115,-109.3817885
70981,6,49,13,10,16,0,94,38.208807547447115,-109.381519
70982,6,48,14,10,15,0,93,38.208807547447115,-109.3812495
70983,6,48,14,10,15,0,93,38.208807547447115,-109.38098
70984,6,48,14,9,16,0,93,38.208807547447115,-109.3807105
70985,7,47,13,9,16,0,92,38.208807547447115,-109.380441
70986,5,44,13,9,16,1,88,38.208807547447115,-109.3801716
70987,4,44,13,8,15,2,86,38.208807547447115,-109.3799021
70988,4,44,13,8,14,2,85,38.208807547447115,-109.3796326
70989,5,43,14,8,14,1,85,38.208807547447115,-109.3793631
70990,7,42,14,9,15,1,88,38.208807547447115,-109.3790936
70991,12,39,14,10,15,0,90,38.208807547447115,-109.3788241
70992,17,36,14,10,14,0,91,38.208807547447115,-109.3785546
70993,20,34,14,10,13,0,91,38.208807547447115,-109.3782851
70994,17,36,14,10,14,0,91,38.208807547447115,-109.3780156
70995,13,39,14,10,15,0,91,38.208807547447115,-109.3777461
70996,8,40,13,9,15,1,86,38.208807547447115,-109.3774766
70997,7,40,13,10,15,1,86,38.208807547447115,-109.3772071
70998,8,39,13,10,14,1,85,38.208807547447115,-109.3769376
70999,11,38,14,10,14,1,88,38.208807547447115,-109.3766681
71000,15,39,14,10,14,0,92,38.208807547447115,-109.3763986
71001,10,39,13,11,14,1,88,38.208807547447115,-109.3761291
71002,7,42,12,10,13,1,85,38.208807547447115,-109.3758596
71003,6,45,12,9,12,2,86,38.208807547447115,-109.3755901
71004,6,46,12,9,12,1,86,38.208807547447115,-109.3753206
71005,7,44,13,10,13,1,88,38.208807547447115,-109.3750512
71006,9,44,13,10,14,1,91,38.208807547447115,-109.3747817
71007,9,45,13,10,14,1,92,38.208807547447115,-109.3745122
71008,11,38,11,10,14,0,84,38.208807547447115,-109.3742427
71009,8,27,9,19,9,0,72,38.208807547447115,-109.3739732
71010,5,30,9,18,11,0,73,38.208807547447115,-109.3737037
71011,11,41,16,9,13,1,91,38.20853805286188,-109.4149364
71012,10,42,15,8,14,2,91,38.20853805286188,-109.4146669
71013,8,42,16,9,13,2,90,38.20853805286188,-109.4143974
71014,9,42,16,11,14,1,93,38.20853805286188,-109.4141279
71015,7,42,16,10,14,1,90,38.20853805286188,-109.4138584
71016,6,42,16,9,13,2,88,38.20853805286188,-109.4135889
71017,5,42,15,8,13,3,86,38.20853805286188,-109.4133194
71018,5,43,15,7,14,3,87,38.20853805286188,-109.4130499
71019,5,44,15,9,13,2,88,38.20853805286188,-109.4127804
71020,5,46,15,9,13,2,90,38.20853805286188,-109.4125109
71021,6,47,15,9,14,1,92,38.20853805286188,-109.4122414
71022,6,46,15,9,14,1,91,38.20853805286188,-109.4119719
71023,6,46,15,8,14,1,90,38.20853805286188,-109.4117024
71024,8,46,15,9,14,0,92,38.20853805286188,-109.4114329
71025,10,45,15,9,14,0,93,38.20853805286188,-109.4111634
71026,9,45,15,8,15,0,92,38.20853805286188,-109.4108939
71027,7,45,15,8,16,1,92,38.20853805286188,-109.4106244
71028,7,46,15,8,15,1,92,38.20853805286188,-109.4103549
71029,7,45,16,8,16,1,93,38.20853805286188,-109.4100855
71030,6,43,16,9,16,1,91,38.20853805286188,-109.409816
71031,5,42,16,9,16,2,90,38.20853805286188,-109.4095465
71032,6,41,16,10,15,1,89,38.20853805286188,-109.409277
71033,6,43,15,10,17,1,92,38.20853805286188,-109.4090075
71034,6,44,15,9,17,1,92,38.20853805286188,-109.408738
71035,6,44,15,9,17,0,91,38.20853805286188,-109.4084685
71036,7,43,16,9,16,0,91,38.20853805286188,-109.408199
71037,8,42,16,10,15,1,92,38.20853805286188,-109.4079295
71038,8,41,16,10,16,1,92,38.20853805286188,-109.40766
71039,7,41,16,10,15,1,90,38.20853805286188,-109.4073905
71040,7,41,16,9,15,1,89,38.20853805286188,-109.407121
71041,7,40,17,9,15,1,89,38.20853805286188,-109.4068515
71042,8,39,16,10,15,1,89,38.20853805286188,-109.406582
71043,8,40,16,10,15,1,90,38.20853805286188,-109.4063125
71044,8,41,15,10,16,0,90,38.20853805286188,-109.406043
71045,8,40,14,11,16,0,89,38.20853805286188,-109.4057735
71046,11,40,14,10,16,0,91,38.20853805286188,-109.405504
71047,11,39,14,11,16,0,91,38.20853805286188,-109.4052345
71048,10,39,14,11,16,0,90,38.20853805286188,-109.4049651
71049,11,39,14,11,16,0,91,38.20853805286188,-109.4046956
71050,10,40,14,10,16,0,90,38.20853805286188,-109.4044261
71051,9,40,14,9,17,0,89,38.20853805286188,-109.4041566
71052,8,41,14,9,17,0,89,38.20853805286188,-109.4038871
71053,8,40,14,9,17,1,89,38.20853805286188,-109.4036176
71054,8,38,14,9,16,1,86,38.20853805286188,-109.4033481
71055,9,38,14,10,16,1,88,38.20853805286188,-109.4030786
71056,10,39,14,9,16,1,89,38.20853805286188,-109.4028091
71057,8,38,13,8,16,2,85,38.20853805286188,-109.4025396
71058,8,38,13,8,16,2,85,38.20853805286188,-109.4022701
71059,8,37,13,9,16,1,84,38.20853805286188,-109.4020006
71060,7,37,13,10,16,2,85,38.20853805286188,-109.4017311
71061,8,37,14,10,16,1,86,38.20853805286188,-109.4014616
71062,9,38,14,10,16,1,88,38.20853805286188,-109.4011921
71063,10,38,14,10,16,1,89,38.20853805286188,-109.4009226
71064,10,39,14,11,16,0,90,38.20853805286188,-109.4006531
71065,10,39,14,11,16,0,90,38.20853805286188,-109.4003836
71066,11,37,14,12,16,0,90,38.20853805286188,-109.4001142
71067,12,36,14,12,15,1,90,38.20853805286188,-109.3998447
71068,11,36,14,12,15,1,89,38.20853805286188,-109.3995752
71069,9,36,14,12,16,1,88,38.20853805286188,-109.3993057
71070,8,35,14,13,15,2,87,38.20853805286188,-109.3990362
71071,7,35,13,12,16,2,85,38.20853805286188,-109.3987667
71072,7,36,13,12,16,2,86,38.20853805286188,-109.3984972
71073,6,35,14,12,16,2,85,38.20853805286188,-109.3982277
71074,6,35,13,12,15,2,83,38.20853805286188,-109.3979582
71075,8,36,14,13,16,1,88,38.20853805286188,-109.3976887
71076,9,37,14,12,16,0,88,38.20853805286188,-109.3974192
71077,9,37,14,12,15,0,87,38.20853805286188,-109.3971497
71078,9,37,13,12,15,0,86,38.20853805286188,-109.3968802
71079,9,37,13,13,15,0,87,38.20853805286188,-109.3966107
71080,7,33,12,12,13,1,78,38.20853805286188,-109.3963412
71081,3,34,11,9,13,3,73,38.20853805286188,-109.3960717
71082,1,38,10,3,14,5,71,38.20853805286188,-109.3958022
71083,0,36,9,2,11,7,65,38.20853805286188,-109.3955327
71084,3,26,9,8,10,4,60,38.20853805286188,-109.3952632
71085,4,22,12,13,13,4,68,38.20853805286188,-109.3949938
71086,3,24,12,19,16,3,77,38.20853805286188,-109.3947243
71087,5,32,13,17,17,2,86,38.20853805286188,-109.3944548
71088,2,35,12,20,17,1,87,38.20853805286188,-109.3941853
71089,4,23,10,27,24,1,89,38.20853805286188,-109.3939158
71090,7,18,8,27,24,5,89,38.20853805286188,-109.3936463
71091,6,15,7,26,22,6,82,38.20853805286188,-109.3933768
71092,4,18,9,26,24,6,87,38.20853805286188,-109.3931073
71093,2,20,9,25,27,4,87,38.20853805286188,-109.3928378
71094,2,20,9,26,27,3,87,38.20853805286188,-109.3925683
71095,2,20,9,27,25,4,87,38.20853805286188,-109.3922988
71096,3,17,8,26,25,6,85,38.20853805286188,-109.3920293
71097,5,14,7,24,25,6,81,38.20853805286188,-109.3917598
71098,3,19,9,24,26,6,87,38.20853805286188,-109.3914903
71099,2,21,9,25,26,4,87,38.20853805286188,-109.3912208
71100,2,21,9,26,28,2,88,38.20853805286188,-109.3909513
71101,3,20,8,29,27,1,88,38.20853805286188,-109.3906818
71102,5,17,9,30,27,2,90,38.20853805286188,-109.3904123
71103,5,19,10,27,29,2,92,38.20853805286188,-109.3901429
71104,4,22,11,23,25,3,88,38.20853805286188,-109.3898734
71105,4,25,13,20,22,4,88,38.20853805286188,-109.3896039
71106,3,27,12,19,23,4,88,38.20853805286188,-109.3893344
71107,6,28,12,18,20,3,87,38.20853805286188,-109.3890649
71108,6,30,12,17,20,3,88,38.20853805286188,-109.3887954
71109,4,31,11,20,18,1,85,38.20853805286188,-109.3885259
71110,3,32,11,18,15,1,80,38.20853805286188,-109.3882564
71111,3,36,10,14,14,1,78,38.20853805286188,-109.3879869
71112,6,39,10,12,13,1,81,38.20853805286188,-109.3877174
71113,2,31,10,17,15,2,77,38.20853805286188,-109.3874479
71114,4,25,10,22,15,2,78,38.20853805286188,-109.3871784
71115,5,24,11,27,17,2,86,38.20853805286188,-109.3869089
71116,4,26,12,26,19,2,89,38.20853805286188,-109.3866394
71117,4,23,11,27,19,2,86,38.20853805286188,-109.3863699
71118,5,22,11,23,17,2,80,38.20853805286188,-109.3861004
71119,6,20,11,16,16,4,73,38.20853805286188,-109.3858309
71120,7,19,10,13,15,4,68,38.20853805286188,-109.3855614
71121,8,26,10,13,16,2,75,38.20853805286188,-109.3852919
71122,5,25,10,13,17,3,73,38.20853805286188,-109.3850225
71123,4,25,10,11,15,4,69,38.20853805286188,-109.384753
71124,3,26,9,8,13,6,65,38.20853805286188,-109.3844835
71125,3,27,10,8,14,5,67,38.20853805286188,-109.384214
71126,2,28,10,9,14,5,68,38.20853805286188,-109.3839445
71127,1,27,10,7,11,6,62,38.20853805286188,-109.383675
71128,3,34,10,8,13,4,72,38.20853805286188,-109.3834055
71129,5,42,11,10,14,1,83,38.20853805286188,-109.383136
71130,4,44,12,11,14,1,86,38.20853805286188,-109.3828665
71131,4,49,12,9,15,1,90,38.20853805286188,-109.382597
71132,4,51,12,9,15,0,91,38.20853805286188,-109.3823275
71133,5,51,13,9,15,0,93,38.20853805286188,-109.382058
71134,6,48,14,11,15,0,94,38.20853805286188,-109.3817885
71135,6,46,14,12,15,0,93,38.20853805286188,-109.381519
71136,6,46,14,11,15,1,93,38.20853805286188,-109.3812495
71137,6,46,14,11,15,1,93,38.20853805286188,-109.38098
71138,6,45,14,10,16,0,91,38.20853805286188,-109.3807105
71139,7,45,14,9,17,0,92,38.20853805286188,-109.380441
71140,5,42,14,10,17,1,89,38.20853805286188,-109.3801716
71141,5,44,14,8,16,1,88,38.20853805286188,-109.3799021
71142,5,44,14,8,15,1,87,38.20853805286188,-109.3796326
71143,6,43,15,8,16,1,89,38.20853805286188,-109.3793631
71144,10,45,14,9,15,0,93,38.20853805286188,-109.3790936
71145,13,40,14,10,15,0,92,38.20853805286188,-109.3788241
71146,18,37,14,10,13,0,92,38.20853805286188,-109.3785546
71147,19,35,14,10,14,0,92,38.20853805286188,-109.3782851
71148,16,36,14,10,15,0,91,38.20853805286188,-109.3780156
71149,12,39,13,10,15,0,89,38.20853805286188,-109.3777461
71150,8,40,12,9,15,1,85,38.20853805286188,-109.3774766
71151,7,40,13,9,14,1,84,38.20853805286188,-109.3772071
71152,7,40,13,9,14,1,84,38.20853805286188,-109.3769376
71153,8,39,13,10,14,1,85,38.20853805286188,-109.3766681
71154,9,40,13,11,14,1,88,38.20853805286188,-109.3763986
71155,7,40,12,10,13,1,83,38.20853805286188,-109.3761291
71156,6,44,12,10,12,1,85,38.20853805286188,-109.3758596
71157,6,46,12,9,12,1,86,38.20853805286188,-109.3755901
71158,7,45,13,10,13,1,89,38.20853805286188,-109.3753206
71159,8,42,13,10,14,1,88,38.20853805286188,-109.3750512
71160,9,43,13,11,14,1,91,38.20853805286188,-109.3747817
71161,9,45,13,10,14,0,91,38.20853805286188,-109.3745122
71162,10,38,11,10,13,1,83,38.20853805286188,-109.3742427
71163,7,28,9,16,7,0,67,38.20853805286188,-109.3739732
71164,7,33,9,17,9,0,75,38.20853805286188,-109.3737037
71165,7,42,16,9,14,1,89,38.20826855827664,-109.4141279
71166,6,41,16,9,14,2,88,38.20826855827664,-109.4138584
71167,5,41,16,9,14,2,87,38.20826855827664,-109.4135889
71168,5,42,15,9,14,2,87,38.20826855827664,-109.4133194
71169,5,44,16,9,14,2,90,38.20826855827664,-109.4130499
71170,5,43,16,9,14,2,89,38.20826855827664,-109.4127804
71171,6,44,16,9,14,1,90,38.20826855827664,-109.4125109
71172,7,45,16,9,14,1,92,38.20826855827664,-109.4122414
71173,7,46,16,8,15,1,93,38.20826855827664,-109.4119719
71174,9,45,15,8,15,0,92,38.20826855827664,-109.4117024
71175,9,44,15,9,15,0,92,38.20826855827664,-109.4114329
71176,7,45,15,8,16,1,92,38.20826855827664,-109.4111634
71177,6,45,15,7,16,2,91,38.20826855827664,-109.4108939
71178,6,45,15,6,16,2,90,38.20826855827664,-109.4106244
71179,6,43,15,7,15,3,89,38.20826855827664,-109.4103549
71180,6,44,15,8,15,1,89,38.20826855827664,-109.4100855
71181,6,45,15,9,16,1,92,38.20826855827664,-109.409816
71182,6,45,15,9,16,1,92,38.20826855827664,-109.4095465
71183,7,44,16,10,16,1,94,38.20826855827664,-109.409277
71184,8,43,15,10,16,0,92,38.20826855827664,-109.4090075
71185,7,44,15,10,16,0,92,38.20826855827664,-109.408738
71186,6,44,15,10,16,0,91,38.20826855827664,-109.4084685
71187,7,42,16,10,15,1,91,38.20826855827664,-109.408199
71188,7,43,16,9,15,1,91,38.20826855827664,-109.4079295
71189,8,42,16,10,15,1,92,38.20826855827664,-109.40766
71190,8,42,16,10,15,1,92,38.20826855827664,-109.4073905
71191,8,41,16,10,15,1,91,38.20826855827664,-109.407121
71192,9,41,17,10,15,1,93,38.20826855827664,-109.4068515
71193,7,42,16,9,15,1,90,38.20826855827664,-109.406582
71194,7,43,15,9,16,1,91,38.20826855827664,-109.4063125
71195,8,42,15,9,16,1,91,38.20826855827664,-109.406043
71196,10,41,15,10,16,0,92,38.20826855827664,-109.4057735
71197,11,40,14,10,16,0,91,38.20826855827664,-109.405504
71198,11,38,14,11,16,0,90,38.20826855827664,-109.4052345
71199,10,39,14,12,16,0,91,38.20826855827664,-109.4049651
71200,10,40,14,11,16,0,91,38.20826855827664,-109.4046956
71201,9,41,14,11,16,0,91,38.20826855827664,-109.4044261
71202,9,41,14,10,16,0,90,38.20826855827664,-109.4041566
71203,9,41,14,9,17,1,91,38.20826855827664,-109.4038871
71204,8,40,14,10,17,1,90,38.20826855827664,-109.4036176
71205,8,39,14,10,16,1,88,38.20826855827664,-109.4033481
71206,9,39,14,10,16,1,89,38.20826855827664,-109.4030786
71207,10,38,14,10,16,1,89,38.20826855827664,-109.4028091
71208,8,37,13,10,16,1,85,38.20826855827664,-109.4025396
71209,8,37,13,10,16,1,85,38.20826855827664,-109.4022701
71210,10,37,13,10,15,1,86,38.20826855827664,-109.4020006
71211,8,38,13,9,16,1,85,38.20826855827664,-109.4017311
71212,9,38,14,10,16,1,88,38.20826855827664,-109.4014616
71213,10,38,14,10,16,1,89,38.20826855827664,-109.4011921
71214,10,40,14,10,16,1,91,38.20826855827664,-109.4009226
71215,9,41,14,10,16,0,90,38.20826855827664,-109.4006531
71216,10,40,14,10,16,0,90,38.20826855827664,-109.4003836
71217,11,38,14,11,16,0,90,38.20826855827664,-109.4001142
71218,12,36,14,11,15,1,89,38.20826855827664,-109.3998447
71219,12,35,14,11,15,1,88,38.20826855827664,-109.3995752
71220,10,36,14,12,16,1,89,38.20826855827664,-109.3993057
71221,9,35,14,12,15,2,87,38.20826855827664,-109.3990362
71222,8,36,13,12,15,2,86,38.20826855827664,-109.3987667
71223,9,36,13,12,15,1,86,38.20826855827664,-109.3984972
71224,9,36,13,12,16,1,87,38.20826855827664,-109.3982277
71225,8,35,13,12,16,1,85,38.20826855827664,-109.3979582
71226,11,36,13,12,15,1,88,38.20826855827664,-109.3976887
71227,11,37,13,11,15,0,87,38.20826855827664,-109.3974192
71228,12,37,13,11,15,0,88,38.20826855827664,-109.3971497
71229,13,37,13,11,15,0,89,38.20826855827664,-109.3968802
71230,12,37,13,11,15,0,88,38.20826855827664,-109.3966107
71231,9,32,12,10,14,1,78,38.20826855827664,-109.3963412
71232,3,35,10,7,14,3,72,38.20826855827664,-109.3960717
71233,1,39,10,3,14,4,71,38.20826855827664,-109.3958022
71234,1,38,9,2,12,7,69,38.20826855827664,-109.3955327
71235,1,35,9,3,10,8,66,38.20826855827664,-109.3952632
71236,1,23,10,7,9,9,59,38.20826855827664,-109.3949938
71237,1,23,12,11,11,7,65,38.20826855827664,-109.3947243
71238,3,30,13,16,15,3,80,38.20826855827664,-109.3944548
71239,4,37,13,17,16,1,88,38.20826855827664,-109.3941853
71240,4,23,10,28,22,2,89,38.20826855827664,-109.3939158
71241,5,18,8,30,23,4,88,38.20826855827664,-109.3936463
71242,5,15,7,30,22,7,86,38.20826855827664,-109.3933768
71243,6,17,8,28,24,6,89,38.20826855827664,-109.3931073
71244,5,21,9,28,25,2,90,38.20826855827664,-109.3928378
71245,5,23,10,26,25,1,90,38.20826855827664,-109.3925683
71246,4,24,10,25,26,1,90,38.20826855827664,-109.3922988
71247,4,23,9,22,27,3,88,38.20826855827664,-109.3920293
71248,3,19,9,20,30,7,88,38.20826855827664,-109.3917598
71249,2,20,10,19,31,5,87,38.20826855827664,-109.3914903
71250,2,20,9,26,27,4,88,38.20826855827664,-109.3912208
71251,3,20,9,28,26,4,90,38.20826855827664,-109.3909513
71252,4,18,9,26,26,4,87,38.20826855827664,-109.3906818
71253,5,17,9,23,32,2,88,38.20826855827664,-109.3904123
71254,4,18,11,18,35,3,89,38.20826855827664,-109.3901429
71255,4,20,12,17,32,4,89,38.20826855827664,-109.3898734
71256,2,23,12,18,27,4,86,38.20826855827664,-109.3896039
71257,2,24,12,19,23,4,84,38.20826855827664,-109.3893344
71258,3,24,12,21,22,4,86,38.20826855827664,-109.3890649
71259,4,28,12,18,21,3,86,38.20826855827664,-109.3887954
71260,3,33,12,15,20,2,85,38.20826855827664,-109.3885259
71261,5,36,12,13,18,0,84,38.20826855827664,-109.3882564
71262,7,36,12,12,16,1,84,38.20826855827664,-109.3879869
71263,7,35,12,15,17,1,87,38.20826855827664,-109.3877174
71264,9,31,12,21,16,1,90,38.20826855827664,-109.3874479
71265,10,26,11,23,18,1,89,38.20826855827664,-109.3871784
71266,9,21,10,24,21,2,87,38.20826855827664,-109.3869089
71267,2,20,11,26,23,4,86,38.20826855827664,-109.3866394
71268,3,20,10,26,23,4,86,38.20826855827664,-109.3863699
71269,3,20,11,27,23,4,88,38.20826855827664,-109.3861004
71270,5,21,11,27,20,4,88,38.20826855827664,-109.3858309
71271,10,22,10,23,17,3,85,38.20826855827664,-109.3855614
71272,18,25,11,17,15,2,88,38.20826855827664,-109.3852919
71273,17,26,12,14,16,2,87,38.20826855827664,-109.3850225
71274,17,28,12,13,15,2,87,38.20826855827664,-109.384753
71275,16,29,12,13,14,2,86,38.20826855827664,-109.3844835
71276,14,29,11,12,15,3,84,38.20826855827664,-109.384214
71277,6,24,11,12,15,4,72,38.20826855827664,-109.3839445
71278,2,27,9,9,10,6,63,38.20826855827664,-109.383675
71279,3,35,8,10,11,2,69,38.20826855827664,-109.3834055
71280,5,43,11,14,13,1,87,38.20826855827664,-109.383136
71281,4,46,12,13,14,1,90,38.20826855827664,-109.3828665
71282,4,49,12,12,13,1,91,38.20826855827664,-109.382597
71283,4,47,12,11,14,1,89,38.20826855827664,-109.3823275
71284,5,46,12,10,15,0,88,38.20826855827664,-109.382058
71285,6,46,13,10,15,0,90,38.20826855827664,-109.3817885
71286,8,45,14,11,15,0,93,38.20826855827664,-109.381519
71287,6,45,14,12,15,1,93,38.20826855827664,-109.3812495
71288,5,45,14,11,15,1,91,38.20826855827664,-109.38098
71289,4,44,14,10,16,1,89,38.20826855827664,-109.3807105
71290,4,44,14,10,17,1,90,38.20826855827664,-109.380441
71291,5,44,14,10,17,1,91,38.20826855827664,-109.3801716
71292,6,45,14,9,16,0,90,38.20826855827664,-109.3799021
71293,7,45,14,9,16,0,91,38.20826855827664,-109.3796326
71294,8,43,14,9,16,0,90,38.20826855827664,-109.3793631
71295,10,43,14,9,15,0,91,38.20826855827664,-109.3790936
71296,11,40,14,10,15,0,90,38.20826855827664,-109.3788241
71297,12,40,14,10,15,0,91,38.20826855827664,-109.3785546
71298,10,38,13,10,15,1,87,38.20826855827664,-109.3782851
71299,8,38,12,10,14,1,83,38.20826855827664,-109.3780156
71300,6,42,12,9,14,1,84,38.20826855827664,-109.3777461
71301,5,41,12,9,14,1,82,38.20826855827664,-109.3774766
71302,6,40,12,9,14,1,82,38.20826855827664,-109.3772071
71303,7,39,13,9,13,2,83,38.20826855827664,-109.3769376
71304,6,39,13,9,13,2,82,38.20826855827664,-109.3766681
71305,6,42,12,9,12,2,83,38.20826855827664,-109.3763986
71306,4,45,11,8,13,1,82,38.20826855827664,-109.3761291
71307,4,48,11,8,13,1,85,38.20826855827664,-109.3758596
71308,5,48,12,7,13,1,86,38.20826855827664,-109.3755901
71309,7,45,13,9,15,1,90,38.20826855827664,-109.3753206
71310,8,42,13,10,13,1,87,38.20826855827664,-109.3750512
71311,8,44,13,10,13,1,89,38.20826855827664,-109.3747817
71312,6,47,12,9,14,1,89,38.20826855827664,-109.3745122
71313,6,36,9,11,12,1,75,38.20826855827664,-109.3742427
71314,6,31,9,15,5,0,66,38.20826855827664,-109.3739732
71315,5,37,9,16,11,0,78,38.20826855827664,-109.3737037
71316,5,42,16,8,15,2,88,38.20799906369141,-109.4135889
71317,5,44,16,8,15,2,90,38.20799906369141,-109.4133194
71318,5,46,16,8,15,1,91,38.20799906369141,-109.4130499
71319,6,45,16,9,15,1,92,38.20799906369141,-109.4127804
71320,7,45,16,9,16,1,94,38.20799906369141,-109.4125109
71321,7,45,16,8,16,0,92,38.20799906369141,-109.4122414
71322,9,45,15,8,16,0,93,38.20799906369141,-109.4119719
71323,10,43,15,8,16,0,92,38.20799906369141,-109.4117024
71324,8,43,15,9,15,1,91,38.20799906369141,-109.4114329
71325,7,44,15,9,15,1,91,38.20799906369141,-109.4111634
71326,6,44,15,8,15,2,90,38.20799906369141,-109.4108939
71327,6,42,15,8,14,3,88,38.20799906369141,-109.4106244
71328,5,40,15,9,14,3,86,38.20799906369141,-109.4103549
71329,5,42,16,9,16,2,90,38.20799906369141,-109.4100855
71330,6,43,16,10,17,1,93,38.20799906369141,-109.409816
71331,6,43,15,10,16,1,91,38.20799906369141,-109.4095465
71332,8,43,15,10,16,1,93,38.20799906369141,-109.409277
71333,7,44,15,9,17,0,92,38.20799906369141,-109.4090075
71334,6,44,16,9,16,1,92,38.20799906369141,-109.408738
71335,6,43,16,10,16,1,92,38.20799906369141,-109.4084685
71336,7,43,16,10,16,1,93,38.20799906369141,-109.408199
71337,8,43,16,9,16,0,92,38.20799906369141,-109.4079295
71338,9,42,16,10,15,0,92,38.20799906369141,-109.40766
71339,9,41,16,10,15,1,92,38.20799906369141,-109.4073905
71340,8,41,17,10,15,1,92,38.20799906369141,-109.407121
71341,8,43,16,10,15,1,93,38.20799906369141,-109.4068515
71342,7,43,16,9,15,2,92,38.20799906369141,-109.406582
71343,7,43,16,8,16,1,91,38.20799906369141,-109.4063125
71344,7,43,16,9,17,1,93,38.20799906369141,-109.406043
71345,8,42,15,10,17,0,92,38.20799906369141,-109.4057735
71346,9,42,14,10,17,0,92,38.20799906369141,-109.405504
71347,10,42,14,10,17,0,93,38.20799906369141,-109.4052345
71348,9,42,14,11,16,0,92,38.20799906369141,-109.4049651
71349,9,43,14,11,16,0,93,38.20799906369141,-109.4046956
71350,9,43,14,10,16,0,92,38.20799906369141,-109.4044261
71351,9,43,15,9,17,0,93,38.20799906369141,-109.4041566
71352,9,42,15,9,16,0,91,38.20799906369141,-109.4038871
71353,8,40,15,9,16,1,89,38.20799906369141,-109.4036176
71354,8,39,14,10,16,1,88,38.20799906369141,-109.4033481
71355,8,39,14,10,16,1,88,38.20799906369141,-109.4030786
71356,8,38,14,11,15,1,87,38.20799906369141,-109.4028091
71357,7,37,13,11,15,1,84,38.20799906369141,-109.4025396
71358,8,37,13,11,15,1,85,38.20799906369141,-109.4022701
71359,9,37,13,10,15,1,85,38.20799906369141,-109.4020006
71360,7,37,13,10,15,2,84,38.20799906369141,-109.4017311
71361,9,38,14,10,16,1,88,38.20799906369141,-109.4014616
71362,10,39,14,10,16,1,90,38.20799906369141,-109.4011921
71363,10,40,14,10,16,0,90,38.20799906369141,-109.4009226
71364,9,40,14,10,16,0,89,38.20799906369141,-109.4006531
71365,9,39,14,10,16,1,89,38.20799906369141,-109.4003836
71366,10,39,14,10,16,1,90,38.20799906369141,-109.4001142
71367,10,38,14,11,16,1,90,38.20799906369141,-109.3998447
71368,10,37,14,11,16,1,89,38.20799906369141,-109.3995752
71369,10,37,14,11,16,1,89,38.20799906369141,-109.3993057
71370,9,37,13,11,16,1,87,38.20799906369141,-109.3990362
71371,10,37,13,12,15,1,88,38.20799906369141,-109.3987667
71372,12,35,13,11,15,1,87,38.20799906369141,-109.3984972
71373,14,35,13,11,15,0,88,38.20799906369141,-109.3982277
71374,12,36,13,11,15,0,87,38.20799906369141,-109.3979582
71375,11,36,13,11,15,1,87,38.20799906369141,-109.3976887
71376,13,36,13,10,15,0,87,38.20799906369141,-109.3974192
71377,14,36,12,10,15,0,87,38.20799906369141,-109.3971497
71378,14,34,12,10,15,0,85,38.20799906369141,-109.3968802
71379,12,32,12,9,14,1,80,38.20799906369141,-109.3966107
71380,6,32,11,9,14,2,74,38.20799906369141,-109.3963412
71381,3,35,10,7,13,3,71,38.20799906369141,-109.3960717
71382,2,36,10,6,14,4,72,38.20799906369141,-109.3958022
71383,2,35,11,5,15,5,73,38.20799906369141,-109.3955327
71384,1,37,10,2,13,8,71,38.20799906369141,-109.3952632
71385,1,38,10,2,12,7,70,38.20799906369141,-109.3949938
71386,1,24,11,5,9,10,60,38.20799906369141,-109.3947243
71387,4,24,13,13,12,7,73,38.20799906369141,-109.3944548
71388,6,32,13,17,18,3,89,38.20799906369141,-109.3941853
71389,3,25,12,18,24,4,86,38.20799906369141,-109.3939158
71390,3,21,10,21,29,3,87,38.20799906369141,-109.3936463
71391,3,19,9,25,25,6,87,38.20799906369141,-109.3933768
71392,4,20,10,22,29,3,88,38.20799906369141,-109.3931073
71393,5,22,11,24,25,2,89,38.20799906369141,-109.3928378
71394,8,25,10,23,23,1,90,38.20799906369141,-109.3925683
71395,13,26,9,22,21,0,91,38.20799906369141,-109.3922988
71396,12,24,8,25,22,0,91,38.20799906369141,-109.3920293
71397,6,20,8,29,25,2,90,38.20799906369141,-109.3917598
71398,3,19,9,26,27,5,89,38.20799906369141,-109.3914903
71399,2,20,9,30,26,2,89,38.20799906369141,-109.3912208
71400,2,21,9,31,25,2,90,38.20799906369141,-109.3909513
71401,5,19,8,30,26,3,91,38.20799906369141,-109.3906818
71402,8,16,7,31,26,4,92,38.20799906369141,-109.3904123
71403,6,16,9,27,31,2,91,38.20799906369141,-109.3901429
71404,8,18,10,22,31,2,91,38.20799906369141,-109.3898734
71405,5,21,11,21,28,3,89,38.20799906369141,-109.3896039
71406,3,22,12,20,25,4,86,38.20799906369141,-109.3893344
71407,3,21,12,20,25,4,85,38.20799906369141,-109.3890649
71408,6,27,12,19,20,3,87,38.20799906369141,-109.3887954
71409,4,34,12,19,20,1,90,38.20799906369141,-109.3885259
71410,4,37,12,18,17,0,88,38.20799906369141,-109.3882564
71411,6,36,11,17,16,0,86,38.20799906369141,-109.3879869
71412,5,33,11,22,17,0,88,38.20799906369141,-109.3877174
71413,9,30,11,21,18,1,90,38.20799906369141,-109.3874479
71414,11,32,11,19,17,1,91,38.20799906369141,-109.3871784
71415,12,33,11,18,16,1,91,38.20799906369141,-109.3869089
71416,14,30,11,17,16,1,89,38.20799906369141,-109.3866394
71417,19,25,10,15,20,2,91,38.20799906369141,-109.3863699
71418,16,24,10,17,22,3,92,38.20799906369141,-109.3861004
71419,12,23,11,19,23,3,91,38.20799906369141,-109.3858309
71420,12,23,10,20,21,3,89,38.20799906369141,-109.3855614
71421,20,25,11,18,14,2,90,38.20799906369141,-109.3852919
71422,21,24,11,15,14,3,88,38.20799906369141,-109.3850225
71423,20,26,11,13,13,3,86,38.20799906369141,-109.384753
71424,18,27,10,11,12,2,80,38.20799906369141,-109.3844835
71425,20,25,10,13,11,2,81,38.20799906369141,-109.384214
71426,24,23,11,16,11,2,87,38.20799906369141,-109.3839445
71427,4,22,10,15,14,4,69,38.20799906369141,-109.383675
71428,2,31,9,12,13,3,70,38.20799906369141,-109.3834055
71429,3,45,9,12,11,1,81,38.20799906369141,-109.383136
71430,4,48,11,14,12,1,90,38.20799906369141,-109.3828665
71431,5,50,13,14,12,0,94,38.20799906369141,-109.382597
71432,6,46,14,15,13,1,95,38.20799906369141,-109.3823275
71433,7,44,14,14,14,0,93,38.20799906369141,-109.382058
71434,7,44,14,12,16,0,93,38.20799906369141,-109.3817885
71435,12,42,14,10,15,0,93,38.20799906369141,-109.381519
71436,7,45,14,12,15,0,93,38.20799906369141,-109.3812495
71437,5,45,14,10,15,1,90,38.20799906369141,-109.38098
71438,4,45,13,9,16,1,88,38.20799906369141,-109.3807105
71439,5,45,14,9,16,1,90,38.20799906369141,-109.380441
71440,5,45,14,10,17,0,91,38.20799906369141,-109.3801716
71441,7,45,14,9,17,0,92,38.20799906369141,-109.3799021
71442,8,43,14,10,17,0,92,38.20799906369141,-109.3796326
71443,9,41,14,11,16,0,91,38.20799906369141,-109.3793631
71444,11,41,14,11,15,0,92,38.20799906369141,-109.3790936
71445,9,41,14,10,16,0,90,38.20799906369141,-109.3788241
71446,7,41,13,9,14,1,85,38.20799906369141,-109.3785546
71447,6,39,12,9,14,1,81,38.20799906369141,-109.3782851
71448,5,41,12,8,13,2,81,38.20799906369141,-109.3780156
71449,4,48,10,8,13,1,84,38.20799906369141,-109.3777461
71450,4,48,10,8,13,2,85,38.20799906369141,-109.3774766
71451,4,45,11,8,13,2,83,38.20799906369141,-109.3772071
71452,5,43,11,9,13,2,83,38.20799906369141,-109.3769376
71453,5,44,11,8,12,2,82,38.20799906369141,-109.3766681
71454,4,48,10,6,12,2,82,38.20799906369141,-109.3763986
71455,3,50,10,8,13,1,85,38.20799906369141,-109.3761291
71456,4,49,11,8,14,1,87,38.20799906369141,-109.3758596
71457,5,46,12,8,15,1,87,38.20799906369141,-109.3755901
71458,6,42,13,10,15,1,87,38.20799906369141,-109.3753206
71459,7,44,13,10,14,1,89,38.20799906369141,-109.3750512
71460,7,45,13,9,14,1,89,38.20799906369141,-109.3747817
71461,8,46,12,9,14,0,89,38.20799906369141,-109.3745122
71462,7,37,9,11,11,1,76,38.20799906369141,-109.3742427
71463,5,33,9,16,6,0,69,38.20799906369141,-109.3739732
71464,6,41,11,15,12,0,85,38.20799906369141,-109.3737037
71465,7,46,15,8,15,1,92,38.20772956910618,-109.4127804
71466,8,44,15,9,15,1,92,38.20772956910618,-109.4125109
71467,8,44,15,9,15,0,91,38.20772956910618,-109.4122414
71468,9,45,15,8,16,0,93,38.20772956910618,-109.4119719
71469,9,44,15,9,16,0,93,38.20772956910618,-109.4117024
71470,8,43,15,9,16,0,91,38.20772956910618,-109.4114329
71471,7,43,15,9,16,0,90,38.20772956910618,-109.4111634
71472,6,44,15,8,16,1,90,38.20772956910618,-109.4108939
71473,6,44,15,8,16,1,90,38.20772956910618,-109.4106244
71474,7,44,16,10,16,1,94,38.20772956910618,-109.4103549
71475,8,43,16,10,16,0,93,38.20772956910618,-109.4100855
71476,7,42,15,10,17,0,91,38.20772956910618,-109.409816
71477,7,43,15,10,17,0,92,38.20772956910618,-109.4095465
71478,7,43,15,10,16,1,92,38.20772956910618,-109.409277
71479,6,42,16,9,15,2,90,38.20772956910618,-109.4090075
71480,6,43,16,10,15,1,91,38.20772956910618,-109.408738
71481,7,42,16,10,16,1,92,38.20772956910618,-109.4084685
71482,7,42,16,10,16,1,92,38.20772956910618,-109.408199
71483,8,42,16,10,16,0,92,38.20772956910618,-109.4079295
71484,8,42,16,10,16,0,92,38.20772956910618,-109.40766
71485,8,42,16,10,16,1,93,38.20772956910618,-109.4073905
71486,7,41,16,9,16,1,90,38.20772956910618,-109.407121
71487,7,43,16,9,16,1,92,38.20772956910618,-109.4068515
71488,6,43,17,8,16,1,91,38.20772956910618,-109.406582
71489,7,44,17,9,16,1,94,38.20772956910618,-109.4063125
71490,7,43,16,9,16,0,91,38.20772956910618,-109.406043
71491,8,43,15,10,17,0,93,38.20772956910618,-109.4057735
71492,7,43,15,9,17,0,91,38.20772956910618,-109.405504
71493,8,43,14,9,17,0,91,38.20772956910618,-109.4052345
71494,8,43,15,10,17,0,93,38.20772956910618,-109.4049651
71495,7,43,15,10,17,0,92,38.20772956910618,-109.4046956
71496,7,43,15,9,17,0,91,38.20772956910618,-109.4044261
71497,7,43,16,9,17,1,93,38.20772956910618,-109.4041566
71498,7,43,15,8,16,1,90,38.20772956910618,-109.4038871
71499,7,43,15,8,16,1,90,38.20772956910618,-109.4036176
71500,6,42,15,8,16,1,88,38.20772956910618,-109.4033481
71501,5,41,14,8,16,2,86,38.20772956910618,-109.4030786
71502,6,40,14,9,15,1,85,38.20772956910618,-109.4028091
71503,6,39,14,10,15,1,85,38.20772956910618,-109.4025396
71504,7,39,14,11,15,1,87,38.20772956910618,-109.4022701
71505,9,40,14,11,15,1,90,38.20772956910618,-109.4020006
71506,9,39,14,10,15,1,88,38.20772956910618,-109.4017311
71507,8,39,14,10,16,1,88,38.20772956910618,-109.4014616
71508,9,39,14,10,16,1,89,38.20772956910618,-109.4011921
71509,9,39,14,11,16,0,89,38.20772956910618,-109.4009226
71510,9,39,14,11,17,0,90,38.20772956910618,-109.4006531
71511,9,39,14,10,16,1,89,38.20772956910618,-109.4003836
71512,9,39,14,11,16,1,90,38.20772956910618,-109.4001142
71513,9,39,14,11,17,1,91,38.20772956910618,-109.3998447
71514,9,38,14,11,16,1,89,38.20772956910618,-109.3995752
71515,9,37,14,12,16,1,89,38.20772956910618,-109.3993057
71516,10,38,14,11,15,1,89,38.20772956910618,-109.3990362
71517,10,37,13,12,15,1,88,38.20772956910618,-109.3987667
71518,11,37,13,11,15,1,88,38.20772956910618,-109.3984972
71519,14,36,13,11,15,0,89,38.20772956910618,-109.3982277
71520,14,35,13,11,14,0,87,38.20772956910618,-109.3979582
71521,12,36,13,12,15,0,88,38.20772956910618,-109.3976887
71522,12,36,13,11,15,0,87,38.20772956910618,-109.3974192
71523,12,35,12,9,15,1,84,38.20772956910618,-109.3971497
71524,12,33,12,9,15,1,82,38.20772956910618,-109.3968802
71525,9,32,12,9,14,2,78,38.20772956910618,-109.3966107
71526,6,34,11,7,14,3,75,38.20772956910618,-109.3963412
71527,3,33,11,7,13,4,71,38.20772956910618,-109.3960717
71528,5,35,11,7,15,3,76,38.20772956910618,-109.3958022
71529,6,35,11,9,17,1,79,38.20772956910618,-109.3955327
71530,3,41,11,6,17,1,79,38.20772956910618,-109.3952632
71531,1,42,9,2,14,5,73,38.20772956910618,-109.3949938
71532,1,33,9,4,10,7,64,38.20772956910618,-109.3947243
71533,4,24,12,12,10,7,69,38.20772956910618,-109.3944548
71534,3,25,14,20,17,5,84,38.20772956910618,-109.3941853
71535,3,25,14,19,21,5,87,38.20772956910618,-109.3939158
71536,2,23,12,20,27,3,87,38.20772956910618,-109.3936463
71537,3,21,11,20,29,3,87,38.20772956910618,-109.3933768
71538,3,21,11,21,28,4,88,38.20772956910618,-109.3931073
71539,2,21,11,22,28,3,87,38.20772956910618,-109.3928378
71540,4,24,10,23,25,2,88,38.20772956910618,-109.3925683
71541,4,25,10,23,26,1,89,38.20772956910618,-109.3922988
71542,2,24,9,26,27,1,89,38.20772956910618,-109.3920293
71543,2,23,8,29,25,1,88,38.20772956910618,-109.3917598
71544,4,23,7,31,24,2,91,38.20772956910618,-109.3914903
71545,3,23,9,27,27,1,90,38.20772956910618,-109.3912208
71546,3,24,9,23,28,1,88,38.20772956910618,-109.3909513
71547,3,23,8,26,27,1,88,38.20772956910618,-109.3906818
71548,6,21,9,27,26,2,91,38.20772956910618,-109.3904123
71549,6,20,10,25,28,2,91,38.20772956910618,-109.3901429
71550,7,19,10,23,28,2,89,38.20772956910618,-109.3898734
71551,6,20,10,23,27,2,88,38.20772956910618,-109.3896039
71552,4,22,12,22,24,3,87,38.20772956910618,-109.3893344
71553,5,22,12,18,22,5,84,38.20772956910618,-109.3890649
71554,3,25,12,25,20,4,89,38.20772956910618,-109.3887954
71555,3,29,12,22,21,3,90,38.20772956910618,-109.3885259
71556,3,33,12,15,22,3,88,38.20772956910618,-109.3882564
71557,3,32,12,16,22,3,88,38.20772956910618,-109.3879869
71558,5,28,11,21,21,3,89,38.20772956910618,-109.3877174
71559,6,27,11,22,20,3,89,38.20772956910618,-109.3874479
71560,10,27,11,22,18,2,90,38.20772956910618,-109.3871784
71561,10,31,11,19,17,1,89,38.20772956910618,-109.3869089
71562,9,36,12,18,16,0,91,38.20772956910618,-109.3866394
71563,9,35,12,18,16,0,90,38.20772956910618,-109.3863699
71564,10,31,12,17,19,1,90,38.20772956910618,-109.3861004
71565,12,28,11,19,19,2,91,38.20772956910618,-109.3858309
71566,17,24,10,20,18,1,90,38.20772956910618,-109.3855614
71567,21,26,10,18,16,1,92,38.20772956910618,-109.3852919
71568,22,22,11,16,17,2,90,38.20772956910618,-109.3850225
71569,21,23,10,14,14,2,84,38.20772956910618,-109.384753
71570,19,23,9,11,12,2,76,38.20772956910618,-109.3844835
71571,20,20,8,8,10,3,69,38.20772956910618,-109.384214
71572,35,19,9,8,9,2,82,38.20772956910618,-109.3839445
71573,19,14,11,19,14,4,81,38.20772956910618,-109.383675
71574,5,21,10,17,14,5,72,38.20772956910618,-109.3834055
71575,2,37,9,10,14,3,75,38.20772956910618,-109.383136
71576,3,53,9,11,10,0,86,38.20772956910618,-109.3828665
71577,4,52,12,14,12,0,94,38.20772956910618,-109.382597
71578,5,48,13,15,13,0,94,38.20772956910618,-109.3823275
71579,6,45,14,14,14,0,93,38.20772956910618,-109.382058
71580,7,45,14,12,14,1,93,38.20772956910618,-109.3817885
71581,11,42,14,11,14,0,92,38.20772956910618,-109.381519
71582,11,42,14,12,14,0,93,38.20772956910618,-109.3812495
71583,9,44,14,11,15,0,93,38.20772956910618,-109.38098
71584,6,46,14,10,16,0,92,38.20772956910618,-109.3807105
71585,6,46,14,10,16,0,92,38.20772956910618,-109.380441
71586,8,44,13,10,16,0,91,38.20772956910618,-109.3801716
71587,8,42,13,10,17,0,90,38.20772956910618,-109.3799021
71588,8,42,14,11,17,0,92,38.20772956910618,-109.3796326
71589,9,42,14,11,16,0,92,38.20772956910618,-109.3793631
71590,8,43,13,10,15,0,89,38.20772956910618,-109.3790936
71591,7,43,12,9,14,1,86,38.20772956910618,-109.3788241
71592,6,42,12,9,13,1,83,38.20772956910618,-109.3785546
71593,6,40,12,9,13,1,81,38.20772956910618,-109.3782851
71594,5,43,11,8,13,1,81,38.20772956910618,-109.3780156
71595,3,51,10,7,13,1,85,38.20772956910618,-109.3777461
71596,3,52,10,7,13,1,86,38.20772956910618,-109.3774766
71597,4,49,10,7,13,2,85,38.20772956910618,-109.3772071
71598,4,47,10,7,13,2,83,38.20772956910618,-109.3769376
71599,3,49,10,6,12,2,82,38.20772956910618,-109.3766681
71600,3,53,9,5,12,2,84,38.20772956910618,-109.3763986
71601,3,48,10,8,13,1,83,38.20772956910618,-109.3761291
71602,5,49,11,9,14,1,89,38.20772956910618,-109.3758596
71603,6,47,12,9,14,1,89,38.20772956910618,-109.3755901
71604,5,44,12,9,14,1,85,38.20772956910618,-109.3753206
71605,5,50,11,8,12,1,87,38.20772956910618,-109.3750512
71606,6,49,11,8,12,1,87,38.20772956910618,-109.3747817
71607,7,46,11,8,14,0,86,38.20772956910618,-109.3745122
71608,8,37,9,11,10,0,75,38.20772956910618,-109.3742427
71609,4,36,8,14,4,0,66,38.20772956910618,-109.3739732
71610,7,47,10,12,11,0,87,38.20772956910618,-109.3737037
71611,8,43,15,9,16,1,92,38.20746007452094,-109.4119719
71612,6,43,16,10,17,1,93,38.20746007452094,-109.4117024
71613,7,43,15,9,17,0,91,38.20746007452094,-109.4114329
71614,7,43,15,9,16,1,91,38.20746007452094,-109.4111634
71615,6,44,15,9,16,1,91,38.20746007452094,-109.4108939
71616,7,44,15,9,15,1,91,38.20746007452094,-109.4106244
71617,6,44,16,9,16,1,92,38.20746007452094,-109.4103549
71618,8,43,15,10,16,0,92,38.20746007452094,-109.4100855
71619,9,42,15,11,16,0,93,38.20746007452094,-109.409816
71620,8,42,15,10,16,0,91,38.20746007452094,-109.4095465
71621,8,43,15,9,15,1,91,38.20746007452094,-109.409277
71622,7,43,16,9,15,1,91,38.20746007452094,-109.4090075
71623,7,42,15,9,16,1,90,38.20746007452094,-109.408738
71624,7,42,15,10,17,0,91,38.20746007452094,-109.4084685
71625,8,41,15,11,16,0,91,38.20746007452094,-109.408199
71626,9,40,15,10,16,0,90,38.20746007452094,-109.4079295
71627,9,42,15,10,16,0,92,38.20746007452094,-109.40766
71628,8,42,16,10,17,0,93,38.20746007452094,-109.4073905
71629,7,41,16,10,16,1,91,38.20746007452094,-109.407121
71630,6,40,16,10,16,1,89,38.20746007452094,-109.4068515
71631,6,41,17,9,16,1,90,38.20746007452094,-109.406582
71632,6,42,16,9,16,1,90,38.20746007452094,-109.4063125
71633,7,42,16,10,17,0,92,38.20746007452094,-109.406043
71634,8,42,15,10,17,0,92,38.20746007452094,-109.4057735
71635,9,43,15,10,17,0,94,38.20746007452094,-109.405504
71636,7,43,15,10,17,0,92,38.20746007452094,-109.4052345
71637,7,43,15,9,16,1,91,38.20746007452094,-109.4049651
71638,7,43,15,9,17,1,92,38.20746007452094,-109.4046956
71639,7,44,15,8,17,1,92,38.20746007452094,-109.4044261
71640,5,44,15,8,17,1,90,38.20746007452094,-109.4041566
71641,6,43,15,7,16,1,88,38.20746007452094,-109.4038871
71642,7,43,15,8,16,1,90,38.20746007452094,-109.4036176
71643,7,43,15,8,16,1,90,38.20746007452094,-109.4033481
71644,6,43,15,8,16,1,89,38.20746007452094,-109.4030786
71645,7,43,15,9,16,1,91,38.20746007452094,-109.4028091
71646,7,42,15,9,16,0,89,38.20746007452094,-109.4025396
71647,8,41,15,10,15,0,89,38.20746007452094,-109.4022701
71648,9,41,14,11,15,0,90,38.20746007452094,-109.4020006
71649,10,40,14,10,15,1,90,38.20746007452094,-109.4017311
71650,10,41,14,10,16,0,91,38.20746007452094,-109.4014616
71651,10,41,14,10,16,0,91,38.20746007452094,-109.4011921
71652,9,41,14,10,17,0,91,38.20746007452094,-109.4009226
71653,10,40,14,10,17,0,91,38.20746007452094,-109.4006531
71654,11,39,14,11,16,0,91,38.20746007452094,-109.4003836
71655,8,38,14,12,16,1,89,38.20746007452094,-109.4001142
71656,8,39,14,11,16,1,89,38.20746007452094,-109.3998447
71657,9,38,14,11,16,1,89,38.20746007452094,-109.3995752
71658,9,37,14,12,16,1,89,38.20746007452094,-109.3993057
71659,12,37,13,12,15,0,89,38.20746007452094,-109.3990362
71660,9,36,13,12,15,1,86,38.20746007452094,-109.3987667
71661,10,37,13,11,15,1,87,38.20746007452094,-109.3984972
71662,12,37,14,11,15,0,89,38.20746007452094,-109.3982277
71663,15,35,14,12,14,0,90,38.20746007452094,-109.3979582
71664,16,35,14,12,13,0,90,38.20746007452094,-109.3976887
71665,13,36,13,12,14,0,88,38.20746007452094,-109.3974192
71666,11,36,12,10,15,1,85,38.20746007452094,-109.3971497
71667,11,36,12,9,15,1,84,38.20746007452094,-109.3968802
71668,10,34,13,9,14,1,81,38.20746007452094,-109.3966107
71669,9,32,13,9,14,2,79,38.20746007452094,-109.3963412
71670,7,34,12,10,15,2,80,38.20746007452094,-109.3960717
71671,9,36,12,11,16,1,85,38.20746007452094,-109.3958022
71672,12,37,13,11,16,0,89,38.20746007452094,-109.3955327
71673,8,37,11,10,15,1,82,38.20746007452094,-109.3952632
71674,2,43,10,3,15,3,76,38.20746007452094,-109.3949938
71675,1,39,10,3,12,5,70,38.20746007452094,-109.3947243
71676,2,30,10,8,11,7,68,38.20746007452094,-109.3944548
71677,3,21,12,17,10,6,69,38.20746007452094,-109.3941853
71678,2,25,14,15,15,9,80,38.20746007452094,-109.3939158
71679,2,27,13,18,19,5,84,38.20746007452094,-109.3936463
71680,2,24,12,20,24,4,86,38.20746007452094,-109.3933768
71681,2,21,12,19,29,4,87,38.20746007452094,-109.3931073
71682,3,18,11,20,28,5,85,38.20746007452094,-109.3928378
71683,3,21,10,22,27,3,86,38.20746007452094,-109.3925683
71684,3,23,10,23,28,2,89,38.20746007452094,-109.3922988
71685,2,24,9,24,28,2,89,38.20746007452094,-109.3920293
71686,2,23,9,24,26,3,87,38.20746007452094,-109.3917598
71687,3,23,9,25,25,3,88,38.20746007452094,-109.3914903
71688,2,24,10,21,28,2,87,38.20746007452094,-109.3912208
71689,1,25,10,20,29,2,87,38.20746007452094,-109.3909513
71690,2,25,10,21,29,2,89,38.20746007452094,-109.3906818
71691,2,24,10,20,29,3,88,38.20746007452094,-109.3904123
71692,4,22,10,22,28,3,89,38.20746007452094,-109.3901429
71693,5,21,11,21,28,3,89,38.20746007452094,-109.3898734
71694,5,20,11,19,28,3,86,38.20746007452094,-109.3896039
71695,4,22,12,18,27,3,86,38.20746007452094,-109.3893344
71696,6,26,12,20,20,3,87,38.20746007452094,-109.3890649
71697,4,28,12,20,19,3,86,38.20746007452094,-109.3887954
71698,4,28,12,17,20,4,85,38.20746007452094,-109.3885259
71699,3,30,13,13,21,6,86,38.20746007452094,-109.3882564
71700,2,30,13,13,20,7,85,38.20746007452094,-109.3879869
71701,3,25,12,18,21,5,84,38.20746007452094,-109.3877174
71702,3,23,13,19,21,6,85,38.20746007452094,-109.3874479
71703,5,25,13,20,20,4,87,38.20746007452094,-109.3871784
71704,6,27,12,21,19,3,88,38.20746007452094,-109.3869089
71705,6,32,12,19,18,1,88,38.20746007452094,-109.3866394
71706,5,37,13,18,16,0,89,38.20746007452094,-109.3863699
71707,6,34,13,17,18,1,89,38.20746007452094,-109.3861004
71708,10,31,12,15,20,1,89,38.20746007452094,-109.3858309
71709,19,28,10,16,16,1,90,38.20746007452094,-109.3855614
71710,30,30,9,14,13,0,96,38.20746007452094,-109.3852919
71711,31,24,8,13,14,1,91,38.20746007452094,-109.3850225
71712,27,22,8,12,14,1,84,38.20746007452094,-109.384753
71713,24,19,8,10,14,2,77,38.20746007452094,-109.3844835
71714,22,15,6,9,15,4,71,38.20746007452094,-109.384214
71715,23,9,7,18,14,5,76,38.20746007452094,-109.3839445
71716,21,13,9,23,13,8,87,38.20746007452094,-109.383675
71717,13,15,12,20,13,6,79,38.20746007452094,-109.3834055
71718,3,26,11,14,14,5,73,38.20746007452094,-109.383136
71719,2,45,9,9,13,1,79,38.20746007452094,-109.3828665
71720,3,53,10,9,13,0,88,38.20746007452094,-109.382597
71721,4,48,11,13,13,0,89,38.20746007452094,-109.3823275
71722,5,46,12,12,14,0,89,38.20746007452094,-109.382058
71723,6,46,14,11,14,1,92,38.20746007452094,-109.3817885
71724,9,44,14,11,15,1,94,38.20746007452094,-109.381519
71725,12,42,14,12,14,0,94,38.20746007452094,-109.3812495
71726,11,42,14,12,14,0,93,38.20746007452094,-109.38098
71727,9,43,14,10,16,0,92,38.20746007452094,-109.3807105
71728,7,43,14,10,17,1,92,38.20746007452094,-109.380441
71729,8,41,14,10,17,1,91,38.20746007452094,-109.3801716
71730,7,40,13,10,16,1,87,38.20746007452094,-109.3799021
71731,6,41,13,11,15,1,87,38.20746007452094,-109.3796326
71732,4,41,12,10,14,1,82,38.20746007452094,-109.3793631
71733,4,42,11,7,13,2,79,38.20746007452094,-109.3790936
71734,4,46,10,8,13,1,82,38.20746007452094,-109.3788241
71735,4,45,11,8,13,1,82,38.20746007452094,-109.3785546
71736,5,42,11,8,12,2,80,38.20746007452094,-109.3782851
71737,5,41,12,8,12,2,80,38.20746007452094,-109.3780156
71738,3,46,10,7,12,2,80,38.20746007452094,-109.3777461
71739,3,51,10,6,13,2,85,38.20746007452094,-109.3774766
71740,4,48,11,7,12,2,84,38.20746007452094,-109.3772071
71741,4,47,11,7,12,2,83,38.20746007452094,-109.3769376
71742,3,50,10,5,12,2,82,38.20746007452094,-109.3766681
71743,2,52,9,5,13,2,83,38.20746007452094,-109.3763986
71744,3,48,10,8,14,1,84,38.20746007452094,-109.3761291
71745,5,50,10,9,14,1,89,38.20746007452094,-109.3758596
71746,5,52,10,8,13,1,89,38.20746007452094,-109.3755901
71747,4,51,10,7,13,1,86,38.20746007452094,-109.3753206
71748,4,55,10,7,12,1,89,38.20746007452094,-109.3750512
71749,4,54,10,7,12,2,89,38.20746007452094,-109.3747817
71750,6,46,10,9,13,1,85,38.20746007452094,-109.3745122
71751,6,37,9,14,9,0,75,38.20746007452094,-109.3742427
71752,3,40,8,16,3,0,70,38.20746007452094,-109.3739732
71753,5,53,9,12,10,0,89,38.20746007452094,-109.3737037
71754,6,42,16,10,16,1,91,38.20719058,-109.4114329
71755,6,42,15,10,16,1,90,38.20719058,-109.4111634
71756,5,41,15,10,16,1,88,38.20719058,-109.4108939
71757,5,41,15,9,16,2,88,38.20719058,-109.4106244
71758,5,42,16,10,16,1,90,38.20719058,-109.4103549
71759,7,43,15,10,16,1,92,38.20719058,-109.4100855
71760,7,43,15,10,16,1,92,38.20719058,-109.409816
71761,7,43,15,10,16,1,92,38.20719058,-109.4095465
71762,6,43,15,10,16,1,91,38.20719058,-109.409277
71763,8,43,16,9,16,0,92,38.20719058,-109.4090075
71764,9,42,15,10,17,0,93,38.20719058,-109.408738
71765,10,40,15,11,16,0,92,38.20719058,-109.4084685
71766,10,40,15,11,16,0,92,38.20719058,-109.408199
71767,9,39,15,12,16,0,91,38.20719058,-109.4079295
71768,10,41,15,10,16,0,92,38.20719058,-109.40766
71769,9,42,16,10,17,0,94,38.20719058,-109.4073905
71770,8,42,16,10,17,0,93,38.20719058,-109.407121
71771,8,41,16,11,16,0,92,38.20719058,-109.4068515
71772,7,42,16,10,16,1,92,38.20719058,-109.406582
71773,7,42,16,11,16,0,92,38.20719058,-109.4063125
71774,7,42,15,11,17,0,92,38.20719058,-109.406043
71775,8,42,15,10,17,0,92,38.20719058,-109.4057735
71776,7,43,15,11,17,0,93,38.20719058,-109.405504
71777,6,42,15,11,16,0,90,38.20719058,-109.4052345
71778,5,42,15,10,16,1,89,38.20719058,-109.4049651
71779,6,43,15,9,16,1,90,38.20719058,-109.4046956
71780,8,44,15,8,16,0,91,38.20719058,-109.4044261
71781,6,42,14,8,16,1,87,38.20719058,-109.4041566
71782,6,42,15,8,16,1,88,38.20719058,-109.4038871
71783,7,42,15,9,16,1,90,38.20719058,-109.4036176
71784,8,43,15,9,16,0,91,38.20719058,-109.4033481
71785,8,44,14,9,15,0,90,38.20719058,-109.4030786
71786,7,44,15,9,15,0,90,38.20719058,-109.4028091
71787,6,42,15,9,15,1,88,38.20719058,-109.4025396
71788,7,41,15,10,15,1,89,38.20719058,-109.4022701
71789,8,41,14,11,15,1,90,38.20719058,-109.4020006
71790,9,40,14,11,15,1,90,38.20719058,-109.4017311
71791,10,42,14,11,15,0,92,38.20719058,-109.4014616
71792,10,42,14,10,16,0,92,38.20719058,-109.4011921
71793,10,42,14,10,16,0,92,38.20719058,-109.4009226
71794,10,41,14,9,16,0,90,38.20719058,-109.4006531
71795,12,40,14,10,16,0,92,38.20719058,-109.4003836
71796,10,39,14,11,16,0,90,38.20719058,-109.4001142
71797,10,37,14,12,16,0,89,38.20719058,-109.3998447
71798,10,37,14,12,16,1,90,38.20719058,-109.3995752
71799,9,37,14,12,15,1,88,38.20719058,-109.3993057
71800,13,36,13,12,15,1,90,38.20719058,-109.3990362
71801,10,37,13,12,15,1,88,38.20719058,-109.3987667
71802,10,38,14,11,15,1,89,38.20719058,-109.3984972
71803,12,38,14,11,16,0,91,38.20719058,-109.3982277
71804,12,37,14,12,16,0,91,38.20719058,-109.3979582
71805,15,36,14,13,14,0,92,38.20719058,-109.3976887
71806,14,36,13,12,14,0,89,38.20719058,-109.3974192
71807,14,36,13,11,15,0,89,38.20719058,-109.3971497
71808,14,36,13,11,15,0,89,38.20719058,-109.3968802
71809,14,34,13,12,15,0,88,38.20719058,-109.3966107
71810,16,31,13,11,15,1,87,38.20719058,-109.3963412
71811,10,34,13,11,16,1,85,38.20719058,-109.3960717
71812,8,37,13,11,17,0,86,38.20719058,-109.3958022
71813,9,37,13,11,17,0,87,38.20719058,-109.3955327
71814,8,37,12,11,15,1,84,38.20719058,-109.3952632
71815,3,35,11,6,16,3,74,38.20719058,-109.3949938
71816,1,37,10,3,13,5,69,38.20719058,-109.3947243
71817,1,37,10,4,11,7,70,38.20719058,-109.3944548
71818,2,32,11,9,11,5,70,38.20719058,-109.3941853
71819,0,23,10,15,11,7,66,38.20719058,-109.3939158
71820,0,22,12,19,11,7,71,38.20719058,-109.3936463
71821,2,24,13,21,16,6,82,38.20719058,-109.3933768
71822,1,21,12,23,22,5,84,38.20719058,-109.3931073
71823,1,19,12,19,28,7,86,38.20719058,-109.3928378
71824,2,20,12,18,27,6,85,38.20719058,-109.3925683
71825,2,21,10,21,27,4,85,38.20719058,-109.3922988
71826,2,21,9,23,27,5,87,38.20719058,-109.3920293
71827,1,21,9,22,26,7,86,38.20719058,-109.3917598
71828,2,20,9,24,26,7,88,38.20719058,-109.3914903
71829,2,21,9,24,27,5,88,38.20719058,-109.3912208
71830,1,23,10,23,28,3,88,38.20719058,-109.3909513
71831,1,23,10,22,29,3,88,38.20719058,-109.3906818
71832,3,22,10,22,28,3,88,38.20719058,-109.3904123
71833,3,21,10,22,28,4,88,38.20719058,-109.3901429
71834,4,21,11,22,28,4,90,38.20719058,-109.3898734
71835,5,20,11,20,28,4,88,38.20719058,-109.3896039
71836,5,21,11,19,27,4,87,38.20719058,-109.3893344
71837,5,24,11,20,22,3,85,38.20719058,-109.3890649
71838,5,28,12,19,19,3,86,38.20719058,-109.3887954
71839,3,29,13,13,19,7,84,38.20719058,-109.3885259
71840,2,31,13,11,19,8,84,38.20719058,-109.3882564
71841,2,33,13,12,20,7,87,38.20719058,-109.3879869
71842,4,28,13,15,21,4,85,38.20719058,-109.3877174
71843,3,24,12,25,19,3,86,38.20719058,-109.3874479
71844,3,26,11,24,19,3,86,38.20719058,-109.3871784
71845,4,28,12,19,19,3,85,38.20719058,-109.3869089
71846,7,32,12,14,18,2,85,38.20719058,-109.3866394
71847,6,35,12,15,17,1,86,38.20719058,-109.3863699
71848,6,35,12,18,16,1,88,38.20719058,-109.3861004
71849,8,33,12,19,16,1,89,38.20719058,-109.3858309
71850,16,31,11,18,15,1,92,38.20719058,-109.3855614
71851,29,31,9,11,12,0,92,38.20719058,-109.3852919
71852,29,25,8,13,13,2,90,38.20719058,-109.3850225
71853,29,22,7,14,15,2,89,38.20719058,-109.384753
71854,23,22,8,14,18,4,89,38.20719058,-109.3844835
71855,17,20,8,14,18,6,83,38.20719058,-109.384214
71856,14,17,10,19,16,8,84,38.20719058,-109.3839445
71857,16,17,10,20,14,8,85,38.20719058,-109.383675
71858,21,17,11,14,13,7,83,38.20719058,-109.3834055
71859,13,22,12,13,13,5,78,38.20719058,-109.383136
71860,4,33,11,9,13,3,73,38.20719058,-109.3828665
71861,2,49,9,8,13,1,82,38.20719058,-109.382597
71862,2,46,9,9,14,1,81,38.20719058,-109.3823275
71863,4,43,11,11,14,1,84,38.20719058,-109.382058
71864,6,43,12,12,14,1,88,38.20719058,-109.3817885
71865,6,45,14,13,14,1,93,38.20719058,-109.381519
71866,8,43,14,12,15,0,92,38.20719058,-109.3812495
71867,8,43,14,11,16,0,92,38.20719058,-109.38098
71868,8,42,14,11,17,1,93,38.20719058,-109.3807105
71869,7,41,14,11,16,1,90,38.20719058,-109.380441
71870,6,41,13,10,16,1,87,38.20719058,-109.3801716
71871,4,42,12,10,13,2,83,38.20719058,-109.3799021
71872,3,41,10,8,13,2,77,38.20719058,-109.3796326
71873,3,42,10,6,13,2,76,38.20719058,-109.3793631
71874,1,46,10,4,12,3,76,38.20719058,-109.3790936
71875,2,50,9,5,12,2,80,38.20719058,-109.3788241
71876,3,50,10,6,12,2,83,38.20719058,-109.3785546
71877,4,45,11,8,12,2,82,38.20719058,-109.3782851
71878,5,43,12,9,12,2,83,38.20719058,-109.3780156
71879,4,45,11,8,12,2,82,38.20719058,-109.3777461
71880,4,52,11,7,12,2,88,38.20719058,-109.3774766
71881,5,48,11,7,12,2,85,38.20719058,-109.3772071
71882,5,45,11,7,11,3,82,38.20719058,-109.3769376
71883,5,48,11,7,11,2,84,38.20719058,-109.3766681
71884,4,49,11,7,14,1,86,38.20719058,-109.3763986
71885,3,48,10,9,13,1,84,38.20719058,-109.3761291
71886,4,51,10,7,13,1,86,38.20719058,-109.3758596
71887,3,54,9,6,13,1,86,38.20719058,-109.3755901
71888,2,55,9,5,13,1,85,38.20719058,-109.3753206
71889,2,56,9,5,12,1,85,38.20719058,-109.3750512
71890,3,54,9,6,12,1,85,38.20719058,-109.3747817
71891,3,47,8,8,11,1,78,38.20719058,-109.3745122
71892,3,41,7,13,5,0,69,38.20719058,-109.3742427
71893,3,44,8,15,3,0,73,38.20719058,-109.3739732
71894,4,52,9,11,10,1,87,38.20719058,-109.3737037
71895,6,43,16,9,15,1,90,38.206921085350466,-109.4106244
71896,6,41,15,9,16,1,88,38.206921085350466,-109.4103549
71897,6,40,15,9,15,2,87,38.206921085350466,-109.4100855
71898,5,41,16,9,15,2,88,38.206921085350466,-109.409816
71899,5,43,16,9,15,2,90,38.206921085350466,-109.4095465
71900,5,43,16,9,16,1,90,38.206921085350466,-109.409277
71901,7,43,16,9,16,0,91,38.206921085350466,-109.4090075
71902,8,42,15,10,17,0,92,38.206921085350466,-109.408738
71903,8,40,15,10,17,0,90,38.206921085350466,-109.4084685
71904,8,39,15,10,16,0,88,38.206921085350466,-109.408199
71905,8,40,15,10,16,1,90,38.206921085350466,-109.4079295
71906,8,41,15,11,16,0,91,38.206921085350466,-109.40766
71907,7,42,15,10,17,0,91,38.206921085350466,-109.4073905
71908,7,43,16,10,16,0,92,38.206921085350466,-109.407121
71909,7,42,16,10,16,0,91,38.206921085350466,-109.4068515
71910,9,41,16,11,16,0,93,38.206921085350466,-109.406582
71911,9,42,15,10,16,0,92,38.206921085350466,-109.4063125
71912,8,42,15,11,17,0,93,38.206921085350466,-109.406043
71913,7,42,16,11,17,0,93,38.206921085350466,-109.4057735
71914,5,41,15,10,16,1,88,38.206921085350466,-109.405504
71915,6,41,15,11,15,1,89,38.206921085350466,-109.4052345
71916,6,42,15,10,15,1,89,38.206921085350466,-109.4049651
71917,6,43,15,10,15,0,89,38.206921085350466,-109.4046956
71918,8,43,15,11,16,0,93,38.206921085350466,-109.4044261
71919,8,42,15,11,17,0,93,38.206921085350466,-109.4041566
71920,7,42,15,10,16,0,90,38.206921085350466,-109.4038871
71921,8,43,15,10,16,0,92,38.206921085350466,-109.4036176
71922,8,43,15,10,15,0,91,38.206921085350466,-109.4033481
71923,8,43,14,10,15,0,90,38.206921085350466,-109.4030786
71924,6,42,15,8,15,1,87,38.206921085350466,-109.4028091
71925,5,41,15,8,15,2,86,38.206921085350466,-109.4025396
71926,6,40,15,9,15,2,87,38.206921085350466,-109.4022701
71927,8,38,15,11,15,1,88,38.206921085350466,-109.4020006
71928,8,37,15,11,15,1,87,38.206921085350466,-109.4017311
71929,8,40,15,11,15,1,90,38.206921085350466,-109.4014616
71930,8,42,15,11,15,0,91,38.206921085350466,-109.4011921
71931,9,42,15,11,15,0,92,38.206921085350466,-109.4009226
71932,9,41,14,11,16,0,91,38.206921085350466,-109.4006531
71933,11,41,14,10,16,0,92,38.206921085350466,-109.4003836
71934,11,40,14,11,16,0,92,38.206921085350466,-109.4001142
71935,12,38,14,12,15,0,91,38.206921085350466,-109.3998447
71936,13,36,14,12,15,0,90,38.206921085350466,-109.3995752
71937,12,37,14,12,15,0,90,38.206921085350466,-109.3993057
71938,13,35,14,12,15,0,89,38.206921085350466,-109.3990362
71939,12,36,14,12,14,0,88,38.206921085350466,-109.3987667
71940,11,38,14,11,15,0,89,38.206921085350466,-109.3984972
71941,10,39,14,11,16,0,90,38.206921085350466,-109.3982277
71942,11,39,14,11,16,0,91,38.206921085350466,-109.3979582
71943,15,37,14,12,14,0,92,38.206921085350466,-109.3976887
71944,16,35,13,12,14,0,90,38.206921085350466,-109.3974192
71945,15,36,13,11,14,0,89,38.206921085350466,-109.3971497
71946,14,35,13,12,14,0,88,38.206921085350466,-109.3968802
71947,13,34,13,13,15,0,88,38.206921085350466,-109.3966107
71948,13,34,13,12,17,0,89,38.206921085350466,-109.3963412
71949,9,37,14,12,17,0,89,38.206921085350466,-109.3960717
71950,7,39,14,13,17,0,90,38.206921085350466,-109.3958022
71951,6,39,14,12,18,0,89,38.206921085350466,-109.3955327
71952,10,41,14,10,18,0,93,38.206921085350466,-109.3952632
71953,10,35,12,9,15,1,82,38.206921085350466,-109.3949938
71954,4,35,11,5,15,3,73,38.206921085350466,-109.3947243
71955,1,36,11,2,14,6,70,38.206921085350466,-109.3944548
71956,1,37,10,1,13,7,69,38.206921085350466,-109.3941853
71957,1,35,10,4,12,8,70,38.206921085350466,-109.3939158
71958,1,29,10,8,9,9,66,38.206921085350466,-109.3936463
71959,1,21,11,15,10,9,67,38.206921085350466,-109.3933768
71960,2,19,12,20,13,7,73,38.206921085350466,-109.3931073
71961,2,22,14,23,20,4,85,38.206921085350466,-109.3928378
71962,2,22,11,22,22,4,83,38.206921085350466,-109.3925683
71963,1,20,10,24,23,5,83,38.206921085350466,-109.3922988
71964,2,18,10,24,24,7,85,38.206921085350466,-109.3920293
71965,2,18,9,24,24,8,85,38.206921085350466,-109.3917598
71966,3,17,9,25,27,8,89,38.206921085350466,-109.3914903
71967,2,17,8,23,23,7,80,38.206921085350466,-109.3912208
71968,2,19,9,28,23,6,87,38.206921085350466,-109.3909513
71969,2,19,9,28,24,4,86,38.206921085350466,-109.3906818
71970,2,21,10,24,27,4,88,38.206921085350466,-109.3904123
71971,3,19,10,20,31,5,88,38.206921085350466,-109.3901429
71972,3,21,11,19,31,4,89,38.206921085350466,-109.3898734
71973,4,21,12,18,29,5,89,38.206921085350466,-109.3896039
71974,5,21,12,16,26,5,85,38.206921085350466,-109.3893344
71975,5,22,12,14,23,7,83,38.206921085350466,-109.3890649
71976,6,26,12,19,20,4,87,38.206921085350466,-109.3887954
71977,5,25,12,18,20,5,85,38.206921085350466,-109.3885259
71978,3,25,12,14,20,7,81,38.206921085350466,-109.3882564
71979,2,28,12,11,20,8,81,38.206921085350466,-109.3879869
71980,2,29,12,11,19,7,80,38.206921085350466,-109.3877174
71981,4,30,11,14,21,3,83,38.206921085350466,-109.3874479
71982,4,30,11,16,20,2,83,38.206921085350466,-109.3871784
71983,4,31,12,16,20,2,85,38.206921085350466,-109.3869089
71984,5,32,12,13,19,2,83,38.206921085350466,-109.3866394
71985,6,35,11,16,17,0,85,38.206921085350466,-109.3863699
71986,6,35,11,17,16,1,86,38.206921085350466,-109.3861004
71987,6,34,11,17,17,1,86,38.206921085350466,-109.3858309
71988,11,35,11,17,15,1,90,38.206921085350466,-109.3855614
71989,18,40,10,12,11,1,92,38.206921085350466,-109.3852919
71990,20,36,9,10,12,1,88,38.206921085350466,-109.3850225
71991,18,33,9,12,16,1,89,38.206921085350466,-109.384753
71992,13,29,10,16,17,2,87,38.206921085350466,-109.3844835
71993,12,25,11,15,17,4,84,38.206921085350466,-109.384214
71994,10,24,11,14,16,6,81,38.206921085350466,-109.3839445
71995,11,25,11,16,16,4,83,38.206921085350466,-109.383675
71996,12,25,11,14,16,5,83,38.206921085350466,-109.3834055
71997,11,24,12,12,15,6,80,38.206921085350466,-109.383136
71998,5,21,12,13,11,7,69,38.206921085350466,-109.3828665
71999,2,36,10,11,14,2,75,38.206921085350466,-109.382597
72000,3,47,9,11,13,1,84,38.206921085350466,-109.3823275
72001,4,44,10,12,13,1,84,38.206921085350466,-109.382058
72002,6,42,11,13,13,1,86,38.206921085350466,-109.3817885
72003,5,44,13,14,13,1,90,38.206921085350466,-109.381519
72004,5,45,14,13,14,1,92,38.206921085350466,-109.3812495
72005,7,42,14,11,16,1,91,38.206921085350466,-109.38098
72006,7,41,14,12,16,1,91,38.206921085350466,-109.3807105
72007,7,41,13,12,15,1,89,38.206921085350466,-109.380441
72008,6,42,13,11,14,1,87,38.206921085350466,-109.3801716
72009,4,44,11,9,13,2,83,38.206921085350466,-109.3799021
72010,4,44,10,8,12,2,80,38.206921085350466,-109.3796326
72011,2,47,10,6,12,2,79,38.206921085350466,-109.3793631
72012,1,49,9,4,11,3,77,38.206921085350466,-109.3790936
72013,2,49,9,5,12,3,80,38.206921085350466,-109.3788241
72014,2,50,10,6,12,2,82,38.206921085350466,-109.3785546
72015,3,47,10,7,12,2,81,38.206921085350466,-109.3782851
72016,4,46,10,9,12,2,83,38.206921085350466,-109.3780156
72017,4,49,10,9,12,1,85,38.206921085350466,-109.3777461
72018,4,52,10,8,12,2,88,38.206921085350466,-109.3774766
72019,5,49,11,8,12,2,87,38.206921085350466,-109.3772071
72020,6,48,12,9,11,2,88,38.206921085350466,-109.3769376
72021,7,50,12,9,12,1,91,38.206921085350466,-109.3766681
72022,6,50,11,10,13,1,91,38.206921085350466,-109.3763986
72023,7,48,12,12,13,0,92,38.206921085350466,-109.3761291
72024,4,54,10,8,13,1,90,38.206921085350466,-109.3758596
72025,3,57,10,5,13,1,89,38.206921085350466,-109.3755901
72026,2,55,9,5,14,1,86,38.206921085350466,-109.3753206
72027,2,55,9,5,13,1,85,38.206921085350466,-109.3750512
72028,3,56,9,6,13,0,87,38.206921085350466,-109.3747817
72029,3,51,7,9,8,1,79,38.206921085350466,-109.3745122
72030,3,44,7,13,4,0,71,38.206921085350466,-109.3742427
72031,2,42,8,21,4,0,77,38.206921085350466,-109.3739732
72032,4,48,10,11,12,1,86,38.206921085350466,-109.3737037
72033,5,37,16,9,14,3,84,38.20665159076523,-109.409816
72034,5,39,16,10,14,2,86,38.20665159076523,-109.4095465
72035,6,42,16,10,15,1,90,38.20665159076523,-109.409277
72036,9,39,15,12,16,0,91,38.20665159076523,-109.4090075
72037,10,38,15,12,16,0,91,38.20665159076523,-109.408738
72038,10,38,15,12,16,0,91,38.20665159076523,-109.4084685
72039,9,38,14,12,16,0,89,38.20665159076523,-109.408199
72040,7,39,14,10,15,1,86,38.20665159076523,-109.4079295
72041,7,40,14,12,16,0,89,38.20665159076523,-109.40766
72042,6,41,14,11,16,0,88,38.20665159076523,-109.4073905
72043,6,41,15,10,16,1,89,38.20665159076523,-109.407121
72044,6,42,16,10,16,1,91,38.20665159076523,-109.4068515
72045,9,42,15,11,16,0,93,38.20665159076523,-109.406582
72046,9,40,15,12,16,0,92,38.20665159076523,-109.4063125
72047,6,41,15,11,16,0,89,38.20665159076523,-109.406043
72048,5,41,15,10,16,1,88,38.20665159076523,-109.4057735
72049,5,41,15,10,15,1,87,38.20665159076523,-109.405504
72050,5,41,15,9,14,2,86,38.20665159076523,-109.4052345
72051,5,41,15,10,15,1,87,38.20665159076523,-109.4049651
72052,6,42,15,11,15,0,89,38.20665159076523,-109.4046956
72053,7,43,15,12,15,0,92,38.20665159076523,-109.4044261
72054,8,44,15,11,16,0,94,38.20665159076523,-109.4041566
72055,8,44,15,12,16,0,95,38.20665159076523,-109.4038871
72056,8,43,15,11,16,0,93,38.20665159076523,-109.4036176
72057,7,43,15,11,16,0,92,38.20665159076523,-109.4033481
72058,6,43,15,10,16,0,90,38.20665159076523,-109.4030786
72059,5,43,14,8,15,1,86,38.20665159076523,-109.4028091
72060,5,42,15,9,15,2,88,38.20665159076523,-109.4025396
72061,7,38,16,11,15,1,88,38.20665159076523,-109.4022701
72062,10,35,16,12,15,1,89,38.20665159076523,-109.4020006
72063,10,34,16,13,14,1,88,38.20665159076523,-109.4017311
72064,8,38,15,11,15,1,88,38.20665159076523,-109.4014616
72065,7,40,14,12,15,1,89,38.20665159076523,-109.4011921
72066,7,39,14,12,15,1,88,38.20665159076523,-109.4009226
72067,9,39,15,12,16,0,91,38.20665159076523,-109.4006531
72068,10,39,14,11,16,0,90,38.20665159076523,-109.4003836
72069,10,38,14,11,16,0,89,38.20665159076523,-109.4001142
72070,11,37,14,12,15,0,89,38.20665159076523,-109.3998447
72071,13,36,14,12,15,0,90,38.20665159076523,-109.3995752
72072,13,36,14,12,15,0,90,38.20665159076523,-109.3993057
72073,14,37,14,12,15,0,92,38.20665159076523,-109.3990362
72074,12,36,14,12,15,0,89,38.20665159076523,-109.3987667
72075,11,38,14,11,16,0,90,38.20665159076523,-109.3984972
72076,10,39,14,11,16,0,90,38.20665159076523,-109.3982277
72077,11,39,14,12,15,0,91,38.20665159076523,-109.3979582
72078,12,38,14,12,15,0,91,38.20665159076523,-109.3976887
72079,13,38,14,13,14,0,92,38.20665159076523,-109.3974192
72080,13,38,14,12,15,0,92,38.20665159076523,-109.3971497
72081,13,37,14,12,15,0,91,38.20665159076523,-109.3968802
72082,14,35,13,13,14,0,89,38.20665159076523,-109.3966107
72083,12,37,13,13,16,0,91,38.20665159076523,-109.3963412
72084,10,39,14,13,16,0,92,38.20665159076523,-109.3960717
72085,9,40,14,13,16,0,92,38.20665159076523,-109.3958022
72086,7,41,14,12,17,0,91,38.20665159076523,-109.3955327
72087,7,41,14,10,18,0,90,38.20665159076523,-109.3952632
72088,9,36,14,10,16,1,86,38.20665159076523,-109.3949938
72089,7,34,12,9,15,2,79,38.20665159076523,-109.3947243
72090,3,34,10,5,15,4,71,38.20665159076523,-109.3944548
72091,1,37,10,1,15,6,70,38.20665159076523,-109.3941853
72092,1,41,9,4,15,3,73,38.20665159076523,-109.3939158
72093,2,39,9,5,14,4,73,38.20665159076523,-109.3936463
72094,2,31,10,9,12,5,69,38.20665159076523,-109.3933768
72095,2,28,10,13,12,5,70,38.20665159076523,-109.3931073
72096,3,28,11,13,11,7,73,38.20665159076523,-109.3928378
72097,3,27,11,16,13,5,75,38.20665159076523,-109.3925683
72098,1,21,11,17,15,6,71,38.20665159076523,-109.3922988
72099,3,24,11,20,21,4,83,38.20665159076523,-109.3920293
72100,2,19,9,24,26,5,85,38.20665159076523,-109.3917598
72101,3,14,7,26,23,6,79,38.20665159076523,-109.3914903
72102,3,15,8,25,23,7,81,38.20665159076523,-109.3912208
72103,3,17,9,27,25,7,88,38.20665159076523,-109.3909513
72104,2,19,10,28,26,4,89,38.20665159076523,-109.3906818
72105,3,20,10,28,25,4,90,38.20665159076523,-109.3904123
72106,4,19,10,25,28,4,90,38.20665159076523,-109.3901429
72107,3,22,11,18,31,4,89,38.20665159076523,-109.3898734
72108,4,23,12,16,27,5,87,38.20665159076523,-109.3896039
72109,4,23,12,14,24,6,83,38.20665159076523,-109.3893344
72110,6,23,12,15,21,6,83,38.20665159076523,-109.3890649
72111,5,23,12,20,21,5,86,38.20665159076523,-109.3887954
72112,4,21,13,22,23,5,88,38.20665159076523,-109.3885259
72113,4,23,12,20,22,5,86,38.20665159076523,-109.3882564
72114,4,27,11,13,22,4,81,38.20665159076523,-109.3879869
72115,3,29,11,12,23,3,81,38.20665159076523,-109.3877174
72116,3,32,11,12,22,4,84,38.20665159076523,-109.3874479
72117,3,29,12,11,19,7,81,38.20665159076523,-109.3871784
72118,3,28,14,10,16,11,82,38.20665159076523,-109.3869089
72119,2,28,14,9,16,12,81,38.20665159076523,-109.3866394
72120,2,33,12,8,20,7,82,38.20665159076523,-109.3863699
72121,4,32,12,13,22,2,85,38.20665159076523,-109.3861004
72122,4,32,11,17,20,2,86,38.20665159076523,-109.3858309
72123,7,31,11,18,18,1,86,38.20665159076523,-109.3855614
72124,10,35,11,18,15,1,90,38.20665159076523,-109.3852919
72125,14,33,11,16,15,1,90,38.20665159076523,-109.3850225
72126,12,28,10,17,18,2,87,38.20665159076523,-109.384753
72127,9,26,10,18,19,3,85,38.20665159076523,-109.3844835
72128,8,27,9,19,18,3,84,38.20665159076523,-109.384214
72129,9,27,9,22,17,2,86,38.20665159076523,-109.3839445
72130,10,26,9,23,17,2,87,38.20665159076523,-109.383675
72131,10,25,9,21,19,3,87,38.20665159076523,-109.3834055
72132,9,22,11,20,21,4,87,38.20665159076523,-109.383136
72133,5,21,11,22,20,6,85,38.20665159076523,-109.3828665
72134,4,25,10,15,13,4,71,38.20665159076523,-109.382597
72135,3,44,9,13,13,1,83,38.20665159076523,-109.3823275
72136,3,48,10,13,12,1,87,38.20665159076523,-109.382058
72137,4,44,10,12,13,1,84,38.20665159076523,-109.3817885
72138,5,40,11,14,13,1,84,38.20665159076523,-109.381519
72139,5,46,13,14,13,0,91,38.20665159076523,-109.3812495
72140,6,45,13,13,14,1,92,38.20665159076523,-109.38098
72141,6,43,13,12,14,1,89,38.20665159076523,-109.3807105
72142,7,42,13,12,14,1,89,38.20665159076523,-109.380441
72143,7,43,13,11,13,1,88,38.20665159076523,-109.3801716
72144,6,44,12,11,12,1,86,38.20665159076523,-109.3799021
72145,5,47,12,11,12,1,88,38.20665159076523,-109.3796326
72146,4,49,11,8,12,1,85,38.20665159076523,-109.3793631
72147,2,49,10,5,12,2,80,38.20665159076523,-109.3790936
72148,1,47,9,4,12,3,76,38.20665159076523,-109.3788241
72149,2,47,9,6,12,2,78,38.20665159076523,-109.3785546
72150,3,43,9,6,12,2,75,38.20665159076523,-109.3782851
72151,5,42,9,6,12,2,76,38.20665159076523,-109.3780156
72152,5,43,9,6,12,1,76,38.20665159076523,-109.3777461
72153,4,44,9,6,12,1,76,38.20665159076523,-109.3774766
72154,5,45,9,7,12,1,79,38.20665159076523,-109.3772071
72155,5,48,9,8,12,1,83,38.20665159076523,-109.3769376
72156,6,49,10,9,12,1,87,38.20665159076523,-109.3766681
72157,6,50,11,10,12,1,90,38.20665159076523,-109.3763986
72158,9,49,12,12,13,0,95,38.20665159076523,-109.3761291
72159,6,50,12,9,13,1,91,38.20665159076523,-109.3758596
72160,4,51,11,7,13,1,87,38.20665159076523,-109.3755901
72161,4,52,11,8,13,1,89,38.20665159076523,-109.3753206
72162,3,54,10,7,13,1,88,38.20665159076523,-109.3750512
72163,4,53,10,8,13,1,89,38.20665159076523,-109.3747817
72164,3,48,8,11,8,1,79,38.20665159076523,-109.3745122
72165,3,36,8,16,4,0,67,38.20665159076523,-109.3742427
72166,1,32,9,23,10,0,75,38.20665159076523,-109.3739732
72167,4,52,10,7,14,1,88,38.20665159076523,-109.3737037
72168,11,37,15,13,15,0,91,38.20638209617999,-109.408738
72169,10,38,15,13,15,0,91,38.20638209617999,-109.4084685
72170,9,38,15,13,15,0,90,38.20638209617999,-109.408199
72171,8,39,14,11,15,0,87,38.20638209617999,-109.4079295
72172,8,39,15,12,16,0,90,38.20638209617999,-109.40766
72173,6,40,14,10,16,1,87,38.20638209617999,-109.4073905
72174,5,41,15,8,16,2,87,38.20638209617999,-109.407121
72175,5,40,15,9,15,2,86,38.20638209617999,-109.4068515
72176,8,41,15,11,15,0,90,38.20638209617999,-109.406582
72177,8,40,15,13,15,0,91,38.20638209617999,-109.4063125
72178,6,40,14,11,15,1,87,38.20638209617999,-109.406043
72179,5,41,14,9,15,1,85,38.20638209617999,-109.4057735
72180,4,42,14,8,15,2,85,38.20638209617999,-109.405504
72181,4,42,14,8,14,2,84,38.20638209617999,-109.4052345
72182,4,41,14,9,14,2,84,38.20638209617999,-109.4049651
72183,5,41,15,11,15,1,88,38.20638209617999,-109.4046956
72184,6,43,15,12,16,0,92,38.20638209617999,-109.4044261
72185,7,43,15,11,16,0,92,38.20638209617999,-109.4041566
72186,8,43,15,12,15,0,93,38.20638209617999,-109.4038871
72187,7,43,15,12,16,0,93,38.20638209617999,-109.4036176
72188,6,43,15,12,16,0,92,38.20638209617999,-109.4033481
72189,5,42,15,10,16,1,89,38.20638209617999,-109.4030786
72190,5,42,15,9,15,2,88,38.20638209617999,-109.4028091
72191,6,41,15,9,16,1,88,38.20638209617999,-109.4025396
72192,7,38,16,11,15,1,88,38.20638209617999,-109.4022701
72193,8,36,16,12,15,1,88,38.20638209617999,-109.4020006
72194,9,36,16,12,15,1,89,38.20638209617999,-109.4017311
72195,7,39,15,11,15,1,88,38.20638209617999,-109.4014616
72196,8,40,15,11,16,0,90,38.20638209617999,-109.4011921
72197,8,39,15,12,16,0,90,38.20638209617999,-109.4009226
72198,9,39,15,12,15,0,90,38.20638209617999,-109.4006531
72199,11,38,14,11,15,0,89,38.20638209617999,-109.4003836
72200,12,37,14,12,15,0,90,38.20638209617999,-109.4001142
72201,12,36,14,12,15,0,89,38.20638209617999,-109.3998447
72202,12,35,14,12,15,0,88,38.20638209617999,-109.3995752
72203,13,36,14,12,15,0,90,38.20638209617999,-109.3993057
72204,15,37,14,12,15,0,93,38.20638209617999,-109.3990362
72205,13,36,14,11,16,0,90,38.20638209617999,-109.3987667
72206,12,37,14,11,16,0,90,38.20638209617999,-109.3984972
72207,11,38,14,11,16,0,90,38.20638209617999,-109.3982277
72208,10,38,14,12,16,0,90,38.20638209617999,-109.3979582
72209,10,39,14,12,16,0,91,38.20638209617999,-109.3976887
72210,11,39,14,12,16,0,92,38.20638209617999,-109.3974192
72211,11,39,14,12,16,0,92,38.20638209617999,-109.3971497
72212,12,37,14,12,15,0,90,38.20638209617999,-109.3968802
72213,15,36,13,11,15,0,90,38.20638209617999,-109.3966107
72214,13,35,13,12,15,0,88,38.20638209617999,-109.3963412
72215,12,36,13,13,15,0,89,38.20638209617999,-109.3960717
72216,11,38,14,12,16,0,91,38.20638209617999,-109.3958022
72217,9,39,14,12,17,0,91,38.20638209617999,-109.3955327
72218,7,40,15,13,17,0,92,38.20638209617999,-109.3952632
72219,6,40,14,12,17,0,89,38.20638209617999,-109.3949938
72220,6,39,14,13,17,0,89,38.20638209617999,-109.3947243
72221,7,38,13,12,16,0,86,38.20638209617999,-109.3944548
72222,7,37,12,9,15,1,81,38.20638209617999,-109.3941853
72223,2,35,10,8,14,3,72,38.20638209617999,-109.3939158
72224,2,38,10,6,15,3,74,38.20638209617999,-109.3936463
72225,2,35,10,5,14,4,70,38.20638209617999,-109.3933768
72226,2,34,10,5,14,6,71,38.20638209617999,-109.3931073
72227,1,32,11,7,13,6,70,38.20638209617999,-109.3928378
72228,2,32,10,11,11,4,70,38.20638209617999,-109.3925683
72229,1,31,9,11,9,6,67,38.20638209617999,-109.3922988
72230,1,26,10,12,12,8,69,38.20638209617999,-109.3920293
72231,3,23,10,19,16,5,76,38.20638209617999,-109.3917598
72232,2,20,10,25,24,4,85,38.20638209617999,-109.3914903
72233,2,14,7,24,24,6,77,38.20638209617999,-109.3912208
72234,3,15,9,27,26,9,89,38.20638209617999,-109.3909513
72235,4,18,10,25,28,6,91,38.20638209617999,-109.3906818
72236,4,19,10,29,26,4,92,38.20638209617999,-109.3904123
72237,3,18,11,24,28,4,88,38.20638209617999,-109.3901429
72238,3,21,11,19,30,4,88,38.20638209617999,-109.3898734
72239,3,23,12,17,29,5,89,38.20638209617999,-109.3896039
72240,2,22,12,21,25,5,87,38.20638209617999,-109.3893344
72241,3,23,11,25,21,4,87,38.20638209617999,-109.3890649
72242,3,23,12,26,18,5,87,38.20638209617999,-109.3887954
72243,5,22,12,24,21,5,89,38.20638209617999,-109.3885259
72244,4,22,12,22,22,5,87,38.20638209617999,-109.3882564
72245,4,24,12,20,22,5,87,38.20638209617999,-109.3879869
72246,4,23,12,18,21,6,84,38.20638209617999,-109.3877174
72247,4,25,12,14,21,7,83,38.20638209617999,-109.3874479
72248,4,25,14,10,17,11,81,38.20638209617999,-109.3871784
72249,2,25,15,8,15,14,79,38.20638209617999,-109.3869089
72250,2,26,15,8,17,13,81,38.20638209617999,-109.3866394
72251,2,27,12,8,21,10,80,38.20638209617999,-109.3863699
72252,3,27,12,15,22,5,84,38.20638209617999,-109.3861004
72253,4,27,12,16,21,5,85,38.20638209617999,-109.3858309
72254,4,28,13,17,20,4,86,38.20638209617999,-109.3855614
72255,4,30,12,20,19,3,88,38.20638209617999,-109.3852919
72256,5,29,11,21,19,2,87,38.20638209617999,-109.3850225
72257,5,28,11,18,22,3,87,38.20638209617999,-109.384753
72258,4,26,11,20,25,3,89,38.20638209617999,-109.3844835
72259,3,24,10,24,25,2,88,38.20638209617999,-109.384214
72260,5,23,9,27,24,2,90,38.20638209617999,-109.3839445
72261,3,22,9,28,23,4,89,38.20638209617999,-109.383675
72262,2,20,9,28,23,4,86,38.20638209617999,-109.3834055
72263,3,19,10,25,24,6,87,38.20638209617999,-109.383136
72264,2,20,11,20,25,7,85,38.20638209617999,-109.3828665
72265,2,23,12,17,17,6,77,38.20638209617999,-109.382597
72266,1,37,9,14,12,1,74,38.20638209617999,-109.3823275
72267,3,48,10,15,11,1,88,38.20638209617999,-109.382058
72268,3,48,10,15,12,0,88,38.20638209617999,-109.3817885
72269,3,40,10,13,14,1,81,38.20638209617999,-109.381519
72270,6,45,12,14,13,0,90,38.20638209617999,-109.3812495
72271,5,45,12,12,13,1,88,38.20638209617999,-109.38098
72272,5,43,12,10,12,2,84,38.20638209617999,-109.3807105
72273,6,39,12,10,12,2,81,38.20638209617999,-109.380441
72274,7,39,12,11,12,1,82,38.20638209617999,-109.3801716
72275,6,41,12,12,12,1,84,38.20638209617999,-109.3799021
72276,5,45,12,11,11,1,85,38.20638209617999,-109.3796326
72277,5,47,11,9,11,1,84,38.20638209617999,-109.3793631
72278,4,46,10,6,12,2,80,38.20638209617999,-109.3790936
72279,2,40,8,4,10,3,67,38.20638209617999,-109.3788241
72280,2,39,8,4,11,3,67,38.20638209617999,-109.3785546
72281,3,39,8,5,11,2,68,38.20638209617999,-109.3782851
72282,3,36,8,4,11,3,65,38.20638209617999,-109.3780156
72283,2,34,7,4,10,3,60,38.20638209617999,-109.3777461
72284,2,35,7,4,10,3,61,38.20638209617999,-109.3774766
72285,3,36,8,4,10,3,64,38.20638209617999,-109.3772071
72286,4,36,8,5,10,3,66,38.20638209617999,-109.3769376
72287,4,38,9,6,11,2,70,38.20638209617999,-109.3766681
72288,6,46,10,8,11,1,82,38.20638209617999,-109.3763986
72289,8,48,11,10,13,0,90,38.20638209617999,-109.3761291
72290,9,44,13,10,13,1,90,38.20638209617999,-109.3758596
72291,8,44,13,10,13,1,89,38.20638209617999,-109.3755901
72292,6,47,12,9,13,1,88,38.20638209617999,-109.3753206
72293,4,52,10,7,12,2,87,38.20638209617999,-109.3750512
72294,3,52,10,7,13,1,86,38.20638209617999,-109.3747817
72295,4,46,9,11,10,1,81,38.20638209617999,-109.3745122
72296,3,35,8,16,7,0,69,38.20638209617999,-109.3742427
72297,1,33,9,17,10,1,71,38.20638209617999,-109.3739732
72298,4,52,10,8,12,1,87,38.20638209617999,-109.3737037
72299,8,38,15,12,16,0,89,38.20611260159476,-109.4079295
72300,7,38,15,12,16,1,89,38.20611260159476,-109.40766
72301,6,40,15,11,16,1,89,38.20611260159476,-109.4073905
72302,5,41,15,9,16,1,87,38.20611260159476,-109.407121
72303,6,41,14,9,15,1,86,38.20611260159476,-109.4068515
72304,7,42,15,10,15,1,90,38.20611260159476,-109.406582
72305,6,40,14,12,15,1,88,38.20611260159476,-109.4063125
72306,6,40,14,11,14,1,86,38.20611260159476,-109.406043
72307,5,41,14,10,14,1,85,38.20611260159476,-109.4057735
72308,5,42,14,9,15,2,87,38.20611260159476,-109.405504
72309,4,41,14,8,14,2,83,38.20611260159476,-109.4052345
72310,5,41,14,8,14,2,84,38.20611260159476,-109.4049651
72311,5,42,14,9,15,1,86,38.20611260159476,-109.4046956
72312,5,42,15,11,16,1,90,38.20611260159476,-109.4044261
72313,7,43,15,11,15,0,91,38.20611260159476,-109.4041566
72314,7,43,15,11,16,0,92,38.20611260159476,-109.4038871
72315,7,43,16,12,16,0,94,38.20611260159476,-109.4036176
72316,5,43,16,12,16,0,92,38.20611260159476,-109.4033481
72317,4,42,15,10,16,1,88,38.20611260159476,-109.4030786
72318,4,43,15,9,17,1,89,38.20611260159476,-109.4028091
72319,5,42,15,10,16,1,89,38.20611260159476,-109.4025396
72320,5,40,15,11,15,1,87,38.20611260159476,-109.4022701
72321,6,39,15,11,15,1,87,38.20611260159476,-109.4020006
72322,6,38,15,10,15,2,86,38.20611260159476,-109.4017311
72323,6,39,14,10,15,2,86,38.20611260159476,-109.4014616
72324,9,39,15,11,15,0,89,38.20611260159476,-109.4011921
72325,9,39,15,12,16,0,91,38.20611260159476,-109.4009226
72326,10,39,15,12,15,0,91,38.20611260159476,-109.4006531
72327,13,39,15,12,15,0,94,38.20611260159476,-109.4003836
72328,14,37,14,13,14,0,92,38.20611260159476,-109.4001142
72329,14,36,14,12,14,0,90,38.20611260159476,-109.3998447
72330,13,36,15,12,14,0,90,38.20611260159476,-109.3995752
72331,14,36,15,13,15,0,93,38.20611260159476,-109.3993057
72332,15,35,14,13,14,0,91,38.20611260159476,-109.3990362
72333,16,35,14,11,15,0,91,38.20611260159476,-109.3987667
72334,15,35,14,11,15,0,90,38.20611260159476,-109.3984972
72335,12,36,14,12,16,0,90,38.20611260159476,-109.3982277
72336,10,36,14,13,16,0,89,38.20611260159476,-109.3979582
72337,8,37,14,13,16,0,88,38.20611260159476,-109.3976887
72338,10,38,14,12,17,0,91,38.20611260159476,-109.3974192
72339,10,38,14,13,16,0,91,38.20611260159476,-109.3971497
72340,12,36,14,13,16,0,91,38.20611260159476,-109.3968802
72341,16,35,13,11,15,0,90,38.20611260159476,-109.3966107
72342,12,35,13,12,16,0,88,38.20611260159476,-109.3963412
72343,11,35,13,12,16,0,87,38.20611260159476,-109.3960717
72344,11,36,14,12,17,0,90,38.20611260159476,-109.3958022
72345,10,38,14,12,17,0,91,38.20611260159476,-109.3955327
72346,8,39,14,14,16,0,91,38.20611260159476,-109.3952632
72347,6,42,15,12,18,0,93,38.20611260159476,-109.3949938
72348,7,41,15,11,17,0,91,38.20611260159476,-109.3947243
72349,10,40,14,12,16,0,92,38.20611260159476,-109.3944548
72350,11,38,14,12,15,0,90,38.20611260159476,-109.3941853
72351,6,34,11,10,14,2,77,38.20611260159476,-109.3939158
72352,4,37,11,7,16,2,77,38.20611260159476,-109.3936463
72353,3,36,10,6,17,2,74,38.20611260159476,-109.3933768
72354,2,33,10,5,18,3,71,38.20611260159476,-109.3931073
72355,1,34,10,5,17,3,70,38.20611260159476,-109.3928378
72356,2,39,10,3,15,5,74,38.20611260159476,-109.3925683
72357,2,42,9,6,12,4,75,38.20611260159476,-109.3922988
72358,2,40,9,7,8,5,71,38.20611260159476,-109.3920293
72359,1,31,9,7,9,7,64,38.20611260159476,-109.3917598
72360,1,20,10,13,11,9,64,38.20611260159476,-109.3914903
72361,5,23,10,24,21,4,87,38.20611260159476,-109.3912208
72362,2,17,9,28,27,6,89,38.20611260159476,-109.3909513
72363,3,16,10,28,28,6,91,38.20611260159476,-109.3906818
72364,3,16,11,29,27,4,90,38.20611260159476,-109.3904123
72365,4,17,11,28,27,4,91,38.20611260159476,-109.3901429
72366,3,19,10,25,28,4,89,38.20611260159476,-109.3898734
72367,3,20,10,24,29,3,89,38.20611260159476,-109.3896039
72368,3,21,11,24,27,3,89,38.20611260159476,-109.3893344
72369,3,20,12,23,25,5,88,38.20611260159476,-109.3890649
72370,9,20,12,24,21,4,90,38.20611260159476,-109.3887954
72371,14,19,11,19,24,5,92,38.20611260159476,-109.3885259
72372,12,21,12,19,24,6,94,38.20611260159476,-109.3882564
72373,9,24,12,20,20,6,91,38.20611260159476,-109.3879869
72374,6,25,11,18,20,6,86,38.20611260159476,-109.3877174
72375,5,25,12,16,21,5,84,38.20611260159476,-109.3874479
72376,2,25,13,11,22,9,82,38.20611260159476,-109.3871784
72377,2,25,13,11,22,10,83,38.20611260159476,-109.3869089
72378,3,24,12,15,24,7,85,38.20611260159476,-109.3866394
72379,5,22,12,15,25,7,86,38.20611260159476,-109.3863699
72380,4,23,12,18,24,6,87,38.20611260159476,-109.3861004
72381,3,23,12,18,23,5,84,38.20611260159476,-109.3858309
72382,3,24,13,17,21,6,84,38.20611260159476,-109.3855614
72383,3,25,13,15,20,7,83,38.20611260159476,-109.3852919
72384,3,28,13,15,21,6,86,38.20611260159476,-109.3850225
72385,3,30,12,17,22,4,88,38.20611260159476,-109.384753
72386,3,29,10,20,22,2,86,38.20611260159476,-109.3844835
72387,3,26,10,24,22,2,87,38.20611260159476,-109.384214
72388,2,22,10,28,24,2,88,38.20611260159476,-109.3839445
72389,1,21,9,25,26,5,87,38.20611260159476,-109.383675
72390,2,17,8,27,23,7,84,38.20611260159476,-109.3834055
72391,3,18,10,23,24,7,85,38.20611260159476,-109.383136
72392,3,19,12,18,25,6,83,38.20611260159476,-109.3828665
72393,4,22,11,17,20,6,80,38.20611260159476,-109.382597
72394,1,28,10,11,11,5,66,38.20611260159476,-109.3823275
72395,1,44,8,10,11,2,76,38.20611260159476,-109.382058
72396,3,47,10,14,12,1,87,38.20611260159476,-109.3817885
72397,4,46,10,12,13,1,86,38.20611260159476,-109.381519
72398,5,44,11,14,13,1,88,38.20611260159476,-109.3812495
72399,4,45,11,11,13,1,85,38.20611260159476,-109.38098
72400,4,43,11,9,12,2,81,38.20611260159476,-109.3807105
72401,5,41,12,9,12,3,82,38.20611260159476,-109.380441
72402,5,42,11,9,11,2,80,38.20611260159476,-109.3801716
72403,4,44,11,10,11,2,82,38.20611260159476,-109.3799021
72404,4,46,11,9,11,2,83,38.20611260159476,-109.3796326
72405,4,46,10,8,11,2,81,38.20611260159476,-109.3793631
72406,3,42,9,7,11,2,74,38.20611260159476,-109.3790936
72407,4,35,9,5,11,3,67,38.20611260159476,-109.3788241
72408,2,36,9,4,12,3,66,38.20611260159476,-109.3785546
72409,2,37,8,4,12,3,66,38.20611260159476,-109.3782851
72410,2,36,8,4,12,3,65,38.20611260159476,-109.3780156
72411,2,32,8,4,11,4,61,38.20611260159476,-109.3777461
72412,2,33,7,4,9,4,59,38.20611260159476,-109.3774766
72413,2,33,8,4,10,3,60,38.20611260159476,-109.3772071
72414,3,35,8,4,10,3,63,38.20611260159476,-109.3769376
72415,3,36,9,6,12,2,68,38.20611260159476,-109.3766681
72416,4,43,10,10,12,1,80,38.20611260159476,-109.3763986
72417,8,46,12,11,13,0,90,38.20611260159476,-109.3761291
72418,10,41,14,11,13,1,90,38.20611260159476,-109.3758596
72419,8,40,13,9,12,2,84,38.20611260159476,-109.3755901
72420,4,45,11,7,12,2,81,38.20611260159476,-109.3753206
72421,3,52,10,6,12,2,85,38.20611260159476,-109.3750512
72422,3,49,10,6,12,2,82,38.20611260159476,-109.3747817
72423,3,41,8,10,10,2,74,38.20611260159476,-109.3745122
72424,1,32,8,14,7,2,64,38.20611260159476,-109.3742427
72425,3,41,8,12,9,1,74,38.20611260159476,-109.3739732
72426,4,47,9,8,12,1,81,38.20611260159476,-109.3737037
72427,5,42,14,8,16,1,86,38.20584310700952,-109.4068515
72428,5,42,15,10,16,1,89,38.20584310700952,-109.406582
72429,5,40,14,11,15,1,86,38.20584310700952,-109.4063125
72430,5,40,14,11,15,1,86,38.20584310700952,-109.406043
72431,5,41,14,10,15,1,86,38.20584310700952,-109.4057735
72432,4,41,14,10,15,2,86,38.20584310700952,-109.405504
72433,4,39,14,10,14,3,84,38.20584310700952,-109.4052345
72434,5,39,14,9,14,2,83,38.20584310700952,-109.4049651
72435,5,40,14,11,15,1,86,38.20584310700952,-109.4046956
72436,6,41,15,12,15,1,90,38.20584310700952,-109.4044261
72437,6,41,15,12,16,0,90,38.20584310700952,-109.4041566
72438,6,41,15,12,16,0,90,38.20584310700952,-109.4038871
72439,5,42,16,13,16,0,92,38.20584310700952,-109.4036176
72440,5,42,16,13,16,0,92,38.20584310700952,-109.4033481
72441,4,43,15,11,17,0,90,38.20584310700952,-109.4030786
72442,5,43,15,9,16,1,89,38.20584310700952,-109.4028091
72443,5,43,15,10,15,1,89,38.20584310700952,-109.4025396
72444,6,42,15,10,15,1,89,38.20584310700952,-109.4022701
72445,6,40,15,10,14,1,86,38.20584310700952,-109.4020006
72446,7,39,15,10,15,1,87,38.20584310700952,-109.4017311
72447,6,39,15,11,14,1,86,38.20584310700952,-109.4014616
72448,7,39,15,12,15,1,89,38.20584310700952,-109.4011921
72449,8,39,15,12,16,0,90,38.20584310700952,-109.4009226
72450,10,39,15,12,16,0,92,38.20584310700952,-109.4006531
72451,13,39,15,11,15,0,93,38.20584310700952,-109.4003836
72452,13,38,15,13,14,0,93,38.20584310700952,-109.4001142
72453,12,37,14,14,14,0,91,38.20584310700952,-109.3998447
72454,12,36,15,13,15,0,91,38.20584310700952,-109.3995752
72455,12,36,15,13,15,0,91,38.20584310700952,-109.3993057
72456,13,35,15,14,14,0,91,38.20584310700952,-109.3990362
72457,15,35,14,12,14,0,90,38.20584310700952,-109.3987667
72458,15,35,14,12,15,0,91,38.20584310700952,-109.3984972
72459,13,35,14,13,15,0,90,38.20584310700952,-109.3982277
72460,12,35,14,14,15,0,90,38.20584310700952,-109.3979582
72461,10,35,14,14,16,0,89,38.20584310700952,-109.3976887
72462,10,36,14,13,17,0,90,38.20584310700952,-109.3974192
72463,12,35,13,13,16,0,89,38.20584310700952,-109.3971497
72464,13,35,14,13,16,0,91,38.20584310700952,-109.3968802
72465,14,36,14,13,16,0,93,38.20584310700952,-109.3966107
72466,11,35,14,13,16,0,89,38.20584310700952,-109.3963412
72467,11,35,14,13,16,0,89,38.20584310700952,-109.3960717
72468,12,36,13,12,16,0,89,38.20584310700952,-109.3958022
72469,10,37,14,12,17,0,90,38.20584310700952,-109.3955327
72470,7,38,14,13,17,0,89,38.20584310700952,-109.3952632
72471,6,41,15,12,18,0,92,38.20584310700952,-109.3949938
72472,6,41,15,12,18,0,92,38.20584310700952,-109.3947243
72473,8,41,14,12,17,0,92,38.20584310700952,-109.3944548
72474,9,40,14,12,16,0,91,38.20584310700952,-109.3941853
72475,10,39,13,11,15,0,88,38.20584310700952,-109.3939158
72476,6,38,12,10,17,1,84,38.20584310700952,-109.3936463
72477,6,37,11,11,17,0,82,38.20584310700952,-109.3933768
72478,6,35,11,11,17,1,81,38.20584310700952,-109.3931073
72479,5,36,11,9,17,1,79,38.20584310700952,-109.3928378
72480,4,35,10,9,15,2,75,38.20584310700952,-109.3925683
72481,3,36,10,4,14,5,72,38.20584310700952,-109.3922988
72482,3,40,10,6,12,4,75,38.20584310700952,-109.3920293
72483,2,38,9,6,9,5,69,38.20584310700952,-109.3917598
72484,2,32,10,5,7,7,63,38.20584310700952,-109.3914903
72485,4,21,11,19,14,5,74,38.20584310700952,-109.3912208
72486,2,18,10,29,24,2,85,38.20584310700952,-109.3909513
72487,4,13,10,32,23,7,89,38.20584310700952,-109.3906818
72488,4,15,10,29,24,8,90,38.20584310700952,-109.3904123
72489,2,19,11,22,28,5,87,38.20584310700952,-109.3901429
72490,2,21,11,21,30,4,89,38.20584310700952,-109.3898734
72491,2,21,10,21,30,3,87,38.20584310700952,-109.3896039
72492,3,20,10,23,27,4,87,38.20584310700952,-109.3893344
72493,3,17,11,25,27,8,91,38.20584310700952,-109.3890649
72494,2,13,11,27,29,10,92,38.20584310700952,-109.3887954
72495,2,12,11,25,29,14,93,38.20584310700952,-109.3885259
72496,6,16,12,22,27,10,93,38.20584310700952,-109.3882564
72497,6,20,12,21,22,8,89,38.20584310700952,-109.3879869
72498,3,23,14,17,20,9,86,38.20584310700952,-109.3877174
72499,2,22,12,21,24,6,87,38.20584310700952,-109.3874479
72500,3,21,12,20,27,5,88,38.20584310700952,-109.3871784
72501,3,20,12,19,29,6,89,38.20584310700952,-109.3869089
72502,3,19,12,22,28,6,90,38.20584310700952,-109.3866394
72503,4,19,12,21,29,5,90,38.20584310700952,-109.3863699
72504,4,20,12,18,29,5,88,38.20584310700952,-109.3861004
72505,3,22,12,18,26,5,86,38.20584310700952,-109.3858309
72506,3,23,12,18,23,5,84,38.20584310700952,-109.3855614
72507,3,24,12,17,23,6,85,38.20584310700952,-109.3852919
72508,3,25,12,17,22,5,84,38.20584310700952,-109.3850225
72509,3,27,12,16,21,6,85,38.20584310700952,-109.384753
72510,3,29,11,20,19,3,85,38.20584310700952,-109.3844835
72511,4,28,10,23,20,1,86,38.20584310700952,-109.384214
72512,4,24,9,26,21,1,85,38.20584310700952,-109.3839445
72513,1,22,10,25,26,3,87,38.20584310700952,-109.383675
72514,2,19,9,26,25,5,86,38.20584310700952,-109.3834055
72515,3,18,11,24,25,6,87,38.20584310700952,-109.383136
72516,2,18,12,19,24,8,83,38.20584310700952,-109.3828665
72517,2,19,11,19,21,7,79,38.20584310700952,-109.382597
72518,0,16,10,12,12,8,58,38.20584310700952,-109.3823275
72519,1,36,8,7,10,4,66,38.20584310700952,-109.382058
72520,2,43,8,8,12,2,75,38.20584310700952,-109.3817885
72521,4,45,10,9,14,1,83,38.20584310700952,-109.381519
72522,4,45,10,10,14,1,84,38.20584310700952,-109.3812495
72523,4,44,10,8,13,2,81,38.20584310700952,-109.38098
72524,3,44,11,8,12,3,81,38.20584310700952,-109.3807105
72525,3,44,11,7,11,3,79,38.20584310700952,-109.380441
72526,3,46,10,6,11,3,79,38.20584310700952,-109.3801716
72527,2,47,9,5,12,4,79,38.20584310700952,-109.3799021
72528,3,48,10,6,11,3,81,38.20584310700952,-109.3796326
72529,3,46,10,6,11,3,79,38.20584310700952,-109.3793631
72530,3,43,9,6,11,3,75,38.20584310700952,-109.3790936
72531,5,37,10,6,12,2,72,38.20584310700952,-109.3788241
72532,3,36,10,5,12,4,70,38.20584310700952,-109.3785546
72533,2,36,9,5,12,5,69,38.20584310700952,-109.3782851
72534,1,36,8,4,11,5,65,38.20584310700952,-109.3780156
72535,1,35,8,3,12,5,64,38.20584310700952,-109.3777461
72536,1,32,8,4,11,4,60,38.20584310700952,-109.3774766
72537,2,35,9,4,11,4,65,38.20584310700952,-109.3772071
72538,1,37,9,6,12,4,69,38.20584310700952,-109.3769376
72539,3,41,10,10,13,2,79,38.20584310700952,-109.3766681
72540,5,49,12,10,13,1,90,38.20584310700952,-109.3763986
72541,6,49,12,10,12,1,90,38.20584310700952,-109.3761291
72542,6,42,13,11,12,2,86,38.20584310700952,-109.3758596
72543,6,42,13,9,12,2,84,38.20584310700952,-109.3755901
72544,5,46,11,7,12,2,83,38.20584310700952,-109.3753206
72545,4,49,11,8,12,2,86,38.20584310700952,-109.3750512
72546,3,45,10,7,14,2,81,38.20584310700952,-109.3747817
72547,3,30,9,13,10,3,68,38.20584310700952,-109.3745122
72548,2,30,8,13,7,2,62,38.20584310700952,-109.3742427
72549,6,44,8,9,7,1,75,38.20584310700952,-109.3739732
72550,4,35,8,5,11,3,66,38.20584310700952,-109.3737037
72551,5,40,15,10,15,1,86,38.20557361242429,-109.406043
72552,5,40,14,9,15,2,85,38.20557361242429,-109.4057735
72553,4,39,14,9,14,3,83,38.20557361242429,-109.405504
72554,4,39,14,10,14,2,83,38.20557361242429,-109.4052345
72555,6,39,14,11,15,1,86,38.20557361242429,-109.4049651
72556,7,39,15,13,15,0,89,38.20557361242429,-109.4046956
72557,6,40,15,13,16,0,90,38.20557361242429,-109.4044261
72558,6,42,15,11,16,0,90,38.20557361242429,-109.4041566
72559,6,41,15,13,16,0,91,38.20557361242429,-109.4038871
72560,6,41,16,14,16,0,93,38.20557361242429,-109.4036176
72561,5,42,15,14,16,0,92,38.20557361242429,-109.4033481
72562,5,42,15,12,16,0,90,38.20557361242429,-109.4030786
72563,5,42,16,10,16,1,90,38.20557361242429,-109.4028091
72564,4,42,15,10,15,1,87,38.20557361242429,-109.4025396
72565,4,41,15,10,14,1,85,38.20557361242429,-109.4022701
72566,5,40,15,10,14,2,86,38.20557361242429,-109.4020006
72567,6,38,15,11,13,2,85,38.20557361242429,-109.4017311
72568,7,38,15,13,14,1,88,38.20557361242429,-109.4014616
72569,7,40,15,12,15,1,90,38.20557361242429,-109.4011921
72570,7,40,15,12,15,1,90,38.20557361242429,-109.4009226
72571,8,41,15,12,15,0,91,38.20557361242429,-109.4006531
72572,11,41,15,11,15,0,93,38.20557361242429,-109.4003836
72573,11,39,15,12,15,0,92,38.20557361242429,-109.4001142
72574,12,37,14,13,15,0,91,38.20557361242429,-109.3998447
72575,12,36,14,13,15,0,90,38.20557361242429,-109.3995752
72576,12,36,15,13,15,0,91,38.20557361242429,-109.3993057
72577,12,36,15,14,15,0,92,38.20557361242429,-109.3990362
72578,12,35,14,14,15,0,90,38.20557361242429,-109.3987667
72579,11,35,14,14,15,0,89,38.20557361242429,-109.3984972
72580,11,35,14,14,15,0,89,38.20557361242429,-109.3982277
72581,12,35,14,14,14,0,89,38.20557361242429,-109.3979582
72582,11,35,14,13,15,0,88,38.20557361242429,-109.3976887
72583,13,35,14,12,16,0,90,38.20557361242429,-109.3974192
72584,15,35,14,11,16,0,91,38.20557361242429,-109.3971497
72585,15,35,14,11,15,0,90,38.20557361242429,-109.3968802
72586,13,35,14,12,16,0,90,38.20557361242429,-109.3966107
72587,12,36,14,13,16,0,91,38.20557361242429,-109.3963412
72588,11,36,14,14,16,0,91,38.20557361242429,-109.3960717
72589,11,36,14,13,16,0,90,38.20557361242429,-109.3958022
72590,10,37,14,12,17,0,90,38.20557361242429,-109.3955327
72591,8,37,14,13,17,0,89,38.20557361242429,-109.3952632
72592,8,38,14,12,18,0,90,38.20557361242429,-109.3949938
72593,7,40,14,12,18,0,91,38.20557361242429,-109.3947243
72594,6,40,15,13,18,0,92,38.20557361242429,-109.3944548
72595,6,40,14,13,18,0,91,38.20557361242429,-109.3941853
72596,9,39,14,12,17,0,91,38.20557361242429,-109.3939158
72597,9,39,13,12,17,0,90,38.20557361242429,-109.3936463
72598,8,39,13,11,18,0,89,38.20557361242429,-109.3933768
72599,7,39,13,11,18,0,88,38.20557361242429,-109.3931073
72600,6,40,13,11,18,0,88,38.20557361242429,-109.3928378
72601,6,38,13,11,16,1,85,38.20557361242429,-109.3925683
72602,5,34,11,8,14,2,74,38.20557361242429,-109.3922988
72603,3,40,9,6,11,3,72,38.20557361242429,-109.3920293
72604,2,41,8,5,10,3,69,38.20557361242429,-109.3917598
72605,2,38,8,5,7,5,65,38.20557361242429,-109.3914903
72606,2,22,10,8,13,8,63,38.20557361242429,-109.3912208
72607,7,19,12,19,20,5,82,38.20557361242429,-109.3909513
72608,6,16,12,18,29,9,90,38.20557361242429,-109.3906818
72609,6,14,10,31,23,8,92,38.20557361242429,-109.3904123
72610,4,19,12,21,29,5,90,38.20557361242429,-109.3901429
72611,3,20,11,21,29,4,88,38.20557361242429,-109.3898734
72612,3,19,11,21,30,5,89,38.20557361242429,-109.3896039
72613,3,19,10,21,31,5,89,38.20557361242429,-109.3893344
72614,3,18,10,24,31,4,90,38.20557361242429,-109.3890649
72615,4,18,11,25,30,4,92,38.20557361242429,-109.3887954
72616,4,15,10,32,27,4,92,38.20557361242429,-109.3885259
72617,3,16,11,32,22,5,89,38.20557361242429,-109.3882564
72618,7,18,12,23,22,7,89,38.20557361242429,-109.3879869
72619,7,22,12,19,23,7,90,38.20557361242429,-109.3877174
72620,2,22,13,22,22,7,88,38.20557361242429,-109.3874479
72621,3,18,12,22,26,8,89,38.20557361242429,-109.3871784
72622,3,16,11,22,27,9,88,38.20557361242429,-109.3869089
72623,4,15,11,25,25,9,89,38.20557361242429,-109.3866394
72624,5,16,11,24,25,6,87,38.20557361242429,-109.3863699
72625,4,18,11,22,29,5,89,38.20557361242429,-109.3861004
72626,3,21,12,17,29,4,86,38.20557361242429,-109.3858309
72627,4,23,12,16,26,5,86,38.20557361242429,-109.3855614
72628,4,22,12,17,26,5,86,38.20557361242429,-109.3852919
72629,3,22,12,19,26,4,86,38.20557361242429,-109.3850225
72630,3,25,12,18,23,4,85,38.20557361242429,-109.384753
72631,3,27,12,17,21,5,85,38.20557361242429,-109.3844835
72632,4,28,10,19,19,2,82,38.20557361242429,-109.384214
72633,5,28,10,23,18,1,85,38.20557361242429,-109.3839445
72634,4,26,9,25,21,2,87,38.20557361242429,-109.383675
72635,2,22,11,24,24,3,86,38.20557361242429,-109.3834055
72636,3,21,11,20,26,5,86,38.20557361242429,-109.383136
72637,3,20,12,18,26,8,87,38.20557361242429,-109.3828665
72638,3,20,12,19,19,9,82,38.20557361242429,-109.382597
72639,0,18,9,17,15,6,65,38.20557361242429,-109.3823275
72640,1,30,9,9,10,5,64,38.20557361242429,-109.382058
72641,2,42,7,7,10,2,70,38.20557361242429,-109.3817885
72642,3,44,9,8,12,1,77,38.20557361242429,-109.381519
72643,5,48,10,8,13,1,85,38.20557361242429,-109.3812495
72644,5,47,10,8,12,1,83,38.20557361242429,-109.38098
72645,5,43,10,7,12,2,79,38.20557361242429,-109.3807105
72646,4,44,10,6,12,3,79,38.20557361242429,-109.380441
72647,3,47,9,4,12,3,78,38.20557361242429,-109.3801716
72648,2,47,8,3,11,3,74,38.20557361242429,-109.3799021
72649,3,43,9,5,12,3,75,38.20557361242429,-109.3796326
72650,3,42,9,6,12,3,75,38.20557361242429,-109.3793631
72651,3,41,9,5,12,3,73,38.20557361242429,-109.3790936
72652,4,36,10,6,12,3,71,38.20557361242429,-109.3788241
72653,3,32,10,7,13,4,69,38.20557361242429,-109.3785546
72654,2,30,10,5,12,6,65,38.20557361242429,-109.3782851
72655,2,30,9,5,11,7,64,38.20557361242429,-109.3780156
72656,2,31,10,5,13,6,67,38.20557361242429,-109.3777461
72657,2,32,10,5,10,8,67,38.20557361242429,-109.3774766
72658,1,35,9,2,10,9,66,38.20557361242429,-109.3772071
72659,1,39,10,6,11,5,72,38.20557361242429,-109.3769376
72660,3,42,10,12,12,2,81,38.20557361242429,-109.3766681
72661,5,50,11,10,13,1,90,38.20557361242429,-109.3763986
72662,6,50,11,11,13,1,92,38.20557361242429,-109.3761291
72663,7,45,12,10,12,1,87,38.20557361242429,-109.3758596
72664,7,42,11,9,12,1,82,38.20557361242429,-109.3755901
72665,5,42,11,8,12,2,80,38.20557361242429,-109.3753206
72666,4,47,11,8,13,2,85,38.20557361242429,-109.3750512
72667,3,45,10,5,14,4,81,38.20557361242429,-109.3747817
72668,3,27,9,13,9,2,63,38.20557361242429,-109.3745122
72669,1,31,8,13,7,2,62,38.20557361242429,-109.3742427
72670,3,43,7,8,9,2,72,38.20557361242429,-109.3739732
72671,3,34,8,5,10,3,63,38.20557361242429,-109.3737037
72672,6,39,15,12,15,1,88,38.20530411783905,-109.4049651
72673,6,39,15,12,15,1,88,38.20530411783905,-109.4046956
72674,5,40,15,11,16,1,88,38.20530411783905,-109.4044261
72675,5,41,15,11,15,1,88,38.20530411783905,-109.4041566
72676,8,41,15,12,15,0,91,38.20530411783905,-109.4038871
72677,8,41,15,12,16,0,92,38.20530411783905,-109.4036176
72678,7,42,15,12,16,0,92,38.20530411783905,-109.4033481
72679,5,42,15,12,16,1,91,38.20530411783905,-109.4030786
72680,5,42,15,11,16,1,90,38.20530411783905,-109.4028091
72681,5,42,15,11,16,1,90,38.20530411783905,-109.4025396
72682,4,42,16,11,15,1,89,38.20530411783905,-109.4022701
72683,5,40,16,11,14,1,87,38.20530411783905,-109.4020006
72684,6,38,16,11,13,2,86,38.20530411783905,-109.4017311
72685,7,39,16,13,15,1,91,38.20530411783905,-109.4014616
72686,7,41,15,12,15,1,91,38.20530411783905,-109.4011921
72687,7,41,15,12,15,1,91,38.20530411783905,-109.4009226
72688,7,41,15,12,15,1,91,38.20530411783905,-109.4006531
72689,7,41,15,11,16,0,90,38.20530411783905,-109.4003836
72690,7,40,15,12,16,0,90,38.20530411783905,-109.4001142
72691,8,39,15,13,16,0,91,38.20530411783905,-109.3998447
72692,10,38,15,13,15,0,91,38.20530411783905,-109.3995752
72693,11,37,15,14,15,0,92,38.20530411783905,-109.3993057
72694,11,36,15,15,15,0,92,38.20530411783905,-109.3990362
72695,12,35,14,16,15,0,92,38.20530411783905,-109.3987667
72696,11,35,14,15,15,0,90,38.20530411783905,-109.3984972
72697,11,35,14,14,15,0,89,38.20530411783905,-109.3982277
72698,12,35,14,13,14,0,88,38.20530411783905,-109.3979582
72699,12,35,14,13,15,0,89,38.20530411783905,-109.3976887
72700,13,35,14,13,15,0,90,38.20530411783905,-109.3974192
72701,15,34,14,12,15,0,90,38.20530411783905,-109.3971497
72702,15,34,14,12,15,0,90,38.20530411783905,-109.3968802
72703,12,34,14,13,15,0,88,38.20530411783905,-109.3966107
72704,11,35,14,14,16,0,90,38.20530411783905,-109.3963412
72705,12,35,14,15,16,0,92,38.20530411783905,-109.3960717
72706,12,35,14,13,16,0,90,38.20530411783905,-109.3958022
72707,12,35,14,12,16,0,89,38.20530411783905,-109.3955327
72708,11,36,13,14,16,0,90,38.20530411783905,-109.3952632
72709,10,37,14,13,17,0,91,38.20530411783905,-109.3949938
72710,8,38,14,13,17,0,90,38.20530411783905,-109.3947243
72711,7,39,14,13,17,0,90,38.20530411783905,-109.3944548
72712,7,39,14,12,18,0,90,38.20530411783905,-109.3941853
72713,9,38,14,13,17,0,91,38.20530411783905,-109.3939158
72714,11,39,13,12,17,0,92,38.20530411783905,-109.3936463
72715,9,40,14,12,17,0,92,38.20530411783905,-109.3933768
72716,6,40,14,12,18,0,90,38.20530411783905,-109.3931073
72717,5,41,14,12,18,0,90,38.20530411783905,-109.3928378
72718,7,39,13,12,16,0,87,38.20530411783905,-109.3925683
72719,5,38,10,7,13,2,75,38.20530411783905,-109.3922988
72720,2,40,9,5,11,3,70,38.20530411783905,-109.3920293
72721,2,40,8,5,9,4,68,38.20530411783905,-109.3917598
72722,2,36,8,5,6,5,62,38.20530411783905,-109.3914903
72723,1,28,9,6,10,8,62,38.20530411783905,-109.3912208
72724,1,23,11,15,14,6,70,38.20530411783905,-109.3909513
72725,7,20,12,21,17,5,82,38.20530411783905,-109.3906818
72726,5,19,12,19,29,5,89,38.20530411783905,-109.3904123
72727,1,20,12,19,30,7,89,38.20530411783905,-109.3901429
72728,2,19,10,23,30,6,90,38.20530411783905,-109.3898734
72729,3,18,10,26,28,5,90,38.20530411783905,-109.3896039
72730,3,16,10,28,27,4,88,38.20530411783905,-109.3893344
72731,4,17,11,26,30,2,90,38.20530411783905,-109.3890649
72732,3,20,11,25,30,2,91,38.20530411783905,-109.3887954
72733,3,22,12,20,28,3,88,38.20530411783905,-109.3885259
72734,2,23,12,20,26,3,86,38.20530411783905,-109.3882564
72735,3,26,13,21,23,3,89,38.20530411783905,-109.3879869
72736,3,27,12,18,22,4,86,38.20530411783905,-109.3877174
72737,3,29,11,16,23,4,86,38.20530411783905,-109.3874479
72738,3,26,12,16,23,5,85,38.20530411783905,-109.3871784
72739,2,22,12,23,23,5,87,38.20530411783905,-109.3869089
72740,3,19,12,27,23,5,89,38.20530411783905,-109.3866394
72741,3,17,12,25,24,8,89,38.20530411783905,-109.3863699
72742,4,15,11,25,25,7,87,38.20530411783905,-109.3861004
72743,3,17,11,22,28,6,87,38.20530411783905,-109.3858309
72744,3,20,12,17,29,6,87,38.20530411783905,-109.3855614
72745,2,21,12,17,29,5,86,38.20530411783905,-109.3852919
72746,2,22,12,18,28,4,86,38.20530411783905,-109.3850225
72747,2,24,12,18,25,5,86,38.20530411783905,-109.384753
72748,3,26,12,16,23,5,85,38.20530411783905,-109.3844835
72749,3,28,12,18,22,3,86,38.20530411783905,-109.384214
72750,5,28,10,24,19,1,87,38.20530411783905,-109.3839445
72751,3,26,9,27,18,1,84,38.20530411783905,-109.383675
72752,3,24,10,26,20,2,85,38.20530411783905,-109.3834055
72753,3,23,11,23,24,4,88,38.20530411783905,-109.383136
72754,3,22,12,17,28,6,88,38.20530411783905,-109.3828665
72755,3,21,12,16,18,9,79,38.20530411783905,-109.382597
72756,2,18,10,15,12,6,63,38.20530411783905,-109.3823275
72757,2,32,8,7,8,5,62,38.20530411783905,-109.382058
72758,2,40,7,6,8,3,66,38.20530411783905,-109.3817885
72759,2,43,7,7,9,2,70,38.20530411783905,-109.381519
72760,3,44,8,6,10,2,73,38.20530411783905,-109.3812495
72761,5,45,9,8,11,1,79,38.20530411783905,-109.38098
72762,5,45,9,8,12,1,80,38.20530411783905,-109.3807105
72763,5,46,9,7,12,1,80,38.20530411783905,-109.380441
72764,3,45,8,5,11,2,74,38.20530411783905,-109.3801716
72765,2,44,7,3,10,3,69,38.20530411783905,-109.3799021
72766,3,35,8,5,11,3,65,38.20530411783905,-109.3796326
72767,3,34,9,5,12,3,66,38.20530411783905,-109.3793631
72768,3,34,10,7,13,3,70,38.20530411783905,-109.3790936
72769,5,28,11,13,16,3,76,38.20530411783905,-109.3788241
72770,3,24,11,14,17,4,73,38.20530411783905,-109.3785546
72771,4,20,11,13,15,7,70,38.20530411783905,-109.3782851
72772,5,19,12,14,14,7,71,38.20530411783905,-109.3780156
72773,6,21,12,13,14,6,72,38.20530411783905,-109.3777461
72774,3,26,12,10,12,8,71,38.20530411783905,-109.3774766
72775,2,29,11,6,13,7,68,38.20530411783905,-109.3772071
72776,1,36,10,4,12,7,70,38.20530411783905,-109.3769376
72777,2,42,10,8,12,4,78,38.20530411783905,-109.3766681
72778,4,46,10,9,12,2,83,38.20530411783905,-109.3763986
72779,4,46,9,9,12,1,81,38.20530411783905,-109.3761291
72780,4,43,9,8,11,2,77,38.20530411783905,-109.3758596
72781,4,40,9,7,11,2,73,38.20530411783905,-109.3755901
72782,3,39,9,6,11,3,71,38.20530411783905,-109.3753206
72783,3,43,9,7,12,2,76,38.20530411783905,-109.3750512
72784,3,44,9,7,13,2,78,38.20530411783905,-109.3747817
72785,2,30,8,14,8,2,64,38.20530411783905,-109.3745122
72786,1,37,8,13,7,2,68,38.20530411783905,-109.3742427
72787,2,43,9,9,11,2,76,38.20530411783905,-109.3739732
72788,3,39,9,6,11,2,70,38.20530411783905,-109.3737037
72789,8,39,15,13,15,0,90,38.205034623253816,-109.4038871
72790,8,39,15,14,15,0,91,38.205034623253816,-109.4036176
72791,7,40,15,13,16,0,91,38.205034623253816,-109.4033481
72792,5,40,15,12,16,1,89,38.205034623253816,-109.4030786
72793,4,41,16,11,16,1,89,38.205034623253816,-109.4028091
72794,4,42,16,13,16,1,92,38.205034623253816,-109.4025396
72795,4,41,16,11,15,1,88,38.205034623253816,-109.4022701
72796,5,40,16,11,15,1,88,38.205034623253816,-109.4020006
72797,5,39,16,12,14,1,87,38.205034623253816,-109.4017311
72798,6,41,16,13,15,1,92,38.205034623253816,-109.4014616
72799,7,42,15,12,15,0,91,38.205034623253816,-109.4011921
72800,8,42,15,11,15,0,91,38.205034623253816,-109.4009226
72801,6,42,15,11,16,1,91,38.205034623253816,-109.4006531
72802,5,41,15,11,15,1,88,38.205034623253816,-109.4003836
72803,5,41,15,11,15,1,88,38.205034623253816,-109.4001142
72804,6,40,15,12,15,1,89,38.205034623253816,-109.3998447
72805,7,39,15,14,15,0,90,38.205034623253816,-109.3995752
72806,8,39,15,16,15,0,93,38.205034623253816,-109.3993057
72807,9,37,15,16,15,0,92,38.205034623253816,-109.3990362
72808,9,35,15,17,15,0,91,38.205034623253816,-109.3987667
72809,10,35,15,15,16,0,91,38.205034623253816,-109.3984972
72810,11,35,14,14,15,0,89,38.205034623253816,-109.3982277
72811,11,36,14,14,15,0,90,38.205034623253816,-109.3979582
72812,14,35,14,12,14,0,89,38.205034623253816,-109.3976887
72813,14,35,14,12,15,0,90,38.205034623253816,-109.3974192
72814,14,34,14,12,15,0,89,38.205034623253816,-109.3971497
72815,14,33,14,13,14,0,88,38.205034623253816,-109.3968802
72816,13,32,14,14,15,0,88,38.205034623253816,-109.3966107
72817,12,33,14,15,15,0,89,38.205034623253816,-109.3963412
72818,12,34,14,15,16,0,91,38.205034623253816,-109.3960717
72819,12,34,14,14,16,0,90,38.205034623253816,-109.3958022
72820,12,35,14,13,16,0,90,38.205034623253816,-109.3955327
72821,13,35,13,14,15,0,90,38.205034623253816,-109.3952632
72822,14,36,13,13,15,0,91,38.205034623253816,-109.3949938
72823,11,37,13,13,16,0,90,38.205034623253816,-109.3947243
72824,9,37,13,12,17,0,88,38.205034623253816,-109.3944548
72825,8,38,13,12,18,0,89,38.205034623253816,-109.3941853
72826,8,37,13,13,18,0,89,38.205034623253816,-109.3939158
72827,14,37,13,11,16,0,91,38.205034623253816,-109.3936463
72828,13,38,13,12,16,0,92,38.205034623253816,-109.3933768
72829,9,38,14,12,17,0,90,38.205034623253816,-109.3931073
72830,7,40,14,12,17,0,90,38.205034623253816,-109.3928378
72831,10,38,13,11,15,0,87,38.205034623253816,-109.3925683
72832,2,33,10,6,13,5,69,38.205034623253816,-109.3922988
72833,1,37,9,3,11,6,67,38.205034623253816,-109.3920293
72834,1,39,8,3,10,5,66,38.205034623253816,-109.3917598
72835,1,36,8,3,9,6,63,38.205034623253816,-109.3914903
72836,2,34,9,4,10,7,66,38.205034623253816,-109.3912208
72837,2,30,9,4,10,9,64,38.205034623253816,-109.3909513
72838,2,25,10,8,10,10,65,38.205034623253816,-109.3906818
72839,4,24,12,17,13,7,77,38.205034623253816,-109.3904123
72840,5,21,11,28,18,4,87,38.205034623253816,-109.3901429
72841,2,20,11,25,27,3,88,38.205034623253816,-109.3898734
72842,3,19,11,25,27,3,88,38.205034623253816,-109.3896039
72843,4,17,10,28,26,4,89,38.205034623253816,-109.3893344
72844,5,15,9,29,27,4,89,38.205034623253816,-109.3890649
72845,4,18,10,26,27,3,88,38.205034623253816,-109.3887954
72846,3,19,10,25,29,3,89,38.205034623253816,-109.3885259
72847,2,22,11,21,29,3,88,38.205034623253816,-109.3882564
72848,3,26,12,19,24,4,88,38.205034623253816,-109.3879869
72849,4,31,12,13,23,3,86,38.205034623253816,-109.3877174
72850,4,34,11,16,19,0,84,38.205034623253816,-109.3874479
72851,3,34,12,18,21,0,88,38.205034623253816,-109.3871784
72852,3,30,12,18,22,2,87,38.205034623253816,-109.3869089
72853,4,25,12,20,24,3,88,38.205034623253816,-109.3866394
72854,3,22,12,20,27,4,88,38.205034623253816,-109.3863699
72855,3,18,13,23,25,7,89,38.205034623253816,-109.3861004
72856,3,17,13,22,25,9,89,38.205034623253816,-109.3858309
72857,3,18,12,22,25,8,88,38.205034623253816,-109.3855614
72858,3,19,12,23,26,4,87,38.205034623253816,-109.3852919
72859,2,21,12,21,28,3,87,38.205034623253816,-109.3850225
72860,2,22,12,19,29,3,87,38.205034623253816,-109.384753
72861,2,23,12,19,25,4,85,38.205034623253816,-109.3844835
72862,3,26,12,18,23,4,86,38.205034623253816,-109.384214
72863,3,26,11,25,20,2,87,38.205034623253816,-109.3839445
72864,5,25,9,29,19,1,88,38.205034623253816,-109.383675
72865,4,24,9,27,19,1,84,38.205034623253816,-109.3834055
72866,3,24,9,28,19,2,85,38.205034623253816,-109.383136
72867,1,23,10,27,21,3,85,38.205034623253816,-109.3828665
72868,4,21,12,18,14,8,77,38.205034623253816,-109.382597
72869,4,22,10,7,12,7,62,38.205034623253816,-109.3823275
72870,2,33,8,5,8,6,62,38.205034623253816,-109.382058
72871,2,38,7,5,7,4,63,38.205034623253816,-109.3817885
72872,2,39,7,5,7,3,63,38.205034623253816,-109.381519
72873,2,43,7,4,8,3,67,38.205034623253816,-109.3812495
72874,2,41,8,6,9,2,68,38.205034623253816,-109.38098
72875,3,43,8,6,9,2,71,38.205034623253816,-109.3807105
72876,2,44,8,5,9,2,70,38.205034623253816,-109.380441
72877,2,42,7,4,9,3,67,38.205034623253816,-109.3801716
72878,2,41,7,2,9,3,64,38.205034623253816,-109.3799021
72879,3,28,8,5,12,5,61,38.205034623253816,-109.3796326
72880,4,25,10,9,14,5,67,38.205034623253816,-109.3793631
72881,5,24,11,15,17,3,75,38.205034623253816,-109.3790936
72882,14,23,11,17,17,2,84,38.205034623253816,-109.3788241
72883,11,21,11,21,18,4,86,38.205034623253816,-109.3785546
72884,7,21,11,21,22,7,89,38.205034623253816,-109.3782851
72885,4,22,12,21,22,9,90,38.205034623253816,-109.3780156
72886,3,23,12,22,21,7,88,38.205034623253816,-109.3777461
72887,5,24,11,22,18,5,85,38.205034623253816,-109.3774766
72888,3,23,12,10,11,9,68,38.205034623253816,-109.3772071
72889,2,34,10,7,12,6,71,38.205034623253816,-109.3769376
72890,1,40,9,5,11,4,70,38.205034623253816,-109.3766681
72891,2,41,8,4,11,4,70,38.205034623253816,-109.3763986
72892,2,38,8,4,10,3,65,38.205034623253816,-109.3761291
72893,2,35,8,4,9,3,61,38.205034623253816,-109.3758596
72894,2,31,8,4,10,4,59,38.205034623253816,-109.3755901
72895,2,30,8,4,10,4,58,38.205034623253816,-109.3753206
72896,2,36,8,5,10,4,65,38.205034623253816,-109.3750512
72897,2,35,8,6,9,5,65,38.205034623253816,-109.3747817
72898,1,30,7,13,6,3,60,38.205034623253816,-109.3745122
72899,1,37,7,11,6,3,65,38.205034623253816,-109.3742427
72900,2,38,8,5,10,3,66,38.205034623253816,-109.3739732
72901,2,40,9,5,10,3,69,38.205034623253816,-109.3737037
72902,5,40,16,11,15,1,88,38.20476512866858,-109.4022701
72903,5,39,16,11,15,2,88,38.20476512866858,-109.4020006
72904,5,39,16,11,14,1,86,38.20476512866858,-109.4017311
72905,7,40,16,11,15,1,90,38.20476512866858,-109.4014616
72906,7,40,15,12,15,1,90,38.20476512866858,-109.4011921
72907,8,41,15,12,16,0,92,38.20476512866858,-109.4009226
72908,6,41,15,12,16,0,90,38.20476512866858,-109.4006531
72909,5,40,15,12,15,1,88,38.20476512866858,-109.4003836
72910,5,40,15,10,15,2,87,38.20476512866858,-109.4001142
72911,5,40,15,12,15,1,88,38.20476512866858,-109.3998447
72912,6,40,16,15,15,1,93,38.20476512866858,-109.3995752
72913,7,39,16,16,15,0,93,38.20476512866858,-109.3993057
72914,8,39,15,16,15,0,93,38.20476512866858,-109.3990362
72915,9,36,15,15,16,0,91,38.20476512866858,-109.3987667
72916,10,35,15,15,16,0,91,38.20476512866858,-109.3984972
72917,10,35,15,15,15,0,90,38.20476512866858,-109.3982277
72918,11,35,14,15,15,0,90,38.20476512866858,-109.3979582
72919,14,34,14,13,14,0,89,38.20476512866858,-109.3976887
72920,11,36,14,13,15,0,89,38.20476512866858,-109.3974192
72921,10,35,14,14,16,0,89,38.20476512866858,-109.3971497
72922,11,34,14,14,16,0,89,38.20476512866858,-109.3968802
72923,12,33,14,14,15,0,88,38.20476512866858,-109.3966107
72924,11,33,14,15,16,0,89,38.20476512866858,-109.3963412
72925,10,34,15,16,16,0,91,38.20476512866858,-109.3960717
72926,11,34,15,15,16,0,91,38.20476512866858,-109.3958022
72927,12,35,14,14,16,0,91,38.20476512866858,-109.3955327
72928,14,35,14,13,15,0,91,38.20476512866858,-109.3952632
72929,14,35,13,12,15,0,89,38.20476512866858,-109.3949938
72930,13,36,13,11,15,0,88,38.20476512866858,-109.3947243
72931,11,36,13,12,16,0,88,38.20476512866858,-109.3944548
72932,9,37,14,13,17,0,90,38.20476512866858,-109.3941853
72933,8,37,14,13,17,0,89,38.20476512866858,-109.3939158
72934,12,37,13,12,16,0,90,38.20476512866858,-109.3936463
72935,13,37,13,12,16,0,91,38.20476512866858,-109.3933768
72936,12,37,13,12,16,0,90,38.20476512866858,-109.3931073
72937,10,37,14,12,17,0,90,38.20476512866858,-109.3928378
72938,10,38,14,13,15,0,90,38.20476512866858,-109.3925683
72939,5,34,11,10,14,2,76,38.20476512866858,-109.3922988
72940,2,35,10,5,13,5,70,38.20476512866858,-109.3920293
72941,1,38,10,2,12,6,69,38.20476512866858,-109.3917598
72942,1,38,9,3,10,5,66,38.20476512866858,-109.3914903
72943,1,35,8,4,8,7,63,38.20476512866858,-109.3912208
72944,2,35,8,4,9,5,63,38.20476512866858,-109.3909513
72945,2,35,8,4,9,6,64,38.20476512866858,-109.3906818
72946,1,26,9,5,9,9,59,38.20476512866858,-109.3904123
72947,4,20,11,18,13,5,71,38.20476512866858,-109.3901429
72948,4,23,12,28,20,3,90,38.20476512866858,-109.3898734
72949,2,23,12,22,25,3,87,38.20476512866858,-109.3896039
72950,2,21,11,22,27,3,86,38.20476512866858,-109.3893344
72951,3,17,10,26,26,4,86,38.20476512866858,-109.3890649
72952,5,14,9,29,27,5,89,38.20476512866858,-109.3887954
72953,6,13,8,32,26,6,91,38.20476512866858,-109.3885259
72954,9,16,8,29,25,5,92,38.20476512866858,-109.3882564
72955,17,23,9,22,22,2,95,38.20476512866858,-109.3879869
72956,7,36,12,14,18,1,88,38.20476512866858,-109.3877174
72957,3,41,11,11,15,1,82,38.20476512866858,-109.3874479
72958,4,44,12,11,16,0,87,38.20476512866858,-109.3871784
72959,5,39,12,12,17,1,86,38.20476512866858,-109.3869089
72960,4,34,12,15,20,2,87,38.20476512866858,-109.3866394
72961,5,28,12,19,21,2,87,38.20476512866858,-109.3863699
72962,4,26,12,21,22,3,88,38.20476512866858,-109.3861004
72963,4,24,11,24,21,4,88,38.20476512866858,-109.3858309
72964,3,21,11,25,22,4,86,38.20476512866858,-109.3855614
72965,2,19,11,23,26,5,86,38.20476512866858,-109.3852919
72966,4,16,10,22,28,6,86,38.20476512866858,-109.3850225
72967,5,17,10,22,28,6,88,38.20476512866858,-109.384753
72968,2,21,12,20,30,4,89,38.20476512866858,-109.3844835
72969,2,23,12,17,25,5,84,38.20476512866858,-109.384214
72970,3,25,12,18,24,5,87,38.20476512866858,-109.3839445
72971,3,24,11,22,25,3,88,38.20476512866858,-109.383675
72972,7,24,9,27,20,2,89,38.20476512866858,-109.3834055
72973,7,25,9,27,19,1,88,38.20476512866858,-109.383136
72974,4,23,9,28,18,2,84,38.20476512866858,-109.3828665
72975,4,24,10,20,16,4,78,38.20476512866858,-109.382597
72976,5,19,11,14,14,6,69,38.20476512866858,-109.3823275
72977,3,19,10,6,10,8,56,38.20476512866858,-109.382058
72978,3,25,8,5,10,7,58,38.20476512866858,-109.3817885
72979,4,30,8,5,10,4,61,38.20476512866858,-109.381519
72980,3,39,7,5,7,3,64,38.20476512866858,-109.3812495
72981,3,39,7,5,8,3,65,38.20476512866858,-109.38098
72982,2,41,7,4,8,3,65,38.20476512866858,-109.3807105
72983,2,41,7,3,8,3,64,38.20476512866858,-109.380441
72984,2,38,7,4,9,3,63,38.20476512866858,-109.3801716
72985,4,32,9,5,10,3,63,38.20476512866858,-109.3799021
72986,5,21,11,13,15,4,69,38.20476512866858,-109.3796326
72987,7,16,11,19,17,5,75,38.20476512866858,-109.3793631
72988,10,20,10,22,18,4,84,38.20476512866858,-109.3790936
72989,16,21,9,21,21,3,91,38.20476512866858,-109.3788241
72990,11,21,11,16,26,5,90,38.20476512866858,-109.3785546
72991,6,21,11,18,27,8,91,38.20476512866858,-109.3782851
72992,5,21,11,20,23,10,90,38.20476512866858,-109.3780156
72993,6,19,11,20,22,10,88,38.20476512866858,-109.3777461
72994,6,17,11,20,24,9,87,38.20476512866858,-109.3774766
72995,6,19,11,22,14,6,78,38.20476512866858,-109.3772071
72996,2,25,10,12,13,5,67,38.20476512866858,-109.3769376
72997,3,31,9,6,12,4,65,38.20476512866858,-109.3766681
72998,4,30,9,4,11,4,62,38.20476512866858,-109.3763986
72999,3,31,8,5,10,4,61,38.20476512866858,-109.3761291
73000,2,27,8,5,11,5,58,38.20476512866858,-109.3758596
73001,4,24,9,5,12,5,59,38.20476512866858,-109.3755901
73002,6,26,9,6,11,5,63,38.20476512866858,-109.3753206
73003,4,29,9,6,11,5,64,38.20476512866858,-109.3750512
73004,4,27,8,7,8,5,59,38.20476512866858,-109.3747817
73005,3,27,8,12,7,4,61,38.20476512866858,-109.3745122
73006,1,30,8,9,8,5,61,38.20476512866858,-109.3742427
73007,1,33,8,5,9,6,62,38.20476512866858,-109.3739732
73008,1,37,9,4,10,5,66,38.20476512866858,-109.3737037
73009,8,40,15,14,15,0,92,38.204495634083344,-109.4009226
73010,7,41,15,13,15,0,91,38.204495634083344,-109.4006531
73011,6,40,15,12,15,1,89,38.204495634083344,-109.4003836
73012,5,40,15,11,15,2,88,38.204495634083344,-109.4001142
73013,5,40,15,13,15,1,89,38.204495634083344,-109.3998447
73014,5,40,16,14,15,1,91,38.204495634083344,-109.3995752
73015,6,39,15,14,15,1,90,38.204495634083344,-109.3993057
73016,8,40,15,15,15,0,93,38.204495634083344,-109.3990362
73017,11,38,15,15,15,0,94,38.204495634083344,-109.3987667
73018,10,37,15,17,15,0,94,38.204495634083344,-109.3984972
73019,11,36,15,16,14,0,92,38.204495634083344,-109.3982277
73020,13,35,15,15,14,0,92,38.204495634083344,-109.3979582
73021,14,34,14,15,14,0,91,38.204495634083344,-109.3976887
73022,11,36,14,15,15,0,91,38.204495634083344,-109.3974192
73023,8,36,15,16,16,0,91,38.204495634083344,-109.3971497
73024,9,35,15,15,16,0,90,38.204495634083344,-109.3968802
73025,10,35,15,15,16,0,91,38.204495634083344,-109.3966107
73026,9,34,15,17,16,0,91,38.204495634083344,-109.3963412
73027,8,34,15,17,16,1,91,38.204495634083344,-109.3960717
73028,8,35,15,15,16,0,89,38.204495634083344,-109.3958022
73029,9,36,14,13,16,0,88,38.204495634083344,-109.3955327
73030,9,37,14,13,16,0,89,38.204495634083344,-109.3952632
73031,10,36,14,13,17,0,90,38.204495634083344,-109.3949938
73032,12,35,14,13,16,0,90,38.204495634083344,-109.3947243
73033,12,35,14,13,16,0,90,38.204495634083344,-109.3944548
73034,11,35,14,13,16,0,89,38.204495634083344,-109.3941853
73035,10,36,14,14,16,0,90,38.204495634083344,-109.3939158
73036,10,37,14,15,16,0,92,38.204495634083344,-109.3936463
73037,9,38,14,14,16,0,91,38.204495634083344,-109.3933768
73038,8,38,15,14,17,0,92,38.204495634083344,-109.3931073
73039,7,39,14,12,17,0,89,38.204495634083344,-109.3928378
73040,8,39,14,12,16,0,89,38.204495634083344,-109.3925683
73041,7,32,13,11,14,2,79,38.204495634083344,-109.3922988
73042,3,30,11,7,12,6,69,38.204495634083344,-109.3920293
73043,1,33,10,3,11,7,65,38.204495634083344,-109.3917598
73044,1,41,9,2,12,5,70,38.204495634083344,-109.3914903
73045,2,38,7,5,9,4,65,38.204495634083344,-109.3912208
73046,2,40,7,4,7,4,64,38.204495634083344,-109.3909513
73047,1,36,7,3,8,5,60,38.204495634083344,-109.3906818
73048,2,30,8,3,8,7,58,38.204495634083344,-109.3904123
73049,4,24,11,9,12,6,66,38.204495634083344,-109.3901429
73050,8,28,13,18,15,3,85,38.204495634083344,-109.3898734
73051,4,31,13,23,18,1,90,38.204495634083344,-109.3896039
73052,2,25,11,29,21,1,89,38.204495634083344,-109.3893344
73053,2,19,9,27,24,4,85,38.204495634083344,-109.3890649
73054,2,12,6,21,28,4,73,38.204495634083344,-109.3887954
73055,3,10,5,21,28,5,72,38.204495634083344,-109.3885259
73056,8,14,8,28,25,8,91,38.204495634083344,-109.3882564
73057,12,23,10,22,22,1,90,38.204495634083344,-109.3879869
73058,6,33,12,20,18,0,89,38.204495634083344,-109.3877174
73059,4,44,11,11,15,1,86,38.204495634083344,-109.3874479
73060,4,47,13,10,17,0,91,38.204495634083344,-109.3871784
73061,4,45,12,11,18,0,90,38.204495634083344,-109.3869089
73062,4,41,11,14,17,0,87,38.204495634083344,-109.3866394
73063,5,38,11,16,17,0,87,38.204495634083344,-109.3863699
73064,4,38,11,16,18,1,88,38.204495634083344,-109.3861004
73065,7,33,11,19,16,1,87,38.204495634083344,-109.3858309
73066,6,24,10,27,19,2,88,38.204495634083344,-109.3855614
73067,3,16,11,26,25,7,88,38.204495634083344,-109.3852919
73068,1,10,9,30,20,14,84,38.204495634083344,-109.3850225
73069,5,15,12,23,25,9,89,38.204495634083344,-109.384753
73070,2,20,13,22,27,5,89,38.204495634083344,-109.3844835
73071,2,23,12,18,26,5,86,38.204495634083344,-109.384214
73072,2,25,12,15,24,5,83,38.204495634083344,-109.3839445
73073,3,23,12,17,26,4,85,38.204495634083344,-109.383675
73074,4,24,11,19,23,4,85,38.204495634083344,-109.3834055
73075,6,25,11,22,20,3,87,38.204495634083344,-109.383136
73076,7,26,10,22,19,2,86,38.204495634083344,-109.3828665
73077,7,25,10,19,18,3,82,38.204495634083344,-109.382597
73078,6,23,11,17,18,4,79,38.204495634083344,-109.3823275
73079,5,20,12,13,14,7,71,38.204495634083344,-109.382058
73080,8,16,12,12,12,7,67,38.204495634083344,-109.3817885
73081,9,19,11,9,12,4,64,38.204495634083344,-109.381519
73082,3,32,8,6,10,5,64,38.204495634083344,-109.3812495
73083,3,34,7,5,10,3,62,38.204495634083344,-109.38098
73084,2,32,8,5,12,4,63,38.204495634083344,-109.3807105
73085,2,31,9,8,13,4,67,38.204495634083344,-109.380441
73086,4,27,10,13,14,3,71,38.204495634083344,-109.3801716
73087,7,23,12,19,17,2,80,38.204495634083344,-109.3799021
73088,5,20,10,25,19,4,83,38.204495634083344,-109.3796326
73089,6,21,11,23,23,4,88,38.204495634083344,-109.3793631
73090,9,23,11,20,24,4,91,38.204495634083344,-109.3790936
73091,8,23,11,20,25,3,90,38.204495634083344,-109.3788241
73092,4,21,11,20,28,4,88,38.204495634083344,-109.3785546
73093,4,19,10,22,25,8,88,38.204495634083344,-109.3782851
73094,5,18,10,22,24,11,90,38.204495634083344,-109.3780156
73095,4,16,10,21,25,11,87,38.204495634083344,-109.3777461
73096,4,16,10,20,25,11,86,38.204495634083344,-109.3774766
73097,6,16,11,25,19,8,85,38.204495634083344,-109.3772071
73098,5,17,11,19,15,4,71,38.204495634083344,-109.3769376
73099,4,26,10,9,14,4,67,38.204495634083344,-109.3766681
73100,6,27,9,6,13,4,65,38.204495634083344,-109.3763986
73101,5,26,9,7,11,5,63,38.204495634083344,-109.3761291
73102,5,20,11,11,14,5,66,38.204495634083344,-109.3758596
73103,7,20,12,14,15,4,72,38.204495634083344,-109.3755901
73104,8,21,12,14,14,4,73,38.204495634083344,-109.3753206
73105,6,39,15,13,15,1,89,38.204226139498104,-109.3993057
73106,8,39,15,15,15,0,92,38.204226139498104,-109.3990362
73107,10,37,15,15,15,0,92,38.204226139498104,-109.3987667
73108,10,37,15,16,15,0,93,38.204226139498104,-109.3984972
73109,12,37,15,15,14,0,93,38.204226139498104,-109.3982277
73110,15,35,15,15,14,0,94,38.204226139498104,-109.3979582
73111,14,34,15,16,14,0,93,38.204226139498104,-109.3976887
73112,14,35,15,15,14,0,93,38.204226139498104,-109.3974192
73113,12,35,15,15,15,0,92,38.204226139498104,-109.3971497
73114,10,34,15,16,16,0,91,38.204226139498104,-109.3968802
73115,9,34,15,17,16,0,91,38.204226139498104,-109.3966107
73116,9,34,15,18,15,0,91,38.204226139498104,-109.3963412
73117,9,35,15,17,15,0,91,38.204226139498104,-109.3960717
73118,8,36,15,15,16,0,90,38.204226139498104,-109.3958022
73119,7,37,15,13,17,0,89,38.204226139498104,-109.3955327
73120,6,37,15,12,17,1,88,38.204226139498104,-109.3952632
73121,8,37,15,13,17,0,90,38.204226139498104,-109.3949938
73122,9,35,15,14,16,0,89,38.204226139498104,-109.3947243
73123,11,35,15,15,16,0,92,38.204226139498104,-109.3944548
73124,11,34,15,15,16,0,91,38.204226139498104,-109.3941853
73125,10,35,15,15,16,0,91,38.204226139498104,-109.3939158
73126,10,36,15,14,16,0,91,38.204226139498104,-109.3936463
73127,9,37,15,15,16,0,92,38.204226139498104,-109.3933768
73128,8,38,15,14,17,0,92,38.204226139498104,-109.3931073
73129,8,39,15,13,17,0,92,38.204226139498104,-109.3928378
73130,6,37,14,12,16,1,86,38.204226139498104,-109.3925683
73131,8,31,13,12,14,2,80,38.204226139498104,-109.3922988
73132,6,29,11,8,12,4,70,38.204226139498104,-109.3920293
73133,2,30,10,5,11,7,65,38.204226139498104,-109.3917598
73134,1,36,9,3,12,6,67,38.204226139498104,-109.3914903
73135,2,36,8,5,9,4,64,38.204226139498104,-109.3912208
73136,3,40,7,4,7,4,65,38.204226139498104,-109.3909513
73137,2,35,7,4,7,5,60,38.204226139498104,-109.3906818
73138,2,28,7,4,8,6,55,38.204226139498104,-109.3904123
73139,5,22,11,10,10,6,64,38.204226139498104,-109.3901429
73140,6,30,13,16,15,3,83,38.204226139498104,-109.3898734
73141,4,33,12,22,17,2,90,38.204226139498104,-109.3896039
73142,3,25,11,26,20,1,86,38.204226139498104,-109.3893344
73143,2,18,9,27,26,4,86,38.204226139498104,-109.3890649
73144,1,11,6,21,27,5,71,38.204226139498104,-109.3887954
73145,3,10,6,22,27,4,72,38.204226139498104,-109.3885259
73146,4,12,7,27,26,5,81,38.204226139498104,-109.3882564
73147,8,22,9,25,23,2,89,38.204226139498104,-109.3879869
73148,10,29,10,23,17,0,89,38.204226139498104,-109.3877174
73149,6,44,11,10,15,0,86,38.204226139498104,-109.3874479
73150,5,47,12,10,17,0,91,38.204226139498104,-109.3871784
73151,4,45,12,10,18,0,89,38.204226139498104,-109.3869089
73152,4,40,11,11,17,0,83,38.204226139498104,-109.3866394
73153,5,35,12,12,16,1,81,38.204226139498104,-109.3863699
73154,4,32,11,13,14,2,76,38.204226139498104,-109.3861004
73155,7,35,12,15,15,0,84,38.204226139498104,-109.3858309
73156,6,27,11,24,18,1,87,38.204226139498104,-109.3855614
73157,6,19,12,19,27,7,90,38.204226139498104,-109.3852919
73158,1,8,8,22,21,18,78,38.204226139498104,-109.3850225
73159,2,12,10,22,18,18,82,38.204226139498104,-109.384753
73160,3,18,13,22,23,10,89,38.204226139498104,-109.3844835
73161,3,22,12,21,23,4,85,38.204226139498104,-109.384214
73162,4,24,11,18,23,4,84,38.204226139498104,-109.3839445
73163,4,23,12,17,26,4,86,38.204226139498104,-109.383675
73164,4,23,11,19,25,3,85,38.204226139498104,-109.3834055
73165,4,23,11,22,24,3,87,38.204226139498104,-109.383136
73166,5,25,11,24,21,3,89,38.204226139498104,-109.3828665
73167,9,27,10,20,20,2,88,38.204226139498104,-109.382597
73168,8,29,11,19,18,2,87,38.204226139498104,-109.3823275
73169,8,31,12,16,17,2,86,38.204226139498104,-109.382058
73170,10,26,11,17,17,2,83,38.204226139498104,-109.3817885
73171,10,23,11,18,15,2,79,38.204226139498104,-109.381519
73172,3,26,10,16,15,3,73,38.204226139498104,-109.3812495
73173,4,26,10,15,16,3,74,38.204226139498104,-109.38098
73174,4,23,10,16,17,3,73,38.204226139498104,-109.3807105
73175,4,20,10,23,18,2,77,38.204226139498104,-109.380441
73176,6,18,10,28,20,2,84,38.204226139498104,-109.3801716
73177,4,20,11,26,24,4,89,38.204226139498104,-109.3799021
73178,2,22,11,22,24,5,86,38.204226139498104,-109.3796326
73179,3,24,12,20,24,5,88,38.204226139498104,-109.3793631
73180,4,23,11,21,24,4,87,38.204226139498104,-109.3790936
73181,5,23,11,23,24,4,90,38.204226139498104,-109.3788241
73182,4,21,10,25,26,3,89,38.204226139498104,-109.3785546
73183,4,20,9,27,25,4,89,38.204226139498104,-109.3782851
73184,4,17,9,24,25,8,87,38.204226139498104,-109.3780156
73185,3,14,9,23,25,10,84,38.204226139498104,-109.3777461
73186,4,15,8,25,23,9,84,38.204226139498104,-109.3774766
73187,4,13,9,22,24,9,81,38.204226139498104,-109.3772071
73188,8,18,9,28,17,4,84,38.204226139498104,-109.3769376
73189,16,30,14,14,14,0,88,38.20395664491287,-109.3974192
73190,15,29,13,14,14,0,85,38.20395664491287,-109.3971497
73191,12,29,14,14,14,1,84,38.20395664491287,-109.3968802
73192,10,31,14,15,14,1,85,38.20395664491287,-109.3966107
73193,9,31,14,17,14,1,86,38.20395664491287,-109.3963412
73194,11,34,15,15,15,0,90,38.20395664491287,-109.3960717
73195,11,35,15,15,16,0,92,38.20395664491287,-109.3958022
73196,7,37,15,15,16,0,90,38.20395664491287,-109.3955327
73197,6,38,15,13,17,0,89,38.20395664491287,-109.3952632
73198,7,38,15,14,17,0,91,38.20395664491287,-109.3949938
73199,8,37,15,15,17,0,92,38.20395664491287,-109.3947243
73200,9,36,15,14,17,0,91,38.20395664491287,-109.3944548
73201,9,37,15,13,17,0,91,38.20395664491287,-109.3941853
73202,8,37,15,14,17,0,91,38.20395664491287,-109.3939158
73203,7,38,15,14,17,0,91,38.20395664491287,-109.3936463
73204,7,38,15,14,17,0,91,38.20395664491287,-109.3933768
73205,7,38,15,14,17,0,91,38.20395664491287,-109.3931073
73206,7,38,15,13,17,0,90,38.20395664491287,-109.3928378
73207,8,35,14,13,15,1,86,38.20395664491287,-109.3925683
73208,9,30,13,11,14,2,79,38.20395664491287,-109.3922988
73209,7,28,12,11,13,3,74,38.20395664491287,-109.3920293
73210,3,28,11,8,12,5,67,38.20395664491287,-109.3917598
73211,1,33,9,4,11,6,64,38.20395664491287,-109.3914903
73212,1,35,8,2,10,6,62,38.20395664491287,-109.3912208
73213,2,39,8,4,8,4,65,38.20395664491287,-109.3909513
73214,2,35,7,4,8,4,60,38.20395664491287,-109.3906818
73215,2,27,8,3,10,6,56,38.20395664491287,-109.3904123
73216,9,21,12,13,11,3,69,38.20395664491287,-109.3901429
73217,6,32,13,21,17,1,90,38.20395664491287,-109.3898734
73218,4,30,12,28,17,1,92,38.20395664491287,-109.3896039
73219,2,24,11,29,21,1,88,38.20395664491287,-109.3893344
73220,2,19,10,26,27,4,88,38.20395664491287,-109.3890649
73221,0,12,6,18,27,6,69,38.20395664491287,-109.3887954
73222,1,11,6,22,25,5,70,38.20395664491287,-109.3885259
73223,2,12,7,24,24,5,74,38.20395664491287,-109.3882564
73224,5,21,8,28,22,4,88,38.20395664491287,-109.3879869
73225,15,28,10,23,15,0,91,38.20395664491287,-109.3877174
73226,6,42,12,12,15,0,87,38.20395664491287,-109.3874479
73227,5,46,12,9,17,0,89,38.20395664491287,-109.3871784
73228,5,44,12,11,16,0,88,38.20395664491287,-109.3869089
73229,4,38,12,16,13,1,84,38.20395664491287,-109.3866394
73230,4,33,12,18,13,1,81,38.20395664491287,-109.3863699
73231,3,30,12,23,15,1,84,38.20395664491287,-109.3861004
73232,5,28,12,24,18,1,88,38.20395664491287,-109.3858309
73233,9,22,12,20,20,5,88,38.20395664491287,-109.3855614
73234,3,15,11,17,27,18,91,38.20395664491287,-109.3852919
73235,2,10,11,17,26,22,88,38.20395664491287,-109.3850225
73236,2,15,13,19,27,16,92,38.20395664491287,-109.384753
73237,3,19,13,21,25,8,89,38.20395664491287,-109.3844835
73238,3,21,12,20,25,4,85,38.20395664491287,-109.384214
73239,3,22,11,18,26,3,83,38.20395664491287,-109.3839445
73240,5,21,11,17,28,3,85,38.20395664491287,-109.383675
73241,5,20,10,23,27,2,87,38.20395664491287,-109.3834055
73242,5,21,10,25,26,2,89,38.20395664491287,-109.383136
73243,5,22,10,26,23,3,89,38.20395664491287,-109.3828665
73244,7,26,11,22,20,3,89,38.20395664491287,-109.382597
73245,5,28,12,20,20,3,88,38.20395664491287,-109.3823275
73246,6,31,11,18,19,1,86,38.20395664491287,-109.382058
73247,6,29,11,21,18,1,86,38.20395664491287,-109.3817885
73248,6,25,10,24,18,1,84,38.20395664491287,-109.381519
73249,7,22,9,25,20,2,85,38.20395664491287,-109.3812495
73250,7,21,10,26,19,2,85,38.20395664491287,-109.38098
73251,7,21,9,26,19,2,84,38.20395664491287,-109.3807105
73252,7,23,9,25,21,2,87,38.20395664491287,-109.380441
73253,7,24,10,23,22,3,89,38.20395664491287,-109.3801716
73254,5,25,10,26,21,2,89,38.20395664491287,-109.3799021
73255,5,24,10,25,21,3,88,38.20395664491287,-109.3796326
73256,4,23,11,25,22,3,88,38.20395664491287,-109.3793631
73257,4,22,11,24,23,4,88,38.20395664491287,-109.3790936
73258,5,22,10,24,23,3,87,38.20395664491287,-109.3788241
73259,6,22,9,27,23,2,89,38.20395664491287,-109.3785546
73260,4,22,9,26,24,3,88,38.20395664491287,-109.3782851
73261,6,36,15,14,16,1,88,38.20368715032764,-109.3952632
73262,7,37,16,16,16,0,92,38.20368715032764,-109.3949938
73263,7,37,16,14,16,1,91,38.20368715032764,-109.3947243
73264,6,38,16,13,17,1,91,38.20368715032764,-109.3944548
73265,6,38,16,13,17,1,91,38.20368715032764,-109.3941853
73266,6,38,16,13,17,1,91,38.20368715032764,-109.3939158
73267,7,39,15,14,17,0,92,38.20368715032764,-109.3936463
73268,6,39,16,14,17,0,92,38.20368715032764,-109.3933768
73269,6,39,15,14,17,0,91,38.20368715032764,-109.3931073
73270,6,38,14,13,16,0,87,38.20368715032764,-109.3928378
73271,6,36,14,14,14,1,85,38.20368715032764,-109.3925683
73272,8,29,12,11,13,2,75,38.20368715032764,-109.3922988
73273,11,26,11,10,13,2,73,38.20368715032764,-109.3920293
73274,5,26,9,8,13,3,64,38.20368715032764,-109.3917598
73275,2,32,9,6,12,4,65,38.20368715032764,-109.3914903
73276,1,40,8,3,9,6,67,38.20368715032764,-109.3912208
73277,2,38,7,4,9,4,64,38.20368715032764,-109.3909513
73278,1,32,7,3,9,5,57,38.20368715032764,-109.3906818
73279,2,25,8,4,9,8,56,38.20368715032764,-109.3904123
73280,4,24,12,9,10,7,66,38.20368715032764,-109.3901429
73281,7,32,14,16,15,3,87,38.20368715032764,-109.3898734
73282,5,29,13,23,17,2,89,38.20368715032764,-109.3896039
73283,3,24,12,26,22,3,90,38.20368715032764,-109.3893344
73284,1,19,10,26,27,3,86,38.20368715032764,-109.3890649
73285,2,17,9,27,25,6,86,38.20368715032764,-109.3887954
73286,2,14,8,27,24,6,81,38.20368715032764,-109.3885259
73287,2,16,10,27,24,6,85,38.20368715032764,-109.3882564
73288,5,24,11,23,23,2,88,38.20368715032764,-109.3879869
73289,9,35,12,20,16,0,92,38.20368715032764,-109.3877174
73290,4,44,12,10,18,0,88,38.20368715032764,-109.3874479
73291,5,45,12,10,16,0,88,38.20368715032764,-109.3871784
73292,6,42,12,12,17,0,89,38.20368715032764,-109.3869089
73293,5,35,13,21,15,0,89,38.20368715032764,-109.3866394
73294,4,26,11,25,18,1,85,38.20368715032764,-109.3863699
73295,3,21,11,26,21,3,85,38.20368715032764,-109.3861004
73296,2,21,11,25,24,3,86,38.20368715032764,-109.3858309
73297,2,20,11,24,26,5,88,38.20368715032764,-109.3855614
73298,2,18,12,25,24,9,90,38.20368715032764,-109.3852919
73299,2,16,13,26,23,9,89,38.20368715032764,-109.3850225
73300,3,19,13,20,27,7,89,38.20368715032764,-109.384753
73301,2,19,12,19,28,5,85,38.20368715032764,-109.3844835
73302,2,20,12,19,29,4,86,38.20368715032764,-109.384214
73303,3,20,11,18,30,4,86,38.20368715032764,-109.3839445
73304,4,20,12,18,28,4,86,38.20368715032764,-109.383675
73305,4,21,12,20,29,4,90,38.20368715032764,-109.3834055
73306,4,21,11,21,28,3,88,38.20368715032764,-109.383136
73307,4,22,11,21,26,3,87,38.20368715032764,-109.3828665
73308,4,23,11,20,24,4,86,38.20368715032764,-109.382597
73309,3,24,12,20,23,5,87,38.20368715032764,-109.3823275
73310,3,24,12,21,21,4,85,38.20368715032764,-109.382058
73311,3,24,12,22,22,4,87,38.20368715032764,-109.3817885
73312,2,24,12,21,25,4,88,38.20368715032764,-109.381519
73313,2,22,12,20,27,4,87,38.20368715032764,-109.3812495
73314,3,22,12,21,24,4,86,38.20368715032764,-109.38098
73315,7,24,10,9,11,3,64,38.20341766,-109.3922988
73316,5,25,8,7,10,3,58,38.20341766,-109.3920293
73317,2,31,8,6,10,3,60,38.20341766,-109.3917598
73318,1,38,7,4,10,3,63,38.20341766,-109.3914903
73319,1,39,7,3,9,4,63,38.20341766,-109.3912208
73320,2,38,7,4,8,3,62,38.20341766,-109.3909513
73321,1,32,7,4,9,5,58,38.20341766,-109.3906818
73322,3,25,9,6,11,6,60,38.20341766,-109.3904123
73323,8,30,14,15,13,4,84,38.20341766,-109.3901429
73324,7,32,14,15,18,3,89,38.20341766,-109.3898734
73325,4,29,13,23,18,3,90,38.20341766,-109.3896039
73326,2,24,12,25,22,3,88,38.20341766,-109.3893344
73327,2,21,10,28,24,3,88,38.20341766,-109.3890649
73328,4,19,10,30,22,3,88,38.20341766,-109.3887954
73329,3,20,10,28,23,3,87,38.20341766,-109.3885259
73330,3,24,11,25,21,3,87,38.20341766,-109.3882564
73331,5,33,12,17,20,2,89,38.20341766,-109.3879869
73332,6,41,12,10,19,1,89,38.20341766,-109.3877174
73333,4,43,12,10,17,1,87,38.20341766,-109.3874479
73334,5,45,12,10,16,1,89,38.20341766,-109.3871784
73335,8,36,12,15,17,1,89,38.20341766,-109.3869089
73336,8,25,12,22,18,3,88,38.20341766,-109.3866394
73337,3,19,12,21,26,5,86,38.20341766,-109.3863699
73338,4,19,12,17,29,6,87,38.20341766,-109.3861004
73339,4,18,11,24,26,5,88,38.20341766,-109.3858309
73340,4,18,11,23,25,6,87,38.20341766,-109.3855614
73341,4,18,11,23,25,6,87,38.20341766,-109.3852919
73342,3,18,11,24,26,4,86,38.20341766,-109.3850225
73343,3,18,12,20,28,4,85,38.20341766,-109.384753
73344,3,19,12,19,29,4,86,38.20341766,-109.3844835
73345,3,20,12,17,30,4,86,38.20341766,-109.384214
73346,3,20,12,14,31,5,85,38.20341766,-109.3839445
,,,,,,,,,
min,0,0,0,0,0,0,,,
max,59,66,24,41,35,44,min,16,
median,4,35,12,6,12,4,max,101,
mean,6.181956999,33.84359278,12.25701119,7.423425634,11.35959208,7.967387896,medium,81,
,,,,,,,mean,79.03296658,
